,code,date,rate,pre_close,close,diff,volume
0,96770,2021-05-14,0.04263565891472868,258000,269000,11000,883903
1,96770,2021-05-04,0.07045009784735812,255500,273500,18000,1215923
2,96770,2021-05-03,0.05545286506469501,270500,255500,-15000,1122359
3,96770,2021-04-12,0.11974789915966387,238000,266500,28500,4266364
4,96770,2021-04-08,0.047311827956989246,232500,243500,11000,1121741
5,96770,2021-04-01,0.10273972602739725,219000,241500,22500,3578846
6,96770,2021-03-30,0.08780487804878048,205000,223000,18000,1439750
7,96770,2021-03-16,0.05689277899343545,228500,215500,-13000,2124858
8,96770,2021-03-15,0.0577319587628866,242500,228500,-14000,1316842
9,96770,2021-03-11,0.06858407079646017,226000,241500,15500,1171776
10,96770,2021-03-08,0.0496031746031746,252021-05-24,0.0434782608695652,12000,239500,-12500,1043253
11,96770,2021-03-05,0.045454545454545456,264000,252000,-12000,1331646
12,96770,2021-02-24,0.0632688927943761,284500,266500,-18000,1188062
13,96770,2021-02-22,0.04054054054054054,296000,284000,-12000,1093541
14,96770,2021-02-17,0.043936731107205626,284500,297000,12500,1890952
15,96770,2021-02-15,0.04215851602023609,296500,284000,-12500,3822679
16,96770,2021-02-08,0.07401315789473684,304000,281500,-22500,2914442
17,96770,2021-02-05,0.04100946372239748,317000,304000,-13000,2736810
18,96770,2021-02-01,0.12857142857142856,280000,316000,36000,3348470
19,96770,2021-01-19,0.06930693069306931,252500,270000,17500,1921736
20,96770,2021-01-14,0.06761565836298933,281000,262000,-19000,2611650
21,96770,2021-01-08,0.07604562737642585,263000,283000,20000,3408996
22,96770,2021-01-06,0.05327868852459016,244000,257000,13000,4279330
23,96770,2021-01-05,0.05627705627705628,231000,244000,13000,3195931
24,96770,2021-01-04,0.21578947368421053,190000,231000,41000,4269290
25,96770,2020-12-09,0.05113636363636364,176000,185000,9000,1818578
26,96770,2020-12-01,0.05491329479768786,173000,182500,9500,1433423
27,96770,2020-11-26,0.07033639143730887,163500,175000,11500,1984163
28,96770,2020-11-09,0.10954063604240283,141500,157000,15500,2099423
29,96770,2020-11-05,0.045454545454545456,132000,138000,6000,1075695
30,96770,2020-11-03,0.07346938775510205,122500,131500,9000,831848
31,96770,2020-09-24,0.06418918918918919,148000,138500,-9500,872556
32,96770,2020-09-22,0.04126984126984127,157500,151000,-6500,801039
33,96770,2020-09-10,0.0821917808219178,146000,158000,12000,1781157
34,96770,2020-08-31,0.07643312101910828,157000,145000,-12000,2094753
35,96770,2020-08-27,0.051829268292682924,164000,155500,-8500,1783453
36,96770,2020-08-25,0.07213114754098361,152500,163500,11000,1600600
37,96770,2020-08-20,0.054878048780487805,164000,155000,-9000,1211612
38,96770,2020-08-18,0.06686046511627906,172000,160500,-11500,1703952
39,96770,2020-08-14,0.054945054945054944,182000,172000,-10000,1615501
40,96770,2020-08-07,0.12538226299694188,163500,184000,20500,6000468
41,96770,2020-08-05,0.20454545454545456,132000,159000,27000,6130458
42,96770,2020-07-22,0.08,125000,135000,10000,2025022
43,96770,2020-06-29,0.04411764705882353,136000,130000,-6000,955726
44,96770,2020-06-24,0.06640625,128000,136500,8500,1754143
45,96770,2020-06-17,0.0815450643776824,116500,126000,9500,2417549
46,96770,2020-06-16,0.09389671361502347,106500,116500,10000,1091035
47,96770,2020-06-15,0.07391304347826087,115000,106500,-8500,1106675
48,96770,2020-06-12,0.04564315352697095,120500,115000,-5500,1153794
49,96770,2020-06-01,0.046413502109704644,118500,124000,5500,664521
50,96770,2020-05-26,0.14150943396226415,106000,121000,15000,2739083
51,96770,2020-05-19,0.06921487603305786,96800,103500,6700,1724747
52,96770,2020-04-13,0.041791044776119404,100500,96300,-4200,778610
53,96770,2020-04-09,0.04700854700854701,93600,98000,4400,1180802
54,96770,2020-04-06,0.05239687848383501,89700,94400,4700,1393130
55,96770,2020-04-02,0.09575757575757576,82500,90400,7900,2074973
56,96770,2020-04-01,0.05172413793103448,87000,82500,-4500,835614
57,96770,2020-03-26,0.05555555555555555,90000,85000,-5000,3277516
58,96770,2020-03-25,0.25,72000,90000,18000,2877009
59,96770,2020-03-24,0.19402985074626866,60300,72000,11700,1571585
60,96770,2020-03-23,0.06944444444444445,64800,60300,-4500,1162459
61,96770,2020-03-20,0.13089005235602094,57300,64800,7500,1719407
62,96770,2020-03-19,0.1918194640338505,70900,57300,-13600,2188651
63,96770,2020-03-18,0.08985879332477535,77900,70900,-7000,919817
64,96770,2020-03-16,0.07283236994219654,86500,80200,-6300,1113686
65,96770,2020-03-13,0.06385281385281386,92400,86500,-5900,1232107
66,96770,2020-03-12,0.05714285714285714,98000,92400,-5600,1006172
67,96770,2020-03-09,0.0824074074074074,108000,99100,-8900,1440983
68,96770,2020-03-06,0.04424778761061947,113000,108000,-5000,827288
69,96770,2020-02-24,0.05363984674329502,130500,123500,-7000,531391
70,96770,2020-02-05,0.046875,128000,134000,6000,1477432
71,96770,2020-02-03,0.05,130000,123500,-6500,784715
72,96770,2020-01-31,0.04,125000,130000,5000,1239192
73,96770,2020-01-08,0.05190311418685121,144500,137000,-7500,703267
74,96770,2019-08-30,0.057692307692307696,156000,165000,9000,355730
75,96770,2019-07-11,0.04229607250755287,165500,172500,7000,384074
76,96770,2019-07-04,0.05864197530864197,162000,171500,9500,520983
77,96770,2019-04-15,0.04594594594594595,185000,193500,8500,487399
78,96770,2019-01-02,0.0584958217270195,179500,169000,-10500,475975
79,96770,2018-11-01,0.05152224824355972,213500,202500,-11000,308901
80,96770,2018-10-11,0.046296296296296294,216000,206000,-10000,280235
81,96770,2018-07-02,0.06930693069306931,202000,188000,-14000,613068
82,96770,2018-05-04,0.043583535108958835,206500,197500,-9000,390566
83,96770,2018-05-02,0.061068702290076333,196500,208500,12000,624815
84,96770,2018-03-12,0.0488997555012225,204500,214500,10000,377770
85,96770,2018-02-26,0.047619047619047616,199500,209000,9500,500147
86,96770,2018-01-29,0.06060606060606061,198000,210000,12000,633031
87,96770,2017-08-24,0.04093567251461988,171000,178000,7000,405005
88,96770,2017-08-04,0.043478260869565216,172500,180000,7500,313745
89,96770,2017-01-03,0.05442176870748299,147000,155000,8000,487764
90,96770,2016-11-10,0.05901639344262295,152500,161500,9000,382468
91,96770,2016-09-29,0.05211726384364821,153500,161500,8000,697944
92,96770,2016-08-23,0.04262295081967213,152500,146000,-6500,477003
93,278530,2021-01-08,0.045895522388059704,13400,14015,615,661826
94,278530,2020-06-16,0.054164239953407106,8585,9050,465,461987
95,278530,2020-06-15,0.046640755136035536,9005,8585,-420,451938
96,278530,2020-04-01,0.044854881266490766,7580,7240,-340,430499
97,278530,2020-03-25,0.05677785663591199,7045,7445,400,3021485
98,278530,2020-03-24,0.08551617873651772,6490,7045,555,1349958
99,278530,2020-03-23,0.05116959064327485,6840,6490,-350,306679
100,278530,2020-03-20,0.07462686567164178,6365,6840,475,626680
101,278530,2020-03-19,0.07552650689905592,6885,6365,-520,2282123
102,278530,2020-03-18,0.05099931082012405,7255,6885,-370,1002904
103,278530,2020-03-09,0.042165242165242166,8775,8405,-370,527736
104,278530,2018-10-11,0.04009034443817053,8855,8500,-355,880361
105,11780,2021-05-26,0.04194260485651214,226500,236000,9500,440802
106,11780,2021-05-21,0.04925053533190578,233500,222000,-11500,626952
107,11780,2021-05-17,0.06762295081967214,244000,227500,-16500,804028
108,11780,2021-05-13,0.05588822355289421,250500,236500,-14000,1178557
109,11780,2021-05-12,0.05113636363636364,264000,250500,-13500,925915
110,11780,2021-05-11,0.04864864864864865,277500,264000,-13500,918965
111,11780,2021-05-07,0.05067567567567568,296000,281000,-15000,1118955
112,11780,2021-05-06,0.0962962962962963,270000,296000,26000,2085191
113,11780,2021-04-28,0.07027027027027027,277500,258000,-19500,935010
114,11780,2021-04-21,0.05420560747663551,267500,282000,14500,1074273
115,11780,2021-04-19,0.06,250000,265000,15000,778193
116,11780,2021-04-05,0.04669260700389105,257000,245000,-12000,585049
117,11780,2021-03-29,0.08786610878661087,239000,260000,21000,2005314
118,11780,2021-03-26,0.0598669623059867,225500,239000,13500,1296751
119,11780,2021-03-19,0.04708520179372197,223000,233500,10500,668468
120,11780,2021-03-15,0.0735930735930736,231000,214000,-17000,648067
121,11780,2021-03-12,0.04054054054054054,222000,231000,9000,729949
122,11780,2021-03-11,0.06220095693779904,209000,222000,13000,667625
123,11780,2021-03-09,0.053117782909930716,216500,205000,-11500,614628
124,11780,2021-03-08,0.07478632478632478,234000,216500,-17500,482484
125,11780,2021-03-03,0.08373205741626795,209000,226500,17500,848949
126,11780,2021-02-26,0.04308390022675737,220500,211000,-9500,622167
127,11780,2021-02-25,0.047505938242280284,210500,220500,10000,538615
128,11780,2021-02-24,0.09071274298056156,231500,210500,-21000,937047
129,11780,2021-02-22,0.07014028056112225,249500,232000,-17500,680371
130,11780,2021-02-08,0.05244122965641953,276500,262000,-14500,713052
131,11780,2021-02-05,0.09288537549407115,253000,276500,23500,1873503
132,11780,2021-01-29,0.10649819494584838,277000,247500,-29500,2025982
133,11780,2021-01-28,0.2311111111111111,225000,277000,52000,3611897
134,11780,2021-01-26,0.12213740458015267,196500,220500,24000,922812
135,11780,2021-01-21,0.08139534883720931,172000,186000,14000,835900
136,11780,2021-01-20,0.04242424242424243,165000,172000,7000,285181
137,11780,2021-01-14,0.05846153846153846,162500,172000,9500,463623
138,11780,2021-01-11,0.04776119402985075,167500,159500,-8000,524432
139,11780,2021-01-07,0.06501547987616099,161500,172000,10500,530278
140,11780,2021-01-05,0.076158940397351,151000,162500,11500,905999
141,11780,2021-01-04,0.041379310344827586,145000,151000,6000,360114
142,11780,2020-12-16,0.08888888888888889,135000,147000,12000,861714
143,11780,2020-11-24,0.050335570469798654,149000,141500,-7500,640945
144,11780,2020-11-19,0.05964912280701754,142500,151000,8500,508080
145,11780,2020-11-18,0.05555555555555555,135000,142500,7500,582475
146,11780,2020-11-10,0.1111111111111111,153000,136000,-17000,877923
147,11780,2020-11-05,0.1449814126394052,134500,154000,19500,614061
148,11780,2020-10-27,0.0528169014084507,142000,134500,-7500,274299
149,11780,2020-10-16,0.059233449477351915,143500,135000,-8500,323399
150,11780,2020-10-08,0.10588235294117647,127500,141000,13500,584077
151,11780,2020-10-07,0.04081632653061224,122500,127500,5000,273734
152,11780,2020-10-05,0.07727272727272727,110000,118500,8500,346158
153,11780,2020-09-28,0.10187110187110188,96200,106000,9800,407438
154,11780,2020-09-14,0.045,100000,104500,4500,235136
155,11780,2020-09-08,0.10493273542600896,111500,99800,-11700,362556
156,11780,2020-09-07,0.1365953109072375,98100,111500,13400,448358
157,11780,2020-08-19,0.04,100000,104000,4000,192293
158,11780,2020-08-07,0.07045454545454545,88000,94200,6200,463565
159,11780,2020-08-05,0.04232164449818621,82700,86200,3500,212410
160,11780,2020-07-15,0.054958183990442055,83700,88300,4600,554799
161,11780,2020-07-14,0.05548549810844893,79300,83700,4400,550286
162,11780,2020-07-13,0.10599721059972106,71700,79300,7600,621466
163,11780,2020-06-25,0.04258064516129032,77500,74200,-3300,140052
164,11780,2020-06-19,0.04825737265415549,74600,78200,3600,345894
165,11780,2020-06-16,0.11594202898550725,69000,77000,8000,417830
166,11780,2020-06-11,0.04681404421326398,76900,73300,-3600,316903
167,11780,2020-06-03,0.04507042253521127,71000,74200,3200,490051
168,11780,2020-05-07,0.05043227665706052,69400,72900,3500,390709
169,11780,2020-05-04,0.07460732984293193,76400,70700,-5700,368916
170,11780,2020-04-27,0.07768361581920905,70800,76300,5500,394219
171,11780,2020-04-23,0.06716417910447761,67000,71500,4500,344644
172,11780,2020-04-01,0.05092592592592592,64800,61500,-3300,183538
173,11780,2020-03-31,0.05194805194805195,61600,64800,3200,267827
174,11780,2020-03-30,0.051194539249146756,58600,61600,3000,359271
175,11780,2020-03-27,0.05206463195691203,55700,58600,2900,368634
176,11780,2020-03-25,0.04395604395604396,54600,57000,2400,233039
177,11780,2020-03-20,0.2992036405005688,43950,57100,13150,222820
178,11780,2020-03-19,0.13654223968565815,50900,43950,-6950,198103
179,11780,2020-03-17,0.04,52500,50400,-2100,153508
180,11780,2020-03-13,0.06944444444444445,57600,53600,-4000,196782
181,11780,2020-03-12,0.0754414125200642,62300,57600,-4700,256224
182,11780,2020-03-09,0.04186046511627907,64500,61800,-2700,192663
183,11780,2020-03-05,0.06623586429725363,61900,66000,4100,226620
184,11780,2020-03-04,0.05811965811965812,58500,61900,3400,180579
185,11780,2020-02-28,0.049679487179487176,62400,59300,-3100,220357
186,11780,2020-02-06,0.07099697885196375,66200,70900,4700,238530
187,11780,2020-01-31,0.07887323943661972,71000,65400,-5600,479667
188,11780,2020-01-28,0.04993429697766097,76100,72300,-3800,171215
189,11780,2020-01-08,0.04903225806451613,77500,73700,-3800,142062
190,11780,2019-11-25,0.07475317348377997,70900,76200,5300,250017
191,11780,2019-11-04,0.04090267983074753,70900,73800,2900,357952
192,11780,2019-08-26,0.04456824512534819,71800,68600,-3200,178761
193,11780,2019-08-06,0.044897959183673466,73500,70200,-3300,239754
194,11780,2019-08-05,0.07547169811320754,79500,73500,-6000,229740
195,11780,2019-06-24,0.04205128205128205,97500,93400,-4100,171185
196,11780,2019-06-10,0.046858359957401494,93900,98300,4400,108300
197,11780,2019-05-02,0.06209150326797386,91800,97500,5700,320936
198,11780,2019-04-17,0.04334677419354839,99200,94900,-4300,386798
199,11780,2019-03-19,0.04040404040404041,99000,95000,-4000,178702
200,11780,2019-03-15,0.04253112033195021,96400,100500,4100,202474
201,11780,2019-02-25,0.04079497907949791,95600,99500,3900,233946
202,11780,2019-02-20,0.07897664071190211,89900,97000,7100,466078
203,11780,2019-02-07,0.042081949058693245,90300,86500,-3800,203199
204,11780,2019-01-07,0.10648714810281518,81700,90400,8700,349107
205,11780,2018-12-10,0.05995475113122172,88400,83100,-5300,188085
206,11780,2018-11-12,0.041189931350114416,87400,91000,3600,137966
207,11780,2018-11-06,0.058394160583941604,95900,90300,-5600,189049
208,11780,2018-11-02,0.07834101382488479,86800,93600,6800,263126
209,11780,2018-10-31,0.0423728813559322,82600,86100,3500,150418
210,11780,2018-10-23,0.04927211646136618,89300,84900,-4400,140179
211,11780,2018-10-22,0.05430932703659976,84700,89300,4600,124410
212,11780,2018-10-12,0.0428921568627451,81600,85100,3500,165410
213,11780,2018-10-11,0.059907834101382486,86800,81600,-5200,220892
214,11780,2018-10-05,0.04789053591790194,87700,83500,-4200,290954
215,11780,2018-10-01,0.09644670050761421,98500,89000,-9500,363084
216,11780,2018-09-17,0.041176470588235294,102000,97800,-4200,194237
217,11780,2018-08-06,0.07692307692307693,110500,102000,-8500,384941
218,11780,2018-08-03,0.05238095238095238,105000,110500,5500,190338
219,11780,2018-08-01,0.06637168141592921,113000,105500,-7500,262673
220,11780,2018-07-16,0.05701754385964912,114000,107500,-6500,183133
221,11780,2018-06-21,0.06220095693779904,104500,111000,6500,257058
222,11780,2018-06-14,0.04433497536945813,101500,106000,4500,309391
223,11780,2018-05-25,0.04186046511627907,107500,103000,-4500,109801
224,11780,2018-05-23,0.04954954954954955,111000,105500,-5500,183724
225,11780,2018-04-30,0.09693877551020408,98000,107500,9500,663667
226,11780,2018-04-27,0.043663471778487756,93900,98000,4100,262147
227,11780,2018-04-12,0.05183585313174946,92600,97400,4800,197167
228,11780,2018-04-06,0.041928721174004195,95400,91400,-4000,146214
229,11780,2018-04-04,0.06205493387589013,98300,92200,-6100,172903
230,11780,2018-03-21,0.06420021762785637,91900,97800,5900,347310
231,11780,2018-03-05,0.0670391061452514,89500,83500,-6000,358114
232,11780,2018-02-26,0.04740406320541761,88600,92800,4200,271427
233,11780,2018-02-20,0.0431578947368421,95000,90900,-4100,174649
234,11780,2018-02-19,0.042810098792535674,91100,95000,3900,210828
235,11780,2018-02-12,0.04088397790055249,90500,86800,-3700,454196
236,11780,2018-02-07,0.099,100000,90100,-9900,383269
237,11780,2018-01-30,0.051643192488262914,106500,101000,-5500,199610
238,11780,2018-01-19,0.065,100000,106500,6500,214735
239,11780,2018-01-12,0.04608294930875576,108500,103500,-5000,342417
240,11780,2018-01-02,0.04020100502512563,99500,103500,4000,123963
241,11780,2017-12-14,0.04479283314669653,89300,93300,4000,309565
242,11780,2017-12-11,0.04640371229698376,86200,90200,4000,235509
243,11780,2017-11-29,0.04393063583815029,86500,90300,3800,351924
244,11780,2017-11-28,0.0535931790499391,82100,86500,4400,756712
245,11780,2017-11-27,0.044529262086514,78600,82100,3500,573905
246,11780,2017-11-23,0.04920212765957447,75200,78900,3700,265540
247,11780,2017-11-01,0.0792507204610951,69400,74900,5500,552428
248,11780,2017-10-13,0.05091937765205092,70700,67100,-3600,356462
249,11780,2017-09-22,0.051047120418848166,76400,72500,-3900,211152
250,11780,2017-07-03,0.05170068027210884,73500,77300,3800,296922
251,11780,2017-05-22,0.04582210242587601,74200,77600,3400,457794
252,11780,2017-04-26,0.043184885290148446,74100,77300,3200,274329
253,11780,2017-04-11,0.046632124352331605,77200,80800,3600,332702
254,11780,2017-03-29,0.05459387483355526,75100,79200,4100,411145
255,11780,2017-02-03,0.0564042303172738,85100,80300,-4800,565951
256,11780,2017-01-20,0.05293440736478711,86900,82300,-4600,465813
257,11780,2017-01-12,0.05005688282138794,87900,92300,4400,302907
258,11780,2017-01-02,0.041463414634146344,82000,85400,3400,153951
259,11780,2016-12-20,0.0440251572327044,79500,83000,3500,268354
260,11780,2016-12-15,0.08683853459972862,73700,80100,6400,403637
261,11780,2016-12-01,0.04794520547945205,73000,76500,3500,214448
262,11780,2016-11-22,0.0445945945945946,74000,77300,3300,213181
263,11780,2016-11-15,0.0451527224435591,75300,71900,-3400,161746
264,11780,2016-11-11,0.07058823529411765,68000,72800,4800,230143
265,11780,2016-11-07,0.04580152671755725,65500,68500,3000,115698
266,11780,2016-10-14,0.05285118219749652,71900,75700,3800,295309
267,11780,2016-10-12,0.045033112582781455,75500,72100,-3400,289863
268,11780,2016-10-10,0.04317548746518106,71800,74900,3100,287300
269,11780,2016-10-04,0.04864091559370529,69900,73300,3400,322273
270,11780,2016-09-29,0.0680786686838124,66100,70600,4500,289744
271,11780,2016-08-17,0.12363067292644757,63900,71800,7900,1098106
272,11780,2016-08-05,0.046511627906976744,60200,63000,2800,146587
273,66570,2021-04-15,0.06501547987616099,161500,172000,10500,5009228
274,66570,2021-04-01,0.06,150000,159000,9000,3574578
275,66570,2021-03-30,0.08185053380782918,140500,152000,11500,3244882
276,66570,2021-03-23,0.06129032258064516,155000,145500,-9500,2053555
277,66570,2021-03-16,0.0429042904290429,151500,158000,6500,1996472
278,66570,2021-02-26,0.048701298701298704,154000,146500,-7500,2453529
279,66570,2021-02-24,0.047619047619047616,157500,150000,-7500,3061646
280,66570,2021-02-23,0.05120481927710843,166000,157500,-8500,2897046
281,66570,2021-02-16,0.045454545454545456,165000,172500,7500,3199701
282,66570,2021-02-10,0.040372670807453416,161000,167500,6500,3256875
283,66570,2021-02-04,0.045454545454545456,165000,157500,-7500,2660265
284,66570,2021-02-03,0.04430379746835443,158000,165000,7000,3179393
285,66570,2021-01-29,0.06990881458966565,164500,153000,-11500,5396272
286,66570,2021-01-26,0.0449438202247191,178000,170000,-8000,3706727
287,66570,2021-01-22,0.04054054054054054,185000,177500,-7500,7015098
288,66570,2021-01-21,0.10778443113772455,167000,185000,18000,16304954
289,66570,2021-01-20,0.12837837837837837,148000,167000,19000,10340439
290,66570,2021-01-19,0.06474820143884892,139000,148000,9000,4114713
291,66570,2021-01-15,0.047619047619047616,147000,140000,-7000,3051738
292,66570,2021-01-14,0.05,140000,147000,7000,5618859
293,66570,2021-01-07,0.09090909090909091,137500,150000,12500,9782722
294,66570,2021-01-04,0.05185185185185185,135000,142000,7000,1868234
295,66570,2020-12-29,0.05622489959839357,124500,131500,7000,7476122
296,66570,2020-12-28,0.11160714285714286,112000,124500,12500,21982050
297,66570,2020-12-24,0.06276150627615062,119500,112000,-7500,11918248
298,66570,2020-12-23,0.2960954446854664,92200,119500,27300,16565841
299,66570,2020-12-16,0.0417558886509636,93400,97300,3900,1785477
300,66570,2020-12-08,0.06502242152466367,89200,95000,5800,4702429
301,66570,2020-12-03,0.051222351571594875,85900,90300,4400,2391369
302,66570,2020-11-18,0.04470588235294118,85000,88800,3800,2116015
303,66570,2020-09-09,0.05128205128205128,85800,90200,4400,3555936
304,66570,2020-09-01,0.04156769596199525,84200,87700,3500,1133236
305,66570,2020-08-21,0.0636042402826855,84900,90300,5400,2978055
306,66570,2020-08-18,0.05298759864712514,88700,84000,-4700,1462971
307,66570,2020-08-12,0.051807228915662654,83000,87300,4300,2704977
308,66570,2020-08-10,0.11010362694300518,77200,85700,8500,3706582
309,66570,2020-08-04,0.052702702702702706,74000,77900,3900,1738014
310,66570,2020-08-03,0.04667609618104668,70700,74000,3300,1183563
311,66570,2020-07-15,0.05790960451977401,70800,74900,4100,2504840
312,66570,2020-07-06,0.047692307692307694,65000,68100,3100,1461414
313,66570,2020-06-17,0.046012269938650305,65200,68200,3000,1576915
314,66570,2020-06-15,0.07227138643067847,67800,62900,-4900,1545344
315,66570,2020-06-10,0.052552552552552555,66600,70100,3500,2744224
316,66570,2020-06-09,0.040625,64000,66600,2600,1897513
317,66570,2020-05-27,0.04203152364273205,57100,59500,2400,1707086
318,66570,2020-04-07,0.06653620352250489,51100,54500,3400,2123508
319,66570,2020-03-25,0.09234234234234234,44400,48500,4100,1506779
320,66570,2020-03-24,0.06093189964157706,41850,44400,2550,1316623
321,66570,2020-03-23,0.07206208425720621,45100,41850,-3250,1186795
322,66570,2020-03-19,0.090625,48000,43650,-4350,1601945
323,66570,2020-03-16,0.04,52500,50400,-2100,948845
324,66570,2020-03-13,0.05405405405405406,55500,52500,-3000,1968749
325,66570,2020-03-12,0.059322033898305086,59000,55500,-3500,1649095
326,66570,2020-03-09,0.04145936981757877,60300,57800,-2500,1001568
327,66570,2020-02-24,0.04236006051437216,66100,63300,-2800,874557
328,66570,2019-10-07,0.045180722891566265,66400,69400,3000,955986
329,66570,2019-09-10,0.05872756933115824,61300,64900,3600,1293106
330,66570,2019-07-05,0.05221932114882506,76600,72600,-4000,1835388
331,66570,2019-06-11,0.06033376123234917,77900,82600,4700,1765695
332,66570,2019-04-25,0.04477611940298507,73700,77000,3300,1382565
333,66570,2019-03-29,0.04016620498614958,72200,75100,2900,1064758
334,66570,2019-03-25,0.040735873850197106,76100,73000,-3100,806732
335,66570,2019-03-21,0.04263565891472868,77400,74100,-3300,1570980
336,66570,2019-03-06,0.043478260869565216,71300,74400,3100,1630920
337,66570,2019-02-11,0.06944444444444445,64800,69300,4500,1987125
338,66570,2019-01-25,0.06595092024539877,65200,69500,4300,1749374
339,66570,2018-12-20,0.04134762633996937,65300,62600,-2700,1670644
340,66570,2018-12-06,0.043235704323570434,71700,68600,-3100,1054851
341,66570,2018-11-01,0.04265402843601896,63300,66000,2700,1056023
342,66570,2018-10-11,0.04447852760736196,65200,62300,-2900,1441637
343,66570,2018-09-18,0.04033379694019471,71900,69000,-2900,2606048
344,66570,2018-08-29,0.04748982360922659,73700,77200,3500,1417794
345,66570,2018-08-09,0.05928853754940711,75900,80400,4500,2132947
346,66570,2018-07-27,0.07090464547677261,81800,76000,-5800,2544391
347,66570,2018-06-21,0.048723897911832945,86200,82000,-4200,1395643
348,66570,2018-06-19,0.04484304932735426,89200,85200,-4000,1012856
349,66570,2018-06-14,0.04,90000,93600,3600,1444370
350,66570,2018-06-01,0.047516198704103674,92600,88200,-4400,2401034
351,66570,2018-05-08,0.04141414141414142,99000,94900,-4100,1398768
352,66570,2018-04-23,0.04128440366972477,109000,104500,-4500,1135766
353,66570,2018-04-06,0.05714285714285714,105000,111000,6000,1519548
354,66570,2018-04-04,0.05429864253393665,110500,104500,-6000,909945
355,66570,2018-03-23,0.04484304932735426,111500,106500,-5000,696815
356,66570,2018-02-19,0.05452674897119342,97200,102500,5300,893618
357,66570,2018-01-24,0.0639269406392694,109500,102500,-7000,1406328
358,66570,2018-01-08,0.05405405405405406,111000,105000,-6000,2480029
359,66570,2018-01-05,0.04716981132075472,106000,111000,5000,883832
360,66570,2017-12-27,0.07862903225806452,99200,107000,7800,1187463
361,66570,2017-10-31,0.04008438818565401,94800,91000,-3800,2091668
362,66570,2017-10-19,0.06747787610619468,90400,96500,6100,4384919
363,66570,2017-10-11,0.08168316831683169,80800,87400,6600,3091409
364,66570,2017-09-13,0.05301204819277108,83000,87400,4400,2808612
365,66570,2017-09-05,0.045949214026602174,82700,86500,3800,2612281
366,66570,2017-08-30,0.10618279569892473,74400,82300,7900,3932544
367,66570,2017-08-04,0.049707602339181284,68400,71800,3400,1976833
368,66570,2017-07-10,0.04194857916102842,73900,70800,-3100,3056226
369,66570,2017-07-07,0.041504539559014265,77100,73900,-3200,2330893
370,66570,2017-06-22,0.046565774155995346,85900,81900,-4000,2179462
371,66570,2017-06-02,0.06519065190651907,81300,86600,5300,1869364
372,66570,2017-05-11,0.045871559633027525,76300,79800,3500,1876649
373,66570,2017-05-08,0.07391910739191074,71700,77000,5300,2624129
374,66570,2017-04-28,0.04426002766251729,72300,69100,-3200,2295287
375,66570,2017-04-10,0.04231311706629055,70900,67900,-3000,1306155
376,66570,2017-04-06,0.050595238095238096,67200,70600,3400,1571616
377,66570,2017-03-23,0.04046242774566474,69200,72000,2800,2098932
378,66570,2017-03-07,0.04975124378109453,60300,63300,3000,1734620
379,66570,2017-02-27,0.05901116427432217,62700,59000,-3700,2350933
380,66570,2017-02-01,0.04512635379061372,55400,57900,2500,2286272
381,66570,2017-01-31,0.041353383458646614,53200,55400,2200,1376669
382,66570,2017-01-03,0.05232558139534884,51600,54300,2700,1715000
383,66570,2016-11-09,0.04293193717277487,47750,45700,-2050,1461344
384,66570,2016-10-11,0.05108055009823183,50900,53500,2600,2898941
385,66570,2016-10-10,0.05165289256198347,48400,50900,2500,1730902
386,278540,2021-01-08,0.050948307921160285,13445,14130,685,604784
387,278540,2020-06-16,0.04822777454968042,8605,9020,415,24274
388,278540,2020-06-15,0.04388888888888889,9000,8605,-395,11822
389,278540,2020-04-01,0.04643557880967953,7645,7290,-355,309158
390,278540,2020-03-25,0.05594900849858357,7060,7455,395,337547
391,278540,2020-03-24,0.08448540706605223,6510,7060,550,323388
392,278540,2020-03-23,0.054466230936819175,6885,6510,-375,328221
393,278540,2020-03-20,0.07410296411856475,6410,6885,475,656502
394,278540,2020-03-19,0.07636887608069164,6940,6410,-530,1046125
395,278540,2020-03-18,0.05126452494873548,7315,6940,-375,1037569
396,278540,2020-03-09,0.04473386183465459,8830,8435,-395,1053757
397,278540,2020-02-24,0.04042553191489362,9400,9020,-380,1662335
398,278540,2018-10-11,0.044075558099599316,8735,8350,-385,724495
399,11790,2021-06-01,0.043137254901960784,127500,133000,5500,337279
400,11790,2021-05-13,0.05860805860805861,136500,128500,-8000,659609
401,11790,2021-04-30,0.04929577464788732,142000,135000,-7000,538661
402,11790,2021-04-29,0.04797047970479705,135500,142000,6500,471127
403,11790,2021-04-12,0.054945054945054944,136500,144000,7500,1062066
404,11790,2021-03-30,0.053061224489795916,122500,129000,6500,407194
405,11790,2021-03-25,0.07555555555555556,112500,121000,8500,614029
406,11790,2021-03-24,0.0514018691588785,107000,112500,5500,592142
407,11790,2021-03-23,0.06140350877192982,114000,107000,-7000,1266374
408,11790,2021-02-24,0.051181102362204724,127000,120500,-6500,713869
409,11790,2021-02-22,0.04,137500,132000,-5500,405858
410,11790,2021-02-15,0.04198473282442748,131000,136500,5500,652023
411,11790,2021-02-10,0.056451612903225805,124000,131000,7000,680105
412,11790,2021-02-02,0.08433734939759036,124500,135000,10500,1291196
413,11790,2021-01-21,0.06278026905829596,111500,118500,7000,613499
414,11790,2021-01-19,0.0891089108910891,101000,110000,9000,1108463
415,11790,2021-01-14,0.05740181268882175,99300,105000,5700,435318
416,11790,2021-01-08,0.04411764705882353,102000,106500,4500,756952
417,11790,2021-01-04,0.0797872340425532,94000,101500,7500,1004073
418,11790,2020-11-27,0.07524271844660194,82400,88600,6200,1250995
419,11790,2020-11-03,0.08795669824086604,73900,80400,6500,909163
420,11790,2020-10-19,0.06777493606138107,78200,72900,-5300,647889
421,11790,2020-09-28,0.04381443298969072,77600,81000,3400,241127
422,11790,2020-09-24,0.08761682242990654,85600,78100,-7500,707403
423,11790,2020-08-24,0.0771850170261067,88100,94900,6800,1060520
424,11790,2020-08-21,0.09850374064837905,80200,88100,7900,1079569
425,11790,2020-08-20,0.04976303317535545,84400,80200,-4200,474352
426,11790,2020-08-14,0.055865921787709494,89500,84500,-5000,813931
427,11790,2020-08-07,0.05084745762711865,82600,86800,4200,983407
428,11790,2020-08-06,0.046894803548795945,78900,82600,3700,743012
429,11790,2020-08-05,0.046419098143236075,75400,78900,3500,716819
430,11790,2020-08-03,0.10157367668097282,69900,77000,7100,952558
431,11790,2020-07-23,0.04599406528189911,67400,70500,3100,422996
432,11790,2020-07-09,0.06748466257668712,65200,69600,4400,751267
433,11790,2020-07-06,0.04538087520259319,61700,64500,2800,448329
434,11790,2020-06-22,0.05423728813559322,59000,62200,3200,903177
435,11790,2020-06-16,0.07518796992481203,53200,57200,4000,432090
436,11790,2020-06-15,0.0859106529209622,58200,53200,-5000,648329
437,11790,2020-05-26,0.07875457875457875,54600,58900,4300,859136
438,11790,2020-05-18,0.043137254901960784,51000,53200,2200,519478
439,11790,2020-05-13,0.051440329218107,48600,51100,2500,758424
440,11790,2020-04-24,0.04702495201535509,52100,49650,-2450,674208
441,11790,2020-04-21,0.05905511811023622,50800,53800,3000,990195
442,11790,2020-04-17,0.07841031149301826,46550,50200,3650,745410
443,11790,2020-04-16,0.064,43750,46550,2800,530645
444,11790,2020-04-14,0.06447688564476886,41100,43750,2650,464781
445,11790,2020-04-13,0.060571428571428575,43750,41100,-2650,378340
446,11790,2020-04-08,0.053231939163498096,39450,41550,2100,804422
447,11790,2020-04-06,0.05420054200542006,36900,38900,2000,394806
448,11790,2020-03-25,0.08160237388724036,33700,36450,2750,611397
449,11790,2020-03-24,0.1140495867768595,30250,33700,3450,514471
450,11790,2020-03-23,0.05763239875389408,32100,30250,-1850,510875
451,11790,2020-03-20,0.1443850267379679,28050,32100,4050,725893
452,11790,2020-03-19,0.19164265129682997,34700,28050,-6650,962144
453,11790,2020-03-18,0.11704834605597965,39300,34700,-4600,571181
454,11790,2020-03-16,0.08092485549132948,43250,39750,-3500,339291
455,11790,2020-03-13,0.05670665212649945,45850,43250,-2600,655249
456,11790,2020-03-12,0.06141248720573183,48850,45850,-3000,576175
457,11790,2020-03-09,0.0616822429906542,53500,50200,-3300,387088
458,11790,2020-02-28,0.04283054003724395,53700,51400,-2300,505688
459,11790,2020-02-12,0.04584040747028863,58900,56200,-2700,712465
460,11790,2020-02-11,0.05366726296958855,55900,58900,3000,775403
461,11790,2020-02-04,0.07606679035250463,53900,58000,4100,815230
462,11790,2020-01-22,0.04798464491362764,52100,54600,2500,426653
463,11790,2019-11-08,0.04421768707482993,44100,46050,1950,239015
464,11790,2019-11-04,0.05251396648044693,44750,47100,2350,367117
465,11790,2019-10-28,0.09002433090024331,41100,44800,3700,547251
466,11790,2019-09-25,0.06235294117647059,42500,39850,-2650,717814
467,11790,2019-09-23,0.04086265607264472,44050,42250,-1800,285822
468,11790,2019-08-28,0.041065482796892344,45050,46900,1850,440153
469,11790,2019-08-16,0.044009779951100246,40900,42700,1800,291842
470,11790,2019-08-12,0.043173862310385065,42850,41000,-1850,329159
471,11790,2019-06-28,0.07608695652173914,36800,39600,2800,513524
472,11790,2019-06-14,0.04564315352697095,36150,37800,1650,1513448
473,11790,2019-06-12,0.06828528072837632,32950,35200,2250,504668
474,11790,2019-05-13,0.07593123209169055,34900,32250,-2650,241494
475,11790,2019-02-19,0.05938242280285035,42100,39600,-2500,448190
476,11790,2019-01-07,0.06116642958748222,35150,37300,2150,127528
477,11790,2018-12-13,0.04505813953488372,34400,35950,1550,157744
478,11790,2018-11-02,0.05,33000,34650,1650,167238
479,11790,2018-10-29,0.044444444444444446,33750,32250,-1500,179320
480,11790,2018-10-23,0.05423280423280423,37800,35750,-2050,201755
481,11790,2018-10-11,0.05378973105134474,40900,38700,-2200,229665
482,11790,2018-06-20,0.10112359550561797,40050,44100,4050,544091
483,11790,2018-06-05,0.04071246819338423,39300,40900,1600,337335
484,11790,2018-05-04,0.06241699867197875,37650,40000,2350,341699
485,11790,2018-04-23,0.040106951871657755,37400,38900,1500,189637
486,11790,2018-04-02,0.04183006535947712,38250,36650,-1600,259054
487,11790,2018-03-23,0.0561941251596424,39150,36950,-2200,171075
488,11790,2018-02-07,0.04648241206030151,39800,37950,-1850,453620
489,11790,2018-02-05,0.04833141542002301,43450,41350,-2100,253242
490,11790,2018-01-09,0.041237113402061855,48500,46500,-2000,323663
491,11790,2018-01-03,0.053763440860215055,46500,49000,2500,416954
492,11790,2017-12-28,0.07183580387685291,43850,47000,3150,857606
493,11790,2017-12-19,0.04161979752530934,44450,42600,-1850,235861
494,11790,2017-12-15,0.05158264947245018,42650,44850,2200,253793
495,11790,2017-12-11,0.05055487053020962,40550,42600,2050,152480
496,11790,2017-11-10,0.0460772104607721,40150,42000,1850,336721
497,11790,2017-10-23,0.04236200256739409,38950,40600,1650,194652
498,11790,2017-09-18,0.052121212121212124,41250,43400,2150,552952
499,11790,2017-09-06,0.04329608938547486,35800,37350,1550,197572
500,11790,2017-08-01,0.041379310344827586,36250,37750,1500,301182
501,11790,2017-07-12,0.09170305676855896,34350,37500,3150,1326254
502,11790,2017-06-13,0.08856682769726248,31050,33800,2750,1004550
503,11790,2017-06-09,0.043333333333333335,30000,31300,1300,373150
504,11790,2017-02-10,0.06570512820512821,31200,33250,2050,401664
505,11790,2016-11-14,0.06872852233676977,29100,31100,2000,1076972
506,11790,2016-11-10,0.05137614678899083,27250,28650,1400,305005
507,11790,2016-08-11,0.04,31250,30000,-1250,441543
508,11790,2016-08-09,0.042692939244663386,30450,31750,1300,951138
509,66575,2021-06-03,0.05409153952843273,72100,76000,3900,337838
510,66575,2021-04-15,0.053763440860215055,74400,78400,4000,633100
511,66575,2021-04-01,0.04822695035460993,70500,73900,3400,432366
512,66575,2021-03-30,0.06766917293233082,66500,71000,4500,356761
513,66575,2021-02-24,0.04986522911051213,74200,70500,-3700,412946
514,66575,2021-02-23,0.05115089514066496,78200,74200,-4000,380406
515,66575,2021-01-29,0.05847255369928401,83800,78900,-4900,965102
516,66575,2021-01-21,0.2838801711840228,70100,90000,19900,8780291
517,66575,2021-01-20,0.08012326656394453,64900,70100,5200,1572269
518,66575,2021-01-14,0.04340567612687813,59900,62500,2600,551583
519,66575,2021-01-11,0.04923076923076923,65000,61800,-3200,956353
520,66575,2021-01-06,0.05436337625178827,69900,66100,-3800,1350573
521,66575,2021-01-04,0.11128526645768025,63800,70900,7100,1074522
522,66575,2020-12-30,0.049342105263157895,60800,63800,3000,950246
523,66575,2020-12-29,0.04552590266875981,63700,60800,-2900,1321531
524,66575,2020-12-28,0.25393700787401574,50800,63700,12900,11126669
525,66575,2020-12-24,0.06947368421052631,47500,50800,3300,9349508
526,66575,2020-12-23,0.29958960328317374,36550,47500,10950,3097329
527,66575,2020-12-16,0.049315068493150684,36500,38300,1800,256386
528,66575,2020-12-08,0.043219076005961254,33550,35000,1450,447691
529,66575,2020-09-25,0.0438871473354232,31900,33300,1400,142482
530,66575,2020-09-09,0.04552352048558422,32950,34450,1500,340028
531,66575,2020-08-21,0.07692307692307693,32500,35000,2500,376135
532,66575,2020-08-18,0.06861313868613139,34250,31900,-2350,212543
533,66575,2020-08-10,0.17993079584775087,28900,34100,5200,1166308
534,66575,2020-07-15,0.041044776119402986,26800,27900,1100,165289
535,66575,2020-07-06,0.04970178926441352,25150,26400,1250,138924
536,66575,2020-06-22,0.04745166959578207,28450,27100,-1350,166911
537,66575,2020-06-17,0.046992481203007516,26600,27850,1250,323046
538,66575,2020-06-16,0.07258064516129033,24800,26600,1800,198969
539,66575,2020-06-15,0.0865561694290976,27150,24800,-2350,226314
540,66575,2020-06-10,0.060836501901140684,26300,27900,1600,353413
541,66575,2020-06-09,0.052,25000,26300,1300,245578
542,66575,2020-06-08,0.04821802935010482,23850,25000,1150,172571
543,66575,2020-04-07,0.08870967741935484,18600,20250,1650,157293
544,66575,2020-04-06,0.04201680672268908,17850,18600,750,67066
545,66575,2020-03-25,0.06687898089171974,15700,16750,1050,144934
546,66575,2020-03-24,0.05723905723905724,14850,15700,850,76866
547,66575,2020-03-23,0.0804953560371517,16150,14850,-1300,91262
548,66575,2020-03-19,0.11235955056179775,17800,15800,-2000,148290
549,66575,2020-03-18,0.045576407506702415,18650,17800,-850,131896
550,66575,2020-03-16,0.056511056511056514,20350,19200,-1150,98894
551,66575,2020-03-12,0.06208425720620843,22550,21150,-1400,111056
552,66575,2020-02-24,0.0497131931166348,26150,24850,-1300,56054
553,66575,2019-07-05,0.05409582689335394,32350,30600,-1750,47870
554,66575,2019-06-11,0.05963302752293578,32700,34650,1950,72346
555,66575,2019-04-25,0.040268456375838924,29800,31000,1200,48606
556,66575,2019-03-25,0.04455445544554455,30300,28950,-1350,33312
557,66575,2019-03-06,0.047787610619469026,28250,29600,1350,67001
558,66575,2019-02-11,0.04914933837429111,26450,27750,1300,50003
559,66575,2019-01-25,0.052434456928838954,26700,28100,1400,61028
560,66575,2018-11-02,0.041666666666666664,26400,27500,1100,28907
561,66575,2018-10-23,0.046125461254612546,27100,25850,-1250,18893
562,66575,2018-10-11,0.056672760511883,27350,25800,-1550,51005
563,66575,2018-07-27,0.06315789473684211,33250,31150,-2100,109051
564,66575,2018-07-02,0.04824561403508772,34200,32550,-1650,44866
565,66575,2018-06-21,0.04748603351955307,35800,34100,-1700,45447
566,66575,2018-06-01,0.04780876494023904,37650,35850,-1800,119911
567,66575,2018-04-06,0.043580683156654886,42450,44300,1850,59592
568,66575,2018-04-04,0.050997782705099776,45100,42800,-2300,38518
569,66575,2018-03-27,0.04176334106728538,43100,44900,1800,47935
570,66575,2018-03-23,0.04274465691788527,44450,42550,-1900,31563
571,66575,2018-01-24,0.04112554112554113,46200,44300,-1900,88695
572,66575,2018-01-05,0.043897216274089934,46700,48750,2050,79119
573,66575,2017-12-27,0.056433408577878104,44300,46800,2500,79475
574,66575,2017-12-15,0.048087431693989074,45750,47950,2200,163669
575,66575,2017-12-14,0.04931192660550459,43600,45750,2150,279826
576,66575,2017-10-19,0.05909090909090909,44000,46600,2600,167304
577,66575,2017-10-11,0.05707196029776675,40300,42600,2300,90382
578,66575,2017-09-13,0.04609929078014184,42300,44250,1950,175825
579,66575,2017-09-05,0.04645476772616137,40900,42800,1900,119715
580,66575,2017-08-30,0.09362279511533243,36850,40300,3450,220722
581,66575,2017-08-04,0.04591104734576758,34850,36450,1600,63798
582,66575,2017-07-10,0.05220883534136546,37350,35400,-1950,214427
583,66575,2017-07-07,0.04230769230769231,39000,37350,-1650,102996
584,66575,2017-06-28,0.0413625304136253,41100,39400,-1700,124531
585,66575,2017-06-02,0.07191316146540028,36850,39500,2650,204716
586,66575,2017-05-29,0.046218487394957986,35700,37350,1650,158700
587,66575,2017-05-19,0.041916167664670656,33400,34800,1400,67525
588,66575,2017-05-11,0.062111801242236024,32200,34200,2000,158064
589,66575,2017-05-08,0.06168831168831169,30800,32700,1900,108579
590,66575,2017-03-23,0.05163511187607573,29050,30550,1500,169596
591,66575,2017-03-14,0.04609929078014184,28200,29500,1300,137621
592,66575,2017-02-27,0.05054151624548736,27700,26300,-1400,52300
593,66575,2016-10-11,0.048,25000,26200,1200,50715
594,66575,2016-10-10,0.04384133611691023,23950,25000,1050,34438
595,1040,2021-05-31,0.045662100456621,109500,114500,5000,194144
596,1040,2021-05-25,0.046296296296296294,108000,113000,5000,239875
597,1040,2021-05-21,0.04128440366972477,109000,104500,-4500,168019
598,1040,2021-05-10,0.06212424849699399,99800,106000,6200,363095
599,1040,2021-01-28,0.06057692307692308,104000,97700,-6300,434010
600,1040,2021-01-18,0.06866952789699571,116500,108500,-8000,441842
601,1040,2021-01-14,0.1111111111111111,103500,115000,11500,534049
602,1040,2021-01-13,0.052899287894201424,98300,103500,5200,279740
603,1040,2021-01-08,0.08008429926238145,94900,102500,7600,495583
604,1040,2020-12-23,0.04860267314702309,82300,86300,4000,290573
605,1040,2020-09-16,0.04242424242424243,82500,86000,3500,299253
606,1040,2020-08-25,0.04187192118226601,81200,84600,3400,83910
607,1040,2020-08-20,0.047619047619047616,86100,82000,-4100,129346
608,1040,2020-08-12,0.09101796407185629,83500,91100,7600,592982
609,1040,2020-07-02,0.04498269896193772,86700,90600,3900,91426
610,1040,2020-06-16,0.0602125147579693,84700,89800,5100,88510
611,1040,2020-05-29,0.05510907003444317,87100,91900,4800,142308
612,1040,2020-05-06,0.05979643765903308,78600,83300,4700,147753
613,1040,2020-04-27,0.14783821478382148,71700,82300,10600,420439
614,1040,2020-04-06,0.08675078864353312,63400,68900,5500,163240
615,1040,2020-03-25,0.08347245409015025,59900,64900,5000,146179
616,1040,2020-03-24,0.128060263653484,53100,59900,6800,129160
617,1040,2020-03-23,0.08131487889273356,57800,53100,-4700,96525
618,1040,2020-03-20,0.045207956600361664,55300,57800,2500,162081
619,1040,2020-03-19,0.09344262295081968,61000,55300,-5700,152970
620,1040,2020-03-18,0.0571870170015456,64700,61000,-3700,85941
621,1040,2020-03-13,0.07412790697674419,68800,63700,-5100,242952
622,1040,2020-03-12,0.05364511691884457,72700,68800,-3900,263629
623,1040,2020-03-11,0.04842931937172775,76400,72700,-3700,185801
624,1040,2020-02-28,0.04280618311533888,84100,80500,-3600,136567
625,1040,2020-02-24,0.04022346368715084,89500,85900,-3600,72925
626,1040,2020-02-13,0.08040770101925254,88300,95400,7100,510502
627,1040,2020-02-12,0.04004711425206125,84900,88300,3400,125344
628,1040,2020-01-28,0.042222222222222223,90000,86200,-3800,87432
629,1040,2019-12-10,0.05616740088105727,90800,95900,5100,125099
630,1040,2019-11-12,0.045657015590200446,89800,93900,4100,158831
631,1040,2019-11-04,0.04941176470588235,85000,89200,4200,149034
632,1040,2019-10-04,0.04656862745098039,81600,77800,-3800,106847
633,1040,2019-08-09,0.06612529002320186,86200,80500,-5700,317900
634,1040,2019-01-02,0.04526748971193416,121500,116000,-5500,52125
635,1040,2018-12-21,0.05405405405405406,129500,136500,7000,251975
636,1040,2018-11-15,0.04602510460251046,119500,125000,5500,74419
637,1040,2018-11-09,0.07692307692307693,110500,119000,8500,238656
638,1040,2018-10-11,0.06746031746031746,126000,117500,-8500,242323
639,1040,2018-10-10,0.045454545454545456,132000,126000,-6000,129185
640,1040,2018-07-06,0.05128205128205128,136500,143500,7000,162942
641,1040,2018-06-29,0.040293040293040296,136500,142000,5500,125654
642,1040,2018-06-26,0.045454545454545456,143000,136500,-6500,194468
643,1040,2018-06-07,0.04081632653061224,147000,153000,6000,141123
644,1040,2018-05-30,0.05194805194805195,154000,146000,-8000,204346
645,1040,2017-11-22,0.04116222760290557,206500,198000,-8500,100131
646,1040,2017-11-20,0.04568527918781726,197000,206000,9000,169986
647,1040,2017-11-03,0.04,187500,195000,7500,146245
648,1040,2017-10-26,0.058823529411764705,178500,189000,10500,262386
649,1040,2017-06-12,0.04028436018957346,211000,202500,-8500,106609
650,1040,2017-05-08,0.07671957671957672,189000,203500,14500,256846
651,1040,2017-04-18,0.045454545454545456,176000,184000,8000,298834
652,1040,2017-03-24,0.0425531914893617,164500,171500,7000,152935
653,1040,2016-12-06,0.04057971014492753,172500,179500,7000,83400
654,1040,2016-11-29,0.0705521472392638,163000,174500,11500,132320
655,1040,2016-11-16,0.0650887573964497,169000,180000,11000,153663
656,1040,2016-11-02,0.043859649122807015,171000,163500,-7500,229697
657,1040,2016-09-22,0.049723756906077346,181000,190000,9000,134045
658,1040,2016-08-08,0.04904632152588556,183500,192500,9000,128221
659,1040,2016-08-05,0.05412371134020619,194000,183500,-10500,241409
660,3090,2021-05-26,0.056241426611796985,36450,38500,2050,570964
661,3090,2021-05-24,0.04654255319148936,37600,35850,-1750,420574
662,3090,2021-05-18,0.05847953216374269,34200,36200,2000,613082
663,3090,2021-05-10,0.06286549707602339,34200,36350,2150,503994
664,3090,2021-05-03,0.07988980716253444,36300,33400,-2900,575371
665,3090,2021-04-30,0.04849279161205767,38150,36300,-1850,634894
666,3090,2021-04-14,0.05239520958083832,33400,35150,1750,2663667
667,3090,2021-04-05,0.043010752688172046,32550,31150,-1400,276908
668,3090,2021-03-18,0.045454545454545456,36300,34650,-1650,667493
669,3090,2021-03-17,0.0629575402635432,34150,36300,2150,1554887
670,3090,2021-03-16,0.04434250764525994,32700,34150,1450,318411
671,3090,2021-02-23,0.06798516687268233,40450,37700,-2750,489685
672,3090,2021-02-16,0.048723897911832945,43100,41000,-2100,796138
673,3090,2021-02-08,0.05125408942202835,45850,43500,-2350,499229
674,3090,2021-02-04,0.05894519131334023,48350,45500,-2850,595740
675,3090,2021-01-28,0.05928853754940711,50600,47600,-3000,580461
676,3090,2021-01-22,0.052336448598130844,53500,50700,-2800,978098
677,3090,2021-01-19,0.05217391304347826,57500,54500,-3000,1169994
678,3090,2021-01-13,0.07313195548489666,62900,58300,-4600,1848138
679,3090,2021-01-12,0.13537906137184116,55400,62900,7500,9774664
680,3090,2021-01-11,0.059422750424448216,58900,55400,-3500,1630932
681,3090,2021-01-08,0.0811232449297972,64100,58900,-5200,1496112
682,3090,2021-01-05,0.2575187969924812,53200,66900,13700,12973483
683,3090,2021-01-04,0.05765407554671968,50300,53200,2900,2231955
684,3090,2020-12-29,0.08067940552016985,47100,50900,3800,2136577
685,3090,2020-12-24,0.12867647058823528,54400,47400,-7000,5158192
686,3090,2020-12-23,0.29987129987129985,77700,54400,-23300,6756977
687,3090,2020-12-22,0.15453194650817237,67300,77700,10400,7436720
688,3090,2020-12-18,0.11423841059602649,60400,67300,6900,8573014
689,3090,2020-12-17,0.296137339055794,46600,60400,13800,7980177
690,3090,2020-12-15,0.05236656596173213,49650,47050,-2600,5917354
691,3090,2020-12-11,0.16295427901524032,42650,49600,6950,22769754
692,3090,2020-12-10,0.2674591381872214,33650,42650,9000,16742591
693,3090,2020-12-09,0.12353923205342238,29950,33650,3700,11348392
694,3090,2020-12-08,0.04769475357710652,31450,29950,-1500,693061
695,3090,2020-12-01,0.16764132553606237,25650,29950,4300,12315146
696,3090,2020-11-26,0.04819277108433735,24900,26100,1200,1096051
697,3090,2020-11-25,0.06638115631691649,23350,24900,1550,3937711
698,3090,2020-11-17,0.051685393258426963,22250,21100,-1150,295538
699,3090,2020-11-11,0.05,23000,21850,-1150,410311
700,3090,2020-11-10,0.061224489795918366,24500,23000,-1500,351930
701,3090,2020-11-05,0.05241090146750524,23850,25100,1250,197316
702,3090,2020-10-30,0.048582995951417005,24700,23500,-1200,252976
703,3090,2020-10-28,0.06444444444444444,22500,23950,1450,370903
704,3090,2020-10-26,0.07231404958677685,24200,22450,-1750,420387
705,3090,2020-10-22,0.05436893203883495,25750,24350,-1400,224592
706,3090,2020-10-16,0.062157221206581355,27350,25650,-1700,428344
707,3090,2020-10-14,0.049069373942470386,29550,28100,-1450,424938
708,3090,2020-09-25,0.11524163568773234,26900,30000,3100,1158657
709,3090,2020-09-24,0.06434782608695652,28750,26900,-1850,456044
710,3090,2020-09-22,0.04628099173553719,30250,28850,-1400,607921
711,3090,2020-09-09,0.07320441988950276,36200,33550,-2650,823669
712,3090,2020-09-08,0.0461133069828722,37950,36200,-1750,615869
713,3090,2020-09-03,0.052917232021709636,36850,38800,1950,2320140
714,3090,2020-08-27,0.05100671140939597,37250,35350,-1900,797462
715,3090,2020-08-25,0.09913793103448276,34800,38250,3450,4673079
716,3090,2020-08-24,0.049773755656108594,33150,34800,1650,1350445
717,3090,2020-08-10,0.20317460317460317,31500,37900,6400,15360207
718,3090,2020-08-07,0.09871244635193133,34950,31500,-3450,9489893
719,3090,2020-08-06,0.2992565055762082,26900,34950,8050,11020488
720,3090,2020-08-04,0.08536585365853659,24600,26700,2100,1069732
721,3090,2020-07-31,0.04119850187265917,26700,25600,-1100,519307
722,3090,2020-07-24,0.07010309278350516,24250,25950,1700,2133388
723,3090,2020-07-23,0.049783549783549784,23100,24250,1150,2464508
724,3090,2020-07-20,0.05321507760532151,22550,23750,1200,923100
725,3090,2020-07-15,0.056451612903225805,24800,23400,-1400,516903
726,3090,2020-07-13,0.05217391304347826,23000,24200,1200,724278
727,3090,2020-07-07,0.07738095238095238,25200,23250,-1950,2343692
728,3090,2020-07-03,0.05639097744360902,26600,25100,-1500,964941
729,3090,2020-07-01,0.051470588235294115,27200,25800,-1400,648721
730,3090,2020-06-30,0.06206896551724138,29000,27200,-1800,1347124
731,3090,2020-06-29,0.05073649754500818,30550,29000,-1550,440345
732,3090,2020-06-26,0.04081632653061224,31850,30550,-1300,1060588
733,3090,2020-06-16,0.08623853211009175,27250,29600,2350,2138246
734,3090,2020-06-15,0.0472027972027972,28600,27250,-1350,3125424
735,3090,2020-06-09,0.1598360655737705,24400,28300,3900,14161814
736,3090,2020-06-08,0.043137254901960784,25500,24400,-1100,6037876
737,3090,2020-06-05,0.29770992366412213,19650,25500,5850,8637281
738,3090,2020-06-02,0.09883720930232558,17200,18900,1700,1562542
739,3090,2020-05-04,0.0603448275862069,17400,16350,-1050,1196754
740,3090,2020-04-29,0.07692307692307693,18850,17400,-1450,1702827
741,3090,2020-04-28,0.05513784461152882,19950,18850,-1100,1716522
742,3090,2020-04-24,0.17699115044247787,16950,19950,3000,18444291
743,3090,2020-04-23,0.05042016806722689,17850,16950,-900,6074318
744,3090,2020-04-22,0.29818181818181816,13750,17850,4100,2875629
745,3090,2020-04-21,0.05821917808219178,14600,13750,-850,528254
746,3090,2020-04-20,0.07352941176470588,13600,14600,1000,1133161
747,3090,2020-04-16,0.11475409836065574,12200,13600,1400,1203831
748,3090,2020-04-14,0.06550218340611354,11450,12200,750,2958453
749,3090,2020-04-02,0.049107142857142856,11200,11750,550,110845
750,3090,2020-03-31,0.09268292682926829,10250,11200,950,166432
751,3090,2020-03-27,0.09429824561403509,9120,9980,860,173545
752,3090,2020-03-25,0.06493506493506493,8470,9020,550,276865
753,3090,2020-03-24,0.218705035971223,6950,8470,1520,269723
754,3090,2020-03-20,0.11419753086419752,6480,7220,740,238407
755,3090,2020-03-19,0.19101123595505617,8010,6480,-1530,291401
756,3090,2020-03-17,0.05536332179930796,8670,8190,-480,207246
757,3090,2020-03-12,0.06604747162022703,9690,9050,-640,317452
758,3090,2020-03-11,0.040594059405940595,10100,9690,-410,239004
759,3090,2020-03-04,0.06167400881057269,11350,10650,-700,475083
760,3090,2020-03-02,0.11822660098522167,10150,11350,1200,383766
761,3090,2020-02-28,0.0514018691588785,10700,10150,-550,216774
762,3090,2020-02-24,0.05394190871369295,12050,11400,-650,103487
763,3090,2020-02-20,0.06837606837606838,11700,12500,800,289541
764,3090,2020-01-21,0.06374501992031872,12550,11750,-800,162279
765,3090,2020-01-10,0.046610169491525424,11800,12350,550,162802
766,3090,2020-01-06,0.04633204633204633,12950,12350,-600,109504
767,3090,2019-11-27,0.040740740740740744,13500,12950,-550,64486
768,3090,2019-09-26,0.05177993527508091,15450,14650,-800,306865
769,3090,2019-09-25,0.04923076923076923,16250,15450,-800,139157
770,3090,2019-08-30,0.047619047619047616,15750,16500,750,351864
771,3090,2019-08-08,0.05517241379310345,14500,15300,800,47172
772,3090,2019-08-05,0.06624605678233439,15850,14800,-1050,49138
773,3090,2019-06-17,0.0449438202247191,17800,17000,-800,86495
774,3090,2019-05-31,0.04335260115606936,17300,18050,750,68668
775,3090,2019-05-29,0.046831955922865015,18150,17300,-850,163863
776,3090,2019-05-28,0.05217391304347826,17250,18150,900,71819
777,3090,2019-05-13,0.08728179551122195,20050,18300,-1750,471940
778,3090,2019-05-10,0.04523809523809524,21000,20050,-950,127879
779,3090,2019-04-02,0.04292929292929293,19800,20650,850,292654
780,3090,2019-02-07,0.0610079575596817,18850,20000,1150,693486
781,3090,2018-12-27,0.047337278106508875,16900,17700,800,88928
782,3090,2018-12-11,0.062146892655367235,17700,16600,-1100,100431
783,3090,2018-11-06,0.07166123778501629,15350,16450,1100,181632
784,3090,2018-11-02,0.05423728813559322,14750,15550,800,62551
785,3090,2018-11-01,0.06115107913669065,13900,14750,850,92212
786,3090,2018-10-31,0.044673539518900345,14550,13900,-650,156356
787,3090,2018-10-15,0.04075235109717868,15950,15300,-650,72416
788,3090,2018-10-11,0.07396449704142012,16900,15650,-1250,113828
789,3090,2018-09-18,0.04310344827586207,17400,18150,750,70202
790,3090,2018-09-11,0.06086956521739131,17250,18300,1050,189519
791,3090,2018-08-24,0.05105105105105105,16650,17500,850,250837
792,3090,2018-08-03,0.11333333333333333,15000,16700,1700,644430
793,3090,2018-08-01,0.05442176870748299,14700,15500,800,92179
794,3090,2018-07-23,0.0462046204620462,15150,14450,-700,89252
795,3090,2018-07-18,0.06470588235294118,17000,15900,-1100,194118
796,3090,2018-06-22,0.04843304843304843,17550,18400,850,104459
797,3090,2018-06-19,0.047752808988764044,17800,16950,-850,122211
798,3090,2018-05-21,0.04834605597964377,19650,20600,950,248732
799,3090,2018-05-16,0.049738219895287955,19100,20050,950,183834
800,3090,2018-05-15,0.045,20000,19100,-900,92652
801,3090,2018-05-11,0.05789473684210526,19000,20100,1100,161255
802,3090,2018-04-30,0.085995085995086,20350,18600,-1750,384890
803,3090,2018-04-18,0.08009153318077804,21850,20100,-1750,480789
804,3090,2018-04-12,0.06695464362850972,23150,21600,-1550,320819
805,3090,2018-04-04,0.05620608899297424,21350,22550,1200,293212
806,3090,2018-03-26,0.06958762886597938,19400,20750,1350,165017
807,3090,2018-03-23,0.05596107055961071,20550,19400,-1150,183982
808,3090,2018-03-21,0.06060606060606061,19800,21000,1200,456158
809,3090,2018-03-05,0.04120879120879121,18200,17450,-750,95718
810,3090,2018-02-07,0.04225352112676056,17750,17000,-750,148214
811,3090,2018-01-30,0.0456989247311828,18600,19450,850,279079
812,3090,2018-01-24,0.12254901960784313,20400,17900,-2500,1496276
813,3090,2018-01-05,0.0427807486631016,18700,19500,800,145512
814,3090,2017-12-27,0.09322033898305085,17700,19350,1650,378605
815,3090,2017-12-11,0.055384615384615386,16250,17150,900,234008
816,3090,2017-12-05,0.04456824512534819,17950,17150,-800,166779
817,3090,2017-12-01,0.04046242774566474,17300,18000,700,202021
818,3090,2017-11-22,0.06199460916442048,18550,17400,-1150,443419
819,3090,2017-11-10,0.07692307692307693,15600,16800,1200,716102
820,3090,2017-10-31,0.05423728813559322,14750,15550,800,338373
821,3090,2017-10-11,0.05693950177935943,14050,14850,800,314830
822,3090,2017-09-25,0.06188925081433225,15350,14400,-950,321546
823,3090,2017-09-22,0.040625,16000,15350,-650,284686
824,3090,2017-09-19,0.06028368794326241,14100,14950,850,356160
825,3090,2017-08-31,0.06269592476489028,15950,14950,-1000,728720
826,3090,2017-08-10,0.04878048780487805,16400,15600,-800,565641
827,3090,2017-08-07,0.05787781350482315,15550,16450,900,949239
828,3090,2017-07-26,0.1282051282051282,13650,15400,1750,1497394
829,3090,2017-07-20,0.06274509803921569,12750,13550,800,215389
830,3090,2017-06-23,0.04526748971193416,12150,12700,550,269475
831,3090,2017-06-16,0.06666666666666667,13500,12600,-900,790000
832,3090,2017-06-15,0.08783783783783784,14800,13500,-1300,1648355
833,3090,2017-06-05,0.10869565217391304,13800,15300,1500,657736
834,3090,2017-05-23,0.11428571428571428,12250,13650,1400,1009371
835,3090,2017-04-03,0.0497131931166348,52300,54900,2600,23563
836,3090,2017-03-24,0.04196519959058342,48850,50900,2050,15201
837,3090,2017-03-10,0.0455005055611729,49450,51700,2250,8627
838,3090,2017-02-27,0.04059040590405904,54200,52000,-2200,13761
839,3090,2017-01-24,0.04004576659038902,43700,41950,-1750,9511
840,3090,2017-01-05,0.07283236994219654,43250,46400,3150,20889
841,3090,2016-12-01,0.0407725321888412,46600,44700,-1900,18389
842,3090,2016-11-25,0.06469298245614036,45600,48550,2950,9510
843,3090,2016-11-23,0.08431372549019608,51000,46700,-4300,17156
844,3090,2016-11-16,0.07302231237322515,49300,52900,3600,19026
845,3090,2016-11-10,0.06289308176100629,47700,50700,3000,12081
846,3090,2016-11-04,0.07,45000,48150,3150,14713
847,3090,2016-11-03,0.04895104895104895,42900,45000,2100,13387
848,3090,2016-10-31,0.05982905982905983,46800,44000,-2800,14776
849,3090,2016-10-28,0.040983606557377046,48800,46800,-2000,3728
850,3090,2016-10-20,0.04257528556593977,48150,46100,-2050,17399
851,9240,2021-06-01,0.04608294930875576,108500,113500,5000,91092
852,9240,2021-05-25,0.056338028169014086,106500,112500,6000,83442
853,9240,2021-04-08,0.07264957264957266,117000,125500,8500,255257
854,9240,2021-03-26,0.07042253521126761,106500,114000,7500,246510
855,9240,2021-02-18,0.04285714285714286,105000,100500,-4500,120927
856,9240,2021-02-08,0.04878048780487805,102500,107500,5000,319023
857,9240,2021-02-05,0.06327800829875518,96400,102500,6100,177827
858,9240,2021-01-11,0.046511627906976744,107500,102500,-5000,178616
859,9240,2020-12-15,0.05,100000,105000,5000,212584
860,9240,2020-11-19,0.05263157894736842,95000,100000,5000,143989
861,9240,2020-11-10,0.04964539007092199,98700,93800,-4900,203185
862,9240,2020-11-03,0.06765327695560254,94600,101000,6400,121073
863,9240,2020-10-30,0.058,100000,94200,-5800,585442
864,9240,2020-10-21,0.04975124378109453,100500,105500,5000,113685
865,9240,2020-10-15,0.06787330316742081,110500,103000,-7500,288989
866,9240,2020-10-13,0.06751054852320675,118500,110500,-8000,369276
867,9240,2020-09-25,0.04830917874396135,103500,108500,5000,182307
868,9240,2020-09-23,0.06275303643724696,98800,105000,6200,224164
869,9240,2020-08-21,0.07725788900979326,91900,99000,7100,170764
870,9240,2020-08-20,0.06889564336372847,98700,91900,-6800,160942
871,9240,2020-08-04,0.06307222787385554,98300,104500,6200,132479
872,9240,2020-07-22,0.04072398190045249,110500,106000,-4500,123217
873,9240,2020-07-14,0.044444444444444446,112500,117500,5000,270433
874,9240,2020-07-09,0.1733615221987315,94600,111000,16400,1265273
875,9240,2020-07-03,0.059800664451827246,90300,95700,5400,338005
876,9240,2020-07-01,0.05336426914153132,86200,90800,4600,304547
877,9240,2020-06-29,0.04195011337868481,88200,84500,-3700,59619
878,9240,2020-06-26,0.04378698224852071,84500,88200,3700,96382
879,9240,2020-06-16,0.08863920099875156,80100,87200,7100,108566
880,9240,2020-06-15,0.06096131301289566,85300,80100,-5200,107263
881,9240,2020-06-12,0.04586129753914989,89400,85300,-4100,123824
882,9240,2020-06-03,0.05368421052631579,95000,89900,-5100,215296
883,9240,2020-06-02,0.10336817653890824,86100,95000,8900,350997
884,9240,2020-05-27,0.055872291904218926,87700,82800,-4900,132821
885,9240,2020-05-18,0.04252873563218391,87000,83300,-3700,135886
886,9240,2020-05-13,0.07231920199501247,80200,86000,5800,286113
887,9240,2020-05-12,0.04291287386215865,76900,80200,3300,233329
888,9240,2020-05-08,0.049930651872399444,72100,75700,3600,157753
889,9240,2020-04-27,0.05135520684736091,70100,73700,3600,191188
890,9240,2020-04-21,0.056296296296296296,67500,71300,3800,356690
891,9240,2020-04-20,0.05799373040752351,63800,67500,3700,193921
892,9240,2020-04-07,0.09926470588235294,54400,59800,5400,192569
893,9240,2020-04-06,0.0421455938697318,52200,54400,2200,81984
894,9240,2020-03-25,0.0653061224489796,49000,52200,3200,149836
895,9240,2020-03-24,0.04589114194236926,46850,49000,2150,218630
896,9240,2020-03-23,0.129182156133829,53800,46850,-6950,179247
897,9240,2020-03-20,0.04669260700389105,51400,53800,2400,215454
898,9240,2020-03-19,0.16693679092382496,61700,51400,-10300,220303
899,9240,2020-03-18,0.04192546583850932,64400,61700,-2700,111179
900,9240,2020-03-17,0.1103448275862069,58000,64400,6400,135398
901,9240,2020-03-12,0.0688,62500,58200,-4300,220416
902,9240,2020-02-24,0.048265460030165915,66300,63100,-3200,143887
903,9240,2020-02-17,0.04040404040404041,69300,72100,2800,92487
904,9240,2020-02-04,0.04788732394366197,71000,74400,3400,98491
905,9240,2020-01-15,0.043824701195219126,75300,78600,3300,141071
906,9240,2020-01-07,0.06801736613603473,69100,73800,4700,286832
907,9240,2020-01-03,0.04047976011994003,66700,69400,2700,309676
908,9240,2020-01-02,0.07234726688102894,62200,66700,4500,258851
909,9240,2019-11-25,0.05454545454545454,60500,63800,3300,119771
910,9240,2019-10-28,0.06105610561056106,60600,64300,3700,252620
911,9240,2019-08-12,0.05660377358490566,63600,67200,3600,142832
912,9240,2019-07-30,0.06842105263157895,57000,60900,3900,249174
913,9240,2019-07-29,0.1592920353982301,67800,57000,-10800,647014
914,9240,2019-07-01,0.047748976807639835,73300,69800,-3500,124898
915,9240,2019-06-10,0.07202881152460984,83300,77300,-6000,398950
916,9240,2019-05-30,0.04637336504161712,84100,80200,-3900,265202
917,9240,2019-05-29,0.07886089813800658,91300,84100,-7200,240705
918,9240,2019-05-28,0.04462242562929062,87400,91300,3900,219884
919,9240,2019-05-09,0.06779661016949153,94400,88000,-6400,377264
920,9240,2019-04-29,0.06018518518518518,108000,101500,-6500,327868
921,9240,2019-04-17,0.04081632653061224,98000,102000,4000,230741
922,9240,2019-04-11,0.06496272630457935,93900,100000,6100,395952
923,9240,2019-04-01,0.09477124183006536,91800,100500,8700,389993
924,9240,2019-03-26,0.0533175355450237,84400,88900,4500,128882
925,9240,2019-03-22,0.0546875,89600,84700,-4900,291479
926,9240,2019-02-18,0.061519903498190594,82900,88000,5100,290666
927,9240,2019-02-11,0.05277777777777778,72000,75800,3800,304786
928,9240,2019-01-16,0.046511627906976744,73100,69700,-3400,211069
929,9240,2019-01-11,0.05952380952380952,67200,71200,4000,250730
930,9240,2019-01-09,0.052132701421800945,63300,66600,3300,131744
931,9240,2019-01-08,0.04380664652567976,66200,63300,-2900,231768
932,9240,2018-12-27,0.0425531914893617,65800,68600,2800,170009
933,9240,2018-12-20,0.05434782608695652,64400,67900,3500,383038
934,9240,2018-12-19,0.07154742096505824,60100,64400,4300,216777
935,9240,2018-12-04,0.05573770491803279,61000,64400,3400,377469
936,9240,2018-12-03,0.040955631399317405,58600,61000,2400,198871
937,9240,2018-11-28,0.053763440860215055,55800,58800,3000,282640
938,9240,2018-11-27,0.04690431519699812,53300,55800,2500,269622
939,9240,2018-11-19,0.07749077490774908,54200,58400,4200,296853
940,9240,2018-11-15,0.0546875,51200,54000,2800,219033
941,9240,2018-10-29,0.0499001996007984,50100,47600,-2500,265300
942,9240,2018-10-16,0.21172638436482086,61400,48400,-13000,1772942
943,9240,2018-10-11,0.06167400881057269,68100,63900,-4200,175182
944,9240,2018-09-20,0.060676779463243874,85700,80500,-5200,176721
945,9240,2018-09-13,0.04823529411764706,85000,89100,4100,140457
946,9240,2018-08-23,0.04570184983677911,91900,87700,-4200,125488
947,9240,2018-08-14,0.04875621890547264,100500,95600,-4900,66808
948,9240,2018-07-24,0.04317269076305221,99600,95300,-4300,155070
949,9240,2018-07-23,0.046218487394957986,95200,99600,4400,156123
950,9240,2018-07-20,0.08019323671497584,103500,95200,-8300,200773
951,9240,2018-07-18,0.05855855855855856,111000,104500,-6500,41884
952,9240,2018-05-08,0.049107142857142856,112000,106500,-5500,228015
953,9240,2018-04-27,0.041666666666666664,120000,115000,-5000,169423
954,9240,2018-04-17,0.15306122448979592,147000,124500,-22500,470485
955,9240,2018-02-19,0.056140350877192984,142500,150500,8000,67098
956,9240,2018-02-09,0.04180064308681672,155500,149000,-6500,144741
957,9240,2018-02-08,0.040123456790123455,162000,155500,-6500,71419
958,9240,2018-02-07,0.04516129032258064,155000,162000,7000,70641
959,9240,2018-02-06,0.07738095238095238,168000,155000,-13000,253086
960,9240,2018-01-19,0.05263157894736842,171000,180000,9000,103164
961,9240,2018-01-05,0.05232558139534884,172000,163000,-9000,167265
962,9240,2017-12-08,0.0546448087431694,183000,173000,-10000,43518
963,9240,2017-11-27,0.09253731343283582,167500,183000,15500,201768
964,9240,2017-10-30,0.05013927576601671,179500,170500,-9000,70083
965,9240,2017-10-25,0.04956268221574344,171500,180000,8500,142409
966,9240,2017-10-16,0.11428571428571428,157500,175500,18000,188534
967,9240,2017-09-18,0.06711409395973154,149000,159000,10000,119042
968,9240,2017-09-04,0.041666666666666664,168000,161000,-7000,108563
969,9240,2017-07-18,0.0646900269541779,185500,173500,-12000,272714
970,9240,2017-06-20,0.045454545454545456,198000,189000,-9000,149577
971,9240,2017-06-19,0.050359712230215826,208500,198000,-10500,85513
972,9240,2017-06-01,0.04318181818181818,220000,210500,-9500,75370
973,9240,2017-01-19,0.04156479217603912,204500,213000,8500,87648
974,9240,2017-01-05,0.049738219895287955,191000,200500,9500,84654
975,9240,2016-12-08,0.041666666666666664,192000,200000,8000,83616
976,9240,2016-11-18,0.0664819944598338,180500,192500,12000,139328
977,9240,2016-11-10,0.05,180000,189000,9000,70526
978,9240,2016-11-04,0.04081632653061224,171500,178500,7000,43325
979,9240,2016-10-25,0.06936416184971098,173000,185000,12000,296230
980,9240,2016-10-17,0.042735042735042736,175500,168000,-7500,112417
981,9240,2016-09-20,0.07540983606557378,152500,164000,11500,208592
982,9240,2016-09-19,0.06643356643356643,143000,152500,9500,123799
983,9240,2016-08-16,0.042134831460674156,178000,170500,-7500,110570
984,73240,2021-05-17,0.15669014084507044,5680,4790,-890,5667051
985,73240,2021-05-14,0.040293040293040296,5460,5680,220,2702780
986,73240,2021-05-12,0.10546875,5120,5660,540,7214236
987,73240,2021-05-11,0.14285714285714285,4480,5120,640,11106389
988,73240,2021-05-10,0.08606060606060606,4125,4480,355,2666990
989,73240,2021-01-29,0.05742821473158552,4005,3775,-230,1091694
990,73240,2021-01-28,0.04642857142857143,4200,4005,-195,859799
991,73240,2021-01-21,0.054758800521512385,3835,4045,210,2414529
992,73240,2021-01-11,0.041237113402061855,3880,3720,-160,1302925
993,73240,2021-01-07,0.04582210242587601,3710,3880,170,1142916
994,73240,2020-11-11,0.04314720812182741,3940,4110,170,848595
995,73240,2020-10-27,0.04031209362808843,3845,3690,-155,684547
996,73240,2020-10-26,0.05631868131868132,3640,3845,205,1170298
997,73240,2020-10-22,0.040345821325648415,3470,3610,140,666859
998,73240,2020-09-22,0.057356608478802994,4010,3780,-230,873504
999,73240,2020-09-17,0.08996088657105607,3835,4180,345,3442418
1000,73240,2020-09-14,0.11063218390804598,3480,3865,385,2221176
1001,73240,2020-09-09,0.04411764705882353,3740,3575,-165,581447
1002,73240,2020-09-07,0.044270833333333336,3840,3670,-170,707458
1003,73240,2020-09-01,0.08767123287671233,3650,3970,320,2429167
1004,73240,2020-08-31,0.061046511627906974,3440,3650,210,1346069
1005,73240,2020-08-28,0.12052117263843648,3070,3440,370,3182275
1006,73240,2020-08-20,0.0425531914893617,3290,3150,-140,937501
1007,73240,2020-08-19,0.06472491909385113,3090,3290,200,1573416
1008,73240,2020-08-13,0.049069373942470386,2955,3100,145,1918317
1009,73240,2020-06-16,0.048939641109298535,3065,3215,150,433056
1010,73240,2020-06-15,0.07541478129713423,3315,3065,-250,624406
1011,73240,2020-06-12,0.05285714285714286,3500,3315,-185,748631
1012,73240,2020-06-03,0.06472491909385113,3090,3290,200,1686508
1013,73240,2020-05-29,0.04071661237785016,3070,2945,-125,884606
1014,73240,2020-05-12,0.044233807266982623,3165,3025,-140,770726
1015,73240,2020-05-11,0.04628099173553719,3025,3165,140,1038627
1016,73240,2020-03-24,0.05311355311355311,2730,2875,145,1030655
1017,73240,2020-03-23,0.09900990099009901,3030,2730,-300,870369
1018,73240,2020-03-19,0.08191653786707882,3235,2970,-265,1292563
1019,73240,2020-03-12,0.05655172413793103,3625,3420,-205,1087266
1020,73240,2020-02-24,0.04271356783919598,3980,3810,-170,499909
1021,73240,2019-09-11,0.04410011918951132,4195,4380,185,767686
1022,73240,2019-07-31,0.06315789473684211,4275,4005,-270,886393
1023,73240,2019-07-16,0.05214368482039398,4315,4540,225,699195
1024,73240,2019-07-11,0.04092071611253197,3910,4070,160,272736
1025,73240,2019-06-20,0.05419354838709677,3875,4085,210,530320
1026,73240,2019-04-16,0.05079681274900399,5020,4765,-255,1295212
1027,73240,2019-04-15,0.0669500531349628,4705,5020,315,4893725
1028,73240,2019-04-03,0.04142692750287687,4345,4525,180,438833
1029,73240,2019-03-25,0.05219206680584551,4790,4540,-250,666505
1030,73240,2018-12-27,0.05168986083499006,5030,5290,260,711323
1031,73240,2018-12-24,0.04044117647058824,5440,5220,-220,648141
1032,73240,2018-12-12,0.05108055009823183,5090,5350,260,1070293
1033,73240,2018-11-19,0.04242424242424243,4950,5160,210,878546
1034,73240,2018-10-16,0.07231404958677685,4840,5190,350,865801
1035,73240,2018-10-11,0.059,5000,4705,-295,1147344
1036,73240,2018-06-27,0.044709388971684055,6710,6410,-300,2249689
1037,73240,2018-06-26,0.04192546583850932,6440,6710,270,1787979
1038,73240,2018-06-18,0.043154761904761904,6720,6430,-290,1678408
1039,73240,2018-05-23,0.06168831168831169,6160,6540,380,5044505
1040,73240,2018-04-13,0.04084967320261438,6120,6370,250,9344590
1041,73240,2018-04-06,0.07703081232492998,7140,6590,-550,9204715
1042,73240,2018-04-05,0.08226221079691516,7780,7140,-640,14899172
1043,73240,2018-04-03,0.2988313856427379,5990,7780,1790,45131601
1044,73240,2018-04-02,0.2979414951245937,4615,5990,1375,1116449
1045,73240,2018-03-30,0.3,3550,4615,1065,41733612
1046,73240,2018-03-29,0.12345679012345678,4050,3550,-500,11391282
1047,73240,2018-03-28,0.15975103734439833,4820,4050,-770,12376729
1048,73240,2018-03-23,0.06601941747572816,5150,4810,-340,5791797
1049,73240,2018-03-22,0.09341825902335456,4710,5150,440,12550765
1050,73240,2018-03-20,0.049746192893401014,4925,4680,-245,2334745
1051,73240,2018-03-19,0.050106609808102345,4690,4925,235,5873428
1052,73240,2018-03-08,0.04849884526558892,4330,4540,210,2846964
1053,73240,2018-03-07,0.0826271186440678,4720,4330,-390,3438521
1054,73240,2018-03-05,0.09980806142034548,5210,4690,-520,7531047
1055,73240,2018-03-02,0.06964285714285715,5600,5210,-390,10079139
1056,73240,2018-02-28,0.05263157894736842,5320,5600,280,12637923
1057,73240,2018-02-26,0.16427432216905902,6270,5240,-1030,18964873
1058,73240,2018-02-19,0.04340567612687813,5990,6250,260,1748118
1059,73240,2018-02-12,0.046511627906976744,6450,6150,-300,2141948
1060,73240,2018-02-05,0.04986149584487535,7220,6860,-360,7060656
1061,73240,2018-02-02,0.0989345509893455,6570,7220,650,6976890
1062,73240,2018-02-01,0.10420168067226891,5950,6570,620,7788015
1063,73240,2018-01-18,0.041666666666666664,5040,5250,210,4882351
1064,73240,2018-01-08,0.04563492063492063,5040,4810,-230,2948902
1065,73240,2018-01-03,0.19015659955257272,4470,5320,850,22194916
1066,73240,2017-12-21,0.04661487236403995,4505,4295,-210,3116766
1067,73240,2017-12-15,0.10820895522388059,4020,4455,435,39413163
1068,73240,2017-12-13,0.044902912621359224,4120,3935,-185,5473559
1069,73240,2017-12-12,0.07571801566579635,3830,4120,290,16033682
1070,73240,2017-12-11,0.13146233382570163,3385,3830,445,18823881
1071,73240,2017-12-08,0.2991718426501035,4830,3385,-1445,32842145
1072,73240,2017-12-07,0.29898403483309144,6890,4830,-2060,30104679
1073,73240,2017-12-05,0.05263157894736842,6650,7000,350,3213552
1074,73240,2017-10-25,0.0594059405940594,6060,6420,360,2511082
1075,73240,2017-10-20,0.08075601374570447,5820,6290,470,3863757
1076,73240,2017-09-28,0.05693950177935943,5620,5940,320,5925060
1077,73240,2017-09-27,0.06439393939393939,5280,5620,340,4555630
1078,73240,2017-09-26,0.06237424547283702,4970,5280,310,3150833
1079,73240,2017-09-25,0.04238921001926782,5190,4970,-220,1167394
1080,73240,2017-09-22,0.06148282097649186,5530,5190,-340,1881888
1081,73240,2017-09-21,0.09072978303747535,5070,5530,460,6261346
1082,73240,2017-09-13,0.051330798479087454,5260,4990,-270,3648047
1083,73240,2017-09-11,0.05904059040590406,5420,5100,-320,3079893
1084,73240,2017-09-06,0.18693009118541035,6580,5350,-1230,11136955
1085,73240,2017-08-22,0.040238450074515646,6710,6440,-270,1703971
1086,73240,2017-08-18,0.052259887005649715,7080,6710,-370,2131067
1087,73240,2017-07-19,0.05181347150259067,7720,7320,-400,2326369
1088,73240,2017-07-18,0.07222222222222222,7200,7720,520,2769251
1089,73240,2017-07-13,0.04825737265415549,7460,7100,-360,3464089
1090,73240,2017-07-06,0.06002554278416347,7830,8300,470,6470258
1091,73240,2017-06-19,0.04285714285714286,7700,7370,-330,2078013
1092,73240,2017-06-14,0.057065217391304345,7360,7780,420,2165514
1093,73240,2017-05-26,0.04619565217391304,7360,7020,-340,3533719
1094,73240,2017-04-20,0.04513064133016627,8420,8800,380,2388995
1095,73240,2017-03-22,0.046625766871165646,8150,8530,380,1487374
1096,73240,2017-03-13,0.06690997566909976,8220,8770,550,2918157
1097,73240,2017-02-13,0.057441253263707574,7660,8100,440,1737201
1098,73240,2017-02-09,0.056626506024096385,8300,7830,-470,2453862
1099,73240,2017-01-17,0.04565217391304348,9200,8780,-420,3149022
1100,73240,2017-01-13,0.053591790193842644,8770,9240,470,3264778
1101,73240,2017-01-06,0.05430932703659976,8470,8930,460,1863343
1102,73240,2016-12-29,0.04049079754601227,8150,8480,330,1093582
1103,73240,2016-11-28,0.04411764705882353,8840,8450,-390,1931442
1104,73240,2016-11-25,0.05112960760998811,8410,8840,430,1631394
1105,73240,2016-11-21,0.04721030042918455,9320,8880,-440,2068186
1106,73240,2016-11-18,0.08177339901477833,10150,9320,-830,3527079
1107,73240,2016-11-17,0.04245283018867924,10600,10150,-450,1146563
1108,73240,2016-11-10,0.04739336492890995,10550,10050,-500,3178826
1109,73240,2016-11-03,0.056338028169014086,9940,10500,560,847484
1110,73240,2016-10-10,0.046511627906976744,10750,11250,500,2052557
1111,73240,2016-09-07,0.0845771144278607,10050,10900,850,4112941
1112,73240,2016-08-03,0.043209876543209874,9720,9300,-420,1222824
1113,10780,2021-05-07,0.056074766355140186,64200,67800,3600,131425
1114,10780,2021-04-23,0.04075235109717868,63800,66400,2600,165070
1115,10780,2021-02-24,0.043936731107205626,56900,54400,-2500,141613
1116,10780,2021-01-22,0.08671586715867159,54200,58900,4700,533331
1117,10780,2021-01-19,0.05252918287937743,51400,54100,2700,187248
1118,10780,2020-12-29,0.047058823529411764,51000,53400,2400,513449
1119,10780,2020-12-10,0.05273833671399594,49300,51900,2600,424632
1120,10780,2020-12-02,0.04004329004329004,46200,48050,1850,277219
1121,10780,2020-09-28,0.06382978723404255,37600,40000,2400,72789
1122,10780,2020-09-24,0.048994974874371856,39800,37850,-1950,128043
1123,10780,2020-08-20,0.06511627906976744,43000,40200,-2800,171369
1124,10780,2020-08-18,0.11134676564156946,47150,41900,-5250,262613
1125,10780,2020-08-04,0.047619047619047616,44100,46200,2100,212202
1126,10780,2020-07-31,0.05194805194805195,46200,43800,-2400,313129
1127,10780,2020-07-30,0.045454545454545456,48400,46200,-2200,198376
1128,10780,2020-07-29,0.04086021505376344,46500,48400,1900,146507
1129,10780,2020-07-27,0.06911928651059086,44850,47950,3100,285947
1130,10780,2020-07-24,0.04789719626168224,42800,44850,2050,322602
1131,10780,2020-07-22,0.059050064184852376,38950,41250,2300,295162
1132,10780,2020-07-13,0.0520694259012016,37450,39400,1950,263749
1133,10780,2020-07-09,0.06158357771260997,34100,36200,2100,360142
1134,10780,2020-07-03,0.11394557823129252,29400,32750,3350,379384
1135,10780,2020-06-16,0.1059245960502693,27850,30800,2950,194071
1136,10780,2020-06-15,0.05593220338983051,29500,27850,-1650,147010
1137,10780,2020-06-12,0.05448717948717949,31200,29500,-1700,253725
1138,10780,2020-06-01,0.05032467532467533,30800,32350,1550,111668
1139,10780,2020-05-26,0.09075043630017451,28650,31250,2600,344371
1140,10780,2020-05-25,0.07303370786516854,26700,28650,1950,128327
1141,10780,2020-05-19,0.043478260869565216,25300,26400,1100,120959
1142,10780,2020-05-14,0.040229885057471264,26100,25050,-1050,84282
1143,10780,2020-04-21,0.04384133611691023,23950,22900,-1050,117591
1144,10780,2020-04-13,0.06336633663366337,25250,23650,-1600,96422
1145,10780,2020-04-07,0.06823027718550106,23450,25050,1600,134765
1146,10780,2020-04-06,0.0515695067264574,22300,23450,1150,95781
1147,10780,2020-04-01,0.042316258351893093,22450,21500,-950,101207
1148,10780,2020-03-25,0.12285012285012285,20350,22850,2500,124053
1149,10780,2020-03-24,0.10298102981029811,18450,20350,1900,113576
1150,10780,2020-03-23,0.07518796992481203,19950,18450,-1500,151615
1151,10780,2020-03-20,0.2276923076923077,16250,19950,3700,161270
1152,10780,2020-03-19,0.2034313725490196,20400,16250,-4150,284477
1153,10780,2020-03-18,0.0684931506849315,21900,20400,-1500,117408
1154,10780,2020-03-13,0.07851239669421488,24200,22300,-1900,303963
1155,10780,2020-03-12,0.043478260869565216,25300,24200,-1100,190841
1156,10780,2020-03-11,0.055970149253731345,26800,25300,-1500,128801
1157,10780,2020-02-28,0.046263345195729534,28100,26800,-1300,103340
1158,10780,2020-02-25,0.0449438202247191,26700,27900,1200,87964
1159,10780,2020-02-24,0.0498220640569395,28100,26700,-1400,97795
1160,10780,2020-02-11,0.04948805460750853,29300,30750,1450,77135
1161,10780,2020-02-06,0.040492957746478875,28400,29550,1150,74400
1162,10780,2020-01-15,0.04666666666666667,30000,31400,1400,77710
1163,10780,2019-11-04,0.0440251572327044,31800,33200,1400,96450
1164,10780,2019-08-05,0.04953560371517028,32300,30700,-1600,120938
1165,10780,2019-01-03,0.040268456375838924,29800,28600,-1200,50205
1166,10780,2018-10-11,0.04384724186704385,35350,33800,-1550,93977
1167,10780,2018-08-09,0.05785123966942149,30250,32000,1750,266111
1168,10780,2018-06-11,0.045060658578856154,28850,30150,1300,95137
1169,10780,2018-05-29,0.04213938411669368,30850,29550,-1300,91142
1170,10780,2018-05-28,0.05110732538330494,29350,30850,1500,183678
1171,10780,2018-05-16,0.0529595015576324,32100,30400,-1700,112442
1172,10780,2018-05-11,0.05378151260504202,29750,31350,1600,136206
1173,10780,2018-05-03,0.04643962848297214,32300,30800,-1500,86776
1174,10780,2018-04-30,0.08278145695364239,30200,32700,2500,229849
1175,10780,2018-03-23,0.052202283849918436,30650,29050,-1600,151117
1176,10780,2018-03-05,0.04938271604938271,32400,30800,-1600,138346
1177,10780,2018-03-02,0.04424778761061947,33900,32400,-1500,102212
1178,10780,2018-01-22,0.04415954415954416,35100,36650,1550,200476
1179,10780,2018-01-19,0.04,33750,35100,1350,126184
1180,10780,2017-12-13,0.0413589364844904,33850,35250,1400,97949
1181,10780,2017-12-08,0.04888268156424581,35800,34050,-1750,129638
1182,10780,2017-11-16,0.05131761442441054,36050,37900,1850,154010
1183,10780,2017-11-03,0.046875,35200,36850,1650,347732
1184,10780,2017-09-25,0.07272727272727272,33000,30600,-2400,265432
1185,10780,2017-09-11,0.04711246200607903,32900,34450,1550,118141
1186,10780,2017-08-14,0.07298335467349552,39050,36200,-2850,261844
1187,10780,2017-06-26,0.04225352112676056,46150,44200,-1950,150992
1188,10780,2017-04-24,0.053714285714285714,43750,41400,-2350,232930
1189,10780,2016-11-09,0.058521560574948665,48700,45850,-2850,342394
1190,10780,2016-11-02,0.04027504911591356,50900,48850,-2050,80678
1191,10780,2016-10-31,0.05714285714285714,52500,49500,-3000,121790
1192,10780,2016-08-31,0.04660194174757282,51500,49100,-2400,167786
1193,10780,2016-08-29,0.05380333951762523,53900,51000,-2900,126423
1194,204320,2021-05-28,0.06557377049180328,61000,65000,4000,1110519
1195,204320,2021-05-20,0.07280832095096583,67300,62400,-4900,1824877
1196,204320,2021-05-03,0.07056798623063683,58100,62200,4100,1767218
1197,204320,2021-03-30,0.04489164086687306,64600,67500,2900,778038
1198,204320,2021-03-24,0.047075606276747506,70100,66800,-3300,1676814
1199,204320,2021-03-18,0.05116959064327485,68400,71900,3500,1733883
1200,204320,2021-03-12,0.08482871125611746,61300,66500,5200,1219412
1201,204320,2021-02-24,0.06794682422451995,67700,63100,-4600,901970
1202,204320,2021-02-08,0.07482993197278912,73500,68000,-5500,1654045
1203,204320,2021-02-04,0.04893350062735257,79700,75800,-3900,2862663
1204,204320,2021-02-03,0.11312849162011174,71600,79700,8100,3405569
1205,204320,2021-01-29,0.048143053645116916,72700,69200,-3500,1165146
1206,204320,2021-01-28,0.04342105263157895,76000,72700,-3300,1030492
1207,204320,2021-01-21,0.07095046854082998,74700,80000,5300,1934627
1208,204320,2021-01-14,0.04291287386215865,76900,73600,-3300,1386396
1209,204320,2021-01-08,0.1432791728212703,67700,77400,9700,5970009
1210,204320,2021-01-05,0.06379585326953748,62700,66700,4000,1605512
1211,204320,2021-01-04,0.0663265306122449,58800,62700,3900,1446315
1212,204320,2020-12-23,0.10074626865671642,53600,59000,5400,4708102
1213,204320,2020-12-07,0.05860805860805861,54600,57800,3200,1358502
1214,204320,2020-12-02,0.04238921001926782,51900,54100,2200,1546161
1215,204320,2020-12-01,0.07010309278350516,48500,51900,3400,1167360
1216,204320,2020-11-25,0.061659192825112105,44600,47350,2750,1744298
1217,204320,2020-11-13,0.09828009828009827,40700,44700,4000,4044615
1218,204320,2020-11-12,0.047619047619047616,38850,40700,1850,1030954
1219,204320,2020-11-02,0.05322128851540616,35700,37600,1900,2022863
1220,204320,2020-10-22,0.04131054131054131,35100,33650,-1450,520742
1221,204320,2020-10-20,0.043731778425655975,34300,35800,1500,1101264
1222,204320,2020-10-16,0.04864864864864865,37000,35200,-1800,1082762
1223,204320,2020-10-05,0.10238429172510519,35650,39300,3650,2218464
1224,204320,2020-09-28,0.05128205128205128,33150,34850,1700,951877
1225,204320,2020-09-24,0.08298755186721991,36150,33150,-3000,1802525
1226,204320,2020-09-23,0.04782608695652174,34500,36150,1650,1814070
1227,204320,2020-09-22,0.07008086253369272,37100,34500,-2600,1499754
1228,204320,2020-09-17,0.06596701649175413,33350,35550,2200,3154158
1229,204320,2020-09-14,0.10033444816053512,29900,32900,3000,1862684
1230,204320,2020-08-31,0.06440677966101695,29500,31400,1900,1519774
1231,204320,2020-08-20,0.05351170568561873,29900,28300,-1600,710023
1232,204320,2020-08-18,0.08503937007874016,31750,29050,-2700,884724
1233,204320,2020-08-10,0.060897435897435896,31200,33100,1900,2300018
1234,204320,2020-08-06,0.04878048780487805,28700,30100,1400,1322563
1235,204320,2020-07-30,0.13807531380753138,23900,27200,3300,4743705
1236,204320,2020-06-29,0.04310344827586207,23200,22200,-1000,475873
1237,204320,2020-06-16,0.0603448275862069,23200,24600,1400,560726
1238,204320,2020-06-15,0.09019607843137255,25500,23200,-2300,850666
1239,204320,2020-06-12,0.05730129390018484,27050,25500,-1550,966801
1240,204320,2020-06-03,0.04081632653061224,26950,28050,1100,1129134
1241,204320,2020-05-26,0.04798464491362764,26050,27300,1250,841715
1242,204320,2020-05-22,0.046992481203007516,26600,25350,-1250,699663
1243,204320,2020-05-19,0.13432835820895522,23450,26600,3150,2334798
1244,204320,2020-05-12,0.04183266932270916,25100,24050,-1050,553106
1245,204320,2020-05-08,0.07625272331154684,22950,24700,1750,816975
1246,204320,2020-04-17,0.0411522633744856,24300,25300,1000,609915
1247,204320,2020-04-13,0.05252918287937743,25700,24350,-1350,515665
1248,204320,2020-04-09,0.08898305084745763,23600,25700,2100,1159857
1249,204320,2020-04-06,0.08584686774941995,21550,23400,1850,573131
1250,204320,2020-03-25,0.19382022471910113,17800,21250,3450,1077339
1251,204320,2020-03-24,0.05014749262536873,16950,17800,850,804501
1252,204320,2020-03-23,0.07880434782608696,18400,16950,-1450,491309
1253,204320,2020-03-20,0.06051873198847262,17350,18400,1050,836084
1254,204320,2020-03-19,0.13895781637717122,20150,17350,-2800,638573
1255,204320,2020-03-18,0.06712962962962964,21600,20150,-1450,492058
1256,204320,2020-03-16,0.04072398190045249,22100,21200,-900,562763
1257,204320,2020-03-13,0.09053497942386832,24300,22100,-2200,1345807
1258,204320,2020-03-12,0.0777988614800759,26350,24300,-2050,927134
1259,204320,2020-03-09,0.04712041884816754,28650,27300,-1350,414642
1260,204320,2020-02-28,0.05845181674565561,31650,29800,-1850,537608
1261,204320,2020-02-12,0.040229885057471264,34800,36200,1400,489878
1262,204320,2020-02-06,0.04411764705882353,34000,35500,1500,672359
1263,204320,2020-01-30,0.05234159779614325,36300,34400,-1900,677811
1264,204320,2020-01-28,0.0858974358974359,39000,35650,-3350,1162582
1265,204320,2020-01-23,0.0743801652892562,36300,39000,2700,1373755
1266,204320,2019-12-11,0.04107648725212465,35300,36750,1450,333119
1267,204320,2019-11-19,0.05668016194331984,37050,34950,-2100,776461
1268,204320,2019-10-08,0.04128440366972477,32700,34050,1350,387817
1269,204320,2019-09-24,0.07180851063829788,37600,34900,-2700,2507097
1270,204320,2019-09-20,0.049575070821529746,35300,37050,1750,528557
1271,204320,2019-08-28,0.07198748043818466,31950,34250,2300,784508
1272,204320,2019-08-08,0.04216867469879518,33200,34600,1400,535852
1273,204320,2019-07-29,0.044349070100143065,34950,33400,-1550,940687
1274,204320,2019-07-26,0.09905660377358491,31800,34950,3150,2676141
1275,204320,2019-07-24,0.04180602006688963,29900,31150,1250,896800
1276,204320,2019-07-03,0.05723905723905724,29700,28000,-1700,1040925
1277,204320,2019-05-09,0.040372670807453416,32200,30900,-1300,461648
1278,204320,2019-04-29,0.0796875,32000,34550,2550,671093
1279,204320,2019-04-26,0.07647907647907648,34650,32000,-2650,1451248
1280,204320,2019-04-17,0.06456241032998565,34850,37100,2250,815180
1281,204320,2019-04-11,0.04148148148148148,33750,35150,1400,1175361
1282,204320,2019-03-25,0.04470198675496689,30200,28850,-1350,525142
1283,204320,2019-03-07,0.04236006051437216,33050,31650,-1400,567841
1284,204320,2019-02-28,0.043731778425655975,34300,32800,-1500,509205
1285,204320,2019-02-25,0.04451510333863275,31450,32850,1400,604353
1286,204320,2019-02-12,0.04065040650406504,30750,32000,1250,964386
1287,204320,2019-02-01,0.061855670103092786,33950,31850,-2100,1820409
1288,204320,2019-01-18,0.06290322580645161,31000,32950,1950,929475
1289,204320,2019-01-15,0.05695142378559464,29850,31550,1700,930104
1290,204320,2019-01-09,0.08424908424908426,27300,29600,2300,1300472
1291,204320,2019-01-08,0.08389261744966443,29800,27300,-2500,1139022
1292,204320,2018-12-26,0.05090311986863711,30450,28900,-1550,392398
1293,204320,2018-12-05,0.04132231404958678,30250,29000,-1250,480665
1294,204320,2018-12-03,0.040268456375838924,29800,31000,1200,349705
1295,204320,2018-11-27,0.08133086876155268,27050,29250,2200,849052
1296,204320,2018-11-22,0.0779896013864818,28850,26600,-2250,780605
1297,204320,2018-11-20,0.06622516556291391,30200,28200,-2000,720993
1298,204320,2018-11-12,0.044481054365733116,30350,29000,-1350,399448
1299,204320,2018-11-01,0.04582651391162029,30550,31950,1400,640763
1300,204320,2018-10-30,0.11978221415607986,27550,30850,3300,1438355
1301,204320,2018-10-24,0.06702898550724638,27600,29450,1850,493793
1302,204320,2018-10-23,0.06913996627318718,29650,27600,-2050,536177
1303,204320,2018-10-22,0.06082289803220036,27950,29650,1700,517255
1304,204320,2018-10-17,0.042328042328042326,28350,29550,1200,402036
1305,204320,2018-10-16,0.06779661016949153,26550,28350,1800,552957
1306,204320,2018-10-10,0.06020066889632107,29900,28100,-1800,484854
1307,204320,2018-10-04,0.09062980030721966,32550,29600,-2950,942866
1308,204320,2018-09-11,0.0506155950752394,36550,34700,-1850,902967
1309,204320,2018-08-02,0.0413625304136253,41100,39400,-1700,387022
1310,204320,2018-07-27,0.04773869346733668,39800,41700,1900,1172103
1311,204320,2018-07-24,0.05137395459976105,41850,39700,-2150,828162
1312,204320,2018-07-09,0.04145077720207254,38600,40200,1600,415988
1313,204320,2018-07-06,0.08426966292134831,35600,38600,3000,910533
1314,204320,2018-07-05,0.0424597364568082,34150,35600,1450,590534
1315,204320,2018-07-04,0.06821282401091405,36650,34150,-2500,561257
1316,204320,2018-06-15,0.0423841059602649,37750,39350,1600,1228644
1317,204320,2018-06-08,0.05497076023391813,42750,40400,-2350,453623
1318,204320,2018-06-04,0.05392156862745098,40800,43000,2200,832347
1319,204320,2018-06-01,0.0611183355006502,38450,40800,2350,623473
1320,204320,2018-05-25,0.04716981132075472,42400,40400,-2000,582775
1321,204320,2018-05-23,0.04034896401308615,45850,44000,-1850,364721
1322,204320,2018-05-17,0.05555555555555555,44100,46550,2450,402992
1323,204320,2018-05-16,0.0562874251497006,41750,44100,2350,462180
1324,204320,2018-04-25,0.06828193832599119,227000,211500,-15500,112510
1325,204320,2018-04-04,0.04439746300211417,236500,247000,10500,69193
1326,204320,2018-04-02,0.05818965517241379,232000,245500,13500,109733
1327,204320,2018-03-27,0.04042553191489362,235000,244500,9500,69722
1328,204320,2018-03-23,0.04175365344467641,239500,229500,-10000,70409
1329,204320,2018-03-22,0.05043859649122807,228000,239500,11500,142157
1330,204320,2018-03-02,0.06019417475728155,257500,242000,-15500,75052
1331,204320,2018-02-07,0.18181818181818182,286000,234000,-52000,657625
1332,204320,2018-02-02,0.04159132007233273,276500,288000,11500,119742
1333,204320,2018-01-26,0.06143344709897611,293000,275000,-18000,132386
1334,204320,2017-12-11,0.04258675078864353,317000,303500,-13500,89422
1335,204320,2017-12-05,0.04141104294478527,326000,339500,13500,47738
1336,204320,2017-11-09,0.05804311774461028,301500,319000,17500,91969
1337,204320,2017-11-08,0.04889589905362776,317000,301500,-15500,148197
1338,204320,2017-10-26,0.07487520798668885,300500,323000,22500,90878
1339,204320,2017-10-23,0.05042016806722689,297500,312500,15000,107695
1340,204320,2017-10-18,0.11842105263157894,266000,297500,31500,144174
1341,204320,2017-10-10,0.05893909626719057,254500,269500,15000,142808
1342,204320,2017-09-26,0.06458333333333334,240000,255500,15500,87010
1343,204320,2017-07-28,0.059880239520958084,250500,265500,15000,114958
1344,204320,2017-07-17,0.040339702760084924,235500,245000,9500,72907
1345,204320,2017-06-12,0.04048582995951417,247000,257000,10000,64935
1346,204320,2017-05-10,0.05806451612903226,232500,246000,13500,213595
1347,204320,2017-04-28,0.041666666666666664,240000,230000,-10000,84410
1348,204320,2017-04-20,0.049773755656108594,221000,232000,11000,117944
1349,204320,2017-04-04,0.058027079303675046,258500,243500,-15000,122444
1350,204320,2017-03-03,0.048638132295719845,257000,244500,-12500,127182
1351,204320,2017-02-08,0.0789980732177264,259500,280000,20500,214110
1352,204320,2017-02-07,0.07453416149068323,241500,259500,18000,153696
1353,204320,2017-01-03,0.05823293172690763,249000,263500,14500,102388
1354,204320,2017-01-02,0.06183368869936034,234500,249000,14500,49947
1355,204320,2016-12-16,0.04,250000,240000,-10000,53794
1356,204320,2016-12-05,0.04225352112676056,248500,238000,-10500,39744
1357,204320,2016-11-16,0.04697986577181208,223500,234000,10500,79024
1358,204320,2016-11-04,0.0421455938697318,261000,250000,-11000,71612
1359,204320,2016-10-25,0.07802874743326489,243500,262500,19000,83050
1360,204320,2016-10-11,0.04563492063492063,252000,263500,11500,52005
1361,204320,2016-10-06,0.041666666666666664,264000,253000,-11000,104497
1362,204320,2016-10-04,0.05668016194331984,247000,261000,14000,202205
1363,204320,2016-09-30,0.13333333333333333,285000,247000,-38000,216025
1364,204320,2016-08-19,0.04428044280442804,271000,259000,-12000,72997
1365,204320,2016-08-18,0.06274509803921569,255000,271000,16000,155126
1366,298020,2021-05-14,0.04291845493562232,699000,729000,30000,93808
1367,298020,2021-05-06,0.05678670360110803,722000,763000,41000,129199
1368,298020,2021-04-27,0.06072874493927125,741000,696000,-45000,202519
1369,298020,2021-04-16,0.16666666666666666,600000,700000,100000,350288
1370,298020,2021-04-07,0.052158273381294966,556000,585000,29000,113834
1371,298020,2021-03-29,0.06710310965630115,611000,570000,-41000,167180
1372,298020,2021-03-25,0.06486486486486487,555000,591000,36000,210637
1373,298020,2021-03-16,0.05058365758754864,514000,540000,26000,112905
1374,298020,2021-03-15,0.06418219461697723,483000,514000,31000,122835
1375,298020,2021-03-11,0.1191588785046729,428000,479000,51000,216460
1376,298020,2021-02-25,0.059569074778200254,394500,418000,23500,80529
1377,298020,2021-02-24,0.060714285714285714,420000,394500,-25500,101424
1378,298020,2021-02-18,0.04408352668213457,431000,412000,-19000,119173
1379,298020,2021-02-08,0.054279749478079335,479000,453000,-26000,192765
1380,298020,2021-02-05,0.066815144766147,449000,479000,30000,264110
1381,298020,2021-02-03,0.06370192307692307,416000,442500,26500,828536
1382,298020,2021-02-02,0.06940874035989718,389000,416000,27000,538484
1383,298020,2021-02-01,0.2988313856427379,299500,389000,89500,233497
1384,298020,2021-01-29,0.05071315372424723,315500,299500,-16000,237605
1385,298020,2021-01-28,0.0676818950930626,295500,315500,20000,225905
1386,298020,2021-01-27,0.040492957746478875,284000,295500,11500,171427
1387,298020,2021-01-21,0.04528985507246377,276000,288500,12500,110392
1388,298020,2021-01-20,0.09741550695825049,251500,276000,24500,169921
1389,298020,2021-01-15,0.09649122807017543,228000,250000,22000,283325
1390,298020,2021-01-14,0.06046511627906977,215000,228000,13000,152790
1391,298020,2021-01-11,0.05077262693156733,226500,215000,-11500,89472
1392,298020,2021-01-07,0.06666666666666667,210000,224000,14000,96702
1393,298020,2020-12-29,0.05808080808080808,198000,209500,11500,99324
1394,298020,2020-12-18,0.06553398058252427,206000,219500,13500,87015
1395,298020,2020-12-17,0.07012987012987013,192500,206000,13500,120083
1396,298020,2020-11-18,0.07563025210084033,178500,192000,13500,119127
1397,298020,2020-11-12,0.04519774011299435,177000,185000,8000,92900
1398,298020,2020-11-09,0.047619047619047616,168000,176000,8000,113833
1399,298020,2020-11-05,0.05396825396825397,157500,166000,8500,88112
1400,298020,2020-11-03,0.04501607717041801,155500,162500,7000,126046
1401,298020,2020-11-02,0.08741258741258741,143000,155500,12500,205995
1402,298020,2020-10-12,0.09225092250922509,135500,148000,12500,123529
1403,298020,2020-10-07,0.042801556420233464,128500,134000,5500,34845
1404,298020,2020-09-21,0.04602510460251046,119500,114000,-5500,27127
1405,298020,2020-09-15,0.08108108108108109,111000,120000,9000,214081
1406,298020,2020-09-10,0.056074766355140186,107000,113000,6000,65013
1407,298020,2020-09-07,0.07433808553971487,98200,105500,7300,68514
1408,298020,2020-08-20,0.06018518518518518,108000,101500,-6500,22993
1409,298020,2020-08-18,0.047619047619047616,115500,110000,-5500,24495
1410,298020,2020-08-10,0.04245283018867924,106000,110500,4500,40028
1411,298020,2020-08-07,0.04950495049504951,101000,106000,5000,44455
1412,298020,2020-08-03,0.08370044052863436,113500,104000,-9500,77858
1413,298020,2020-07-14,0.04,125000,120000,-5000,25147
1414,298020,2020-07-10,0.06716417910447761,134000,125000,-9000,20443
1415,298020,2020-07-08,0.07171314741035857,125500,134500,9000,29348
1416,298020,2020-07-02,0.09361702127659574,117500,128500,11000,22320
1417,298020,2020-07-01,0.049107142857142856,112000,117500,5500,23979
1418,298020,2020-06-29,0.04291845493562232,116500,111500,-5000,8456
1419,298020,2020-06-25,0.045454545454545456,121000,115500,-5500,12207
1420,298020,2020-04-29,0.044,125000,130500,5500,16996
1421,298020,2020-04-07,0.05,110000,115500,5500,16184
1422,298020,2020-04-06,0.047619047619047616,105000,110000,5000,15670
1423,298020,2020-04-01,0.058823529411764705,110500,104000,-6500,28887
1424,298020,2020-03-31,0.09950248756218906,100500,110500,10000,18801
1425,298020,2020-03-26,0.04100946372239748,95100,99000,3900,19160
1426,298020,2020-03-25,0.10452961672473868,86100,95100,9000,16198
1427,298020,2020-03-24,0.09821428571428571,78400,86100,7700,15262
1428,298020,2020-03-23,0.1080773606370876,87900,78400,-9500,19046
1429,298020,2020-03-20,0.12404092071611253,78200,87900,9700,24182
1430,298020,2020-03-19,0.21169354838709678,99200,78200,-21000,33647
1431,298020,2020-03-18,0.046153846153846156,104000,99200,-4800,16398
1432,298020,2020-03-16,0.06578947368421052,114000,106500,-7500,26120
1433,298020,2020-03-13,0.09523809523809523,126000,114000,-12000,59850
1434,298020,2020-03-12,0.08029197080291971,137000,126000,-11000,27640
1435,298020,2020-03-11,0.04861111111111111,144000,137000,-7000,11185
1436,298020,2020-02-24,0.04024767801857585,161500,155000,-6500,12506
1437,298020,2020-01-15,0.06930693069306931,151500,162000,10500,19364
1438,298020,2019-09-20,0.0462046204620462,151500,158500,7000,55860
1439,298020,2019-09-18,0.05136986301369863,146000,153500,7500,40013
1440,298020,2019-08-01,0.059027777777777776,144000,152500,8500,94093
1441,298020,2019-07-08,0.044673539518900345,145500,139000,-6500,8393
1442,298020,2019-06-21,0.06,150000,141000,-9000,14522
1443,298020,2019-06-11,0.045936395759717315,141500,148000,6500,16160
1444,298020,2019-05-24,0.04983388704318937,150500,143000,-7500,20340
1445,298020,2019-05-09,0.05014749262536873,169500,161000,-8500,10214
1446,298020,2019-03-28,0.043478260869565216,184000,176000,-8000,13692
1447,298020,2019-03-18,0.07100591715976332,169000,181000,12000,31624
1448,298020,2018-10-31,0.05120481927710843,166000,174500,8500,14726
1449,298020,2018-10-30,0.05732484076433121,157000,166000,9000,13957
1450,298020,2018-10-11,0.05588235294117647,170000,160500,-9500,36018
1451,298020,2018-10-04,0.04619565217391304,184000,175500,-8500,34848
1452,298020,2018-08-23,0.053475935828877004,187000,177000,-10000,66146
1453,298020,2018-08-22,0.06265664160401002,199500,187000,-12500,114151
1454,298020,2018-07-23,0.04567307692307692,208000,198500,-9500,92693
1455,298020,2018-07-19,0.054187192118226604,203000,214000,11000,188354
1456,298020,2018-07-18,0.06451612903225806,217000,203000,-14000,154226
1457,298020,2018-07-16,0.10505050505050505,247500,221500,-26000,331498
1458,298020,2018-07-13,0.08986175115207373,217000,247500,30500,858526
1459,298020,2018-07-16,0.10505050505050505,247500,221500,-26000,331498
1460,298020,2018-07-13,0.08986175115207373,217000,247500,30500,858526
1461,298020,2018-07-16,0.10505050505050505,247500,221500,-26000,331498
1462,298020,2018-07-13,0.08986175115207373,217000,247500,30500,858526
1463,298020,2018-07-16,0.10505050505050505,247500,221500,-26000,331498
1464,298020,2018-07-13,0.08986175115207373,217000,247500,30500,858526
1465,298020,2018-07-16,0.10505050505050505,247500,221500,-26000,331498
1466,298020,2018-07-13,0.08986175115207373,217000,247500,30500,858526
1467,298020,2018-07-16,0.10505050505050505,247500,221500,-26000,331498
1468,298020,2018-07-13,0.08986175115207373,217000,247500,30500,858526
1469,298020,2018-07-16,0.10505050505050505,247500,221500,-26000,331498
1470,298020,2018-07-13,0.08986175115207373,217000,247500,30500,858526
1471,298020,2018-07-16,0.10505050505050505,247500,221500,-26000,331498
1472,298020,2018-07-13,0.08986175115207373,217000,247500,30500,858526
1473,298020,2018-07-16,0.10505050505050505,247500,221500,-26000,331498
1474,298020,2018-07-13,0.08986175115207373,217000,247500,30500,858526
1475,298020,2018-07-16,0.10505050505050505,247500,221500,-26000,331498
1476,298020,2018-07-13,0.08986175115207373,217000,247500,30500,858526
1477,298020,2018-07-16,0.10505050505050505,247500,221500,-26000,331498
1478,298020,2018-07-13,0.08986175115207373,217000,247500,30500,858526
1479,298020,2018-07-16,0.10505050505050505,247500,221500,-26000,331498
1480,298020,2018-07-13,0.08986175115207373,217000,247500,30500,858526
1481,298020,2018-07-16,0.10505050505050505,247500,221500,-26000,331498
1482,298020,2018-07-13,0.08986175115207373,217000,247500,30500,858526
1483,298020,2018-07-16,0.10505050505050505,247500,221500,-26000,331498
1484,298020,2018-07-13,0.08986175115207373,217000,247500,30500,858526
1485,298020,2018-07-16,0.10505050505050505,247500,221500,-26000,331498
1486,298020,2018-07-13,0.08986175115207373,217000,247500,30500,858526
1487,298020,2018-07-16,0.10505050505050505,247500,221500,-26000,331498
1488,298020,2018-07-13,0.08986175115207373,217000,247500,30500,858526
1489,298020,2018-07-16,0.10505050505050505,247500,221500,-26000,331498
1490,298020,2018-07-13,0.08986175115207373,217000,247500,30500,858526
1491,298020,2018-07-16,0.10505050505050505,247500,221500,-26000,331498
1492,298020,2018-07-13,0.08986175115207373,217000,247500,30500,858526
1493,298020,2018-07-16,0.10505050505050505,247500,221500,-26000,331498
1494,298020,2018-07-13,0.08986175115207373,217000,247500,30500,858526
1495,298020,2018-07-16,0.10505050505050505,247500,221500,-26000,331498
1496,298020,2018-07-13,0.08986175115207373,217000,247500,30500,858526
1497,298020,2018-07-16,0.10505050505050505,247500,221500,-26000,331498
1498,298020,2018-07-13,0.08986175115207373,217000,247500,30500,858526
1499,298020,2018-07-16,0.10505050505050505,247500,221500,-26000,331498
1500,298020,2018-07-13,0.08986175115207373,217000,247500,30500,858526
1501,298020,2018-07-16,0.10505050505050505,247500,221500,-26000,331498
1502,298020,2018-07-13,0.08986175115207373,217000,247500,30500,858526
1503,298020,2018-07-16,0.10505050505050505,247500,221500,-26000,331498
1504,298020,2018-07-13,0.08986175115207373,217000,247500,30500,858526
1505,298020,2018-07-16,0.10505050505050505,247500,221500,-26000,331498
1506,298020,2018-07-13,0.08986175115207373,217000,247500,30500,858526
1507,298020,2018-07-16,0.10505050505050505,247500,221500,-26000,331498
1508,298020,2018-07-13,0.08986175115207373,217000,247500,30500,858526
1509,298020,2018-07-16,0.10505050505050505,247500,221500,-26000,331498
1510,298020,2018-07-13,0.08986175115207373,217000,247500,30500,858526
1511,298020,2018-07-16,0.10505050505050505,247500,221500,-26000,331498
1512,298020,2018-07-13,0.08986175115207373,217000,247500,30500,858526
1513,298020,2018-07-16,0.10505050505050505,247500,221500,-26000,331498
1514,298020,2018-07-13,0.08986175115207373,217000,247500,30500,858526
1515,298020,2018-07-16,0.10505050505050505,247500,221500,-26000,331498
1516,298020,2018-07-13,0.08986175115207373,217000,247500,30500,858526
1517,298020,2018-07-16,0.10505050505050505,247500,221500,-26000,331498
1518,298020,2018-07-13,0.08986175115207373,217000,247500,30500,858526
1519,298020,2018-07-16,0.10505050505050505,247500,221500,-26000,331498
1520,298020,2018-07-13,0.08986175115207373,217000,247500,30500,858526
1521,298020,2018-07-16,0.10505050505050505,247500,221500,-26000,331498
1522,298020,2018-07-13,0.08986175115207373,217000,247500,30500,858526
1523,298020,2018-07-16,0.10505050505050505,247500,221500,-26000,331498
1524,298020,2018-07-13,0.08986175115207373,217000,247500,30500,858526
1525,298020,2018-07-16,0.10505050505050505,247500,221500,-26000,331498
1526,298020,2018-07-13,0.08986175115207373,217000,247500,30500,858526
1527,298020,2018-07-16,0.10505050505050505,247500,221500,-26000,331498
1528,298020,2018-07-13,0.08986175115207373,217000,247500,30500,858526
1529,298020,2018-07-16,0.10505050505050505,247500,221500,-26000,331498
1530,298020,2018-07-13,0.08986175115207373,217000,247500,30500,858526
1531,298020,2018-07-16,0.10505050505050505,247500,221500,-26000,331498
1532,298020,2018-07-13,0.08986175115207373,217000,247500,30500,858526
1533,298020,2018-07-16,0.10505050505050505,247500,221500,-26000,331498
1534,298020,2018-07-13,0.08986175115207373,217000,247500,30500,858526
1535,298020,2018-07-16,0.10505050505050505,247500,221500,-26000,331498
1536,298020,2018-07-13,0.08986175115207373,217000,247500,30500,858526
1537,298020,2018-07-16,0.10505050505050505,247500,221500,-26000,331498
1538,298020,2018-07-13,0.08986175115207373,217000,247500,30500,858526
1539,298020,2018-07-16,0.10505050505050505,247500,221500,-26000,331498
1540,298020,2018-07-13,0.08986175115207373,217000,247500,30500,858526
1541,298020,2018-07-16,0.10505050505050505,247500,221500,-26000,331498
1542,298020,2018-07-13,0.08986175115207373,217000,247500,30500,858526
1543,298020,2018-07-16,0.10505050505050505,247500,221500,-26000,331498
1544,298020,2018-07-13,0.08986175115207373,217000,247500,30500,858526
1545,298020,2018-07-16,0.10505050505050505,247500,221500,-26000,331498
1546,298020,2018-07-13,0.08986175115207373,217000,247500,30500,858526
1547,298020,2018-07-16,0.10505050505050505,247500,221500,-26000,331498
1548,298020,2018-07-13,0.08986175115207373,217000,247500,30500,858526
1549,298020,2018-07-16,0.10505050505050505,247500,221500,-26000,331498
1550,298020,2018-07-13,0.08986175115207373,217000,247500,30500,858526
1551,298020,2018-07-16,0.10505050505050505,247500,221500,-26000,331498
1552,23590,2021-05-13,0.0492091388400703,28450,27050,-1400,299273
1553,23590,2021-05-10,0.04878048780487805,26650,27950,1300,561052
1554,23590,2021-02-25,0.05058365758754864,25700,27000,1300,440997
1555,23590,2021-01-29,0.05338078291814947,28100,26600,-1500,1305537
1556,23590,2021-01-27,0.04933586337760911,26350,27650,1300,4030735
1557,23590,2021-01-26,0.09791666666666667,24000,26350,2350,4413622
1558,23590,2020-12-01,0.05336426914153132,21550,22700,1150,793024
1559,23590,2020-11-26,0.04523809523809524,21000,21950,950,542375
1560,23590,2020-11-23,0.0412621359223301,20600,21450,850,385245
1561,23590,2020-11-16,0.05025125628140704,19900,20900,1000,572391
1562,23590,2020-10-26,0.04228855721393035,20100,19250,-850,293093
1563,23590,2020-09-24,0.06040268456375839,22350,21000,-1350,343333
1564,23590,2020-09-21,0.04468085106382979,23500,22450,-1050,481937
1565,23590,2020-09-15,0.05588822355289421,25050,23650,-1400,987342
1566,23590,2020-09-11,0.09565217391304348,23000,25200,2200,5575521
1567,23590,2020-09-08,0.13216957605985039,20050,22700,2650,5439309
1568,23590,2020-08-24,0.04450261780104712,19100,19950,850,139050
1569,23590,2020-08-20,0.05970149253731343,20100,18900,-1200,278407
1570,23590,2020-07-14,0.042105263157894736,23750,22750,-1000,443021
1571,23590,2020-07-10,0.11483253588516747,20900,23300,2400,4139965
1572,23590,2020-06-22,0.04218362282878412,20150,21000,850,1576174
1573,23590,2020-06-18,0.07754010695187166,18700,20150,1450,1703857
1574,23590,2020-06-16,0.045714285714285714,17500,18300,800,313976
1575,23590,2020-06-15,0.06417112299465241,18700,17500,-1200,348577
1576,23590,2020-05-25,0.05053191489361702,18800,19750,950,487220
1577,23590,2020-05-15,0.044009779951100246,20450,19550,-900,1987427
1578,23590,2020-05-12,0.088,18750,20400,1650,4874771
1579,23590,2020-05-08,0.05398457583547558,19450,18400,-1050,3699908
1580,23590,2020-05-07,0.19325153374233128,16300,19450,3150,8024188
1581,23590,2020-04-17,0.04854368932038835,15450,16200,750,236051
1582,23590,2020-03-31,0.04225352112676056,14200,14800,600,201911
1583,23590,2020-03-25,0.07661290322580645,12400,13350,950,214541
1584,23590,2020-03-24,0.05084745762711865,11800,12400,600,181339
1585,23590,2020-03-23,0.09923664122137404,13100,11800,-1300,256047
1586,23590,2020-03-20,0.09166666666666666,12000,13100,1100,271398
1587,23590,2020-03-19,0.13357400722021662,13850,12000,-1850,277811
1588,23590,2020-03-13,0.08038585209003216,15550,14300,-1250,452257
1589,23590,2020-03-12,0.051829268292682924,16400,15550,-850,140232
1590,23590,2020-02-28,0.04477611940298507,16750,16000,-750,374688
1591,23590,2020-01-28,0.047493403693931395,18950,18050,-900,166553
1592,23590,2019-08-16,0.04488778054862843,20050,19150,-900,115970
1593,23590,2019-08-02,0.047961630695443645,20850,19850,-1000,283362
1594,23590,2019-07-17,0.041189931350114416,21850,20950,-900,98250
1595,23590,2019-07-16,0.05811138014527845,20650,21850,1200,146393
1596,23590,2019-06-03,0.046228710462287104,20550,21500,950,164856
1597,23590,2019-05-27,0.17418032786885246,24400,20150,-4250,992065
1598,23590,2019-05-23,0.06236559139784946,23250,24700,1450,535895
1599,23590,2019-04-04,0.05592841163310962,22350,23600,1250,218956
1600,23590,2019-03-25,0.044444444444444446,22500,21500,-1000,75929
1601,23590,2019-03-15,0.041379310344827586,21750,22650,900,125519
1602,23590,2019-01-24,0.10282776349614396,19450,21450,2000,849224
1603,23590,2018-12-10,0.04922279792746114,19300,18350,-950,198747
1604,23590,2018-10-31,0.055408970976253295,18950,20000,1050,80020
1605,23590,2018-10-29,0.04466501240694789,20150,19250,-900,90741
1606,23590,2018-10-23,0.04672897196261682,21400,20400,-1000,47372
1607,23590,2018-10-11,0.06823529411764706,21250,19800,-1450,231001
1608,23590,2018-08-13,0.048582995951417005,24700,23500,-1200,141705
1609,23590,2018-08-08,0.042826552462526764,23350,24350,1000,326180
1610,23590,2018-07-24,0.042600896860986545,22300,23250,950,133586
1611,23590,2018-06-15,0.04233870967741935,24800,23750,-1050,186451
1612,23590,2018-06-07,0.05220883534136546,24900,26200,1300,414449
1613,23590,2018-05-28,0.06109979633401222,24550,26050,1500,189105
1614,23590,2018-05-15,0.048507462686567165,26800,25500,-1300,401923
1615,23590,2018-05-11,0.06387225548902195,25050,26650,1600,435374
1616,23590,2018-05-04,0.045454545454545456,24200,25300,1100,445334
1617,23590,2018-04-27,0.05752212389380531,22600,23900,1300,429729
1618,23590,2018-04-13,0.05145413870246085,22350,23500,1150,355822
1619,23590,2018-03-28,0.06387665198237885,22700,21250,-1450,388582
1620,23590,2018-03-23,0.040339702760084924,23550,22600,-950,289709
1621,23590,2018-03-13,0.045081967213114756,24400,23300,-1100,253222
1622,23590,2018-03-09,0.04535637149028078,23150,24200,1050,210453
1623,23590,2018-02-07,0.040697674418604654,25800,24750,-1050,376610
1624,23590,2018-02-01,0.0658682634730539,25050,26700,1650,468720
1625,23590,2018-01-24,0.04791666666666667,24000,25150,1150,827594
1626,23590,2018-01-11,0.08928571428571429,22400,20400,-2000,1695447
1627,23590,2018-01-08,0.05191873589164785,22150,23300,1150,1249347
1628,23590,2018-01-05,0.16272965879265092,19050,22150,3100,2216327
1629,23590,2017-12-15,0.05249343832020997,19050,20050,1000,226449
1630,23590,2017-11-09,0.05420054200542006,18450,19450,1000,682187
1631,23590,2017-08-03,0.04524886877828054,22100,21100,-1000,248907
1632,23590,2017-07-13,0.046511627906976744,21500,22500,1000,583612
1633,23590,2017-06-20,0.0407673860911271,20850,21700,850,431107
1634,23590,2017-05-25,0.061381074168797956,19550,20750,1200,728757
1635,23590,2017-04-21,0.050761421319796954,19700,20700,1000,665341
1636,23590,2017-04-13,0.04199475065616798,19050,19850,800,185739
1637,23590,2017-03-16,0.08498583569405099,17650,19150,1500,502067
1638,23590,2017-02-01,0.04225352112676056,17750,18500,750,348934
1639,23590,2017-01-03,0.0480225988700565,17700,18550,850,254400
1640,23590,2016-12-08,0.04938271604938271,16200,17000,800,489190
1641,23590,2016-12-05,0.06231454005934718,16850,15800,-1050,1009342
1642,23590,2016-12-02,0.0664819944598338,18050,16850,-1200,810933
1643,23590,2016-11-16,0.04975124378109453,20100,21100,1000,368062
1644,23590,2016-11-09,0.04488778054862843,20050,19150,-900,267281
1645,23590,2016-11-02,0.06403940886699508,20300,19000,-1300,231947
1646,23590,2016-10-27,0.06142506142506143,20350,21600,1250,163651
1647,23590,2016-09-26,0.04328018223234624,21950,22900,950,341792
1648,23590,2016-09-23,0.04028436018957346,21100,21950,850,575437
1649,23590,2016-08-31,0.045351473922902494,22050,21050,-1000,478282
1650,23590,2016-08-17,0.05609284332688588,25850,24400,-1450,258293
1651,12330,2021-04-08,0.056572379367720464,300500,317500,17000,1037853
1652,12330,2021-03-30,0.051056338028169015,284000,298500,14500,522238
1653,12330,2021-02-24,0.046153846153846156,325000,310000,-15000,707003
1654,12330,2021-02-08,0.08652482269503546,352500,322000,-30500,1747047
1655,12330,2021-02-01,0.05669291338582677,317500,335500,18000,664246
1656,12330,2021-01-29,0.04078549848942598,331000,317500,-13500,905941
1657,12330,2021-01-21,0.05555555555555555,342000,361000,19000,1347421
1658,12330,2021-01-19,0.06646058732612056,323500,345000,21500,1090041
1659,12330,2021-01-12,0.05815602836879433,352500,332000,-20500,1874045
1660,12330,2021-01-08,0.180623973727422,304500,359500,55000,5326204
1661,12330,2021-01-07,0.07407407407407407,283500,304500,21000,1402113
1662,12330,2021-01-04,0.1232876712328767,255500,287000,31500,1811364
1663,12330,2020-12-14,0.06172839506172839,243000,258000,15000,1235681
1664,12330,2020-10-30,0.052521008403361345,238000,225500,-12500,888786
1665,12330,2020-10-29,0.05742574257425743,252500,238000,-14500,696270
1666,12330,2020-10-20,0.06741573033707865,222500,237500,15000,1301084
1667,12330,2020-09-01,0.06473214285714286,224000,238500,14500,915042
1668,12330,2020-08-28,0.041474654377880185,217000,226000,9000,778178
1669,12330,2020-08-20,0.0576036866359447,217000,204500,-12500,519337
1670,12330,2020-08-18,0.04241071428571429,224000,214500,-9500,535693
1671,12330,2020-08-10,0.06487695749440715,223500,238000,14500,1265411
1672,12330,2020-08-06,0.047058823529411764,212500,222500,10000,831406
1673,12330,2020-07-13,0.06233766233766234,192500,204500,12000,416475
1674,12330,2020-07-06,0.04603580562659847,195500,204500,9000,336074
1675,12330,2020-06-25,0.05365853658536585,205000,194000,-11000,392726
1676,12330,2020-06-24,0.06217616580310881,193000,205000,12000,734730
1677,12330,2020-06-23,0.04891304347826087,184000,193000,9000,579311
1678,12330,2020-06-16,0.0427807486631016,187000,195000,8000,322656
1679,12330,2020-06-15,0.09223300970873786,206000,187000,-19000,594810
1680,12330,2020-06-03,0.04672897196261682,214000,224000,10000,515118
1681,12330,2020-06-01,0.04040404040404041,198000,206000,8000,260640
1682,12330,2020-05-26,0.045576407506702415,186500,195000,8500,353343
1683,12330,2020-05-19,0.07803468208092486,173000,186500,13500,632454
1684,12330,2020-04-24,0.04519774011299435,177000,169000,-8000,440277
1685,12330,2020-04-09,0.047058823529411764,170000,178000,8000,607783
1686,12330,2020-03-25,0.17301038062283736,144500,169500,25000,810541
1687,12330,2020-03-24,0.08239700374531835,133500,144500,11000,464543
1688,12330,2020-03-23,0.0498220640569395,140500,133500,-7000,522677
1689,12330,2020-03-20,0.08914728682170543,129000,140500,11500,567440
1690,12330,2020-03-19,0.0851063829787234,141000,129000,-12000,577742
1691,12330,2020-03-18,0.07540983606557378,152500,141000,-11500,438595
1692,12330,2020-03-17,0.05572755417956656,161500,152500,-9000,433323
1693,12330,2020-03-16,0.05830903790087463,171500,161500,-10000,329732
1694,12330,2020-03-13,0.04722222222222222,180000,171500,-8500,623997
1695,12330,2020-03-12,0.04,187500,180000,-7500,458209
1696,12330,2020-03-09,0.04433497536945813,203000,194000,-9000,237798
1697,12330,2020-02-28,0.0410958904109589,219000,210000,-9000,317745
1698,12330,2020-02-24,0.04157549234135667,228500,219000,-9500,247956
1699,12330,2019-11-15,0.046747967479674794,246000,257500,11500,295646
1700,12330,2019-07-25,0.05591397849462366,232500,245500,13000,495994
1701,12330,2019-05-09,0.04565217391304348,230000,219500,-10500,287796
1702,12330,2019-01-28,0.04316546762589928,208500,217500,9000,460844
1703,12330,2019-01-23,0.046228710462287104,205500,215000,9500,321733
1704,12330,2019-01-09,0.04922279792746114,193000,202500,9500,277391
1705,12330,2018-12-12,0.09014084507042254,177500,193500,16000,485527
1706,12330,2018-11-30,0.040345821325648415,173500,180500,7000,435192
1707,12330,2018-11-27,0.04491017964071856,167000,174500,7500,396585
1708,12330,2018-11-22,0.08648648648648649,185000,169000,-16000,705244
1709,12330,2018-10-25,0.04450261780104712,191000,182500,-8500,500682
1710,12330,2018-10-23,0.04092071611253197,195500,187500,-8000,436598
1711,12330,2018-10-11,0.04866180048661801,205500,195500,-10000,358876
1712,12330,2018-09-10,0.04219409282700422,237000,227000,-10000,172142
1713,12330,2018-04-12,0.04007633587786259,262000,251500,-10500,364527
1714,12330,2018-04-03,0.044989775051124746,244500,255500,11000,596146
1715,12330,2018-03-30,0.05708661417322835,254000,239500,-14500,744205
1716,12330,2018-03-28,0.0673469387755102,245000,261500,16500,1530584
1717,12330,2018-03-27,0.053763440860215055,232500,245000,12500,586844
1718,12330,2018-02-13,0.0405982905982906,234000,224500,-9500,469496
1719,12330,2018-01-26,0.08208955223880597,268000,246000,-22000,1337931
1720,12330,2018-01-19,0.047058823529411764,255000,267000,12000,241714
1721,12330,2017-10-31,0.04921259842519685,254000,266500,12500,464930
1722,12330,2017-10-26,0.07112970711297072,239000,256000,17000,311911
1723,12330,2017-09-26,0.05227272727272727,220000,231500,11500,437839
1724,12330,2017-09-08,0.046610169491525424,236000,225000,-11000,522430
1725,12330,2017-05-19,0.05,260000,273000,13000,591545
1726,12330,2017-05-08,0.0787746170678337,228500,246500,18000,793349
1727,12330,2017-01-31,0.09022556390977443,266000,242000,-24000,815329
1728,12330,2016-11-10,0.058823529411764705,263500,248000,-15500,547023
1729,12330,2016-09-06,0.04744525547445255,274000,287000,13000,297211
1730,24110,2021-05-06,0.0661764705882353,9520,10150,630,8653675
1731,24110,2021-02-01,0.0421455938697318,7830,8160,330,2696592
1732,24110,2020-12-29,0.06329113924050633,9480,8880,-600,6722586
1733,24110,2020-11-11,0.04401805869074492,8860,9250,390,5795663
1734,24110,2020-08-18,0.04597701149425287,8700,8300,-400,2600765
1735,24110,2020-06-16,0.07099879663056559,8310,8900,590,2692428
1736,24110,2020-06-11,0.04741379310344827,9280,8840,-440,6190796
1737,24110,2020-06-03,0.0811111111111111,9000,9730,730,8315050
1738,24110,2020-06-02,0.06132075471698113,8480,9000,520,5549703
1739,24110,2020-04-27,0.058333333333333334,7200,7620,420,4822565
1740,24110,2020-04-10,0.041278295605858856,7510,7820,310,3715056
1741,24110,2020-04-01,0.04533333333333334,7500,7160,-340,2277600
1742,24110,2020-03-25,0.10329341317365269,6680,7370,690,3811848
1743,24110,2020-03-24,0.08972267536704731,6130,6680,550,2411046
1744,24110,2020-03-23,0.07401812688821752,6620,6130,-490,2587895
1745,24110,2020-03-20,0.12776831345826234,5870,6620,750,3698474
1746,24110,2020-03-19,0.09831029185867896,6510,5870,-640,4156109
1747,24110,2020-03-17,0.054929577464788736,7100,6710,-390,3685283
1748,24110,2020-03-16,0.04697986577181208,7450,7100,-350,3104062
1749,24110,2020-03-13,0.05815423514538559,7910,7450,-460,4868340
1750,24110,2020-03-12,0.060570071258907364,8420,7910,-510,4060421
1751,24110,2020-03-09,0.05543237250554324,9020,8520,-500,2732695
1752,24110,2020-02-24,0.04242424242424243,9900,9480,-420,2460837
1753,24110,2019-12-27,0.048,12500,11900,-600,3927328
1754,24110,2019-10-28,0.047244094488188976,12700,12100,-600,3066015
1755,24110,2019-09-27,0.041044776119402986,13400,12850,-550,1332146
1756,24110,2018-12-27,0.05704697986577181,14900,14050,-850,2245045
1757,24110,2018-10-11,0.052980132450331126,15100,14300,-800,1756133
1758,24110,2018-05-30,0.04024767801857585,16150,15500,-650,1242527
1759,24110,2018-03-28,0.04,16250,15600,-650,1584396
1760,24110,2018-03-23,0.04477611940298507,16750,16000,-750,1118913
1761,24110,2018-02-12,0.04777070063694268,15700,16450,750,1044690
1762,24110,2018-02-06,0.04678362573099415,17100,16300,-800,1704529
1763,24110,2017-09-05,0.04778156996587031,14650,13950,-700,2874363
1764,24110,2017-07-10,0.04240282685512368,14150,14750,600,2138936
1765,24110,2017-02-15,0.041353383458646614,13300,12750,-550,4712661
1766,352820,2021-05-18,0.0482897384305835,248500,260500,12000,395521
1767,352820,2021-05-12,0.05019305019305019,259000,246000,-13000,382142
1768,352820,2021-05-06,0.04801670146137787,239500,251000,11500,264248
1769,352820,2021-04-28,0.046875,256000,244000,-12000,412618
1770,352820,2021-04-22,0.05371900826446281,242000,255000,13000,446672
1771,352820,2021-04-15,0.06157112526539278,235500,250000,14500,1256775
1772,352820,2021-04-14,0.06732673267326733,252500,235500,-17000,1019699
1773,352820,2021-04-07,0.06563706563706563,259000,276000,17000,1032090
1774,352820,2021-04-06,0.04435483870967742,248000,259000,11000,922890
1775,352820,2021-03-25,0.07534246575342465,219000,235500,16500,306749
1776,352820,2021-03-17,0.0547945205479452,219000,231000,12000,387484
1777,352820,2021-03-15,0.043859649122807015,228000,218000,-10000,355512
1778,352820,2021-03-12,0.07801418439716312,211500,228000,16500,461596
1779,352820,2021-03-11,0.09585492227979274,193000,211500,18500,446049
1780,352820,2021-02-24,0.07658643326039387,228500,211000,-17500,572749
1781,352820,2021-02-16,0.09492273730684327,226500,248000,21500,935265
1782,352820,2021-02-09,0.059063136456211814,245500,231000,-14500,583871
1783,352820,2021-02-02,0.06896551724137931,217500,232500,15000,1363038
1784,352820,2021-02-01,0.06356968215158924,204500,217500,13000,608089
1785,352820,2021-01-29,0.07045454545454545,220000,204500,-15500,773127
1786,352820,2021-01-28,0.060240963855421686,207500,220000,12500,1653828
1787,352820,2021-01-25,0.05714285714285714,192500,203500,11000,1884652
1788,352820,2021-01-22,0.11271676300578035,173000,192500,19500,2251812
1789,352820,2021-01-19,0.04833836858006042,165500,173500,8000,459733
1790,352820,2021-01-18,0.054140127388535034,157000,165500,8500,630687
1791,352820,2021-01-15,0.05421686746987952,166000,157000,-9000,689611
1792,352820,2021-01-13,0.09771986970684039,153500,168500,15000,2079262
1793,352820,2020-12-17,0.06647398843930635,173000,161500,-11500,1122966
1794,352820,2020-12-03,0.04120879120879121,182000,189500,7500,666358
1795,352820,2020-11-17,0.04664723032069971,171500,179500,8000,925185
1796,352820,2020-11-16,0.071875,160000,171500,11500,1162127
1797,352820,2020-11-05,0.10067114093959731,149000,164000,15000,1565701
1798,352820,2020-11-03,0.059233449477351915,143500,152000,8500,689435
1799,352820,2020-10-30,0.09554140127388536,157000,142000,-15000,1142310
1800,352820,2020-10-27,0.041666666666666664,156000,162500,6500,1118487
1801,352820,2020-10-26,0.09565217391304348,172500,156000,-16500,987951
1802,352820,2020-10-23,0.041666666666666664,180000,172500,-7500,905547
1803,352820,2020-10-19,0.057356608478802994,200500,189000,-11500,1977996
1804,352820,2020-10-16,0.22286821705426357,258000,200500,-57500,4504395
1805,352820,2020-10-15,0.07384615384615385,162500,258000,95500,6557212
1806,352820,2020-10-27,0.041666666666666664,156000,162500,6500,1118487
1807,352820,2020-10-26,0.09565217391304348,172500,156000,-16500,987951
1808,352820,2020-10-23,0.041666666666666664,180000,172500,-7500,905547
1809,352820,2020-10-19,0.057356608478802994,200500,189000,-11500,1977996
1810,352820,2020-10-16,0.22286821705426357,258000,200500,-57500,4504395
1811,352820,2020-10-15,0.07384615384615385,162500,258000,95500,6557212
1812,352820,2020-10-27,0.041666666666666664,156000,162500,6500,1118487
1813,352820,2020-10-26,0.09565217391304348,172500,156000,-16500,987951
1814,352820,2020-10-23,0.041666666666666664,180000,172500,-7500,905547
1815,352820,2020-10-19,0.057356608478802994,200500,189000,-11500,1977996
1816,352820,2020-10-16,0.22286821705426357,258000,200500,-57500,4504395
1817,352820,2020-10-15,0.07384615384615385,162500,258000,95500,6557212
1818,352820,2020-10-27,0.041666666666666664,156000,162500,6500,1118487
1819,352820,2020-10-26,0.09565217391304348,172500,156000,-16500,987951
1820,352820,2020-10-23,0.041666666666666664,180000,172500,-7500,905547
1821,352820,2020-10-19,0.057356608478802994,200500,189000,-11500,1977996
1822,352820,2020-10-16,0.22286821705426357,258000,200500,-57500,4504395
1823,352820,2020-10-15,0.07384615384615385,162500,258000,95500,6557212
1824,352820,2020-10-27,0.041666666666666664,156000,162500,6500,1118487
1825,352820,2020-10-26,0.09565217391304348,172500,156000,-16500,987951
1826,352820,2020-10-23,0.041666666666666664,180000,172500,-7500,905547
1827,352820,2020-10-19,0.057356608478802994,200500,189000,-11500,1977996
1828,352820,2020-10-16,0.22286821705426357,258000,200500,-57500,4504395
1829,352820,2020-10-15,0.07384615384615385,162500,258000,95500,6557212
1830,352820,2020-10-27,0.041666666666666664,156000,162500,6500,1118487
1831,352820,2020-10-26,0.09565217391304348,172500,156000,-16500,987951
1832,352820,2020-10-23,0.041666666666666664,180000,172500,-7500,905547
1833,352820,2020-10-19,0.057356608478802994,200500,189000,-11500,1977996
1834,352820,2020-10-16,0.22286821705426357,258000,200500,-57500,4504395
1835,352820,2020-10-15,0.07384615384615385,162500,258000,95500,6557212
1836,352820,2020-10-27,0.041666666666666664,156000,162500,6500,1118487
1837,352820,2020-10-26,0.09565217391304348,172500,156000,-16500,987951
1838,352820,2020-10-23,0.041666666666666664,180000,172500,-7500,905547
1839,352820,2020-10-19,0.057356608478802994,200500,189000,-11500,1977996
1840,352820,2020-10-16,0.22286821705426357,258000,200500,-57500,4504395
1841,352820,2020-10-15,0.07384615384615385,162500,258000,95500,6557212
1842,352820,2020-10-27,0.041666666666666664,156000,162500,6500,1118487
1843,352820,2020-10-26,0.09565217391304348,172500,156000,-16500,987951
1844,352820,2020-10-23,0.041666666666666664,180000,172500,-7500,905547
1845,352820,2020-10-19,0.057356608478802994,200500,189000,-11500,1977996
1846,352820,2020-10-16,0.22286821705426357,258000,200500,-57500,4504395
1847,352820,2020-10-15,0.07384615384615385,162500,258000,95500,6557212
1848,352820,2020-10-27,0.041666666666666664,156000,162500,6500,1118487
1849,352820,2020-10-26,0.09565217391304348,172500,156000,-16500,987951
1850,352820,2020-10-23,0.041666666666666664,180000,172500,-7500,905547
1851,352820,2020-10-19,0.057356608478802994,200500,189000,-11500,1977996
1852,352820,2020-10-16,0.22286821705426357,258000,200500,-57500,4504395
1853,352820,2020-10-15,0.07384615384615385,162500,258000,95500,6557212
1854,352820,2020-10-27,0.041666666666666664,156000,162500,6500,1118487
1855,352820,2020-10-26,0.09565217391304348,172500,156000,-16500,987951
1856,352820,2020-10-23,0.041666666666666664,180000,172500,-7500,905547
1857,352820,2020-10-19,0.057356608478802994,200500,189000,-11500,1977996
1858,352820,2020-10-16,0.22286821705426357,258000,200500,-57500,4504395
1859,352820,2020-10-15,0.07384615384615385,162500,258000,95500,6557212
1860,352820,2020-10-27,0.041666666666666664,156000,162500,6500,1118487
1861,352820,2020-10-26,0.09565217391304348,172500,156000,-16500,987951
1862,352820,2020-10-23,0.041666666666666664,180000,172500,-7500,905547
1863,352820,2020-10-19,0.057356608478802994,200500,189000,-11500,1977996
1864,352820,2020-10-16,0.22286821705426357,258000,200500,-57500,4504395
1865,352820,2020-10-15,0.07384615384615385,162500,258000,95500,6557212
1866,352820,2020-10-27,0.041666666666666664,156000,162500,6500,1118487
1867,352820,2020-10-26,0.09565217391304348,172500,156000,-16500,987951
1868,352820,2020-10-23,0.041666666666666664,180000,172500,-7500,905547
1869,352820,2020-10-19,0.057356608478802994,200500,189000,-11500,1977996
1870,352820,2020-10-16,0.22286821705426357,258000,200500,-57500,4504395
1871,352820,2020-10-15,0.07384615384615385,162500,258000,95500,6557212
1872,352820,2020-10-27,0.041666666666666664,156000,162500,6500,1118487
1873,352820,2020-10-26,0.09565217391304348,172500,156000,-16500,987951
1874,352820,2020-10-23,0.041666666666666664,180000,172500,-7500,905547
1875,352820,2020-10-19,0.057356608478802994,200500,189000,-11500,1977996
1876,352820,2020-10-16,0.22286821705426357,258000,200500,-57500,4504395
1877,352820,2020-10-15,0.07384615384615385,162500,258000,95500,6557212
1878,352820,2020-10-27,0.041666666666666664,156000,162500,6500,1118487
1879,352820,2020-10-26,0.09565217391304348,172500,156000,-16500,987951
1880,352820,2020-10-23,0.041666666666666664,180000,172500,-7500,905547
1881,352820,2020-10-19,0.057356608478802994,200500,189000,-11500,1977996
1882,352820,2020-10-16,0.22286821705426357,258000,200500,-57500,4504395
1883,352820,2020-10-15,0.07384615384615385,162500,258000,95500,6557212
1884,352820,2020-10-27,0.041666666666666664,156000,162500,6500,1118487
1885,352820,2020-10-26,0.09565217391304348,172500,156000,-16500,987951
1886,352820,2020-10-23,0.041666666666666664,180000,172500,-7500,905547
1887,352820,2020-10-19,0.057356608478802994,200500,189000,-11500,1977996
1888,352820,2020-10-16,0.22286821705426357,258000,200500,-57500,4504395
1889,352820,2020-10-15,0.07384615384615385,162500,258000,95500,6557212
1890,352820,2020-10-27,0.041666666666666664,156000,162500,6500,1118487
1891,352820,2020-10-26,0.09565217391304348,172500,156000,-16500,987951
1892,352820,2020-10-23,0.041666666666666664,180000,172500,-7500,905547
1893,352820,2020-10-19,0.057356608478802994,200500,189000,-11500,1977996
1894,352820,2020-10-16,0.22286821705426357,258000,200500,-57500,4504395
1895,352820,2020-10-15,0.07384615384615385,162500,258000,95500,6557212
1896,352820,2020-10-27,0.041666666666666664,156000,162500,6500,1118487
1897,352820,2020-10-26,0.09565217391304348,172500,156000,-16500,987951
1898,352820,2020-10-23,0.041666666666666664,180000,172500,-7500,905547
1899,352820,2020-10-19,0.057356608478802994,200500,189000,-11500,1977996
1900,352820,2020-10-16,0.22286821705426357,258000,200500,-57500,4504395
1901,352820,2020-10-15,0.07384615384615385,162500,258000,95500,6557212
1902,352820,2020-10-27,0.041666666666666664,156000,162500,6500,1118487
1903,352820,2020-10-26,0.09565217391304348,172500,156000,-16500,987951
1904,352820,2020-10-23,0.041666666666666664,180000,172500,-7500,905547
1905,352820,2020-10-19,0.057356608478802994,200500,189000,-11500,1977996
1906,352820,2020-10-16,0.22286821705426357,258000,200500,-57500,4504395
1907,352820,2020-10-15,0.07384615384615385,162500,258000,95500,6557212
1908,352820,2020-10-27,0.041666666666666664,156000,162500,6500,1118487
1909,352820,2020-10-26,0.09565217391304348,172500,156000,-16500,987951
1910,352820,2020-10-23,0.041666666666666664,180000,172500,-7500,905547
1911,352820,2020-10-19,0.057356608478802994,200500,189000,-11500,1977996
1912,352820,2020-10-16,0.22286821705426357,258000,200500,-57500,4504395
1913,352820,2020-10-15,0.07384615384615385,162500,258000,95500,6557212
1914,352820,2020-10-27,0.041666666666666664,156000,162500,6500,1118487
1915,352820,2020-10-26,0.09565217391304348,172500,156000,-16500,987951
1916,352820,2020-10-23,0.041666666666666664,180000,172500,-7500,905547
1917,352820,2020-10-19,0.057356608478802994,200500,189000,-11500,1977996
1918,352820,2020-10-16,0.22286821705426357,258000,200500,-57500,4504395
1919,352820,2020-10-15,0.07384615384615385,162500,258000,95500,6557212
1920,352820,2020-10-27,0.041666666666666664,156000,162500,6500,1118487
1921,352820,2020-10-26,0.09565217391304348,172500,156000,-16500,987951
1922,352820,2020-10-23,0.041666666666666664,180000,172500,-7500,905547
1923,352820,2020-10-19,0.057356608478802994,200500,189000,-11500,1977996
1924,352820,2020-10-16,0.22286821705426357,258000,200500,-57500,4504395
1925,352820,2020-10-15,0.07384615384615385,162500,258000,95500,6557212
1926,352820,2020-10-27,0.041666666666666664,156000,162500,6500,1118487
1927,352820,2020-10-26,0.09565217391304348,172500,156000,-16500,987951
1928,352820,2020-10-23,0.041666666666666664,180000,172500,-7500,905547
1929,352820,2020-10-19,0.057356608478802994,200500,189000,-11500,1977996
1930,352820,2020-10-16,0.22286821705426357,258000,200500,-57500,4504395
1931,352820,2020-10-15,0.07384615384615385,162500,258000,95500,6557212
1932,352820,2020-10-27,0.041666666666666664,156000,162500,6500,1118487
1933,352820,2020-10-26,0.09565217391304348,172500,156000,-16500,987951
1934,352820,2020-10-23,0.041666666666666664,180000,172500,-7500,905547
1935,352820,2020-10-19,0.057356608478802994,200500,189000,-11500,1977996
1936,352820,2020-10-16,0.22286821705426357,258000,200500,-57500,4504395
1937,352820,2020-10-15,0.07384615384615385,162500,258000,95500,6557212
1938,352820,2020-10-27,0.041666666666666664,156000,162500,6500,1118487
1939,352820,2020-10-26,0.09565217391304348,172500,156000,-16500,987951
1940,352820,2020-10-23,0.041666666666666664,180000,172500,-7500,905547
1941,352820,2020-10-19,0.057356608478802994,200500,189000,-11500,1977996
1942,352820,2020-10-16,0.22286821705426357,258000,200500,-57500,4504395
1943,352820,2020-10-15,0.07384615384615385,162500,258000,95500,6557212
1944,352820,2020-10-27,0.041666666666666664,156000,162500,6500,1118487
1945,352820,2020-10-26,0.09565217391304348,172500,156000,-16500,987951
1946,352820,2020-10-23,0.041666666666666664,180000,172500,-7500,905547
1947,352820,2020-10-19,0.057356608478802994,200500,189000,-11500,1977996
1948,352820,2020-10-16,0.22286821705426357,258000,200500,-57500,4504395
1949,352820,2020-10-15,0.07384615384615385,162500,258000,95500,6557212
1950,352820,2020-10-27,0.041666666666666664,156000,162500,6500,1118487
1951,352820,2020-10-26,0.09565217391304348,172500,156000,-16500,987951
1952,352820,2020-10-23,0.041666666666666664,180000,172500,-7500,905547
1953,352820,2020-10-19,0.057356608478802994,200500,189000,-11500,1977996
1954,352820,2020-10-16,0.22286821705426357,258000,200500,-57500,4504395
1955,352820,2020-10-15,0.07384615384615385,162500,258000,95500,6557212
1956,352820,2020-10-27,0.041666666666666664,156000,162500,6500,1118487
1957,352820,2020-10-26,0.09565217391304348,172500,156000,-16500,987951
1958,352820,2020-10-23,0.041666666666666664,180000,172500,-7500,905547
1959,352820,2020-10-19,0.057356608478802994,200500,189000,-11500,1977996
1960,352820,2020-10-16,0.22286821705426357,258000,200500,-57500,4504395
1961,352820,2020-10-15,0.07384615384615385,162500,258000,95500,6557212
1962,352820,2020-10-27,0.041666666666666664,156000,162500,6500,1118487
1963,352820,2020-10-26,0.09565217391304348,172500,156000,-16500,987951
1964,352820,2020-10-23,0.041666666666666664,180000,172500,-7500,905547
1965,352820,2020-10-19,0.057356608478802994,200500,189000,-11500,1977996
1966,352820,2020-10-16,0.22286821705426357,258000,200500,-57500,4504395
1967,352820,2020-10-15,0.07384615384615385,162500,258000,95500,6557212
1968,352820,2020-10-27,0.041666666666666664,156000,162500,6500,1118487
1969,352820,2020-10-26,0.09565217391304348,172500,156000,-16500,987951
1970,352820,2020-10-23,0.041666666666666664,180000,172500,-7500,905547
1971,352820,2020-10-19,0.057356608478802994,200500,189000,-11500,1977996
1972,352820,2020-10-16,0.22286821705426357,258000,200500,-57500,4504395
1973,352820,2020-10-15,0.07384615384615385,162500,258000,95500,6557212
1974,352820,2020-10-27,0.041666666666666664,156000,162500,6500,1118487
1975,352820,2020-10-26,0.09565217391304348,172500,156000,-16500,987951
1976,352820,2020-10-23,0.041666666666666664,180000,172500,-7500,905547
1977,352820,2020-10-19,0.057356608478802994,200500,189000,-11500,1977996
1978,352820,2020-10-16,0.22286821705426357,258000,200500,-57500,4504395
1979,352820,2020-10-15,0.07384615384615385,162500,258000,95500,6557212
1980,352820,2020-10-27,0.041666666666666664,156000,162500,6500,1118487
1981,352820,2020-10-26,0.09565217391304348,172500,156000,-16500,987951
1982,352820,2020-10-23,0.041666666666666664,180000,172500,-7500,905547
1983,352820,2020-10-19,0.057356608478802994,200500,189000,-11500,1977996
1984,352820,2020-10-16,0.22286821705426357,258000,200500,-57500,4504395
1985,352820,2020-10-15,0.07384615384615385,162500,258000,95500,6557212
1986,352820,2020-10-27,0.041666666666666664,156000,162500,6500,1118487
1987,352820,2020-10-26,0.09565217391304348,172500,156000,-16500,987951
1988,352820,2020-10-23,0.041666666666666664,180000,172500,-7500,905547
1989,352820,2020-10-19,0.057356608478802994,200500,189000,-11500,1977996
1990,352820,2020-10-16,0.22286821705426357,258000,200500,-57500,4504395
1991,352820,2020-10-15,0.07384615384615385,162500,258000,95500,6557212
1992,352820,2020-10-27,0.041666666666666664,156000,162500,6500,1118487
1993,352820,2020-10-26,0.09565217391304348,172500,156000,-16500,987951
1994,352820,2020-10-23,0.041666666666666664,180000,172500,-7500,905547
1995,352820,2020-10-19,0.057356608478802994,200500,189000,-11500,1977996
1996,352820,2020-10-16,0.22286821705426357,258000,200500,-57500,4504395
1997,352820,2020-10-15,0.07384615384615385,162500,258000,95500,6557212
1998,352820,2020-10-27,0.041666666666666664,156000,162500,6500,1118487
1999,352820,2020-10-26,0.09565217391304348,172500,156000,-16500,987951
2000,352820,2020-10-23,0.041666666666666664,180000,172500,-7500,905547
2001,352820,2020-10-19,0.057356608478802994,200500,189000,-11500,1977996
2002,352820,2020-10-16,0.22286821705426357,258000,200500,-57500,4504395
2003,352820,2020-10-15,0.07384615384615385,162500,258000,95500,6557212
2004,352820,2020-10-27,0.041666666666666664,156000,162500,6500,1118487
2005,352820,2020-10-26,0.09565217391304348,172500,156000,-16500,987951
2006,352820,2020-10-23,0.041666666666666664,180000,172500,-7500,905547
2007,352820,2020-10-19,0.057356608478802994,200500,189000,-11500,1977996
2008,352820,2020-10-16,0.22286821705426357,258000,200500,-57500,4504395
2009,352820,2020-10-15,0.07384615384615385,162500,258000,95500,6557212
2010,352820,2020-10-27,0.041666666666666664,156000,162500,6500,1118487
2011,352820,2020-10-26,0.09565217391304348,172500,156000,-16500,987951
2012,352820,2020-10-23,0.041666666666666664,180000,172500,-7500,905547
2013,352820,2020-10-19,0.057356608478802994,200500,189000,-11500,1977996
2014,352820,2020-10-16,0.22286821705426357,258000,200500,-57500,4504395
2015,352820,2020-10-15,0.07384615384615385,162500,258000,95500,6557212
2016,352820,2020-10-27,0.041666666666666664,156000,162500,6500,1118487
2017,352820,2020-10-26,0.09565217391304348,172500,156000,-16500,987951
2018,352820,2020-10-23,0.041666666666666664,180000,172500,-7500,905547
2019,352820,2020-10-19,0.057356608478802994,200500,189000,-11500,1977996
2020,352820,2020-10-16,0.22286821705426357,258000,200500,-57500,4504395
2021,352820,2020-10-15,0.07384615384615385,162500,258000,95500,6557212
2022,352820,2020-10-27,0.041666666666666664,156000,162500,6500,1118487
2023,352820,2020-10-26,0.09565217391304348,172500,156000,-16500,987951
2024,352820,2020-10-23,0.041666666666666664,180000,172500,-7500,905547
2025,352820,2020-10-19,0.057356608478802994,200500,189000,-11500,1977996
2026,352820,2020-10-16,0.22286821705426357,258000,200500,-57500,4504395
2027,352820,2020-10-15,0.07384615384615385,162500,258000,95500,6557212
2028,352820,2020-10-27,0.041666666666666664,156000,162500,6500,1118487
2029,352820,2020-10-26,0.09565217391304348,172500,156000,-16500,987951
2030,352820,2020-10-23,0.041666666666666664,180000,172500,-7500,905547
2031,352820,2020-10-19,0.057356608478802994,200500,189000,-11500,1977996
2032,352820,2020-10-16,0.22286821705426357,258000,200500,-57500,4504395
2033,352820,2020-10-15,0.07384615384615385,162500,258000,95500,6557212
2034,352820,2020-10-27,0.041666666666666664,156000,162500,6500,1118487
2035,352820,2020-10-26,0.09565217391304348,172500,156000,-16500,987951
2036,352820,2020-10-23,0.041666666666666664,180000,172500,-7500,905547
2037,352820,2020-10-19,0.057356608478802994,200500,189000,-11500,1977996
2038,352820,2020-10-16,0.22286821705426357,258000,200500,-57500,4504395
2039,352820,2020-10-15,0.07384615384615385,162500,258000,95500,6557212
2040,352820,2020-10-27,0.041666666666666664,156000,162500,6500,1118487
2041,352820,2020-10-26,0.09565217391304348,172500,156000,-16500,987951
2042,352820,2020-10-23,0.041666666666666664,180000,172500,-7500,905547
2043,352820,2020-10-19,0.057356608478802994,200500,189000,-11500,1977996
2044,352820,2020-10-16,0.22286821705426357,258000,200500,-57500,4504395
2045,352820,2020-10-15,0.07384615384615385,162500,258000,95500,6557212
2046,352820,2020-10-27,0.041666666666666664,156000,162500,6500,1118487
2047,352820,2020-10-26,0.09565217391304348,172500,156000,-16500,987951
2048,352820,2020-10-23,0.041666666666666664,180000,172500,-7500,905547
2049,352820,2020-10-19,0.057356608478802994,200500,189000,-11500,1977996
2050,352820,2020-10-16,0.22286821705426357,258000,200500,-57500,4504395
2051,352820,2020-10-15,0.07384615384615385,162500,258000,95500,6557212
2052,352820,2020-10-27,0.041666666666666664,156000,162500,6500,1118487
2053,352820,2020-10-26,0.09565217391304348,172500,156000,-16500,987951
2054,352820,2020-10-23,0.041666666666666664,180000,172500,-7500,905547
2055,352820,2020-10-19,0.057356608478802994,200500,189000,-11500,1977996
2056,352820,2020-10-16,0.22286821705426357,258000,200500,-57500,4504395
2057,352820,2020-10-15,0.07384615384615385,162500,258000,95500,6557212
2058,352820,2020-10-27,0.041666666666666664,156000,162500,6500,1118487
2059,352820,2020-10-26,0.09565217391304348,172500,156000,-16500,987951
2060,352820,2020-10-23,0.041666666666666664,180000,172500,-7500,905547
2061,352820,2020-10-19,0.057356608478802994,200500,189000,-11500,1977996
2062,352820,2020-10-16,0.22286821705426357,258000,200500,-57500,4504395
2063,352820,2020-10-15,0.07384615384615385,162500,258000,95500,6557212
2064,352820,2020-10-27,0.041666666666666664,156000,162500,6500,1118487
2065,352820,2020-10-26,0.09565217391304348,172500,156000,-16500,987951
2066,352820,2020-10-23,0.041666666666666664,180000,172500,-7500,905547
2067,352820,2020-10-19,0.057356608478802994,200500,189000,-11500,1977996
2068,352820,2020-10-16,0.22286821705426357,258000,200500,-57500,4504395
2069,352820,2020-10-15,0.07384615384615385,162500,258000,95500,6557212
2070,352820,2020-10-27,0.041666666666666664,156000,162500,6500,1118487
2071,352820,2020-10-26,0.09565217391304348,172500,156000,-16500,987951
2072,352820,2020-10-23,0.041666666666666664,180000,172500,-7500,905547
2073,352820,2020-10-19,0.057356608478802994,200500,189000,-11500,1977996
2074,352820,2020-10-16,0.22286821705426357,258000,200500,-57500,4504395
2075,352820,2020-10-15,0.07384615384615385,162500,258000,95500,6557212
2076,352820,2020-10-27,0.041666666666666664,156000,162500,6500,1118487
2077,352820,2020-10-26,0.09565217391304348,172500,156000,-16500,987951
2078,352820,2020-10-23,0.041666666666666664,180000,172500,-7500,905547
2079,352820,2020-10-19,0.057356608478802994,200500,189000,-11500,1977996
2080,352820,2020-10-16,0.22286821705426357,258000,200500,-57500,4504395
2081,352820,2020-10-15,0.07384615384615385,162500,258000,95500,6557212
2082,352820,2020-10-27,0.041666666666666664,156000,162500,6500,1118487
2083,352820,2020-10-26,0.09565217391304348,172500,156000,-16500,987951
2084,352820,2020-10-23,0.041666666666666664,180000,172500,-7500,905547
2085,352820,2020-10-19,0.057356608478802994,200500,189000,-11500,1977996
2086,352820,2020-10-16,0.22286821705426357,258000,200500,-57500,4504395
2087,352820,2020-10-15,0.07384615384615385,162500,258000,95500,6557212
2088,352820,2020-10-27,0.041666666666666664,156000,162500,6500,1118487
2089,352820,2020-10-26,0.09565217391304348,172500,156000,-16500,987951
2090,352820,2020-10-23,0.041666666666666664,180000,172500,-7500,905547
2091,352820,2020-10-19,0.057356608478802994,200500,189000,-11500,1977996
2092,352820,2020-10-16,0.22286821705426357,258000,200500,-57500,4504395
2093,352820,2020-10-15,0.07384615384615385,162500,258000,95500,6557212
2094,352820,2020-10-27,0.041666666666666664,156000,162500,6500,1118487
2095,352820,2020-10-26,0.09565217391304348,172500,156000,-16500,987951
2096,352820,2020-10-23,0.041666666666666664,180000,172500,-7500,905547
2097,352820,2020-10-19,0.057356608478802994,200500,189000,-11500,1977996
2098,352820,2020-10-16,0.22286821705426357,258000,200500,-57500,4504395
2099,352820,2020-10-15,0.07384615384615385,162500,258000,95500,6557212
2100,352820,2020-10-27,0.041666666666666664,156000,162500,6500,1118487
2101,352820,2020-10-26,0.09565217391304348,172500,156000,-16500,987951
2102,352820,2020-10-23,0.041666666666666664,180000,172500,-7500,905547
2103,352820,2020-10-19,0.057356608478802994,200500,189000,-11500,1977996
2104,352820,2020-10-16,0.22286821705426357,258000,200500,-57500,4504395
2105,352820,2020-10-15,0.07384615384615385,162500,258000,95500,6557212
2106,352820,2020-10-27,0.041666666666666664,156000,162500,6500,1118487
2107,352820,2020-10-26,0.09565217391304348,172500,156000,-16500,987951
2108,352820,2020-10-23,0.041666666666666664,180000,172500,-7500,905547
2109,352820,2020-10-19,0.057356608478802994,200500,189000,-11500,1977996
2110,352820,2020-10-16,0.22286821705426357,258000,200500,-57500,4504395
2111,352820,2020-10-15,0.07384615384615385,162500,258000,95500,6557212
2112,352820,2020-10-27,0.041666666666666664,156000,162500,6500,1118487
2113,352820,2020-10-26,0.09565217391304348,172500,156000,-16500,987951
2114,352820,2020-10-23,0.041666666666666664,180000,172500,-7500,905547
2115,352820,2020-10-19,0.057356608478802994,200500,189000,-11500,1977996
2116,352820,2020-10-16,0.22286821705426357,258000,200500,-57500,4504395
2117,352820,2020-10-15,0.07384615384615385,162500,258000,95500,6557212
2118,352820,2020-10-27,0.041666666666666664,156000,162500,6500,1118487
2119,352820,2020-10-26,0.09565217391304348,172500,156000,-16500,987951
2120,352820,2020-10-23,0.041666666666666664,180000,172500,-7500,905547
2121,352820,2020-10-19,0.057356608478802994,200500,189000,-11500,1977996
2122,352820,2020-10-16,0.22286821705426357,258000,200500,-57500,4504395
2123,352820,2020-10-15,0.07384615384615385,162500,258000,95500,6557212
2124,352820,2020-10-27,0.041666666666666664,156000,162500,6500,1118487
2125,352820,2020-10-26,0.09565217391304348,172500,156000,-16500,987951
2126,352820,2020-10-23,0.041666666666666664,180000,172500,-7500,905547
2127,352820,2020-10-19,0.057356608478802994,200500,189000,-11500,1977996
2128,352820,2020-10-16,0.22286821705426357,258000,200500,-57500,4504395
2129,352820,2020-10-15,0.07384615384615385,162500,258000,95500,6557212
2130,352820,2020-10-27,0.041666666666666664,156000,162500,6500,1118487
2131,352820,2020-10-26,0.09565217391304348,172500,156000,-16500,987951
2132,352820,2020-10-23,0.041666666666666664,180000,172500,-7500,905547
2133,352820,2020-10-19,0.057356608478802994,200500,189000,-11500,1977996
2134,352820,2020-10-16,0.22286821705426357,258000,200500,-57500,4504395
2135,352820,2020-10-15,0.07384615384615385,162500,258000,95500,6557212
2136,352820,2020-10-27,0.041666666666666664,156000,162500,6500,1118487
2137,352820,2020-10-26,0.09565217391304348,172500,156000,-16500,987951
2138,352820,2020-10-23,0.041666666666666664,180000,172500,-7500,905547
2139,352820,2020-10-19,0.057356608478802994,200500,189000,-11500,1977996
2140,352820,2020-10-16,0.22286821705426357,258000,200500,-57500,4504395
2141,352820,2020-10-15,0.07384615384615385,162500,258000,95500,6557212
2142,352820,2020-10-27,0.041666666666666664,156000,162500,6500,1118487
2143,352820,2020-10-26,0.09565217391304348,172500,156000,-16500,987951
2144,352820,2020-10-23,0.041666666666666664,180000,172500,-7500,905547
2145,352820,2020-10-19,0.057356608478802994,200500,189000,-11500,1977996
2146,352820,2020-10-16,0.22286821705426357,258000,200500,-57500,4504395
2147,352820,2020-10-15,0.07384615384615385,162500,258000,95500,6557212
2148,352820,2020-10-27,0.041666666666666664,156000,162500,6500,1118487
2149,352820,2020-10-26,0.09565217391304348,172500,156000,-16500,987951
2150,352820,2020-10-23,0.041666666666666664,180000,172500,-7500,905547
2151,352820,2020-10-19,0.057356608478802994,200500,189000,-11500,1977996
2152,352820,2020-10-16,0.22286821705426357,258000,200500,-57500,4504395
2153,352820,2020-10-15,0.07384615384615385,162500,258000,95500,6557212
2154,352820,2020-10-27,0.041666666666666664,156000,162500,6500,1118487
2155,352820,2020-10-26,0.09565217391304348,172500,156000,-16500,987951
2156,352820,2020-10-23,0.041666666666666664,180000,172500,-7500,905547
2157,352820,2020-10-19,0.057356608478802994,200500,189000,-11500,1977996
2158,352820,2020-10-16,0.22286821705426357,258000,200500,-57500,4504395
2159,352820,2020-10-15,0.07384615384615385,162500,258000,95500,6557212
2160,352820,2020-10-27,0.041666666666666664,156000,162500,6500,1118487
2161,352820,2020-10-26,0.09565217391304348,172500,156000,-16500,987951
2162,352820,2020-10-23,0.041666666666666664,180000,172500,-7500,905547
2163,352820,2020-10-19,0.057356608478802994,200500,189000,-11500,1977996
2164,352820,2020-10-16,0.22286821705426357,258000,200500,-57500,4504395
2165,352820,2020-10-15,0.07384615384615385,162500,258000,95500,6557212
2166,352820,2020-10-27,0.041666666666666664,156000,162500,6500,1118487
2167,352820,2020-10-26,0.09565217391304348,172500,156000,-16500,987951
2168,352820,2020-10-23,0.041666666666666664,180000,172500,-7500,905547
2169,352820,2020-10-19,0.057356608478802994,200500,189000,-11500,1977996
2170,352820,2020-10-16,0.22286821705426357,258000,200500,-57500,4504395
2171,352820,2020-10-15,0.07384615384615385,162500,258000,95500,6557212
2172,352820,2020-10-27,0.041666666666666664,156000,162500,6500,1118487
2173,352820,2020-10-26,0.09565217391304348,172500,156000,-16500,987951
2174,352820,2020-10-23,0.041666666666666664,180000,172500,-7500,905547
2175,352820,2020-10-19,0.057356608478802994,200500,189000,-11500,1977996
2176,352820,2020-10-16,0.22286821705426357,258000,200500,-57500,4504395
2177,352820,2020-10-15,0.07384615384615385,162500,258000,95500,6557212
2178,352820,2020-10-27,0.041666666666666664,156000,162500,6500,1118487
2179,352820,2020-10-26,0.09565217391304348,172500,156000,-16500,987951
2180,352820,2020-10-23,0.041666666666666664,180000,172500,-7500,905547
2181,352820,2020-10-19,0.057356608478802994,200500,189000,-11500,1977996
2182,352820,2020-10-16,0.22286821705426357,258000,200500,-57500,4504395
2183,352820,2020-10-15,0.07384615384615385,162500,258000,95500,6557212
2184,352820,2020-10-27,0.041666666666666664,156000,162500,6500,1118487
2185,352820,2020-10-26,0.09565217391304348,172500,156000,-16500,987951
2186,352820,2020-10-23,0.041666666666666664,180000,172500,-7500,905547
2187,352820,2020-10-19,0.057356608478802994,200500,189000,-11500,1977996
2188,352820,2020-10-16,0.22286821705426357,258000,200500,-57500,4504395
2189,352820,2020-10-15,0.07384615384615385,162500,258000,95500,6557212
2190,352820,2020-10-27,0.041666666666666664,156000,162500,6500,1118487
2191,352820,2020-10-26,0.09565217391304348,172500,156000,-16500,987951
2192,352820,2020-10-23,0.041666666666666664,180000,172500,-7500,905547
2193,352820,2020-10-19,0.057356608478802994,200500,189000,-11500,1977996
2194,352820,2020-10-16,0.22286821705426357,258000,200500,-57500,4504395
2195,352820,2020-10-15,0.07384615384615385,162500,258000,95500,6557212
2196,352820,2020-10-27,0.041666666666666664,156000,162500,6500,1118487
2197,352820,2020-10-26,0.09565217391304348,172500,156000,-16500,987951
2198,352820,2020-10-23,0.041666666666666664,180000,172500,-7500,905547
2199,352820,2020-10-19,0.057356608478802994,200500,189000,-11500,1977996
2200,352820,2020-10-16,0.22286821705426357,258000,200500,-57500,4504395
2201,352820,2020-10-15,0.07384615384615385,162500,258000,95500,6557212
2202,352820,2020-10-27,0.041666666666666664,156000,162500,6500,1118487
2203,352820,2020-10-26,0.09565217391304348,172500,156000,-16500,987951
2204,352820,2020-10-23,0.041666666666666664,180000,172500,-7500,905547
2205,352820,2020-10-19,0.057356608478802994,200500,189000,-11500,1977996
2206,352820,2020-10-16,0.22286821705426357,258000,200500,-57500,4504395
2207,352820,2020-10-15,0.07384615384615385,162500,258000,95500,6557212
2208,352820,2020-10-27,0.041666666666666664,156000,162500,6500,1118487
2209,352820,2020-10-26,0.09565217391304348,172500,156000,-16500,987951
2210,352820,2020-10-23,0.041666666666666664,180000,172500,-7500,905547
2211,352820,2020-10-19,0.057356608478802994,200500,189000,-11500,1977996
2212,352820,2020-10-16,0.22286821705426357,258000,200500,-57500,4504395
2213,352820,2020-10-15,0.07384615384615385,162500,258000,95500,6557212
2214,352820,2020-10-27,0.041666666666666664,156000,162500,6500,1118487
2215,352820,2020-10-26,0.09565217391304348,172500,156000,-16500,987951
2216,352820,2020-10-23,0.041666666666666664,180000,172500,-7500,905547
2217,352820,2020-10-19,0.057356608478802994,200500,189000,-11500,1977996
2218,352820,2020-10-16,0.22286821705426357,258000,200500,-57500,4504395
2219,352820,2020-10-15,0.07384615384615385,162500,258000,95500,6557212
2220,352820,2020-10-27,0.041666666666666664,156000,162500,6500,1118487
2221,352820,2020-10-26,0.09565217391304348,172500,156000,-16500,987951
2222,352820,2020-10-23,0.041666666666666664,180000,172500,-7500,905547
2223,352820,2020-10-19,0.057356608478802994,200500,189000,-11500,1977996
2224,352820,2020-10-16,0.22286821705426357,258000,200500,-57500,4504395
2225,352820,2020-10-15,0.07384615384615385,162500,258000,95500,6557212
2226,352820,2020-10-27,0.041666666666666664,156000,162500,6500,1118487
2227,352820,2020-10-26,0.09565217391304348,172500,156000,-16500,987951
2228,352820,2020-10-23,0.041666666666666664,180000,172500,-7500,905547
2229,352820,2020-10-19,0.057356608478802994,200500,189000,-11500,1977996
2230,352820,2020-10-16,0.22286821705426357,258000,200500,-57500,4504395
2231,352820,2020-10-15,0.07384615384615385,162500,258000,95500,6557212
2232,352820,2020-10-27,0.041666666666666664,156000,162500,6500,1118487
2233,352820,2020-10-26,0.09565217391304348,172500,156000,-16500,987951
2234,352820,2020-10-23,0.041666666666666664,180000,172500,-7500,905547
2235,352820,2020-10-19,0.057356608478802994,200500,189000,-11500,1977996
2236,352820,2020-10-16,0.22286821705426357,258000,200500,-57500,4504395
2237,352820,2020-10-15,0.07384615384615385,162500,258000,95500,6557212
2238,352820,2020-10-27,0.041666666666666664,156000,162500,6500,1118487
2239,352820,2020-10-26,0.09565217391304348,172500,156000,-16500,987951
2240,352820,2020-10-23,0.041666666666666664,180000,172500,-7500,905547
2241,352820,2020-10-19,0.057356608478802994,200500,189000,-11500,1977996
2242,352820,2020-10-16,0.22286821705426357,258000,200500,-57500,4504395
2243,352820,2020-10-15,0.07384615384615385,162500,258000,95500,6557212
2244,352820,2020-10-27,0.041666666666666664,156000,162500,6500,1118487
2245,352820,2020-10-26,0.09565217391304348,172500,156000,-16500,987951
2246,352820,2020-10-23,0.041666666666666664,180000,172500,-7500,905547
2247,352820,2020-10-19,0.057356608478802994,200500,189000,-11500,1977996
2248,352820,2020-10-16,0.22286821705426357,258000,200500,-57500,4504395
2249,352820,2020-10-15,0.07384615384615385,162500,258000,95500,6557212
2250,352820,2020-10-27,0.041666666666666664,156000,162500,6500,1118487
2251,352820,2020-10-26,0.09565217391304348,172500,156000,-16500,987951
2252,352820,2020-10-23,0.041666666666666664,180000,172500,-7500,905547
2253,352820,2020-10-19,0.057356608478802994,200500,189000,-11500,1977996
2254,352820,2020-10-16,0.22286821705426357,258000,200500,-57500,4504395
2255,352820,2020-10-15,0.07384615384615385,162500,258000,95500,6557212
2256,352820,2020-10-27,0.041666666666666664,156000,162500,6500,1118487
2257,352820,2020-10-26,0.09565217391304348,172500,156000,-16500,987951
2258,352820,2020-10-23,0.041666666666666664,180000,172500,-7500,905547
2259,352820,2020-10-19,0.057356608478802994,200500,189000,-11500,1977996
2260,352820,2020-10-16,0.22286821705426357,258000,200500,-57500,4504395
2261,352820,2020-10-15,0.07384615384615385,162500,258000,95500,6557212
2262,352820,2020-10-27,0.041666666666666664,156000,162500,6500,1118487
2263,352820,2020-10-26,0.09565217391304348,172500,156000,-16500,987951
2264,352820,2020-10-23,0.041666666666666664,180000,172500,-7500,905547
2265,352820,2020-10-19,0.057356608478802994,200500,189000,-11500,1977996
2266,352820,2020-10-16,0.22286821705426357,258000,200500,-57500,4504395
2267,352820,2020-10-15,0.07384615384615385,162500,258000,95500,6557212
2268,352820,2020-10-27,0.041666666666666664,156000,162500,6500,1118487
2269,352820,2020-10-26,0.09565217391304348,172500,156000,-16500,987951
2270,352820,2020-10-23,0.041666666666666664,180000,172500,-7500,905547
2271,352820,2020-10-19,0.057356608478802994,200500,189000,-11500,1977996
2272,352820,2020-10-16,0.22286821705426357,258000,200500,-57500,4504395
2273,352820,2020-10-15,0.07384615384615385,162500,258000,95500,6557212
2274,352820,2020-10-27,0.041666666666666664,156000,162500,6500,1118487
2275,352820,2020-10-26,0.09565217391304348,172500,156000,-16500,987951
2276,352820,2020-10-23,0.041666666666666664,180000,172500,-7500,905547
2277,352820,2020-10-19,0.057356608478802994,200500,189000,-11500,1977996
2278,352820,2020-10-16,0.22286821705426357,258000,200500,-57500,4504395
2279,352820,2020-10-15,0.07384615384615385,162500,258000,95500,6557212
2280,352820,2020-10-27,0.041666666666666664,156000,162500,6500,1118487
2281,352820,2020-10-26,0.09565217391304348,172500,156000,-16500,987951
2282,352820,2020-10-23,0.041666666666666664,180000,172500,-7500,905547
2283,352820,2020-10-19,0.057356608478802994,200500,189000,-11500,1977996
2284,352820,2020-10-16,0.22286821705426357,258000,200500,-57500,4504395
2285,352820,2020-10-15,0.07384615384615385,162500,258000,95500,6557212
2286,352820,2020-10-27,0.041666666666666664,156000,162500,6500,1118487
2287,352820,2020-10-26,0.09565217391304348,172500,156000,-16500,987951
2288,352820,2020-10-23,0.041666666666666664,180000,172500,-7500,905547
2289,352820,2020-10-19,0.057356608478802994,200500,189000,-11500,1977996
2290,352820,2020-10-16,0.22286821705426357,258000,200500,-57500,4504395
2291,352820,2020-10-15,0.07384615384615385,162500,258000,95500,6557212
2292,352820,2020-10-27,0.041666666666666664,156000,162500,6500,1118487
2293,352820,2020-10-26,0.09565217391304348,172500,156000,-16500,987951
2294,352820,2020-10-23,0.041666666666666664,180000,172500,-7500,905547
2295,352820,2020-10-19,0.057356608478802994,200500,189000,-11500,1977996
2296,352820,2020-10-16,0.22286821705426357,258000,200500,-57500,4504395
2297,352820,2020-10-15,0.07384615384615385,162500,258000,95500,6557212
2298,352820,2020-10-27,0.041666666666666664,156000,162500,6500,1118487
2299,352820,2020-10-26,0.09565217391304348,172500,156000,-16500,987951
2300,352820,2020-10-23,0.041666666666666664,180000,172500,-7500,905547
2301,352820,2020-10-19,0.057356608478802994,200500,189000,-11500,1977996
2302,352820,2020-10-16,0.22286821705426357,258000,200500,-57500,4504395
2303,352820,2020-10-15,0.07384615384615385,162500,258000,95500,6557212
2304,352820,2020-10-27,0.041666666666666664,156000,162500,6500,1118487
2305,352820,2020-10-26,0.09565217391304348,172500,156000,-16500,987951
2306,352820,2020-10-23,0.041666666666666664,180000,172500,-7500,905547
2307,352820,2020-10-19,0.057356608478802994,200500,189000,-11500,1977996
2308,352820,2020-10-16,0.22286821705426357,258000,200500,-57500,4504395
2309,352820,2020-10-15,0.07384615384615385,162500,258000,95500,6557212
2310,352820,2020-10-27,0.041666666666666664,156000,162500,6500,1118487
2311,352820,2020-10-26,0.09565217391304348,172500,156000,-16500,987951
2312,352820,2020-10-23,0.041666666666666664,180000,172500,-7500,905547
2313,352820,2020-10-19,0.057356608478802994,200500,189000,-11500,1977996
2314,352820,2020-10-16,0.22286821705426357,258000,200500,-57500,4504395
2315,352820,2020-10-15,0.07384615384615385,162500,258000,95500,6557212
2316,352820,2020-10-27,0.041666666666666664,156000,162500,6500,1118487
2317,352820,2020-10-26,0.09565217391304348,172500,156000,-16500,987951
2318,352820,2020-10-23,0.041666666666666664,180000,172500,-7500,905547
2319,352820,2020-10-19,0.057356608478802994,200500,189000,-11500,1977996
2320,352820,2020-10-16,0.22286821705426357,258000,200500,-57500,4504395
2321,352820,2020-10-15,0.07384615384615385,162500,258000,95500,6557212
2322,352820,2020-10-27,0.041666666666666664,156000,162500,6500,1118487
2323,352820,2020-10-26,0.09565217391304348,172500,156000,-16500,987951
2324,352820,2020-10-23,0.041666666666666664,180000,172500,-7500,905547
2325,352820,2020-10-19,0.057356608478802994,200500,189000,-11500,1977996
2326,352820,2020-10-16,0.22286821705426357,258000,200500,-57500,4504395
2327,352820,2020-10-15,0.07384615384615385,162500,258000,95500,6557212
2328,352820,2020-10-27,0.041666666666666664,156000,162500,6500,1118487
2329,352820,2020-10-26,0.09565217391304348,172500,156000,-16500,987951
2330,352820,2020-10-23,0.041666666666666664,180000,172500,-7500,905547
2331,352820,2020-10-19,0.057356608478802994,200500,189000,-11500,1977996
2332,352820,2020-10-16,0.22286821705426357,258000,200500,-57500,4504395
2333,352820,2020-10-15,0.07384615384615385,162500,258000,95500,6557212
2334,352820,2020-10-27,0.041666666666666664,156000,162500,6500,1118487
2335,352820,2020-10-26,0.09565217391304348,172500,156000,-16500,987951
2336,352820,2020-10-23,0.041666666666666664,180000,172500,-7500,905547
2337,352820,2020-10-19,0.057356608478802994,200500,189000,-11500,1977996
2338,352820,2020-10-16,0.22286821705426357,258000,200500,-57500,4504395
2339,352820,2020-10-15,0.07384615384615385,162500,258000,95500,6557212
2340,352820,2020-10-27,0.041666666666666664,156000,162500,6500,1118487
2341,352820,2020-10-26,0.09565217391304348,172500,156000,-16500,987951
2342,352820,2020-10-23,0.041666666666666664,180000,172500,-7500,905547
2343,352820,2020-10-19,0.057356608478802994,200500,189000,-11500,1977996
2344,352820,2020-10-16,0.22286821705426357,258000,200500,-57500,4504395
2345,352820,2020-10-15,0.07384615384615385,162500,258000,95500,6557212
2346,352820,2020-10-27,0.041666666666666664,156000,162500,6500,1118487
2347,352820,2020-10-26,0.09565217391304348,172500,156000,-16500,987951
2348,352820,2020-10-23,0.041666666666666664,180000,172500,-7500,905547
2349,352820,2020-10-19,0.057356608478802994,200500,189000,-11500,1977996
2350,352820,2020-10-16,0.22286821705426357,258000,200500,-57500,4504395
2351,352820,2020-10-15,0.07384615384615385,162500,258000,95500,6557212
2352,352820,2020-10-27,0.041666666666666664,156000,162500,6500,1118487
2353,352820,2020-10-26,0.09565217391304348,172500,156000,-16500,987951
2354,352820,2020-10-23,0.041666666666666664,180000,172500,-7500,905547
2355,352820,2020-10-19,0.057356608478802994,200500,189000,-11500,1977996
2356,352820,2020-10-16,0.22286821705426357,258000,200500,-57500,4504395
2357,352820,2020-10-15,0.07384615384615385,162500,258000,95500,6557212
2358,352820,2020-10-27,0.041666666666666664,156000,162500,6500,1118487
2359,352820,2020-10-26,0.09565217391304348,172500,156000,-16500,987951
2360,352820,2020-10-23,0.041666666666666664,180000,172500,-7500,905547
2361,352820,2020-10-19,0.057356608478802994,200500,189000,-11500,1977996
2362,352820,2020-10-16,0.22286821705426357,258000,200500,-57500,4504395
2363,352820,2020-10-15,0.07384615384615385,162500,258000,95500,6557212
2364,352820,2020-10-27,0.041666666666666664,156000,162500,6500,1118487
2365,352820,2020-10-26,0.09565217391304348,172500,156000,-16500,987951
2366,352820,2020-10-23,0.041666666666666664,180000,172500,-7500,905547
2367,352820,2020-10-19,0.057356608478802994,200500,189000,-11500,1977996
2368,352820,2020-10-16,0.22286821705426357,258000,200500,-57500,4504395
2369,352820,2020-10-15,0.07384615384615385,162500,258000,95500,6557212
2370,352820,2020-10-27,0.041666666666666664,156000,162500,6500,1118487
2371,352820,2020-10-26,0.09565217391304348,172500,156000,-16500,987951
2372,352820,2020-10-23,0.041666666666666664,180000,172500,-7500,905547
2373,352820,2020-10-19,0.057356608478802994,200500,189000,-11500,1977996
2374,352820,2020-10-16,0.22286821705426357,258000,200500,-57500,4504395
2375,352820,2020-10-15,0.07384615384615385,162500,258000,95500,6557212
2376,352820,2020-10-27,0.041666666666666664,156000,162500,6500,1118487
2377,352820,2020-10-26,0.09565217391304348,172500,156000,-16500,987951
2378,352820,2020-10-23,0.041666666666666664,180000,172500,-7500,905547
2379,352820,2020-10-19,0.057356608478802994,200500,189000,-11500,1977996
2380,352820,2020-10-16,0.22286821705426357,258000,200500,-57500,4504395
2381,352820,2020-10-15,0.07384615384615385,162500,258000,95500,6557212
2382,352820,2020-10-27,0.041666666666666664,156000,162500,6500,1118487
2383,352820,2020-10-26,0.09565217391304348,172500,156000,-16500,987951
2384,352820,2020-10-23,0.041666666666666664,180000,172500,-7500,905547
2385,352820,2020-10-19,0.057356608478802994,200500,189000,-11500,1977996
2386,352820,2020-10-16,0.22286821705426357,258000,200500,-57500,4504395
2387,352820,2020-10-15,0.07384615384615385,162500,258000,95500,6557212
2388,352820,2020-10-27,0.041666666666666664,156000,162500,6500,1118487
2389,352820,2020-10-26,0.09565217391304348,172500,156000,-16500,987951
2390,352820,2020-10-23,0.041666666666666664,180000,172500,-7500,905547
2391,352820,2020-10-19,0.057356608478802994,200500,189000,-11500,1977996
2392,352820,2020-10-16,0.22286821705426357,258000,200500,-57500,4504395
2393,352820,2020-10-15,0.07384615384615385,162500,258000,95500,6557212
2394,352820,2020-10-27,0.041666666666666664,156000,162500,6500,1118487
2395,352820,2020-10-26,0.09565217391304348,172500,156000,-16500,987951
2396,352820,2020-10-23,0.041666666666666664,180000,172500,-7500,905547
2397,352820,2020-10-19,0.057356608478802994,200500,189000,-11500,1977996
2398,352820,2020-10-16,0.22286821705426357,258000,200500,-57500,4504395
2399,352820,2020-10-15,0.07384615384615385,162500,258000,95500,6557212
2400,352820,2020-10-27,0.041666666666666664,156000,162500,6500,1118487
2401,352820,2020-10-26,0.09565217391304348,172500,156000,-16500,987951
2402,352820,2020-10-23,0.041666666666666664,180000,172500,-7500,905547
2403,352820,2020-10-19,0.057356608478802994,200500,189000,-11500,1977996
2404,352820,2020-10-16,0.22286821705426357,258000,200500,-57500,4504395
2405,352820,2020-10-15,0.07384615384615385,162500,258000,95500,6557212
2406,352820,2020-10-27,0.041666666666666664,156000,162500,6500,1118487
2407,352820,2020-10-26,0.09565217391304348,172500,156000,-16500,987951
2408,352820,2020-10-23,0.041666666666666664,180000,172500,-7500,905547
2409,352820,2020-10-19,0.057356608478802994,200500,189000,-11500,1977996
2410,352820,2020-10-16,0.22286821705426357,258000,200500,-57500,4504395
2411,352820,2020-10-15,0.07384615384615385,162500,258000,95500,6557212
2412,352820,2020-10-27,0.041666666666666664,156000,162500,6500,1118487
2413,352820,2020-10-26,0.09565217391304348,172500,156000,-16500,987951
2414,352820,2020-10-23,0.041666666666666664,180000,172500,-7500,905547
2415,352820,2020-10-19,0.057356608478802994,200500,189000,-11500,1977996
2416,352820,2020-10-16,0.22286821705426357,258000,200500,-57500,4504395
2417,352820,2020-10-15,0.07384615384615385,162500,258000,95500,6557212
2418,352820,2020-10-27,0.041666666666666664,156000,162500,6500,1118487
2419,352820,2020-10-26,0.09565217391304348,172500,156000,-16500,987951
2420,352820,2020-10-23,0.041666666666666664,180000,172500,-7500,905547
2421,352820,2020-10-19,0.057356608478802994,200500,189000,-11500,1977996
2422,352820,2020-10-16,0.22286821705426357,258000,200500,-57500,4504395
2423,305720,2021-03-11,0.05394662123793299,17610,18560,950,1594966
2424,305720,2021-03-08,0.04171066525871172,18940,18150,-790,1819357
2425,305720,2021-02-24,0.047002032520325206,19680,18755,-925,3512493
2426,305720,2021-01-08,0.04101722723543889,18285,19035,750,10010566
2427,305720,2021-01-04,0.0976,15625,17150,1525,7018933
2428,305720,2020-11-05,0.041807432432432436,11840,12335,495,1805005
2429,305720,2020-11-03,0.04305799648506151,11380,11870,490,948603
2430,305720,2020-09-24,0.05774058577405858,11950,11260,-690,1195146
2431,305720,2020-08-20,0.04455245038477116,12345,11795,-550,1522880
2432,305720,2020-08-07,0.05991902834008097,12350,13090,740,3652049
2433,305720,2020-08-05,0.07063527321190582,11255,12050,795,1576419
2434,305720,2020-08-03,0.04913430042115115,10685,11210,525,1049527
2435,305720,2020-06-16,0.08333333333333333,8700,9425,725,454559
2436,305720,2020-06-15,0.07446808510638298,9400,8700,-700,540305
2437,305720,2020-05-26,0.06228172293364377,8590,9125,535,733925
2438,305720,2020-05-13,0.05422100205902539,7285,7680,395,351674
2439,305720,2020-04-16,0.04145818441744103,6995,7285,290,298671
2440,305720,2020-03-25,0.07896924355777224,6015,6490,475,334117
2441,305720,2020-03-24,0.10366972477064221,5450,6015,565,260099
2442,305720,2020-03-20,0.1446028513238289,4910,5620,710,254111
2443,305720,2020-03-19,0.1670907548770144,5895,4910,-985,517082
2444,305720,2020-03-18,0.08533747090768037,6445,5895,-550,439617
2445,305720,2020-03-16,0.07545839210155147,7090,6555,-535,230654
2446,305720,2020-03-12,0.04712717882504842,7745,7380,-365,328269
2447,305720,2020-03-09,0.0638675340035482,8455,7915,-540,405130
2448,305720,2020-02-28,0.04561611374407583,8440,8055,-385,450023
2449,305720,2020-02-11,0.04512534818941504,8975,9380,405,651318
2450,305720,2020-02-04,0.05218446601941747,8240,8670,430,220728
2451,305720,2020-01-10,0.0412105602060528,7765,8085,320,404534
2452,305720,2019-09-25,0.048284625158831,7870,7490,-380,171601
2453,305720,2019-08-05,0.04116529449018366,7895,7570,-325,84068
2454,305720,2019-05-09,0.04523809523809524,8400,8020,-380,40608
2455,305720,2019-01-07,0.04645476772616137,8180,8560,380,712570
2456,305720,2018-12-03,0.040023201856148494,8620,8965,345,253437
2457,305720,2018-11-02,0.049144119271120924,9055,9500,445,285190
2458,305720,2018-10-23,0.04381049414161997,9815,9385,-430,644986
2459,305720,2018-10-12,0.04522613065326633,8955,9360,405,502650
2460,305720,2018-10-11,0.04378003203416978,9365,8955,-410,469796
2461,60,2021-05-24,0.043478260869565216,17250,18000,750,708415
2462,60,2021-05-17,0.16784869976359337,21150,17600,-3550,3428940
2463,60,2021-05-06,0.046153846153846156,19500,20400,900,512610
2464,60,2021-03-31,0.051630434782608696,18400,19350,950,955676
2465,60,2021-02-22,0.04666666666666667,15000,15700,700,1271128
2466,60,2021-02-01,0.05993690851735016,15850,14900,-950,1152343
2467,60,2021-01-25,0.04276315789473684,15200,15850,650,978548
2468,60,2021-01-14,0.04152249134948097,14450,15050,600,743867
2469,60,2020-12-29,0.08231707317073171,16400,15050,-1350,917229
2470,60,2020-11-10,0.04225352112676056,14200,14800,600,330623
2471,60,2020-11-02,0.04693140794223827,13850,14500,650,214543
2472,60,2020-10-30,0.04482758620689655,14500,13850,-650,316946
2473,60,2020-10-22,0.0410958904109589,14600,15200,600,894578
2474,60,2020-10-19,0.04411764705882353,13600,14200,600,532316
2475,60,2020-10-08,0.04119850187265917,13350,13900,550,438858
2476,60,2020-08-18,0.041044776119402986,13400,12850,-550,255530
2477,60,2020-06-16,0.06367041198501873,13350,14200,850,190591
2478,60,2020-06-15,0.06643356643356643,14300,13350,-950,185654
2479,60,2020-05-15,0.04225352112676056,14200,14800,600,646630
2480,60,2020-04-10,0.0967741935483871,12400,13600,1200,863824
2481,60,2020-04-02,0.041666666666666664,12000,12500,500,177522
2482,60,2020-03-31,0.05172413793103448,11600,12200,600,203185
2483,60,2020-03-27,0.04017857142857143,11200,11650,450,206366
2484,60,2020-03-26,0.08737864077669903,10300,11200,900,370283
2485,60,2020-03-25,0.061855670103092786,9700,10300,600,307937
2486,60,2020-03-23,0.045454545454545456,9900,9450,-450,397366
2487,60,2020-03-20,0.0784313725490196,9180,9900,720,596347
2488,60,2020-03-19,0.20862068965517241,11600,9180,-2420,780973
2489,60,2020-03-17,0.05511811023622047,12700,12000,-700,319127
2490,60,2019-09-10,0.04696132596685083,18100,18950,850,317077
2491,60,2019-08-23,0.04155844155844156,19250,18450,-800,147312
2492,60,2019-08-22,0.04054054054054054,18500,19250,750,197748
2493,60,2019-06-07,0.047619047619047616,22050,21000,-1050,264930
2494,60,2019-05-13,0.04025423728813559,23600,22650,-950,416851
2495,60,2019-04-01,0.04526748971193416,24300,25400,1100,480325
2496,60,2018-12-05,0.04481132075471698,21200,22150,950,285701
2497,60,2018-11-20,0.04578313253012048,20750,21700,950,356371
2498,60,2018-11-12,0.09893048128342247,18700,20550,1850,1190128
2499,60,2018-09-27,0.05660377358490566,18550,19600,1050,580989
2500,60,2018-06-21,0.04830917874396135,20700,19700,-1000,386376
2501,60,2018-03-23,0.04090909090909091,22000,21100,-900,191091
2502,60,2017-12-20,0.0412573673870334,25450,24400,-1050,163624
2503,60,2017-12-19,0.045174537987679675,24350,25450,1100,518201
2504,60,2017-12-18,0.042826552462526764,23350,24350,1000,294976
2505,60,2017-12-01,0.04669260700389105,25700,24500,-1200,164887
2506,60,2017-10-30,0.05090909090909091,27500,26100,-1400,250591
2507,60,2017-10-20,0.046464646464646465,24750,25900,1150,527204
2508,60,2017-07-11,0.04066985645933014,20900,21750,850,409602
2509,32830,2021-05-03,0.04039167686658507,81700,85000,3300,1849657
2510,32830,2021-04-14,0.05084745762711865,76700,80600,3900,896786
2511,32830,2021-03-02,0.04533333333333334,75000,78400,3400,828000
2512,32830,2021-02-22,0.046357615894039736,75500,79000,3500,1218533
2513,32830,2021-02-17,0.04632152588555858,73400,76800,3400,957165
2514,32830,2021-01-18,0.04963680387409201,82600,78500,-4100,1161683
2515,32830,2021-01-07,0.041343669250646,77400,80600,3200,1947359
2516,32830,2020-12-22,0.055408970976253295,75800,80000,4200,2136409
2517,32830,2020-12-11,0.0453920220082531,72700,76000,3300,1091351
2518,32830,2020-11-19,0.04748603351955307,71600,75000,3400,1391353
2519,32830,2020-09-22,0.04,62500,60000,-2500,803162
2520,32830,2020-09-01,0.0718954248366013,61200,65600,4400,2641377
2521,32830,2020-08-20,0.05396825396825397,63000,59600,-3400,1612953
2522,32830,2020-08-19,0.06598984771573604,59100,63000,3900,2918565
2523,32830,2020-08-18,0.09494640122511486,65300,59100,-6200,3076232
2524,32830,2020-08-14,0.0917941585535466,71900,65300,-6600,4598985
2525,32830,2020-08-13,0.21043771043771045,59400,71900,12500,7226406
2526,32830,2020-08-12,0.055062166962699825,56300,59400,3100,1678762
2527,32830,2020-08-10,0.12284263959390863,49250,55300,6050,3134363
2528,32830,2020-08-06,0.05485232067510549,47400,50000,2600,1399072
2529,32830,2020-06-16,0.049162011173184354,44750,46950,2200,578499
2530,32830,2020-06-15,0.04584221748400853,46900,44750,-2150,727179
2531,32830,2020-06-12,0.04285714285714286,49000,46900,-2100,791765
2532,32830,2020-06-03,0.05186721991701245,48200,50700,2500,1753024
2533,32830,2020-05-19,0.04954954954954955,44400,46600,2200,927699
2534,32830,2020-05-04,0.04175152749490835,49100,47050,-2050,913449
2535,32830,2020-04-27,0.0511727078891258,46900,49300,2400,766422
2536,32830,2020-04-10,0.14479638009049775,44200,50600,6400,3246690
2537,32830,2020-04-01,0.05116279069767442,43000,40800,-2200,651313
2538,32830,2020-03-26,0.058823529411764705,45050,42400,-2650,1396917
2539,32830,2020-03-25,0.16861219195849547,38550,45050,6500,1325096
2540,32830,2020-03-24,0.056164383561643834,36500,38550,2050,786810
2541,32830,2020-03-23,0.07511045655375552,33950,36500,2550,943863
2542,32830,2020-03-20,0.06426332288401254,31900,33950,2050,700255
2543,32830,2020-03-19,0.09375,35200,31900,-3300,1005840
2544,32830,2020-03-18,0.10318471337579618,39250,35200,-4050,925997
2545,32830,2020-03-17,0.09143518518518519,43200,39250,-3950,900643
2546,32830,2020-03-16,0.05984766050054407,45950,43200,-2750,522549
2547,32830,2020-03-12,0.05079681274900399,50200,47650,-2550,893419
2548,32830,2020-03-09,0.07553956834532374,55600,51400,-4200,581390
2549,32830,2020-02-24,0.05076923076923077,65000,61700,-3300,396835
2550,32830,2019-01-31,0.05257510729613734,93200,88300,-4900,1138071
2551,32830,2018-11-22,0.04111111111111111,90000,86300,-3700,577166
2552,32830,2018-10-11,0.04113924050632911,94800,90900,-3900,337633
2553,32830,2018-09-21,0.04689203925845147,91700,96000,4300,670255
2554,32830,2018-05-31,0.04186046511627907,107500,103000,-4500,793402
2555,32830,2018-02-23,0.04065040650406504,123000,128000,5000,309916
2556,32830,2018-01-30,0.0421455938697318,130500,125000,-5500,785334
2557,32830,2017-10-31,0.04247104247104247,129500,135000,5500,512542
2558,32830,2017-10-25,0.047058823529411764,127500,133500,6000,851150
2559,32830,2017-10-11,0.07894736842105263,114000,123000,9000,619650
2560,32830,2017-09-07,0.05405405405405406,111000,117000,6000,423899
2561,32830,2017-05-15,0.0423728813559322,118000,123000,5000,642789
2562,32830,2017-03-14,0.045871559633027525,109000,114000,5000,544362
2563,32830,2016-11-14,0.04072398190045249,110500,115000,4500,601144
2564,32830,2016-11-11,0.04739336492890995,105500,110500,5000,626027
2565,32830,2016-10-06,0.0430622009569378,104500,109000,4500,589943
2566,32830,2016-08-19,0.046296296296296294,108000,103000,-5000,548647
2567,32830,2016-08-18,0.05365853658536585,102500,108000,5500,1038485
2568,8770,2021-05-31,0.04209445585215606,97400,101500,4100,1199756
2569,8770,2021-05-26,0.04584221748400853,93800,98100,4300,1736088
2570,8770,2021-03-15,0.0405727923627685,83800,87200,3400,1855348
2571,8770,2020-12-09,0.04059040590405904,81300,84600,3300,1584583
2572,8770,2020-11-10,0.05812417437252312,75700,80100,4400,3178169
2573,8770,2020-09-02,0.04551724137931035,72500,75800,3300,1333521
2574,8770,2020-08-18,0.09252217997465145,78900,71600,-7300,1522556
2575,8770,2020-08-12,0.06620689655172414,72500,77300,4800,2874821
2576,8770,2020-06-30,0.07575757575757576,66000,71000,5000,3299832
2577,8770,2020-06-15,0.054758800521512385,76700,72500,-4200,830788
2578,8770,2020-05-19,0.04755944931163955,79900,83700,3800,1320419
2579,8770,2020-04-28,0.04859335038363171,78200,82000,3800,1661552
2580,8770,2020-04-17,0.048582995951417005,74100,77700,3600,1671138
2581,8770,2020-04-07,0.04551920341394026,70300,73500,3200,1121802
2582,8770,2020-04-06,0.049253731343283584,67000,70300,3300,805194
2583,8770,2020-04-01,0.04113475177304964,70500,67600,-2900,718939
2584,8770,2020-03-25,0.10185185185185185,64800,71400,6600,1246474
2585,8770,2020-03-24,0.04854368932038835,61800,64800,3000,885966
2586,8770,2020-03-23,0.08714918759231906,67700,61800,-5900,735001
2587,8770,2020-03-20,0.0746031746031746,63000,67700,4700,835080
2588,8770,2020-03-19,0.09612625538020086,69700,63000,-6700,1094365
2589,8770,2020-03-18,0.05810810810810811,74000,69700,-4300,1270816
2590,8770,2020-03-17,0.04815864022662889,70600,74000,3400,923565
2591,8770,2020-03-16,0.05992010652463382,75100,70600,-4500,755600
2592,8770,2020-03-13,0.049367088607594936,79000,75100,-3900,1613653
2593,8770,2020-03-10,0.043209876543209874,81000,84500,3500,813711
2594,8770,2020-03-04,0.04024390243902439,82000,85300,3300,595455
2595,8770,2020-02-28,0.04290822407628129,83900,80300,-3600,1041668
2596,8770,2020-02-24,0.0562429696287964,88900,83900,-5000,1047798
2597,8770,2020-02-12,0.05627705627705628,92400,97600,5200,1076967
2598,8770,2020-02-06,0.06741573033707865,89000,95000,6000,1166680
2599,8770,2020-01-28,0.10309278350515463,97000,87000,-10000,2383525
2600,8770,2020-01-20,0.05069124423963134,108500,103000,-5500,1168346
2601,8770,2020-01-07,0.04741833508956796,94900,99400,4500,736235
2602,8770,2019-12-30,0.04009163802978236,87300,90800,3500,726313
2603,8770,2019-12-27,0.041766109785202864,83800,87300,3500,553933
2604,8770,2019-11-06,0.04767879548306148,79700,83500,3800,1049659
2605,8770,2019-10-30,0.043941411451398134,75100,78400,3300,919970
2606,8770,2019-10-28,0.04630788485607009,79900,76200,-3700,1085951
2607,8770,2019-10-01,0.042923433874709975,86200,82500,-3700,653709
2608,8770,2019-09-03,0.0583756345177665,78800,83400,4600,1093997
2609,8770,2019-08-29,0.04461942257217848,76200,79600,3400,1192725
2610,8770,2019-08-08,0.05220883534136546,74700,78600,3900,538608
2611,8770,2019-08-06,0.046894803548795945,78900,75200,-3700,751155
2612,8770,2019-07-29,0.04321728691476591,83300,79700,-3600,759098
2613,8770,2019-07-08,0.04,90000,86400,-3600,517045
2614,8770,2019-07-02,0.060790273556231005,98700,92700,-6000,1156447
2615,8770,2019-06-21,0.05196078431372549,102000,96700,-5300,1036507
2616,8770,2019-06-19,0.04781281790437437,98300,103000,4700,557754
2617,8770,2019-06-04,0.043248945147679324,94800,90700,-4100,817996
2618,8770,2019-05-23,0.06118355065195587,99700,93600,-6100,936540
2619,8770,2019-05-15,0.04739336492890995,105500,100500,-5000,1373470
2620,8770,2019-05-13,0.06880733944954129,109000,101500,-7500,812571
2621,8770,2019-05-10,0.0430622009569378,104500,109000,4500,791825
2622,8770,2019-05-09,0.045662100456621,109500,104500,-5000,753620
2623,8770,2019-04-29,0.04186046511627907,107500,112000,4500,740348
2624,8770,2019-04-09,0.04781281790437437,98300,103000,4700,864936
2625,8770,2019-04-04,0.04951560818083961,92900,97500,4600,994923
2626,8770,2019-03-18,0.07331042382588775,87300,93700,6400,1914249
2627,8770,2019-03-15,0.05307599517490953,82900,87300,4400,1176116
2628,8770,2019-03-07,0.052109181141439205,80600,84800,4200,1231286
2629,8770,2019-02-20,0.044472681067344345,78700,82200,3500,1548212
2630,8770,2019-02-08,0.040364583333333336,76800,73700,-3100,975776
2631,8770,2019-01-28,0.055487053020961775,81100,76600,-4500,1824331
2632,8770,2019-01-25,0.0410783055198973,77900,81100,3200,1172736
2633,8770,2019-01-14,0.06676136363636363,70400,75100,4700,1852458
2634,8770,2019-01-02,0.044444444444444446,76500,73100,-3400,666916
2635,8770,2018-12-27,0.0496551724137931,72500,76100,3600,857814
2636,8770,2018-12-06,0.07429245283018868,84800,78500,-6300,1073993
2637,8770,2018-11-15,0.12955465587044535,74100,83700,9600,2433830
2638,8770,2018-11-09,0.04967320261437908,76500,72700,-3800,1241548
2639,8770,2018-11-02,0.08653846153846154,72800,79100,6300,1002692
2640,8770,2018-10-26,0.06217616580310881,77200,72400,-4800,1231409
2641,8770,2018-10-15,0.04342857142857143,87500,83700,-3800,472235
2642,8770,2018-10-12,0.06447688564476886,82200,87500,5300,896671
2643,8770,2018-10-11,0.06484641638225255,87900,82200,-5700,1380635
2644,8770,2018-10-10,0.046637744034707156,92200,87900,-4300,936866
2645,8770,2018-10-04,0.07512195121951219,102500,94800,-7700,1699004
2646,8770,2018-10-02,0.05092592592592592,108000,102500,-5500,538215
2647,8770,2018-09-27,0.0430622009569378,104500,109000,4500,536308
2648,8770,2018-08-23,0.055,100000,105500,5500,795345
2649,8770,2018-08-20,0.041176470588235294,102000,97800,-4200,506303
2650,8770,2018-08-13,0.04878048780487805,102500,97500,-5000,617841
2651,8770,2018-08-10,0.04205607476635514,107000,102500,-4500,426581
2652,8770,2018-08-01,0.07214428857715431,99800,107000,7200,913356
2653,8770,2018-07-24,0.07236842105263158,91200,97800,6600,841272
2654,8770,2018-07-19,0.08768472906403942,101500,92600,-8900,1572519
2655,8770,2018-07-09,0.1111111111111111,112500,100000,-12500,1606714
2656,8770,2018-07-06,0.041666666666666664,108000,112500,4500,470618
2657,8770,2018-07-03,0.06302521008403361,119000,111500,-7500,1509731
2658,8770,2018-06-26,0.053061224489795916,122500,116000,-6500,535876
2659,8770,2018-06-18,0.04365079365079365,126000,120500,-5500,393753
2660,8770,2018-06-15,0.045454545454545456,132000,126000,-6000,412576
2661,8770,2018-05-25,0.047058823529411764,127500,121500,-6000,411479
2662,8770,2018-05-24,0.05371900826446281,121000,127500,6500,515366
2663,8770,2018-04-30,0.049773755656108594,110500,116000,5500,855646
2664,8770,2018-04-13,0.04,100000,104000,4000,337139
2665,8770,2018-04-12,0.047619047619047616,105000,100000,-5000,577677
2666,8770,2018-04-02,0.06360792492179354,95900,102000,6100,1037147
2667,8770,2018-03-30,0.042391304347826085,92000,95900,3900,493183
2668,8770,2018-03-26,0.04377104377104377,89100,93000,3900,437682
2669,8770,2018-03-09,0.10817307692307693,83200,92200,9000,1628652
2670,8770,2018-02-09,0.040983606557377046,85400,81900,-3500,334811
2671,8770,2018-02-07,0.07597765363128492,89500,82700,-6800,644330
2672,8770,2018-02-05,0.050156739811912224,95700,90900,-4800,495651
2673,8770,2018-02-01,0.04408602150537634,93000,97100,4100,546926
2674,8770,2018-01-09,0.05771495877502945,84900,89800,4900,913864
2675,8770,2017-12-12,0.05509964830011723,85300,80600,-4700,931748
2676,8770,2017-11-20,0.06396063960639606,81300,86500,5200,998332
2677,8770,2017-10-30,0.09272467902995721,70100,76600,6500,2075860
2678,8770,2017-10-26,0.08607198748043818,63900,69400,5500,1848902
2679,8770,2017-10-13,0.06379310344827586,58000,61700,3700,841337
2680,8770,2017-09-28,0.04411764705882353,54400,56800,2400,566251
2681,8770,2017-07-26,0.07933884297520662,60500,65300,4800,2300303
2682,8770,2017-07-17,0.04159132007233273,55300,57600,2300,484711
2683,8770,2017-07-12,0.07809523809523809,52500,56600,4100,996194
2684,8770,2017-06-13,0.04159733777038269,60100,57600,-2500,1042301
2685,8770,2017-05-17,0.04631217838765009,58300,61000,2700,1169854
2686,8770,2017-05-04,0.05202312138728324,51900,54600,2700,794215
2687,8770,2017-04-21,0.045889101338432124,52300,54700,2400,1514485
2688,8770,2017-04-17,0.07465825446898001,47550,51100,3550,1438793
2689,8770,2017-04-03,0.04212860310421286,45100,47000,1900,927726
2690,8770,2017-03-03,0.13095238095238096,50400,43800,-6600,3051489
2691,8770,2017-02-23,0.059670781893004114,48600,51500,2900,2481442
2692,8770,2017-01-26,0.04560260586319218,46050,43950,-2100,1087281
2693,8770,2017-01-19,0.047471620227038186,48450,46150,-2300,669530
2694,8770,2016-12-19,0.04437869822485207,50700,48450,-2250,830048
2695,8770,2016-11-21,0.041666666666666664,52800,50600,-2200,406013
2696,8770,2016-11-10,0.04660194174757282,51500,53900,2400,332158
2697,8770,2016-11-02,0.056261343012704176,55100,52000,-3100,646147
2698,8770,2016-10-25,0.06935483870967742,62000,57700,-4300,1442578
2699,39490,2021-05-13,0.04905660377358491,132500,126000,-6500,362936
2700,39490,2021-05-10,0.052434456928838954,133500,140500,7000,402606
2701,39490,2021-05-03,0.04150943396226415,132500,127000,-5500,125164
2702,39490,2021-04-20,0.04887218045112782,133000,139500,6500,275579
2703,39490,2021-04-01,0.051587301587301584,126000,132500,6500,310435
2704,39490,2021-03-25,0.04081632653061224,122500,127500,5000,193008
2705,39490,2021-03-18,0.044715447154471545,123000,128500,5500,234789
2706,39490,2021-03-11,0.059574468085106386,117500,124500,7000,320108
2707,39490,2021-02-26,0.040892193308550186,134500,129000,-5500,228753
2708,39490,2021-02-23,0.045936395759717315,141500,135000,-6500,218566
2709,39490,2021-02-10,0.047619047619047616,157500,150000,-7500,411313
2710,39490,2021-02-08,0.040268456375838924,149000,155000,6000,259371
2711,39490,2021-01-22,0.0627062706270627,151500,142000,-9500,559331
2712,39490,2021-01-19,0.05673758865248227,141000,149000,8000,217876
2713,39490,2021-01-18,0.04081632653061224,147000,141000,-6000,174061
2714,39490,2021-01-12,0.040123456790123455,162000,155500,-6500,428191
2715,39490,2021-01-11,0.06578947368421052,152000,162000,10000,708792
2716,39490,2021-01-06,0.055762081784386616,134500,142000,7500,1184781
2717,39490,2021-01-04,0.06324110671936758,126500,134500,8000,441480
2718,39490,2020-12-17,0.04868913857677903,133500,127000,-6500,555410
2719,39490,2020-12-10,0.05,140000,133000,-7000,653699
2720,39490,2020-12-04,0.07434944237918216,134500,144500,10000,222603
2721,39490,2020-12-02,0.05058365758754864,128500,135000,6500,171234
2722,39490,2020-11-26,0.06666666666666667,120000,128000,8000,380867
2723,39490,2020-11-23,0.05652173913043478,115000,121500,6500,272429
2724,39490,2020-11-17,0.04878048780487805,123000,117000,-6000,238563
2725,39490,2020-11-16,0.1232876712328767,109500,123000,13500,411528
2726,39490,2020-10-21,0.05399792315680166,96300,101500,5200,140814
2727,39490,2020-09-24,0.0594059405940594,101000,95000,-6000,135757
2728,39490,2020-09-09,0.04424778761061947,113000,108000,-5000,117050
2729,39490,2020-09-02,0.049107142857142856,112000,117500,5500,179184
2730,39490,2020-08-25,0.06190476190476191,105000,111500,6500,129447
2731,39490,2020-08-10,0.102803738317757,107000,118000,11000,451774
2732,39490,2020-08-05,0.05,100000,105000,5000,513471
2733,39490,2020-07-20,0.04174757281553398,103000,98700,-4300,159468
2734,39490,2020-07-17,0.09341825902335456,94200,103000,8800,224420
2735,39490,2020-07-13,0.0892018779342723,85200,92800,7600,202359
2736,39490,2020-07-08,0.045351473922902494,88200,84200,-4000,166962
2737,39490,2020-06-29,0.045707915273132664,89700,85600,-4100,96348
2738,39490,2020-06-25,0.06016597510373444,96400,90600,-5800,170716
2739,39490,2020-06-17,0.06896551724137931,87000,93000,6000,231189
2740,39490,2020-06-16,0.05199516324062878,82700,87000,4300,129806
2741,39490,2020-06-15,0.04833141542002301,86900,82700,-4200,75860
2742,39490,2020-06-03,0.040268456375838924,89400,93000,3600,216388
2743,39490,2020-06-02,0.08363636363636363,82500,89400,6900,188583
2744,39490,2020-06-01,0.045627376425855515,78900,82500,3600,78525
2745,39490,2020-05-19,0.04918032786885246,79300,83200,3900,191845
2746,39490,2020-05-18,0.05312084993359894,75300,79300,4000,115885
2747,39490,2020-04-06,0.10581222056631892,67100,74200,7100,219858
2748,39490,2020-04-01,0.04,70000,67200,-2800,130208
2749,39490,2020-03-25,0.11993243243243243,59200,66300,7100,145727
2750,39490,2020-03-24,0.12547528517110265,52600,59200,6600,126698
2751,39490,2020-03-23,0.0706713780918728,56600,52600,-4000,104078
2752,39490,2020-03-20,0.04044117647058824,54400,56600,2200,121777
2753,39490,2020-03-13,0.05982905982905983,58500,55000,-3500,231429
2754,39490,2020-03-12,0.06995230524642289,62900,58500,-4400,121055
2755,39490,2020-03-09,0.040059347181008904,67400,64700,-2700,72732
2756,39490,2020-01-28,0.07087628865979381,77600,72100,-5500,161129
2757,39490,2020-01-23,0.049019607843137254,81600,77600,-4000,92898
2758,39490,2019-12-13,0.04429530201342282,74500,77800,3300,133048
2759,39490,2019-08-26,0.0409711684370258,65900,63200,-2700,109180
2760,39490,2019-08-20,0.04503105590062112,64400,67300,2900,64740
2761,39490,2019-08-16,0.05373134328358209,67000,63400,-3600,171099
2762,39490,2019-08-08,0.04066265060240964,66400,69100,2700,87112
2763,39490,2019-08-02,0.05096418732782369,72600,68900,-3700,246025
2764,39490,2019-06-25,0.046263345195729534,84300,80400,-3900,177934
2765,39490,2019-04-18,0.051224944320712694,89800,85200,-4600,223594
2766,39490,2019-04-03,0.05975197294250282,88700,94000,5300,225712
2767,39490,2019-04-01,0.059186189889025895,81100,85900,4800,112361
2768,39490,2019-02-08,0.049773755656108594,88400,84000,-4400,126974
2769,39490,2019-01-24,0.06601466992665037,81800,87200,5400,253423
2770,39490,2019-01-16,0.047619047619047616,79800,83600,3800,217660
2771,39490,2019-01-15,0.058355437665782495,75400,79800,4400,144507
2772,39490,2019-01-02,0.04603580562659847,78200,74600,-3600,86300
2773,39490,2018-12-06,0.04976303317535545,84400,80200,-4200,103081
2774,39490,2018-12-04,0.04194260485651214,90600,86800,-3800,73165
2775,39490,2018-12-03,0.06588235294117648,85000,90600,5600,126113
2776,39490,2018-11-29,0.049689440993788817,80500,84500,4000,262867
2777,39490,2018-11-23,0.04,80000,76800,-3200,87500
2778,39490,2018-11-02,0.09868421052631579,76000,83500,7500,157893
2779,39490,2018-10-25,0.0456989247311828,74400,71000,-3400,167542
2780,39490,2018-10-23,0.05071521456436931,76900,73000,-3900,87850
2781,39490,2018-10-11,0.06329113924050633,79000,74000,-5000,188626
2782,39490,2018-10-04,0.049493813273340834,88900,84500,-4400,188621
2783,39490,2018-10-02,0.06421052631578947,95000,88900,-6100,210338
2784,39490,2018-08-27,0.047830923248053395,89900,94200,4300,167085
2785,39490,2018-08-21,0.04186046511627907,86000,89600,3600,128184
2786,39490,2018-08-13,0.06792873051224944,89800,83700,-6100,287378
2787,39490,2018-07-04,0.04271844660194175,103000,98600,-4400,124460
2788,39490,2018-07-02,0.07834101382488479,108500,100000,-8500,182007
2789,39490,2018-06-29,0.04326923076923077,104000,108500,4500,158534
2790,39490,2018-06-20,0.04205607476635514,107000,111500,4500,189316
2791,39490,2018-05-28,0.06147540983606557,122000,129500,7500,190713
2792,39490,2018-05-14,0.04065040650406504,123000,128000,5000,211103
2793,39490,2018-03-23,0.0502283105022831,109500,104000,-5500,101301
2794,39490,2018-03-12,0.05555555555555555,108000,114000,6000,156485
2795,39490,2018-03-09,0.058823529411764705,102000,108000,6000,179985
2796,39490,2018-03-06,0.041025641025641026,97500,101500,4000,157172
2797,39490,2018-02-20,0.045662100456621,109500,104500,-5000,53599
2798,39490,2018-02-12,0.06896551724137931,101500,108500,7000,251548
2799,39490,2018-02-09,0.04245283018867924,106000,101500,-4500,165318
2800,39490,2018-02-08,0.04950495049504951,101000,106000,5000,164144
2801,39490,2018-02-01,0.04205607476635514,107000,111500,4500,132845
2802,39490,2018-01-23,0.05825242718446602,103000,109000,6000,174025
2803,39490,2018-01-18,0.06781376518218624,98800,105500,6700,173495
2804,39490,2018-01-15,0.05549626467449306,93700,98900,5200,189223
2805,39490,2018-01-12,0.07331042382588775,87300,93700,6400,221577
2806,39490,2017-12-13,0.057387057387057384,81900,86600,4700,69956
2807,39490,2017-11-22,0.059880239520958084,83500,88500,5000,334491
2808,39490,2017-11-15,0.0794044665012407,80600,87000,6400,265573
2809,39490,2017-11-13,0.08689839572192513,74800,81300,6500,324329
2810,39490,2017-10-12,0.050546448087431695,73200,76900,3700,166749
2811,39490,2017-09-25,0.06338939197930142,77300,72400,-4900,304807
2812,39490,2017-09-07,0.048748353096179184,75900,79600,3700,108044
2813,39490,2017-08-03,0.04428904428904429,85800,82000,-3800,94879
2814,39490,2017-06-02,0.045774647887323945,85200,89100,3900,125924
2815,39490,2017-03-16,0.07338308457711443,80400,86300,5900,113036
2816,39490,2017-03-03,0.05128205128205128,78000,74000,-4000,46495
2817,39490,2017-02-16,0.055710306406685235,71800,75800,4000,67704
2818,39490,2017-02-06,0.06116642958748222,70300,74600,4300,85693
2819,39490,2016-12-23,0.04477611940298507,67000,70000,3000,82513
2820,39490,2016-12-08,0.06269592476489028,63800,67800,4000,60689
2821,39490,2016-12-05,0.04,65000,62400,-2600,48386
2822,39490,2016-11-18,0.057057057057057055,66600,62800,-3800,110242
2823,39490,2016-10-24,0.04189944134078212,71600,68600,-3000,49134
2824,39490,2016-09-12,0.041168658698539175,75300,72200,-3100,79499
2825,207940,2021-05-17,0.07805907172995781,948000,874000,-74000,546343
2826,207940,2021-05-14,0.09468822170900693,866000,948000,82000,1010588
2827,207940,2021-05-12,0.04773561811505508,817000,856000,39000,785496
2828,207940,2021-03-11,0.043795620437956206,685000,715000,30000,110454
2829,207940,2021-01-29,0.05369928400954654,838000,793000,-45000,276664
2830,207940,2021-01-27,0.05860349127182045,802000,849000,47000,652417
2831,207940,2020-12-29,0.04182509505703422,789000,822000,33000,222705
2832,207940,2020-12-08,0.05909090909090909,880000,828000,-52000,400980
2833,207940,2020-12-07,0.06666666666666667,825000,880000,55000,507215
2834,207940,2020-11-18,0.04909560723514212,774000,812000,38000,403958
2835,207940,2020-11-05,0.06548431105047749,733000,781000,48000,447218
2836,207940,2020-11-04,0.04864091559370529,699000,733000,34000,252251
2837,207940,2020-10-29,0.09419152276295134,637000,697000,60000,301106
2838,207940,2020-10-22,0.0436046511627907,688000,658000,-30000,186612
2839,207940,2020-09-24,0.04539007092198582,705000,673000,-32000,186230
2840,207940,2020-08-12,0.048507462686567165,804000,843000,39000,760424
2841,207940,2020-08-11,0.042801556420233464,771000,804000,33000,761446
2842,207940,2020-08-05,0.0707482993197279,735000,787000,52000,521095
2843,207940,2020-07-22,0.05333333333333334,750000,790000,40000,371837
2844,207940,2020-07-02,0.04521276595744681,752000,786000,34000,266716
2845,207940,2020-06-12,0.07764390896921017,747000,805000,58000,789465
2846,207940,2020-06-11,0.061079545454545456,704000,747000,43000,593199
2847,207940,2020-06-10,0.04142011834319527,676000,704000,28000,282781
2848,207940,2020-05-13,0.04054054054054054,592000,616000,24000,510468
2849,207940,2020-05-04,0.043029259896729774,581000,556000,-25000,302753
2850,207940,2020-04-17,0.04814814814814815,540000,566000,26000,776987
2851,207940,2020-04-10,0.16823406478578892,478500,559000,80500,3037570
2852,207940,2020-04-01,0.061203319502074686,482000,452500,-29500,313016
2853,207940,2020-03-31,0.07111111111111111,450000,482000,32000,665621
2854,207940,2020-03-24,0.09174311926605505,436000,476000,40000,509039
2855,207940,2020-03-20,0.17486338797814208,366000,430000,64000,586738
2856,207940,2020-03-19,0.08614232209737828,400500,366000,-34500,470624
2857,207940,2020-03-18,0.0407185628742515,417500,400500,-17000,276886
2858,207940,2020-03-16,0.05805038335158817,456500,430000,-26500,218369
2859,207940,2020-03-13,0.054865424430641824,483000,456500,-26500,477093
2860,207940,2020-02-24,0.052415210688591986,486500,461000,-25500,278895
2861,207940,2020-02-06,0.05918367346938776,490000,519000,29000,298254
2862,207940,2020-01-23,0.06858407079646017,452000,483000,31000,438529
2863,207940,2019-12-23,0.06557377049180328,396500,422500,26000,385044
2864,207940,2019-10-23,0.08284883720930232,344000,372500,28500,565378
2865,207940,2019-10-01,0.05040650406504065,307500,323000,15500,105042
2866,207940,2019-09-23,0.06351550960118169,338500,317000,-21500,284614
2867,207940,2019-09-19,0.04113924050632911,316000,329000,13000,273672
2868,207940,2019-09-17,0.07325383304940375,293500,315000,21500,342854
2869,207940,2019-08-29,0.04886561954624782,286500,272500,-14000,796095
2870,207940,2019-08-26,0.042328042328042326,283500,271500,-12000,92053
2871,207940,2019-08-12,0.07235621521335807,269500,289000,19500,240244
2872,207940,2019-08-09,0.08016032064128256,249500,269500,20000,251336
2873,207940,2019-08-05,0.0718132854578097,278500,258500,-20000,246067
2874,207940,2019-07-09,0.04107424960505529,316500,303500,-13000,98425
2875,207940,2019-06-04,0.04658901830282862,300500,314500,14000,147236
2876,207940,2019-05-31,0.0582010582010582,283500,300000,16500,145193
2877,207940,2019-05-14,0.07543859649122807,285000,306500,21500,408431
2878,207940,2019-05-13,0.0436241610738255,298000,285000,-13000,180720
2879,207940,2019-05-08,0.07739938080495357,323000,298000,-25000,539282
2880,207940,2019-04-25,0.0649171270718232,362000,338500,-23500,322619
2881,207940,2019-04-02,0.06564885496183206,327500,349000,21500,239085
2882,207940,2019-03-15,0.042134831460674156,356000,341000,-15000,342069
2883,207940,2018-12-28,0.04177897574123989,371000,386500,15500,256133
2884,207940,2018-12-20,0.06521739130434782,368000,344000,-24000,368200
2885,207940,2018-12-17,0.04853128991060025,391500,372500,-19000,402873
2886,207940,2018-12-14,0.045121951219512194,410000,391500,-18500,467797
2887,207940,2018-12-11,0.17787742899850523,334500,394000,59500,1393121
2888,207940,2018-11-14,0.06698564593301436,313500,334500,21000,1495609
2889,207940,2018-11-13,0.09807355516637478,285500,313500,28000,1508590
2890,207940,2018-11-12,0.22418478260869565,368000,285500,-82500,1504675
2891,207940,2018-11-09,0.04291287386215865,384500,368000,-16500,295775
2892,207940,2018-10-30,0.09793103448275862,362500,398000,35500,411792
2893,207940,2018-10-26,0.04859335038363171,391000,372000,-19000,300551
2894,207940,2018-10-23,0.06599552572706935,447000,417500,-29500,434396
2895,207940,2018-10-11,0.0430327868852459,488000,467000,-21000,331580
2896,207940,2018-10-10,0.0412573673870334,509000,488000,-21000,234332
2897,207940,2018-10-02,0.04275092936802974,538000,515000,-23000,192678
2898,207940,2018-09-20,0.04142011834319527,507000,528000,21000,490554
2899,207940,2018-09-18,0.043209876543209874,486000,507000,21000,347511
2900,207940,2018-08-17,0.04090909090909091,440000,458000,18000,233685
2901,207940,2018-08-08,0.07075471698113207,424000,454000,30000,623311
2902,207940,2018-08-07,0.06532663316582915,398000,424000,26000,472153
2903,207940,2018-07-25,0.0535931790499391,410500,388500,-22000,366589
2904,207940,2018-07-13,0.06293706293706294,429000,402000,-27000,796570
2905,207940,2018-07-09,0.041463414634146344,410000,427000,17000,230626
2906,207940,2018-06-22,0.05421686746987952,415000,437500,22500,345522
2907,207940,2018-06-20,0.10236220472440945,381000,420000,39000,400393
2908,207940,2018-06-19,0.06503067484662577,407500,381000,-26500,240421
2909,207940,2018-06-14,0.050058207217694994,429500,408000,-21500,245236
2910,207940,2018-06-04,0.07198228128460686,451500,419000,-32500,689971
2911,207940,2018-05-24,0.04630788485607009,399500,418000,18500,295791
2912,207940,2018-05-16,0.06563706563706563,388500,414000,25500,729170
2913,207940,2018-05-15,0.054274084124830396,368500,388500,20000,426156
2914,207940,2018-05-14,0.04657179818887452,386500,368500,-18000,430529
2915,207940,2018-05-09,0.07422402159244265,370500,398000,27500,1236829
2916,207940,2018-05-04,0.0782051282051282,390000,359500,-30500,1522558
2917,207940,2018-05-02,0.1721311475409836,488000,404000,-84000,2332526
2918,207940,2018-04-26,0.04179728317659352,478500,498500,20000,336856
2919,207940,2018-04-23,0.06521739130434782,506000,473000,-33000,580297
2920,207940,2018-04-19,0.059369202226345084,539000,507000,-32000,476884
2921,207940,2018-04-09,0.08285163776493257,519000,562000,43000,543779
2922,207940,2018-03-29,0.04516129032258064,465000,486000,21000,226147
2923,207940,2018-03-28,0.07,500000,465000,-35000,451007
2924,207940,2018-02-22,0.042352941176470586,425000,443000,18000,374488
2925,207940,2018-02-12,0.05368289637952559,400500,422000,21500,247343
2926,207940,2018-01-29,0.05143540669856459,418000,439500,21500,794689
2927,207940,2018-01-23,0.04129032258064516,387500,403500,16000,193047
2928,207940,2018-01-12,0.04785894206549118,397000,416000,19000,732180
2929,207940,2018-01-02,0.04986522911051213,371000,389500,18500,409343
2930,207940,2017-12-27,0.062409288824383166,344500,366000,21500,277024
2931,207940,2017-12-11,0.06379821958456973,337000,358500,21500,311770
2932,207940,2017-12-07,0.04499274310595065,344500,329000,-15500,427710
2933,207940,2017-12-01,0.061313868613138686,342500,363500,21000,298111
2934,207940,2017-11-30,0.06035665294924554,364500,342500,-22000,790554
2935,207940,2017-11-01,0.057291666666666664,384000,406000,22000,387331
2936,207940,2017-10-25,0.04325032765399738,381500,365000,-16500,326323
2937,207940,2017-10-12,0.08633093525179857,347500,377500,30000,499172
2938,207940,2017-09-22,0.049253731343283584,335000,318500,-16500,437563
2939,207940,2017-09-14,0.06930693069306931,303000,324000,21000,487784
2940,207940,2017-09-12,0.06643356643356643,286000,305000,19000,745221
2941,207940,2017-08-22,0.04189435336976321,274500,286000,11500,362272
2942,207940,2017-07-25,0.05128205128205128,273000,287000,14000,606363
2943,207940,2017-06-29,0.055062166962699825,281500,297000,15500,770998
2944,207940,2017-06-26,0.13453815261044177,249000,282500,33500,1506559
2945,207940,2017-06-23,0.046218487394957986,238000,249000,11000,397068
2946,207940,2017-06-13,0.07221006564551423,228500,245000,16500,525605
2947,207940,2017-06-09,0.04670912951167728,235500,224500,-11000,758098
2948,207940,2017-06-07,0.053763440860215055,232500,245000,12500,512783
2949,207940,2017-06-01,0.04090909090909091,220000,229000,9000,457129
2950,207940,2017-05-31,0.04018912529550828,211500,220000,8500,628168
2951,207940,2017-05-26,0.04656862745098039,204000,213500,9500,432433
2952,207940,2017-02-08,0.04956268221574344,171500,163000,-8500,374070
2953,207940,2017-02-02,0.05214723926380368,163000,171500,8500,597838
2954,207940,2017-01-11,0.052980132450331126,151000,159000,8000,353023
2955,207940,2016-12-28,0.044673539518900345,145500,152000,6500,316778
2956,207940,2016-12-01,0.06168831168831169,154000,144500,-9500,852285
2957,207940,2016-11-25,0.04180064308681672,155500,162000,6500,702370
2958,207940,2016-11-24,0.06325301204819277,166000,155500,-10500,837894
2959,207940,2016-11-15,0.05413105413105413,175500,166000,-9500,2592949
2960,207940,2016-11-14,0.08668730650154799,161500,175500,14000,2977177
2961,207940,2016-11-11,0.12152777777777778,144000,161500,17500,8140539
2962,207940,2016-11-10,0.05572755417956656,161500,144000,-17500,7179018
2963,207940,2016-11-11,0.12152777777777778,144000,161500,17500,8140539
2964,207940,2016-11-10,0.05572755417956656,161500,144000,-17500,7179018
2965,207940,2016-11-11,0.12152777777777778,144000,161500,17500,8140539
2966,207940,2016-11-10,0.05572755417956656,161500,144000,-17500,7179018
2967,207940,2016-11-11,0.12152777777777778,144000,161500,17500,8140539
2968,207940,2016-11-10,0.05572755417956656,161500,144000,-17500,7179018
2969,207940,2016-11-11,0.12152777777777778,144000,161500,17500,8140539
2970,207940,2016-11-10,0.05572755417956656,161500,144000,-17500,7179018
2971,207940,2016-11-11,0.12152777777777778,144000,161500,17500,8140539
2972,207940,2016-11-10,0.05572755417956656,161500,144000,-17500,7179018
2973,207940,2016-11-11,0.12152777777777778,144000,161500,17500,8140539
2974,298050,2021-05-18,0.05,350000,367500,17500,74475
2975,298050,2021-04-20,0.05118601747815231,400500,421000,20500,305844
2976,298050,2021-04-16,0.0611183355006502,384500,408000,23500,252344
2977,298050,2021-03-29,0.07108433734939759,415000,385500,-29500,259347
2978,298050,2021-03-26,0.08923884514435695,381000,415000,34000,261403
2979,298050,2021-03-24,0.08882521489971347,349000,380000,31000,209538
2980,298050,2021-03-15,0.10492845786963434,314500,347500,33000,301832
2981,298050,2021-03-11,0.04251700680272109,294000,306500,12500,105199
2982,298050,2021-03-08,0.049689440993788817,322000,306000,-16000,135130
2983,298050,2021-03-04,0.08848080133555926,299500,326000,26500,446327
2984,298050,2021-02-24,0.048903878583473864,296500,282000,-14500,140221
2985,298050,2021-02-22,0.04666666666666667,300000,286000,-14000,121876
2986,298050,2021-02-17,0.04462809917355372,302500,316000,13500,258763
2987,298050,2021-02-08,0.05492730210016155,309500,292500,-17000,304090
2988,298050,2021-02-05,0.05272108843537415,294000,309500,15500,335300
2989,298050,2021-02-01,0.2185430463576159,226500,276000,49500,1276187
2990,298050,2021-01-28,0.07603686635944701,217000,233500,16500,477284
2991,298050,2021-01-25,0.1711229946524064,187000,219000,32000,840509
2992,298050,2021-01-22,0.10979228486646884,168500,187000,18500,562044
2993,298050,2021-01-18,0.04833836858006042,165500,157500,-8000,81197
2994,298050,2021-01-13,0.07741935483870968,155000,167000,12000,281313
2995,298050,2021-01-07,0.04234527687296417,153500,160000,6500,178260
2996,298050,2020-12-29,0.042105263157894736,142500,148500,6000,87926
2997,298050,2020-11-09,0.06690140845070422,142000,151500,9500,117557
2998,298050,2020-11-02,0.0449438202247191,133500,139500,6000,56427
2999,298050,2020-10-29,0.04150943396226415,132500,138000,5500,86007
3000,298050,2020-10-28,0.0728744939271255,123500,132500,9000,46102
3001,298050,2020-10-26,0.05405405405405406,129500,122500,-7000,59192
3002,298050,2020-09-24,0.05415162454873646,138500,131000,-7500,98552
3003,298050,2020-09-22,0.04377104377104377,148500,142000,-6500,102946
3004,298050,2020-09-10,0.06862745098039216,153000,163500,10500,259291
3005,298050,2020-09-08,0.05864197530864197,162000,152500,-9500,217328
3006,298050,2020-09-03,0.0625,144000,153000,9000,310179
3007,298050,2020-09-01,0.05514705882352941,136000,143500,7500,216262
3008,298050,2020-08-18,0.05985915492957746,142000,133500,-8500,180645
3009,298050,2020-08-14,0.04377104377104377,148500,142000,-6500,142007
3010,298050,2020-08-11,0.04391891891891892,148000,154500,6500,388533
3011,298050,2020-08-10,0.05714285714285714,140000,148000,8000,282941
3012,298050,2020-08-03,0.06060606060606061,132000,140000,8000,316443
3013,298050,2020-07-31,0.05179282868525897,125500,132000,6500,289919
3014,298050,2020-07-27,0.09282700421940929,118500,129500,11000,403469
3015,298050,2020-07-24,0.04435483870967742,124000,118500,-5500,107733
3016,298050,2020-07-22,0.06465517241379311,116000,123500,7500,318952
3017,298050,2020-07-06,0.05429864253393665,110500,116500,6000,121557
3018,298050,2020-07-01,0.043859649122807015,114000,109000,-5000,111671
3019,298050,2020-06-26,0.0931174089068826,123500,112000,-11500,344626
3020,298050,2020-06-25,0.08178438661710037,134500,123500,-11000,284459
3021,298050,2020-06-24,0.07171314741035857,125500,134500,9000,491782
3022,298050,2020-06-23,0.07264957264957266,117000,125500,8500,228280
3023,298050,2020-06-18,0.06763285024154589,103500,110500,7000,116833
3024,298050,2020-06-12,0.045785639958376693,96100,100500,4400,266168
3025,298050,2020-06-11,0.12661195779601406,85300,96100,10800,514763
3026,298050,2020-06-03,0.041273584905660375,84800,88300,3500,76781
3027,298050,2020-05-14,0.05922551252847381,87800,82600,-5200,62905
3028,298050,2020-05-11,0.041474654377880185,86800,90400,3600,45852
3029,298050,2020-04-29,0.04086845466155811,78300,81500,3200,51465
3030,298050,2020-04-28,0.041223404255319146,75200,78300,3100,25361
3031,298050,2020-04-23,0.0438957475994513,72900,76100,3200,24155
3032,298050,2020-04-17,0.05316091954022988,69600,73300,3700,53549
3033,298050,2020-04-07,0.05956112852664577,63800,67600,3800,52840
3034,298050,2020-03-26,0.07522935779816514,54500,58600,4100,96955
3035,298050,2020-03-25,0.1657754010695187,46750,54500,7750,92114
3036,298050,2020-03-24,0.060090702947845805,44100,46750,2650,54422
3037,298050,2020-03-23,0.08125,48000,44100,-3900,47528
3038,298050,2020-03-20,0.04918032786885246,45750,48000,2250,79278
3039,298050,2020-03-19,0.18738898756660746,56300,45750,-10550,82025
3040,298050,2020-03-18,0.07095709570957096,60600,56300,-4300,33332
3041,298050,2020-03-16,0.06716417910447761,67000,62500,-4500,34759
3042,298050,2020-03-13,0.0921409214092141,73800,67000,-6800,66228
3043,298050,2020-03-12,0.0798004987531172,80200,73800,-6400,39808
3044,298050,2020-02-24,0.052060737527114966,92200,87400,-4800,32693
3045,298050,2020-01-28,0.04128440366972477,109000,104500,-4500,30311
3046,298050,2020-01-08,0.04186046511627907,107500,103000,-4500,41910
3047,298050,2019-10-31,0.04782608695652174,115000,109500,-5500,106104
3048,298050,2019-10-16,0.040160642570281124,124500,129500,5000,57932
3049,298050,2019-08-23,0.05384615384615385,130000,137000,7000,259272
3050,298050,2019-08-19,0.08860759493670886,118500,129000,10500,114669
3051,298050,2019-08-16,0.048672566371681415,113000,118500,5500,46925
3052,298050,2019-08-06,0.04897959183673469,122500,116500,-6000,84126
3053,298050,2019-08-02,0.0603448275862069,116000,123000,7000,101754
3054,298050,2019-07-25,0.04365079365079365,126000,120500,-5500,29578
3055,298050,2019-07-16,0.04838709677419355,124000,130000,6000,63558
3056,298050,2019-07-02,0.041666666666666664,120000,125000,5000,23113
3057,298050,2019-06-11,0.04072398190045249,110500,115000,4500,69541
3058,298050,2019-05-16,0.04032258064516129,124000,119000,-5000,29168
3059,298050,2019-05-09,0.050387596899224806,129000,122500,-6500,31965
3060,298050,2019-03-18,0.07692307692307693,123500,133000,9500,50261
3061,298050,2019-02-14,0.040983606557377046,122000,127000,5000,27499
3062,298050,2019-02-12,0.05172413793103448,116000,122000,6000,32760
3063,298050,2019-01-28,0.04405286343612335,113500,118500,5000,21528
3064,298050,2019-01-14,0.05314009661835749,103500,109000,5500,29692
3065,298050,2018-12-21,0.055299539170506916,108500,102500,-6000,70334
3066,298050,2018-11-26,0.043478260869565216,103500,108000,4500,9782
3067,298050,2018-10-31,0.04919678714859438,99600,104500,4900,33263
3068,298050,2018-10-25,0.05069124423963134,108500,103000,-5500,41314
3069,298050,2018-10-24,0.05652173913043478,115000,108500,-6500,40098
3070,298050,2018-10-11,0.052,125000,118500,-6500,58573
3071,298050,2018-10-10,0.0421455938697318,130500,125000,-5500,25391
3072,298050,2018-09-20,0.04013377926421405,149500,143500,-6000,26386
3073,298050,2018-08-02,0.050595238095238096,168000,159500,-8500,44807
3074,298050,2018-07-30,0.040625,160000,166500,6500,45047
3075,298050,2018-07-23,0.05214723926380368,163000,154500,-8500,79709
3076,298050,2018-07-19,0.043076923076923075,162500,169500,7000,192445
3077,298050,2018-07-18,0.06609195402298851,174000,162500,-11500,172571
3078,298050,2018-07-16,0.0875,160000,174000,14000,667957
3079,298050,2018-07-13,0.3620689655172414,174000,160000,-14000,890434
3080,298050,2018-07-16,0.0875,160000,174000,14000,667957
3081,298050,2018-07-13,0.3620689655172414,174000,160000,-14000,890434
3082,298050,2018-07-16,0.0875,160000,174000,14000,667957
3083,298050,2018-07-13,0.3620689655172414,174000,160000,-14000,890434
3084,298050,2018-07-16,0.0875,160000,174000,14000,667957
3085,298050,2018-07-13,0.3620689655172414,174000,160000,-14000,890434
3086,298050,2018-07-16,0.0875,160000,174000,14000,667957
3087,298050,2018-07-13,0.3620689655172414,174000,160000,-14000,890434
3088,298050,2018-07-16,0.0875,160000,174000,14000,667957
3089,298050,2018-07-13,0.3620689655172414,174000,160000,-14000,890434
3090,298050,2018-07-16,0.0875,160000,174000,14000,667957
3091,298050,2018-07-13,0.3620689655172414,174000,160000,-14000,890434
3092,298050,2018-07-16,0.0875,160000,174000,14000,667957
3093,298050,2018-07-13,0.3620689655172414,174000,160000,-14000,890434
3094,298050,2018-07-16,0.0875,160000,174000,14000,667957
3095,298050,2018-07-13,0.3620689655172414,174000,160000,-14000,890434
3096,298050,2018-07-16,0.0875,160000,174000,14000,667957
3097,298050,2018-07-13,0.3620689655172414,174000,160000,-14000,890434
3098,298050,2018-07-16,0.0875,160000,174000,14000,667957
3099,298050,2018-07-13,0.3620689655172414,174000,160000,-14000,890434
3100,298050,2018-07-16,0.0875,160000,174000,14000,667957
3101,298050,2018-07-13,0.3620689655172414,174000,160000,-14000,890434
3102,298050,2018-07-16,0.0875,160000,174000,14000,667957
3103,298050,2018-07-13,0.3620689655172414,174000,160000,-14000,890434
3104,298050,2018-07-16,0.0875,160000,174000,14000,667957
3105,298050,2018-07-13,0.3620689655172414,174000,160000,-14000,890434
3106,298050,2018-07-16,0.0875,160000,174000,14000,667957
3107,298050,2018-07-13,0.3620689655172414,174000,160000,-14000,890434
3108,298050,2018-07-16,0.0875,160000,174000,14000,667957
3109,298050,2018-07-13,0.3620689655172414,174000,160000,-14000,890434
3110,298050,2018-07-16,0.0875,160000,174000,14000,667957
3111,298050,2018-07-13,0.3620689655172414,174000,160000,-14000,890434
3112,298050,2018-07-16,0.0875,160000,174000,14000,667957
3113,298050,2018-07-13,0.3620689655172414,174000,160000,-14000,890434
3114,298050,2018-07-16,0.0875,160000,174000,14000,667957
3115,298050,2018-07-13,0.3620689655172414,174000,160000,-14000,890434
3116,298050,2018-07-16,0.0875,160000,174000,14000,667957
3117,298050,2018-07-13,0.3620689655172414,174000,160000,-14000,890434
3118,298050,2018-07-16,0.0875,160000,174000,14000,667957
3119,298050,2018-07-13,0.3620689655172414,174000,160000,-14000,890434
3120,298050,2018-07-16,0.0875,160000,174000,14000,667957
3121,298050,2018-07-13,0.3620689655172414,174000,160000,-14000,890434
3122,298050,2018-07-16,0.0875,160000,174000,14000,667957
3123,298050,2018-07-13,0.3620689655172414,174000,160000,-14000,890434
3124,298050,2018-07-16,0.0875,160000,174000,14000,667957
3125,298050,2018-07-13,0.3620689655172414,174000,160000,-14000,890434
3126,298050,2018-07-16,0.0875,160000,174000,14000,667957
3127,298050,2018-07-13,0.3620689655172414,174000,160000,-14000,890434
3128,298050,2018-07-16,0.0875,160000,174000,14000,667957
3129,298050,2018-07-13,0.3620689655172414,174000,160000,-14000,890434
3130,298050,2018-07-16,0.0875,160000,174000,14000,667957
3131,298050,2018-07-13,0.3620689655172414,174000,160000,-14000,890434
3132,298050,2018-07-16,0.0875,160000,174000,14000,667957
3133,298050,2018-07-13,0.3620689655172414,174000,160000,-14000,890434
3134,298050,2018-07-16,0.0875,160000,174000,14000,667957
3135,298050,2018-07-13,0.3620689655172414,174000,160000,-14000,890434
3136,298050,2018-07-16,0.0875,160000,174000,14000,667957
3137,298050,2018-07-13,0.3620689655172414,174000,160000,-14000,890434
3138,298050,2018-07-16,0.0875,160000,174000,14000,667957
3139,298050,2018-07-13,0.3620689655172414,174000,160000,-14000,890434
3140,298050,2018-07-16,0.0875,160000,174000,14000,667957
3141,298050,2018-07-13,0.3620689655172414,174000,160000,-14000,890434
3142,298050,2018-07-16,0.0875,160000,174000,14000,667957
3143,298050,2018-07-13,0.3620689655172414,174000,160000,-14000,890434
3144,298050,2018-07-16,0.0875,160000,174000,14000,667957
3145,298050,2018-07-13,0.3620689655172414,174000,160000,-14000,890434
3146,298050,2018-07-16,0.0875,160000,174000,14000,667957
3147,298050,2018-07-13,0.3620689655172414,174000,160000,-14000,890434
3148,298050,2018-07-16,0.0875,160000,174000,14000,667957
3149,298050,2018-07-13,0.3620689655172414,174000,160000,-14000,890434
3150,298050,2018-07-16,0.0875,160000,174000,14000,667957
3151,298050,2018-07-13,0.3620689655172414,174000,160000,-14000,890434
3152,298050,2018-07-16,0.0875,160000,174000,14000,667957
3153,298050,2018-07-13,0.3620689655172414,174000,160000,-14000,890434
3154,298050,2018-07-16,0.0875,160000,174000,14000,667957
3155,298050,2018-07-13,0.3620689655172414,174000,160000,-14000,890434
3156,298050,2018-07-16,0.0875,160000,174000,14000,667957
3157,298050,2018-07-13,0.3620689655172414,174000,160000,-14000,890434
3158,298050,2018-07-16,0.0875,160000,174000,14000,667957
3159,298050,2018-07-13,0.3620689655172414,174000,160000,-14000,890434
3160,298050,2018-07-16,0.0875,160000,174000,14000,667957
3161,298050,2018-07-13,0.3620689655172414,174000,160000,-14000,890434
3162,298050,2018-07-16,0.0875,160000,174000,14000,667957
3163,298050,2018-07-13,0.3620689655172414,174000,160000,-14000,890434
3164,298050,2018-07-16,0.0875,160000,174000,14000,667957
3165,298050,2018-07-13,0.3620689655172414,174000,160000,-14000,890434
3166,298050,2018-07-16,0.0875,160000,174000,14000,667957
3167,298050,2018-07-13,0.3620689655172414,174000,160000,-14000,890434
3168,298050,2018-07-16,0.0875,160000,174000,14000,667957
3169,298050,2018-07-13,0.3620689655172414,174000,160000,-14000,890434
3170,298050,2018-07-16,0.0875,160000,174000,14000,667957
3171,298050,2018-07-13,0.3620689655172414,174000,160000,-14000,890434
3172,298050,2018-07-16,0.0875,160000,174000,14000,667957
3173,13890,2021-05-27,0.042726347914547304,98300,102500,4200,240125
3174,13890,2021-05-25,0.061356297093649086,92900,98600,5700,167533
3175,13890,2021-05-12,0.11345029239766082,85500,95200,9700,642413
3176,13890,2021-02-24,0.048304213771839674,97300,92600,-4700,78007
3177,13890,2020-12-01,0.043478260869565216,103500,108000,4500,118758
3178,13890,2020-11-20,0.0787139689578714,90200,97300,7100,255756
3179,13890,2020-10-29,0.10853658536585366,82000,90900,8900,742137
3180,13890,2020-08-18,0.05104408352668213,86200,81800,-4400,235174
3181,13890,2020-08-10,0.06593406593406594,81900,87300,5400,387429
3182,13890,2020-07-22,0.04740406320541761,88600,84400,-4200,217350
3183,13890,2020-07-09,0.053227633069082674,88300,93000,4700,338393
3184,13890,2020-07-03,0.0502283105022831,87600,92000,4400,338939
3185,13890,2020-07-02,0.09090909090909091,80300,87600,7300,348895
3186,13890,2020-06-26,0.05317769130998703,77100,81200,4100,137368
3187,13890,2020-06-16,0.08426966292134831,71200,77200,6000,114423
3188,13890,2020-06-15,0.08717948717948718,78000,71200,-6800,103522
3189,13890,2020-05-29,0.05,80000,84000,4000,274760
3190,13890,2020-05-28,0.06651108518086347,85700,80000,-5700,575809
3191,13890,2020-05-15,0.046052631578947366,76000,79500,3500,161309
3192,13890,2020-05-06,0.04727272727272727,82500,86400,3900,138272
3193,13890,2020-04-27,0.06353240152477764,78700,83700,5000,190066
3194,13890,2020-04-23,0.06582633053221289,71400,76100,4700,176274
3195,13890,2020-04-16,0.11022364217252396,62600,69500,6900,262669
3196,13890,2020-04-14,0.046822742474916385,59800,62600,2800,141513
3197,13890,2020-04-13,0.0492845786963434,62900,59800,-3100,116034
3198,13890,2020-04-07,0.054673721340388004,56700,59800,3100,211771
3199,13890,2020-04-02,0.09339774557165861,62100,56300,-5800,903242
3200,13890,2020-03-25,0.059336823734729496,57300,60700,3400,314056
3201,13890,2020-03-23,0.06976744186046512,51600,55200,3600,425232
3202,13890,2020-03-20,0.29974811083123426,39700,51600,11900,490495
3203,13890,2020-03-19,0.20440881763527055,49900,39700,-10200,474956
3204,13890,2020-03-18,0.15423728813559323,59000,49900,-9100,950896
3205,13890,2020-03-17,0.1386861313868613,68500,59000,-9500,2060223
3206,13890,2020-03-16,0.04061624649859944,71400,68500,-2900,134425
3207,13890,2020-03-10,0.0450070323488045,71100,74300,3200,239030
3208,13890,2020-03-09,0.06692913385826772,76200,71100,-5100,143328
3209,13890,2020-03-02,0.06643356643356643,85800,80100,-5700,309124
3210,13890,2020-02-28,0.09206349206349207,94500,85800,-8700,631773
3211,13890,2020-02-25,0.040641711229946524,93500,97300,3800,125797
3212,13890,2020-02-24,0.06965174129353234,100500,93500,-7000,164442
3213,13890,2020-02-21,0.04739336492890995,105500,100500,-5000,134952
3214,13890,2020-01-14,0.041666666666666664,98400,102500,4100,120781
3215,13890,2020-01-07,0.04357298474945534,91800,95800,4000,128353
3216,13890,2019-12-26,0.04312354312354312,85800,89500,3700,136056
3217,13890,2019-12-02,0.04092920353982301,90400,86700,-3700,122904
3218,13890,2019-11-22,0.04426787741203178,88100,92000,3900,88420
3219,13890,2019-11-14,0.05517241379310345,87000,91800,4800,196040
3220,13890,2019-11-11,0.05676328502415459,82800,87500,4700,287217
3221,13890,2019-10-30,23.170731707317074,410,83000,82590,1309394
3222,13890,2005-05-16,0.5769230769230769,260,410,150,722024
3223,13890,2005-05-13,0.35,400,260,-140,489703
3224,13890,2005-05-12,0.7391304347826086,230,400,170,547204
3225,13890,2005-05-11,0.24324324324324326,185,230,45,431838
3226,13890,2005-05-10,0.08823529411764706,170,185,15,625659
3227,13890,2005-05-09,0.9447154471544715,3075,170,-2905,1321007
3228,13890,2004-03-17,0.14937759336099585,3615,3075,-540,10360
3229,13890,2004-03-16,0.14941176470588236,4250,3615,-635,17164
3230,13890,2004-03-12,0.08008658008658008,4620,4250,-370,170150
3231,13890,2004-02-05,0.04684684684684685,5550,5290,-260,200990
3232,13890,2004-02-04,0.05113636363636364,5280,5550,270,108090
3233,13890,2004-01-26,0.05113636363636364,5280,5550,270,366710
3234,13890,2003-12-22,0.0732484076433121,6280,5820,-460,196130
3235,13890,2003-11-24,0.061611374407582936,6330,5940,-390,74810
3236,13890,2003-11-19,0.05547226386806597,6670,6300,-370,123300
3237,13890,2003-11-12,0.046153846153846156,7150,6820,-330,187807
3238,13890,2003-11-11,0.04666666666666667,7500,7150,-350,292190
3239,13890,2003-11-10,0.056338028169014086,7100,7500,400,360183
3240,13890,2003-11-06,0.1076923076923077,6500,7200,700,905876
3241,13890,2003-10-27,0.04477611940298507,6030,6300,270,95680
3242,13890,2003-10-14,0.07420494699646643,5660,6080,420,291830
3243,13890,2003-10-02,0.05018587360594796,5380,5650,270,122524
3244,13890,2003-09-22,0.06359300476947535,6290,5890,-400,137090
3245,13890,2003-09-15,0.043010752688172046,6510,6790,280,183460
3246,13890,2003-09-08,0.07692307692307693,6240,6720,480,403712
3247,13890,2003-08-19,0.056129985228951254,6770,7150,380,326046
3248,13890,2003-07-28,0.05170068027210884,7350,7730,380,106270
3249,13890,2003-07-22,0.052564102564102565,7800,7390,-410,155960
3250,13890,2003-07-15,0.04482758620689655,8700,8310,-390,178460
3251,13890,2003-07-07,0.07738095238095238,8400,9050,650,446707
3252,13890,2003-06-23,0.06387665198237885,9080,8500,-580,199130
3253,13890,2003-06-18,0.04536082474226804,9700,9260,-440,198310
3254,13890,2003-05-30,0.061076604554865424,9660,10250,590,653395
3255,13890,2003-05-28,0.0711159737417943,9140,9790,650,491067
3256,13890,2003-05-27,0.09723889555822329,8330,9140,810,1502136
3257,13890,2003-05-22,0.0989010989010989,9100,8200,-900,559857
3258,13890,2003-05-21,0.04597701149425287,8700,9100,400,613266
3259,13890,2003-05-19,0.057579318448883664,8510,9000,490,645313
3260,13890,2003-05-16,0.050617283950617285,8100,8510,410,1353624
3261,13890,2003-05-15,0.14893617021276595,7050,8100,1050,689540
3262,13890,2003-05-13,0.04794520547945205,7300,6950,-350,211120
3263,13890,2003-05-07,0.04335260115606936,6920,7220,300,376372
3264,13890,2003-05-06,0.0406015037593985,6650,6920,270,171195
3265,13890,2003-04-29,0.05511811023622047,6350,6700,350,144852
3266,13890,2003-04-25,0.1049645390070922,7050,6310,-740,251380
3267,13890,2003-04-23,0.047493403693931395,7580,7220,-360,290969
3268,13890,2003-04-21,0.04336043360433604,7380,7700,320,456570
3269,13890,2003-04-18,0.0453257790368272,7060,7380,320,294150
3270,13890,2003-04-07,0.0484375,6400,6710,310,369891
3271,13890,2003-04-04,0.9922480620155039,6450,6400,-50,185340
3272,13890,2003-04-02,0.05929487179487179,6240,6610,370,567120
3273,13890,2003-03-31,0.0453125,6400,6110,-290,198400
3274,13890,2003-03-28,0.06135986733001658,6030,6400,370,446506
3275,13890,2003-03-25,0.09090909090909091,6600,6000,-600,301960
3276,13890,2003-03-20,0.12436115843270869,5870,6600,730,652904
3277,13890,2003-03-19,0.1487279843444227,5110,5870,760,597457
3278,13890,2003-03-18,0.057971014492753624,4830,5110,280,362059
3279,13890,2003-03-17,0.1088560885608856,5420,4830,-590,296720
3280,13890,2003-03-14,0.0796812749003984,5020,5420,400,428640
3281,13890,2003-03-13,0.07037037037037037,5400,5020,-380,177820
3282,13890,2003-03-11,0.12624584717607973,6020,5260,-760,253640
3283,13890,2003-03-07,0.09226190476190477,6720,6100,-620,375099
3284,13890,2003-03-06,0.14936708860759493,7900,6720,-1180,476011
3285,13890,2003-03-05,0.05952380952380952,8400,7900,-500,1142470
3286,13890,2003-03-04,0.043478260869565216,8050,8400,350,480600
3287,13890,2003-02-28,0.04285714285714286,7700,8030,330,171200
3288,13890,2003-02-17,0.04375,8000,8350,350,180630
3289,13890,2003-02-07,0.04524361948955916,8620,8230,-390,122030
3290,13890,2003-02-03,0.05421686746987952,8300,8750,450,310504
3291,13890,2003-01-27,0.05227272727272727,8800,8340,-460,123940
3292,13890,2003-01-24,0.07660020986358866,9530,8800,-730,147445
3293,13890,2003-01-17,0.06331658291457286,9950,9320,-630,145870
3294,13890,2003-01-14,0.04842105263157895,9500,9960,460,648560
3295,13890,2003-01-10,0.046632124352331605,9650,9200,-450,154720
3296,13890,2003-01-07,0.05472103004291846,9320,9830,510,554270
3297,13890,2003-01-02,0.13043478260869565,8050,9100,1050,201550
3298,13890,2002-12-30,0.052941176470588235,8500,8050,-450,133920
3299,13890,2002-12-26,0.09825997952917093,9770,8810,-960,349429
3300,13890,2002-12-24,0.06952380952380953,10500,9770,-730,260320
3301,13890,2002-12-16,0.042735042735042736,11700,11200,-500,216056
3302,13890,2002-12-13,0.04,11250,11700,450,385600
3303,13890,2002-12-09,0.05668016194331984,12350,11650,-700,404206
3304,13890,2002-12-04,0.07806691449814127,13450,12400,-1050,485250
3305,13890,2002-11-29,0.04417670682730924,12450,13000,550,551444
3306,13890,2002-11-26,0.04526748971193416,12150,12700,550,1797694
3307,13890,2002-11-13,0.08962264150943396,10600,11550,950,1573706
3308,13890,2002-11-11,0.05392156862745098,10200,10750,550,558941
3309,13890,2002-10-29,0.0707070707070707,9900,10600,700,1048016
3310,13890,2002-10-28,0.042105263157894736,9500,9900,400,474629
3311,13890,2002-10-22,0.04477611940298507,10050,9600,-450,690670
3312,13890,2002-10-21,0.05188679245283019,10600,10050,-550,582224
3313,13890,2002-10-16,0.1457174638487208,8990,10300,1310,1751045
3314,13890,2002-10-14,0.04046242774566474,8650,9000,350,1155498
3315,13890,2002-10-10,0.14691943127962084,10550,9000,-1550,743110
3316,13890,2002-10-07,0.04,10000,10400,400,1311590
3317,13890,2002-10-01,0.07079646017699115,11300,10500,-800,1331143
3318,13890,2002-09-30,0.07755102040816327,12250,11300,-950,1470967
3319,13890,2002-09-27,0.14930555555555555,14400,12250,-2150,1864310
3320,13890,2002-09-23,0.04059040590405904,13550,13000,-550,1026892
3321,13890,2002-09-19,0.06692913385826772,12700,13550,850,2753135
3322,13890,2002-09-18,0.05223880597014925,13400,12700,-700,968431
3323,13890,2002-09-17,0.04285714285714286,14000,13400,-600,2425592
3324,13890,2002-09-16,0.09375,12800,14000,1200,2279024
3325,13890,2002-09-11,0.0777027027027027,14800,13650,-1150,2140263
3326,13890,2002-09-06,0.14661654135338345,13300,15250,1950,2115855
3327,13890,2002-09-05,0.14655172413793102,11600,13300,1700,58671
3328,13890,2002-09-04,0.1485148514851485,10100,11600,1500,589420
3329,13890,2002-09-03,0.14512471655328799,8820,10100,1280,973330
3330,13890,2002-08-30,0.07458912768647281,7910,8500,590,325640
3331,13890,2002-08-07,0.051470588235294115,6800,7150,350,49240
3332,13890,2002-07-23,0.050359712230215826,6950,7300,350,50310
3333,13890,2002-07-22,0.10783055198973042,7790,6950,-840,76720
3334,13890,2002-07-19,0.05115712545676005,8210,7790,-420,57840
3335,13890,2002-07-15,0.04728950403690888,8670,8260,-410,66050
3336,13890,2002-07-11,0.14873837981407703,7530,8650,1120,435850
3337,13890,2002-06-28,0.06923076923076923,6500,6950,450,40000
3338,13890,2002-06-26,0.11392405063291139,7110,6300,-810,49340
3339,13890,2002-06-25,0.0657030223390276,7610,7110,-500,36710
3340,13890,2002-06-19,0.06539833531510107,8410,7860,-550,52660
3341,13890,2002-06-04,0.06290672451193059,9220,8640,-580,96830
3342,13890,2002-05-21,0.05167464114832536,10450,9910,-540,100090
3343,13890,2002-05-16,0.08967674661105318,9590,10450,860,423810
3344,13890,2002-04-29,0.06403940886699508,10150,9500,-650,88662
3345,13890,2002-04-22,0.05504587155963303,10900,10300,-600,134639
3346,13890,2002-04-10,0.05172413793103448,11600,11000,-600,164870
3347,13890,2002-04-09,0.04526748971193416,12150,11600,-550,215660
3348,13890,2002-04-03,0.04477611940298507,13400,12800,-600,291112
3349,13890,2002-03-26,0.05,14000,13300,-700,325033
3350,13890,2002-03-25,0.10236220472440945,12700,14000,1300,1430067
3351,13890,2002-03-20,0.041353383458646614,13300,12750,-550,303824
3352,13890,2002-03-13,0.060836501901140684,13150,12350,-800,514680
3353,13890,2002-03-06,0.1471861471861472,11550,13250,1700,1700281
3354,13890,2002-02-28,0.06329113924050633,11850,11100,-750,258600
3355,4170,2021-05-13,0.040625,320000,307000,-13000,236725
3356,4170,2021-04-05,0.041970802919708027,274000,285500,11500,117152
3357,4170,2021-03-03,0.043243243243243246,277500,289500,12000,317893
3358,4170,2021-02-23,0.05384615384615385,260000,274000,14000,440567
3359,4170,2021-02-18,0.05179282868525897,251000,264000,13000,659870
3360,4170,2021-01-12,0.04938271604938271,243000,255000,12000,379558
3361,4170,2020-12-11,0.0411522633744856,243000,253000,10000,209250
3362,4170,2020-12-09,0.05150214592274678,233000,245000,12000,297341
3363,4170,2020-11-10,0.05555555555555555,216000,228000,12000,394388
3364,4170,2020-10-19,0.046511627906976744,215000,225000,10000,284701
3365,4170,2020-10-12,0.055288461538461536,208000,219500,11500,257103
3366,4170,2020-09-02,0.04656862745098039,204000,213500,9500,199133
3367,4170,2020-08-18,0.08695652173913043,230000,210000,-20000,303466
3368,4170,2020-08-12,0.04009433962264151,212000,220500,8500,310579
3369,4170,2020-06-30,0.06779661016949153,206500,220500,14000,234125
3370,4170,2020-06-15,0.06493506493506493,231000,216000,-15000,137203
3371,4170,2020-06-12,0.04742268041237113,242500,231000,-11500,126017
3372,4170,2020-05-19,0.05360824742268041,242500,255500,13000,173503
3373,4170,2020-04-27,0.049281314168377825,243500,255500,12000,125254
3374,4170,2020-04-17,0.08137044967880086,233500,252500,19000,203883
3375,4170,2020-04-06,0.05995203836930456,208500,221000,12500,141057
3376,4170,2020-03-30,0.042316258351893093,224500,215000,-9500,159615
3377,4170,2020-03-25,0.07936507936507936,220500,238000,17500,147830
3378,4170,2020-03-24,0.06779661016949153,206500,220500,14000,98816
3379,4170,2020-03-23,0.078125,224000,206500,-17500,80435
3380,4170,2020-03-20,0.09803921568627451,204000,224000,20000,106243
3381,4170,2020-03-19,0.09734513274336283,226000,204000,-22000,138230
3382,4170,2020-03-18,0.04842105263157895,237500,226000,-11500,105391
3383,4170,2020-03-17,0.08695652173913043,218500,237500,19000,112027
3384,4170,2020-03-13,0.060041407867494824,241500,227000,-14500,188739
3385,4170,2020-03-05,0.045454545454545456,253000,264500,11500,104952
3386,4170,2020-03-04,0.047619047619047616,241500,253000,11500,93059
3387,4170,2020-02-28,0.05220883534136546,249000,236000,-13000,172784
3388,4170,2020-02-25,0.0408997955010225,244500,254500,10000,125682
3389,4170,2020-02-24,0.07386363636363637,264000,244500,-19500,185890
3390,4170,2020-02-20,0.04424778761061947,282500,270000,-12500,153588
3391,4170,2020-02-12,0.0582010582010582,283500,300000,16500,94596
3392,4170,2020-02-06,0.05321100917431193,272500,287000,14500,99051
3393,4170,2020-01-30,0.04488330341113106,278500,266000,-12500,123403
3394,4170,2020-01-28,0.12071778140293637,306500,269500,-37000,225560
3395,4170,2020-01-22,0.04297520661157025,302500,315500,13000,89830
3396,4170,2020-01-07,0.05172413793103448,290000,305000,15000,99705
3397,4170,2019-11-28,0.0599250936329588,267000,283000,16000,75969
3398,4170,2019-11-06,0.06875,240000,256500,16500,116783
3399,4170,2019-09-11,0.044534412955465584,247000,258000,11000,73678
3400,4170,2019-09-09,0.04771784232365145,241000,252500,11500,70597
3401,4170,2019-09-05,0.047058823529411764,255000,243000,-12000,82880
3402,4170,2019-09-03,0.052854122621564484,236500,249000,12500,99948
3403,4170,2019-08-29,0.04035874439461883,223000,232000,9000,58273
3404,4170,2019-08-05,0.05870841487279843,255500,240500,-15000,76671
3405,4170,2019-06-21,0.04006410256410257,312000,299500,-12500,103231
3406,4170,2019-06-19,0.04201680672268908,297500,310000,12500,73915
3407,4170,2019-05-15,0.05417956656346749,323000,305500,-17500,163904
3408,4170,2019-05-10,0.04560260586319218,307000,321000,14000,94063
3409,4170,2019-05-09,0.05828220858895705,326000,307000,-19000,110954
3410,4170,2019-03-26,0.04897314375987362,316500,332000,15500,88380
3411,4170,2019-03-18,0.07666666666666666,300000,323000,23000,158774
3412,4170,2019-02-20,0.04797047970479705,271000,284000,13000,168878
3413,4170,2019-02-15,0.043137254901960784,255000,266000,11000,106004
3414,4170,2019-01-23,0.051587301587301584,252000,265000,13000,242494
3415,4170,2018-12-06,0.061619718309859156,284000,266500,-17500,98961
3416,4170,2018-11-23,0.045454545454545456,286000,299000,13000,158351
3417,4170,2018-11-15,0.10433070866141732,254000,280500,26500,209822
3418,4170,2018-11-02,0.04554079696394687,263500,275500,12000,84053
3419,4170,2018-10-26,0.055658627087198514,269500,254500,-15000,155126
3420,4170,2018-10-23,0.05163511187607573,290500,275500,-15000,60877
3421,4170,2018-10-22,0.04308797127468582,278500,290500,12000,69178
3422,4170,2018-10-15,0.04560810810810811,296000,282500,-13500,96722
3423,4170,2018-10-04,0.12661870503597122,347500,303500,-44000,304380
3424,4170,2018-10-02,0.04401650618982118,363500,347500,-16000,95990
3425,4170,2018-09-18,0.05710102489019034,341500,361000,19500,120282
3426,4170,2018-09-13,0.057902973395931145,319500,338000,18500,125928
3427,4170,2018-08-23,0.09154929577464789,284000,310000,26000,243814
3428,4170,2018-08-20,0.05396290050590219,296500,280500,-16000,128549
3429,4170,2018-08-07,0.04451038575667656,337000,322000,-15000,106937
3430,4170,2018-08-01,0.043674698795180725,332000,346500,14500,113027
3431,4170,2018-07-27,0.047021943573667714,319000,334000,15000,104796
3432,4170,2018-07-24,0.058919803600654665,305500,323500,18000,132589
3433,4170,2018-07-16,0.0513595166163142,331000,314000,-17000,114661
3434,4170,2018-07-09,0.08183079056865465,360500,331000,-29500,189240
3435,4170,2018-07-03,0.07483870967741936,387500,358500,-29000,217584
3436,4170,2018-06-26,0.052443384982121574,419500,397500,-22000,128529
3437,4170,2018-06-25,0.07151979565772669,391500,419500,28000,257052
3438,4170,2018-06-20,0.040522875816993466,382500,398000,15500,108479
3439,4170,2018-06-18,0.06332138590203107,418500,392000,-26500,112668
3440,4170,2018-05-29,0.04669703872437358,439000,459500,20500,59718
3441,4170,2018-05-25,0.05692803437164339,465500,439000,-26500,82402
3442,4170,2018-05-24,0.046067415730337076,445000,465500,20500,78477
3443,4170,2018-05-10,0.06717363751584284,394500,421000,26500,125092
3444,4170,2018-05-03,0.041916167664670656,417500,400000,-17500,56760
3445,4170,2018-04-19,0.04539877300613497,407500,389000,-18500,65746
3446,4170,2018-04-02,0.07272727272727272,357500,383500,26000,95826
3447,4170,2018-03-22,0.04675716440422323,331500,347000,15500,79275
3448,4170,2018-03-09,0.055384615384615386,325000,343000,18000,134516
3449,4170,2018-02-19,0.048465266558966075,309500,324500,15000,40460
3450,4170,2018-02-07,0.060431654676258995,347500,326500,-21000,95839
3451,4170,2018-02-05,0.044755244755244755,357500,341500,-16000,44988
3452,4170,2018-02-01,0.043731778425655975,343000,358000,15000,92400
3453,4170,2018-01-26,0.09838709677419355,310000,340500,30500,302543
3454,4170,2018-01-17,0.054009819967266774,305500,322000,16500,83291
3455,4170,2018-01-08,0.04679376083188908,288500,302000,13500,64829
3456,4170,2017-12-15,0.04,287500,299000,11500,67207
3457,4170,2017-12-13,0.052823315118397086,274500,289000,14500,61962
3458,4170,2017-11-27,0.04743833017077799,263500,276000,12500,87062
3459,4170,2017-11-20,0.0637065637065637,259000,275500,16500,105971
3460,4170,2017-11-08,0.05476673427991886,246500,260000,13500,174633
3461,4170,2017-11-07,0.08351648351648351,227500,246500,19000,258495
3462,4170,2017-10-26,0.05128205128205128,214500,225500,11000,129254
3463,4170,2017-10-16,0.06801007556675064,198500,212000,13500,208557
3464,4170,2017-10-13,0.05585106382978723,188000,198500,10500,138594
3465,4170,2017-09-28,0.04087193460490463,183500,191000,7500,104208
3466,4170,2017-09-26,0.05013927576601671,179500,188500,9000,60132
3467,4170,2017-09-15,0.044444444444444446,180000,188000,8000,61088
3468,4170,2017-08-11,0.09534368070953436,225500,204000,-21500,344824
3469,4170,2017-07-26,0.05333333333333334,225000,237000,12000,78402
3470,4170,2017-07-03,0.04139433551198257,229500,239000,9500,38294
3471,4170,2017-06-27,0.041758241758241756,227500,237000,9500,63252
3472,4170,2017-05-11,0.05755395683453238,208500,220500,12000,96890
3473,4170,2017-04-10,0.045,200000,191000,-9000,61942
3474,4170,2017-03-03,0.04922279792746114,193000,183500,-9500,174813
3475,4170,2017-02-23,0.044854881266490766,189500,198000,8500,149713
3476,4170,2016-10-25,0.06015037593984962,199500,187500,-12000,182809
3477,4170,2016-10-14,0.04497354497354497,189000,197500,8500,113993
3478,4170,2016-08-26,0.0886426592797784,180500,196500,16000,238795
3479,80,2021-05-31,0.046235138705416116,37850,39600,1750,1466409
3480,80,2021-05-26,0.04234972677595628,36600,38150,1550,2009431
3481,80,2021-02-05,0.05359877488514548,32650,34400,1750,993285
3482,80,2021-01-18,0.04895104895104895,35750,34000,-1750,783089
3483,80,2020-12-10,0.05263157894736842,31350,33000,1650,1520626
3484,80,2020-10-06,0.06536856745479833,35950,38300,2350,1047653
3485,80,2020-09-28,0.07796101949025487,33350,35950,2600,493071
3486,80,2020-08-18,0.049576783555018135,41350,39300,-2050,1327397
3487,80,2020-08-14,0.06235827664399093,44100,41350,-2750,1758970
3488,80,2020-08-06,0.04086021505376344,46500,44600,-1900,806005
3489,80,2020-08-05,0.06529209621993128,43650,46500,2850,1444373
3490,80,2020-08-03,0.04693140794223827,41550,43500,1950,769702
3491,80,2020-07-10,0.04377880184331797,43400,45300,1900,843773
3492,80,2020-07-07,0.056778679026651215,43150,45600,2450,712358
3493,80,2020-06-10,0.04697986577181208,37250,39000,1750,1007368
3494,80,2020-06-01,0.0763888888888889,36000,38750,2750,1407345
3495,80,2020-05-14,0.04057971014492753,34500,35900,1400,596496
3496,80,2020-05-06,0.04393939393939394,33000,34450,1450,684259
3497,80,2020-04-24,0.052364864864864864,29600,31150,1550,906931
3498,80,2020-04-06,0.05169340463458111,28050,29500,1450,647069
3499,80,2020-04-03,0.04081632653061224,26950,28050,1100,484075
3500,80,2020-03-26,0.0430327868852459,24400,25450,1050,744386
3501,80,2020-03-25,0.07488986784140969,22700,24400,1700,794298
3502,80,2020-03-24,0.04608294930875576,21700,22700,1000,617814
3503,80,2020-03-23,0.10330578512396695,24200,21700,-2500,450741
3504,80,2020-03-20,0.1,22000,24200,2200,776466
3505,80,2020-03-19,0.10569105691056911,24600,22000,-2600,707613
3506,80,2020-03-13,0.058712121212121215,26400,24850,-1550,1080618
3507,80,2020-03-09,0.042735042735042736,29250,28000,-1250,677198
3508,80,2020-03-04,0.07276119402985075,26800,28750,1950,905779
3509,80,2020-02-24,0.056666666666666664,30000,28300,-1700,1048672
3510,80,2020-02-21,0.04,31250,30000,-1250,639772
3511,80,2020-02-19,0.07692307692307693,29250,31500,2250,1005051
3512,80,2020-01-31,0.0491283676703645,31550,30000,-1550,580766
3513,80,2020-01-15,0.08950086058519793,29050,31650,2600,1580120
3514,80,2020-01-14,0.060218978102189784,27400,29050,1650,472229
3515,80,2019-11-19,0.053726169844020795,28850,30400,1550,695372
3516,80,2019-10-14,0.04788213627992634,27150,25850,-1300,843360
3517,80,2019-09-04,0.05360824742268041,24250,25550,1300,1145478
3518,80,2019-09-02,0.07727272727272727,22000,23700,1700,1201975
3519,80,2019-08-14,0.0425531914893617,21150,22050,900,756679
3520,80,2019-06-05,0.0413625304136253,20550,21400,850,856217
3521,80,2019-05-15,0.04411764705882353,20400,21300,900,800910
3522,80,2019-04-24,0.053763440860215055,18600,19600,1000,2091395
3523,80,2019-03-26,0.04735376044568245,17950,18800,850,395953
3524,80,2019-01-04,0.040123456790123455,16200,16850,650,243593
3525,80,2018-11-16,0.0625,16000,17000,1000,656628
3526,80,2018-08-16,0.06,17500,16450,-1050,760633
3527,80,2018-07-11,0.0547945205479452,18250,19250,1000,698006
3528,80,2018-07-03,0.05,19000,18050,-950,684359
3529,80,2018-03-26,0.04215456674473068,21350,22250,900,237307
3530,80,2018-03-20,0.04265402843601896,21100,22000,900,290165
3531,80,2018-01-15,0.0653061224489796,24500,22900,-1600,736486
3532,80,2017-10-16,0.05046728971962617,26750,25400,-1350,879409
3533,80,2017-09-07,0.05091649694501019,24550,25800,1250,399854
3534,80,2017-09-01,0.04789272030651341,26100,24850,-1250,391167
3535,80,2017-08-16,0.07453416149068323,24150,25950,1800,1326446
3536,80,2017-07-24,0.040268456375838924,22350,23250,900,241342
3537,80,2017-07-13,0.04861111111111111,21600,22650,1050,423798
3538,80,2017-07-10,0.05021834061135371,22900,21750,-1150,553806
3539,80,2017-05-19,0.041758241758241756,22750,23700,950,1715511
3540,80,2016-12-28,0.049107142857142856,22400,21300,-1100,485834
3541,80,2016-10-28,0.04096385542168675,20750,21600,850,1046962
3542,20560,2021-05-26,0.07165109034267912,16050,17200,1150,4198700
3543,20560,2021-05-25,0.05245901639344262,15250,16050,800,2241836
3544,20560,2021-03-16,0.05647840531561462,15050,15900,850,2155327
3545,20560,2021-01-18,0.11666666666666667,18000,15900,-2100,6423570
3546,20560,2020-12-14,0.10956175298804781,5020,4470,-550,25411398
3547,20560,2020-12-07,0.045112781954887216,5320,5080,-240,6808967
3548,20560,2020-12-02,0.050699300699300696,5720,5430,-290,27687521
3549,20560,2020-12-01,0.11067961165048544,5150,5720,570,66225152
3550,20560,2020-11-24,0.04120603015075377,4975,5180,205,14568304
3551,20560,2020-11-19,0.05938697318007663,5220,4910,-310,26297052
3552,20560,2020-11-18,0.1,5800,5220,-580,41532094
3553,20560,2020-11-17,0.04129263913824058,5570,5800,230,143068482
3554,20560,2020-11-16,0.29836829836829837,4290,5570,1280,141613627
3555,20560,2020-11-13,0.07788944723618091,3980,4290,310,77785080
3556,20560,2020-11-11,0.10128388017118402,3505,3860,355,25443639
3557,20560,2020-11-09,0.07253086419753087,3240,3475,235,7173687
3558,20560,2020-11-04,0.1317614424410541,3605,3130,-475,25152276
3559,20560,2020-10-23,0.08685162846803378,4145,3785,-360,12170828
3560,20560,2020-10-06,0.0580964153275649,4045,4280,235,8359599
3561,20560,2020-09-07,0.04081632653061224,4165,3995,-170,5788276
3562,20560,2020-09-04,0.053409090909090906,4400,4165,-235,6699768
3563,20560,2020-08-26,0.07047387606318348,4115,4405,290,18570721
3564,20560,2020-08-18,0.059718969555035126,4270,4015,-255,3349500
3565,20560,2020-08-07,0.05012224938875306,4090,4295,205,16011018
3566,20560,2020-07-30,0.05,4300,4085,-215,13719192
3567,20560,2020-07-28,0.20646067415730338,3560,4295,735,75616105
3568,20560,2020-06-15,0.07591933570581258,4215,3895,-320,4235320
3569,20560,2020-06-12,0.0496054114994363,4435,4215,-220,3715166
3570,20560,2020-06-05,0.04866180048661801,4110,4310,200,14279383
3571,20560,2020-05-19,0.05080213903743316,3740,3930,190,9841359
3572,20560,2020-05-04,0.04316546762589928,4170,3990,-180,3335957
3573,20560,2020-04-22,0.045454545454545456,4070,4255,185,23848067
3574,20560,2020-04-17,0.04221635883905013,3790,3950,160,7641100
3575,20560,2020-04-10,0.05858310626702997,3670,3885,215,8636976
3576,20560,2020-04-09,0.047075606276747506,3505,3670,165,14862204
3577,20560,2020-03-26,0.060126582278481014,3160,3350,190,7064621
3578,20560,2020-03-25,0.12255772646536411,2815,3160,345,7830678
3579,20560,2020-03-24,0.054307116104868915,2670,2815,145,3628319
3580,20560,2020-03-20,0.20484581497797358,2270,2735,465,6931246
3581,20560,2020-03-19,0.2993827160493827,3240,2270,-970,6821641
3582,20560,2020-03-18,0.05263157894736842,3420,3240,-180,1466336
3583,20560,2020-03-13,0.0553306342780027,3705,3500,-205,2677600
3584,20560,2020-03-12,0.06557377049180328,3965,3705,-260,1853096
3585,20560,2020-03-09,0.05046948356807512,4260,4045,-215,1436140
3586,20560,2020-03-05,0.06038647342995169,4140,4390,250,2124854
3587,20560,2020-02-28,0.04352941176470588,4250,4065,-185,1440028
3588,20560,2020-02-25,0.04009433962264151,4240,4410,170,1628587
3589,20560,2020-02-24,0.06090808416389812,4515,4240,-275,1907018
3590,20560,2020-02-04,0.04143947655398037,4585,4775,190,943069
3591,20560,2020-01-28,0.05236656596173213,4965,4705,-260,2387108
3592,20560,2019-11-14,0.06210191082802548,6280,5890,-390,10942376
3593,20560,2019-11-13,0.04559270516717325,6580,6280,-300,28833672
3594,20560,2019-11-12,0.12864493996569468,5830,6580,750,91250005
3595,20560,2019-11-08,0.096045197740113,5310,5820,510,34700232
3596,20560,2019-11-07,0.05178571428571429,5600,5310,-290,15227775
3597,20560,2019-11-04,0.05272727272727273,5500,5790,290,5963696
3598,20560,2019-09-04,0.04512635379061372,5540,5290,-250,4748118
3599,20560,2019-08-30,0.043478260869565216,5520,5760,240,3450572
3600,20560,2019-08-19,0.10887096774193548,4960,5500,540,14815143
3601,20560,2019-08-05,0.06976744186046512,5590,5200,-390,2991373
3602,20560,2019-07-25,0.0598159509202454,6520,6130,-390,6002841
3603,20560,2019-07-24,0.06016260162601626,6150,6520,370,7667096
3604,20560,2019-07-05,0.05862068965517241,5800,6140,340,5390999
3605,20560,2019-06-26,0.060034305317324184,5830,5480,-350,5217327
3606,20560,2019-05-31,0.10581222056631892,6710,6000,-710,13324824
3607,20560,2019-05-30,0.1353637901861252,5910,6710,800,27916220
3608,20560,2019-05-28,0.04745166959578207,5690,5960,270,8234275
3609,20560,2019-05-21,0.043029259896729774,5810,5560,-250,4033738
3610,20560,2019-04-30,0.0644122383252818,6210,6610,400,17883895
3611,20560,2019-04-29,0.05045871559633028,6540,6210,-330,6466468
3612,20560,2019-04-24,0.13601036269430053,7720,6670,-1050,26253025
3613,20560,2019-04-23,0.05968331303288672,8210,7720,-490,14507114
3614,20560,2019-04-19,0.11186903137789904,7330,8150,820,9236916
3615,20560,2019-04-17,0.15739644970414202,8450,7120,-1330,14941605
3616,20560,2019-04-16,0.16071428571428573,7280,8450,1170,103645799
3617,20560,2019-04-15,0.3,5600,7280,1680,27666326
3618,20560,2019-04-12,0.29330254041570436,4330,5600,1270,64607109
3619,20560,2019-04-11,0.13054830287206268,3830,4330,500,33786832
3620,20560,2019-03-26,0.14975247524752475,4040,3435,-605,19990131
3621,20560,2018-11-26,0.04220398593200469,4265,4445,180,1975242
3622,20560,2018-11-02,0.047748976807639835,3665,3840,175,818157
3623,20560,2018-10-31,0.07352941176470588,3400,3650,250,830711
3624,20560,2018-10-29,0.04694167852062589,3515,3350,-165,940383
3625,20560,2018-10-11,0.059113300492610835,4060,3820,-240,2046991
3626,20560,2018-06-15,0.06547619047619048,5040,4710,-330,2921426
3627,20560,2018-04-16,0.04104104104104104,4995,5200,205,3152665
3628,20560,2018-03-27,0.04097452934662237,4515,4700,185,929589
3629,20560,2018-03-09,0.04875406283856988,4615,4840,225,2101722
3630,20560,2018-03-02,0.05952380952380952,5040,4740,-300,2544165
3631,20560,2018-02-19,0.047058823529411764,5100,5340,240,1676748
3632,20560,2018-02-07,0.04423076923076923,5200,4970,-230,2423513
3633,20560,2018-01-15,0.07707707707707707,4995,5380,385,9909738
3634,20560,2018-01-12,0.0673076923076923,4680,4995,315,11468901
3635,20560,2017-11-17,0.11264367816091954,4350,4840,490,15568336
3636,20560,2017-10-26,0.09951456310679611,4120,4530,410,6842358
3637,20560,2017-08-11,0.06857142857142857,5250,4890,-360,17284751
3638,20560,2017-07-26,0.045454545454545456,5280,5040,-240,3733962
3639,20560,2017-07-25,0.041742286751361164,5510,5280,-230,1888038
3640,20560,2017-07-14,0.04317789291882556,5790,5540,-250,2083783
3641,20560,2017-07-04,0.06229508196721312,6100,5720,-380,4497890
3642,20560,2017-06-02,0.045098039215686274,5100,5330,230,3025484
3643,20560,2017-03-23,0.04049493813273341,4445,4625,180,1862202
3644,20560,2017-03-03,0.06406080347448426,4605,4310,-295,2669278
3645,20560,2017-02-23,0.04822043628013777,4355,4565,210,2855423
3646,20560,2016-09-12,0.11538461538461539,5200,4600,-600,6154917
3647,20560,2016-08-10,0.07272727272727272,5500,5900,400,6358298
3648,20560,2016-08-08,0.04389312977099236,5240,5470,230,3789523
3649,20560,2016-08-02,0.05102040816326531,4900,5150,250,6750237
3650,78930,2021-06-01,0.04229934924078091,46100,48050,1950,595903
3651,78930,2021-05-20,0.04480651731160896,49100,46900,-2200,719198
3652,78930,2021-05-12,0.047,50000,47650,-2350,939668
3653,78930,2021-05-10,0.055674518201284794,46700,49300,2600,1258898
3654,78930,2021-05-06,0.08488372093023255,43000,46650,3650,1045093
3655,78930,2021-04-26,0.05088757396449704,42250,44400,2150,876231
3656,78930,2021-04-14,0.040973111395646605,39050,40650,1600,1300171
3657,78930,2021-02-24,0.043583535108958835,41300,39500,-1800,720116
3658,78930,2021-02-22,0.05263157894736842,38950,41000,2050,922640
3659,78930,2021-01-11,0.040865384615384616,41600,39900,-1700,1005777
3660,78930,2021-01-08,0.053164556962025315,39500,41600,2100,1207880
3661,78930,2020-12-01,0.047075606276747506,35050,36700,1650,520788
3662,78930,2020-11-30,0.06157965194109773,37350,35050,-2300,1359600
3663,78930,2020-11-16,0.04246575342465753,36500,38050,1550,441698
3664,78930,2020-11-11,0.04477611940298507,36850,38500,1650,1045977
3665,78930,2020-11-10,0.06811594202898551,34500,36850,2350,1208620
3666,78930,2020-10-12,0.046948356807511735,31950,33450,1500,632054
3667,78930,2020-08-20,0.05308464849354376,34850,33000,-1850,538532
3668,78930,2020-06-16,0.055248618784530384,36200,38200,2000,248423
3669,78930,2020-06-03,0.04076433121019108,39250,40850,1600,496828
3670,78930,2020-05-26,0.04353562005277045,37900,39550,1650,388595
3671,78930,2020-05-06,0.04161073825503356,37250,38800,1550,382368
3672,78930,2020-04-06,0.06016042780748663,37400,39650,2250,301095
3673,78930,2020-04-02,0.08615819209039548,35400,38450,3050,364422
3674,78930,2020-03-26,0.06265664160401002,39900,37400,-2500,400721
3675,78930,2020-03-25,0.14326647564469913,34900,39900,5000,484138
3676,78930,2020-03-24,0.0705521472392638,32600,34900,2300,366497
3677,78930,2020-03-23,0.08811188811188811,35750,32600,-3150,339139
3678,78930,2020-03-13,0.05905511811023622,38100,35850,-2250,406795
3679,78930,2020-03-12,0.05105853051058531,40150,38100,-2050,345886
3680,78930,2020-03-10,0.04798962386511025,38550,40400,1850,361388
3681,78930,2020-02-24,0.053469852104664393,43950,41600,-2350,229758
3682,78930,2020-02-06,0.043237250554323724,45100,47050,1950,199039
3683,78930,2019-08-30,0.043478260869565216,46000,48000,2000,209593
3684,78930,2019-03-14,0.042801556420233464,51400,53600,2200,361757
3685,78930,2019-01-02,0.060077519379844964,51600,48500,-3100,271228
3686,78930,2018-10-26,0.04572564612326044,50300,48000,-2300,323772
3687,78930,2018-10-11,0.05311355311355311,54600,51700,-2900,337683
3688,78930,2018-07-02,0.0625,54400,51000,-3400,377965
3689,78930,2018-06-19,0.045060658578856154,57700,55100,-2600,356047
3690,78930,2018-04-04,0.04258675078864353,63400,60700,-2700,341186
3691,78930,2018-02-07,0.04054054054054054,66600,63900,-2700,305362
3692,78930,2018-01-10,0.048154093097913325,62300,65300,3000,423317
3693,78930,2017-11-15,0.0448,62500,59700,-2800,829784
3694,78930,2017-08-16,0.0453257790368272,70600,67400,-3200,535075
3695,78930,2017-05-25,0.040697674418604654,68800,71600,2800,424534
3696,78930,2017-05-22,0.04153846153846154,65000,67700,2700,471803
3697,78930,2017-02-10,0.05697445972495088,50900,53800,2900,400745
3698,192080,2021-04-09,0.08450704225352113,63900,69300,5400,1560141
3699,192080,2021-03-23,0.10380622837370242,57800,63800,6000,2265892
3700,192080,2021-03-12,0.04734848484848485,52800,55300,2500,82584
3701,192080,2021-01-28,0.045171339563862926,64200,61300,-2900,172274
3702,192080,2020-12-18,0.040336134453781515,59500,61900,2400,402323
3703,192080,2020-12-03,0.04006968641114982,57400,59700,2300,226240
3704,192080,2020-11-17,0.04051863857374392,61700,59200,-2500,173892
3705,192080,2020-11-10,0.04482225656877898,64700,61800,-2900,177144
3706,192080,2020-11-03,0.04878048780487805,61500,64500,3000,94281
3707,192080,2020-09-24,0.040735873850197106,76100,73000,-3100,184474
3708,192080,2020-09-22,0.042606516290726815,79800,76400,-3400,204733
3709,192080,2020-08-20,0.060526315789473685,76000,71400,-4600,219701
3710,192080,2020-08-04,0.05138339920948617,75900,79800,3900,333695
3711,192080,2020-07-24,0.056010928961748634,73200,77300,4100,440432
3712,192080,2020-07-23,0.04062909567496723,76300,73200,-3100,331765
3713,192080,2020-07-16,0.04804045512010114,79100,75300,-3800,301044
3714,192080,2020-07-07,0.04896907216494845,77600,81400,3800,466098
3715,192080,2020-07-06,0.07479224376731301,72200,77600,5400,498369
3716,192080,2020-07-02,0.053385416666666664,76800,72700,-4100,1716872
3717,192080,2020-06-30,0.05416116248348745,75700,79800,4100,272045
3718,192080,2020-06-25,0.04528763769889841,81700,78000,-3700,358758
3719,192080,2020-06-23,0.06266318537859007,76600,81400,4800,518805
3720,192080,2020-06-16,0.08472222222222223,72000,78100,6100,385484
3721,192080,2020-06-15,0.041278295605858856,75100,72000,-3100,578828
3722,192080,2020-06-10,0.043668122270742356,68700,71700,3000,477614
3723,192080,2020-06-08,0.04510108864696734,64300,67200,2900,299482
3724,192080,2020-06-03,0.043154761904761904,67200,64300,-2900,528635
3725,192080,2020-05-20,0.051118210862619806,62600,65800,3200,273671
3726,192080,2020-05-11,0.0449438202247191,62300,65100,2800,319466
3727,192080,2020-05-07,0.04475043029259897,58100,60700,2600,599973
3728,192080,2020-04-28,0.06227106227106227,54600,58000,3400,322357
3729,192080,2020-04-14,0.08085106382978724,47000,50800,3800,369150
3730,192080,2020-04-13,0.050505050505050504,49500,47000,-2500,285475
3731,192080,2020-04-10,0.05319148936170213,47000,49500,2500,449453
3732,192080,2020-04-07,0.05333333333333334,52500,49700,-2800,377769
3733,192080,2020-04-02,0.058212058212058215,48100,50900,2800,453073
3734,192080,2020-04-01,0.10829493087557604,43400,48100,4700,1177054
3735,192080,2020-03-25,0.042690815006468305,38650,40300,1650,201128
3736,192080,2020-03-23,0.05343511450381679,39300,37200,-2100,109928
3737,192080,2020-03-20,0.04105960264900662,37750,39300,1550,113861
3738,192080,2020-03-17,0.042666666666666665,37500,39100,1600,154952
3739,192080,2020-03-16,0.06947890818858561,40300,37500,-2800,283236
3740,192080,2020-03-13,0.06279069767441861,43000,40300,-2700,315351
3741,192080,2020-03-12,0.044444444444444446,45000,43000,-2000,229674
3742,192080,2020-03-06,0.05057471264367816,43500,45700,2200,169789
3743,192080,2020-02-28,0.060571428571428575,43750,41100,-2650,127907
3744,192080,2020-02-24,0.047097480832420595,45650,43500,-2150,107431
3745,192080,2020-02-06,0.04449152542372881,47200,49300,2100,93328
3746,192080,2020-01-13,0.04483430799220273,51300,53600,2300,112955
3747,192080,2019-11-01,0.041666666666666664,48000,50000,2000,125760
3748,192080,2019-09-10,0.043478260869565216,55200,57600,2400,67596
3749,192080,2019-08-19,0.04174573055028463,52700,54900,2200,52305
3750,192080,2019-08-08,0.04621072088724584,54100,56600,2500,74899
3751,192080,2019-08-05,0.060714285714285714,56000,52600,-3400,127390
3752,192080,2019-06-14,0.048265460030165915,66300,63100,-3200,245248
3753,192080,2019-04-24,0.11700468018720749,64100,71600,7500,817040
3754,192080,2019-03-08,0.04205607476635514,64200,61500,-2700,253985
3755,192080,2019-01-29,0.048507462686567165,53600,56200,2600,191014
3756,192080,2019-01-02,0.0451505016722408,59800,57100,-2700,87586
3757,192080,2018-12-19,0.07092198581560284,56400,60400,4000,111495
3758,192080,2018-12-10,0.05008347245409015,59900,56900,-3000,98652
3759,192080,2018-11-27,0.048576214405360134,59700,62600,2900,125381
3760,192080,2018-10-24,0.04689655172413793,72500,69100,-3400,131816
3761,192080,2018-10-12,0.057750759878419454,65800,69600,3800,107474
3762,192080,2018-10-11,0.049132947976878616,69200,65800,-3400,127045
3763,192080,2018-09-18,0.05972434915773354,65300,69200,3900,150537
3764,192080,2018-08-14,0.043478260869565216,64400,67200,2800,292875
3765,192080,2018-08-10,0.09847198641765705,58900,64700,5800,594641
3766,192080,2018-08-09,0.06702898550724638,55200,58900,3700,497536
3767,192080,2018-07-23,0.05612244897959184,58800,55500,-3300,91980
3768,192080,2018-07-13,0.04974271012006861,58300,61200,2900,212607
3769,192080,2018-07-12,0.1,53000,58300,5300,164545
3770,192080,2018-07-02,0.040968342644320296,53700,51500,-2200,47176
3771,192080,2018-05-09,0.04317789291882556,57900,60400,2500,106274
3772,192080,2018-05-02,0.04,62500,60000,-2500,193202
3773,192080,2018-04-17,0.04745762711864407,59000,61800,2800,222080
3774,192080,2018-04-13,0.09365079365079365,63000,57100,-5900,480462
3775,192080,2018-04-04,0.06619718309859154,71000,66300,-4700,260649
3776,192080,2018-03-09,0.04821150855365474,64300,67400,3100,254074
3777,192080,2018-03-06,0.05844155844155844,61600,65200,3600,269978
3778,192080,2018-02-12,0.0411663807890223,58300,60700,2400,118006
3779,192080,2018-02-09,0.042692939244663386,60900,58300,-2600,149727
3780,192080,2017-11-17,0.049403747870528106,58700,55800,-2900,234874
3781,192080,2017-11-15,0.041742286751361164,55100,57400,2300,390268
3782,192080,2017-11-13,0.04206500956022945,52300,54500,2200,258980
3783,192080,2017-11-07,0.05975395430579965,56900,53500,-3400,496831
3784,192080,2017-11-06,0.09845559845559845,51800,56900,5100,315820
3785,192080,2017-11-01,0.06237816764132553,51300,54500,3200,254900
3786,192080,2017-10-10,0.04247787610619469,56500,54100,-2400,78920
3787,192080,2017-09-27,0.06862745098039216,51000,54500,3500,167385
3788,192080,2017-09-25,0.05333333333333334,52500,49700,-2800,246222
3789,192080,2017-09-22,0.07570422535211267,56800,52500,-4300,242165
3790,192080,2017-09-15,0.07439446366782007,57800,62100,4300,318014
3791,192080,2017-09-13,0.04181818181818182,55000,57300,2300,102597
3792,192080,2017-08-04,0.07717569786535304,60900,56200,-4700,332352
3793,192080,2017-08-03,0.0484375,64000,60900,-3100,112991
3794,192080,2017-07-20,0.04823151125401929,62200,65200,3000,290956
3795,192080,2017-07-10,0.04192546583850932,64400,61700,-2700,143947
3796,192080,2017-07-05,0.04225352112676056,63900,66600,2700,434803
3797,192080,2017-06-19,0.057755775577557754,60600,64100,3500,543237
3798,192080,2017-06-07,0.05319148936170213,56400,59400,3000,955042
3799,192080,2017-05-08,0.04258943781942078,58700,56200,-2500,376695
3800,192080,2017-05-04,0.08502772643253234,54100,58700,4600,526689
3801,192080,2017-04-19,0.07007575757575757,52800,56500,3700,3489377
3802,192080,2017-04-18,0.2988929889298893,40650,52800,12150,1687686
3803,192080,2017-02-21,0.06033376123234917,38950,41300,2350,256106
3804,192080,2016-12-27,0.06342780026990553,37050,39400,2350,232267
3805,192080,2016-12-21,0.042723631508678236,37450,39050,1600,401304
3806,192080,2016-11-10,0.04153354632587859,31300,32600,1300,45644
3807,192080,2016-11-02,0.09596662030598054,35950,32500,-3450,251381
3808,192080,2016-08-05,0.04308093994778068,38300,39950,1650,232897
3809,29780,2021-05-12,0.05531914893617021,35250,33300,-1950,625267
3810,29780,2021-05-03,0.046742209631728045,35300,33650,-1650,278369
3811,29780,2021-02-01,0.04040404040404041,29700,30900,1200,187508
3812,29780,2020-12-29,0.05563480741797432,35050,33100,-1950,325446
3813,29780,2020-11-19,0.0578386605783866,32850,34750,1900,416655
3814,29780,2020-11-02,0.06292517006802721,29400,31250,1850,385524
3815,29780,2020-06-16,0.04220183486238532,27250,28400,1150,259846
3816,29780,2020-06-15,0.04553415061295972,28550,27250,-1300,275456
3817,29780,2020-06-03,0.043478260869565216,29900,31200,1300,739069
3818,29780,2020-04-29,0.050788091068301226,28550,30000,1450,365982
3819,29780,2020-04-01,0.06354515050167224,29900,28000,-1900,146956
3820,29780,2020-03-30,0.06747404844290658,28900,30850,1950,123892
3821,29780,2020-03-27,0.08239700374531835,26700,28900,2200,212279
3822,29780,2020-03-25,0.046242774566473986,25950,27150,1200,169395
3823,29780,2020-03-23,0.07875457875457875,27300,25150,-2150,181905
3824,29780,2020-03-20,0.15677966101694915,23600,27300,3700,222603
3825,29780,2020-03-19,0.16163410301953818,28150,23600,-4550,223211
3826,29780,2020-03-18,0.05378151260504202,29750,28150,-1600,145562
3827,29780,2020-03-17,0.04186795491143317,31050,29750,-1300,132261
3828,29780,2020-02-06,0.06824512534818941,35900,38350,2450,171331
3829,29780,2019-11-11,0.06571428571428571,35000,37300,2300,208719
3830,29780,2019-09-30,0.04769001490312966,33550,35150,1600,92591
3831,29780,2019-04-23,0.04160688665710186,34850,36300,1450,80522
3832,29780,2018-10-30,0.04505813953488372,34400,32850,-1550,122854
3833,29780,2018-06-15,0.07215189873417721,39500,36650,-2850,326483
3834,29780,2018-05-02,0.057640750670241284,37300,39450,2150,534961
3835,29780,2017-12-27,0.045949214026602174,41350,39450,-1900,284737
3836,29780,2017-05-26,0.041044776119402986,40200,41850,1650,274269
3837,29780,2016-12-28,0.04519119351100811,43150,41200,-1950,194358
3838,29780,2016-09-01,0.15028248587570622,44250,50900,6650,1421011
3839,3670,2021-05-04,0.041811846689895474,143500,149500,6000,354856
3840,3670,2021-04-12,0.049689440993788817,161000,169000,8000,867164
3841,3670,2021-03-30,0.05821917808219178,146000,154500,8500,575359
3842,3670,2021-03-11,0.05517241379310345,145000,153000,8000,714139
3843,3670,2021-03-09,0.059602649006622516,151000,142000,-9000,1131607
3844,3670,2021-03-08,0.062111801242236024,161000,151000,-10000,555247
3845,3670,2021-02-24,0.07058823529411765,170000,158000,-12000,1135629
3846,3670,2021-02-19,0.06769230769230769,162500,173500,11000,944987
3847,3670,2021-02-17,0.04560260586319218,153500,160500,7000,725565
3848,3670,2021-01-22,0.056818181818181816,132000,139500,7500,1337627
3849,3670,2021-01-18,0.04263565891472868,129000,123500,-5500,597673
3850,3670,2021-01-14,0.04780876494023904,125500,131500,6000,554272
3851,3670,2021-01-05,0.05084745762711865,118000,124000,6000,1374593
3852,3670,2021-01-04,0.1346153846153846,104000,118000,14000,2122467
3853,3670,2020-12-09,0.15934065934065933,91000,105500,14500,4196459
3854,3670,2020-12-02,0.05786026200873363,91600,96900,5300,1022585
3855,3670,2020-11-27,0.051605504587155966,87200,91700,4500,1210760
3856,3670,2020-11-24,0.04962779156327544,80600,84600,4000,741036
3857,3670,2020-11-05,0.05236270753512133,78300,82400,4100,527823
3858,3670,2020-09-24,0.0996523754345307,86300,77700,-8600,1044637
3859,3670,2020-09-18,0.05190311418685121,86700,91200,4500,1106653
3860,3670,2020-08-18,0.04618689581095596,93100,88800,-4300,1024762
3861,3670,2020-08-14,0.05,98000,93100,-4900,1012271
3862,3670,2020-08-07,0.09464082098061574,87700,96000,8300,2719370
3863,3670,2020-08-05,0.10580645161290322,77500,85700,8200,4159184
3864,3670,2020-07-31,0.04132231404958678,72600,75600,3000,1104541
3865,3670,2020-07-09,0.08083441981747067,76700,82900,6200,1224524
3866,3670,2020-06-19,0.046831955922865015,72600,76000,3400,1309186
3867,3670,2020-06-17,0.04796511627906977,68800,72100,3300,2719317
3868,3670,2020-06-16,0.1297208538587849,60900,68800,7900,2644125
3869,3670,2020-06-15,0.05727554179566564,64600,60900,-3700,1098297
3870,3670,2020-06-01,0.05765765765765766,55500,58700,3200,645359
3871,3670,2020-05-27,0.04311774461028192,60300,57700,-2600,699736
3872,3670,2020-05-13,0.05964214711729622,50300,53300,3000,923860
3873,3670,2020-04-16,0.08449197860962566,46750,50700,3950,737256
3874,3670,2020-04-07,0.045454545454545456,44000,46000,2000,715089
3875,3670,2020-03-25,0.06649937264742785,39850,42500,2650,847683
3876,3670,2020-03-24,0.07702702702702703,37000,39850,2850,841885
3877,3670,2020-03-20,0.14501510574018128,33100,37900,4800,1026044
3878,3670,2020-03-19,0.16519546027742749,39650,33100,-6550,1511618
3879,3670,2020-03-18,0.08111239860950174,43150,39650,-3500,770704
3880,3670,2020-03-16,0.07660455486542443,48300,44600,-3700,754341
3881,3670,2020-03-13,0.06031128404669261,51400,48300,-3100,1385885
3882,3670,2020-03-12,0.04990757855822551,54100,51400,-2700,977763
3883,3670,2020-03-09,0.06867671691792294,59700,55600,-4100,725587
3884,3670,2020-02-28,0.06313993174061433,58600,54900,-3700,1026027
3885,3670,2020-02-21,0.048465266558966075,61900,58900,-3000,650423
3886,3670,2020-02-11,0.04234527687296417,61400,64000,2600,1202957
3887,3670,2020-02-04,0.05154639175257732,58200,61200,3000,1059952
3888,3670,2020-01-31,0.04966887417218543,60400,57400,-3000,867910
3889,3670,2020-01-20,0.05719557195571956,54200,57300,3100,1274235
3890,3670,2020-01-10,0.07939698492462312,49750,53700,3950,1749322
3891,3670,2020-01-08,0.04282868525896414,50200,48050,-2150,420156
3892,3670,2019-10-28,0.050493962678375415,45550,47850,2300,588776
3893,3670,2019-09-25,0.05379746835443038,47400,44850,-2550,739113
3894,3670,2019-08-08,0.04793028322440087,45900,48100,2200,404593
3895,3670,2019-08-05,0.05755395683453238,48650,45850,-2800,364863
3896,3670,2019-07-29,0.0496031746031746,50400,47900,-2500,503861
3897,3670,2019-07-22,0.05904761904761905,52500,55600,3100,878559
3898,3670,2019-07-08,0.053763440860215055,55800,52800,-3000,363385
3899,3670,2019-07-04,0.04119850187265917,53400,55600,2200,657560
3900,3670,2019-06-04,0.06481481481481481,54000,57500,3500,748248
3901,3670,2019-05-15,0.056640625,51200,54100,2900,319205
3902,3670,2019-05-09,0.05693950177935943,56200,53000,-3200,682957
3903,3670,2019-04-18,0.06451612903225806,62000,58000,-4000,1401684
3904,3670,2019-03-25,0.0629800307219662,65100,61000,-4100,727935
3905,3670,2019-03-21,0.04107424960505529,63300,65900,2600,946363
3906,3670,2019-03-12,0.05910543130990415,62600,66300,3700,556464
3907,3670,2019-03-05,0.04264705882352941,68000,65100,-2900,801455
3908,3670,2019-02-07,0.06166666666666667,60000,63700,3700,964818
3909,3670,2019-01-25,0.06678383128295255,56900,60700,3800,978032
3910,3670,2019-01-17,0.05016181229773463,61800,58700,-3100,609103
3911,3670,2019-01-08,0.0425531914893617,61100,58500,-2600,603462
3912,3670,2019-01-07,0.046232876712328765,58400,61100,2700,753617
3913,3670,2019-01-03,0.04326123128119801,60100,57500,-2600,1070099
3914,3670,2019-01-02,0.0565149136577708,63700,60100,-3600,1175854
3915,3670,2018-12-21,0.08542713567839195,59700,64800,5100,1411732
3916,3670,2018-12-19,0.0506108202443281,57300,60200,2900,991303
3917,3670,2018-12-14,0.062111801242236024,64400,60400,-4000,1087581
3918,3670,2018-12-10,0.04186046511627907,64500,61800,-2700,958053
3919,3670,2018-11-28,0.04564315352697095,72300,69000,-3300,970908
3920,3670,2018-11-26,0.041428571428571426,70000,72900,2900,497982
3921,3670,2018-11-23,0.04240766073871409,73100,70000,-3100,937500
3922,3670,2018-11-14,0.04353393085787452,78100,74700,-3400,1066183
3923,3670,2018-11-08,0.05931034482758621,72500,76800,4300,1233681
3924,3670,2018-11-02,0.07067669172932331,66500,71200,4700,703352
3925,3670,2018-10-29,0.06285714285714286,70000,65600,-4400,951489
3926,3670,2018-10-25,0.05504587155963303,65400,69000,3600,1286413
3927,3670,2018-10-23,0.08490566037735849,74200,67900,-6300,1235451
3928,3670,2018-10-16,0.04451038575667656,67400,70400,3000,787775
3929,3670,2018-10-12,0.08562197092084006,61900,67200,5300,835493
3930,3670,2018-10-11,0.07886904761904762,67200,61900,-5300,892492
3931,3670,2018-10-05,0.07439198855507868,69900,64700,-5200,1100463
3932,3670,2018-10-02,0.04696132596685083,72400,69000,-3400,927840
3933,3670,2018-09-28,0.04450261780104712,76400,73000,-3400,1536859
3934,3670,2018-09-27,0.0670391061452514,71600,76400,4800,701593
3935,3670,2018-09-07,0.0754414125200642,62300,67000,4700,957169
3936,3670,2018-09-04,0.06779661016949153,59000,63000,4000,881809
3937,3670,2018-08-27,0.10058027079303675,51700,56900,5200,1372402
3938,3670,2018-08-21,0.06315789473684211,47500,50500,3000,627314
3939,3670,2018-08-16,0.04179728317659352,47850,49850,2000,443357
3940,3670,2018-08-06,0.04238921001926782,51900,49700,-2200,537832
3941,3670,2018-07-27,0.07158351409978309,46100,49400,3300,1066314
3942,3670,2018-07-25,0.050808314087759814,43300,45500,2200,616673
3943,3670,2018-07-23,0.04628632938643703,46450,44300,-2150,337739
3944,3670,2018-07-19,0.04148471615720524,45800,47700,1900,732114
3945,3670,2018-07-03,0.05561861520998865,44050,46500,2450,939091
3946,3670,2018-06-20,0.06947890818858561,40300,43100,2800,412319
3947,3670,2018-06-18,0.0547945205479452,43800,41400,-2400,486656
3948,3670,2018-06-07,0.04504504504504504,44400,46400,2000,956229
3949,3670,2018-05-30,0.05226480836236934,43050,45300,2250,1852656
3950,3670,2018-05-29,0.06427688504326329,40450,43050,2600,1728339
3951,3670,2018-05-17,0.06793478260869565,36800,39300,2500,738630
3952,3670,2018-05-09,0.10267229254571027,35550,39200,3650,1528395
3953,3670,2018-04-18,0.0912280701754386,42750,38850,-3900,2343328
3954,3670,2018-04-04,0.09978308026030369,46100,41500,-4600,2013408
3955,3670,2018-03-26,0.05876068376068376,46800,49550,2750,462988
3956,3670,2018-03-23,0.05167173252279635,49350,46800,-2550,546106
3957,3670,2018-03-06,0.07486033519553073,44750,48100,3350,728514
3958,3670,2018-02-28,0.05614406779661017,47200,44550,-2650,599460
3959,3670,2018-02-19,0.04189636163175303,45350,47250,1900,513006
3960,3670,2018-02-14,0.04976851851851852,43200,45350,2150,380273
3961,3670,2018-02-08,0.06192660550458716,43600,46300,2700,869263
3962,3670,2018-02-05,0.128,50000,43600,-6400,1350266
3963,3670,2018-01-24,0.04938271604938271,48600,51000,2400,1018165
3964,3670,2018-01-12,0.08680555555555555,43200,46950,3750,2026670
3965,3670,2018-01-11,0.08270676691729323,39900,43200,3300,1402176
3966,3670,2018-01-05,0.07651715039577836,37900,40800,2900,1255699
3967,3670,2017-12-28,0.041884816753926704,38200,39800,1600,1302506
3968,3670,2017-12-26,0.041666666666666664,36000,37500,1500,1117729
3969,3670,2017-12-22,0.07784431137724551,33400,36000,2600,969812
3970,3670,2017-11-28,0.052486187845303865,36200,34300,-1900,1308304
3971,3670,2017-11-21,0.0655307994757536,38150,35650,-2500,2733180
3972,3670,2017-11-16,0.11356932153392331,33900,37750,3850,3144653
3973,3670,2017-11-14,0.06549520766773163,31300,33350,2050,2224638
3974,3670,2017-11-09,0.04159733777038269,30050,31300,1250,1733730
3975,3670,2017-11-06,0.04597701149425287,30450,29050,-1400,1282823
3976,3670,2017-11-03,0.061633281972265024,32450,30450,-2000,2534747
3977,3670,2017-11-02,0.1094017094017094,29250,32450,3200,4002305
3978,3670,2017-11-01,0.04092526690391459,28100,29250,1150,687762
3979,3670,2017-10-23,0.05150976909413854,28150,29600,1450,750673
3980,3670,2017-10-16,0.06951026856240126,31650,29450,-2200,2522327
3981,3670,2017-10-10,0.08600337268128162,29650,32200,2550,1474479
3982,3670,2017-09-22,0.06587837837837837,29600,27650,-1950,2003742
3983,3670,2017-09-21,0.05128205128205128,31200,29600,-1600,1761264
3984,3670,2017-09-20,0.060240963855421686,33200,31200,-2000,2029969
3985,3670,2017-09-19,0.0473186119873817,31700,33200,1500,1691637
3986,3670,2017-09-11,0.10732538330494037,29350,32500,3150,2748544
3987,3670,2017-09-05,0.10454545454545454,33000,29550,-3450,4246289
3988,3670,2017-08-31,0.08374384236453201,30450,33000,2550,3517195
3989,3670,2017-08-30,0.059130434782608696,28750,30450,1700,2060025
3990,3670,2017-08-29,0.07677902621722846,26700,28750,2050,1849377
3991,3670,2017-08-24,0.04431599229287091,25950,27100,1150,1267528
3992,3670,2017-08-18,0.11233480176211454,22700,25250,2550,2144110
3993,3670,2017-08-09,0.06047516198704104,23150,21750,-1400,947012
3994,3670,2017-08-08,0.04279279279279279,22200,23150,950,792217
3995,3670,2017-08-07,0.05531914893617021,23500,22200,-1300,859710
3996,3670,2017-08-04,0.04212860310421286,22550,23500,950,912091
3997,3670,2017-08-01,0.08591885441527446,20950,22750,1800,1681416
3998,3670,2017-07-25,0.05793450881612091,19850,21000,1150,1708603
3999,3670,2017-07-20,0.07714285714285714,17500,18850,1350,1149291
4000,3670,2017-07-17,0.04597701149425287,17400,18200,800,1101365
4001,3670,2017-07-12,0.096875,16000,17550,1550,1921797
4002,3670,2017-07-04,0.04318936877076412,15050,14400,-650,369877
4003,3670,2017-06-09,0.0436241610738255,14900,15550,650,493026
4004,3670,2017-05-25,0.041811846689895474,14350,14950,600,377042
4005,3670,2017-04-11,0.045454545454545456,14300,14950,650,285028
4006,3670,2017-03-20,0.042704626334519574,14050,14650,600,583940
4007,3670,2016-11-22,0.0593607305936073,10950,11600,650,221450
4008,3670,2016-11-14,0.055793991416309016,11650,11000,-650,286801
4009,105560,2021-05-06,0.07879924953095685,53300,57500,4200,3197803
4010,105560,2021-03-09,0.05305305305305305,49950,52600,2650,7203435
4011,105560,2021-03-08,0.0627659574468085,47000,49950,2950,5184062
4012,105560,2021-02-05,0.054696789536266346,42050,44350,2300,3557203
4013,105560,2021-02-01,0.04466501240694789,40300,42100,1800,1995656
4014,105560,2021-01-07,0.045454545454545456,44000,46000,2000,4683821
4015,105560,2020-12-29,0.04824561403508772,45600,43400,-2200,2666286
4016,105560,2020-11-30,0.054223149113660066,47950,45350,-2600,3803160
4017,105560,2020-11-25,0.040948275862068964,46400,48300,1900,3209922
4018,105560,2020-11-11,0.05704697986577181,44700,47250,2550,3407691
4019,105560,2020-11-10,0.04074505238649592,42950,44700,1750,2913985
4020,105560,2020-11-02,0.04738154613466334,40100,42000,1900,1789683
4021,105560,2020-08-20,0.04078947368421053,38000,36450,-1550,2376891
4022,105560,2020-08-18,0.0414572864321608,39800,38150,-1650,2848865
4023,105560,2020-08-14,0.04096385542168675,41500,39800,-1700,2859261
4024,105560,2020-08-11,0.04441453566621804,37150,38800,1650,4668361
4025,105560,2020-07-13,0.041237113402061855,33950,35350,1400,1765624
4026,105560,2020-06-16,0.07368421052631578,33250,35700,2450,2255201
4027,105560,2020-06-15,0.04040404040404041,34650,33250,-1400,3388071
4028,105560,2020-06-12,0.04676753782668501,36350,34650,-1700,3806558
4029,105560,2020-06-04,0.04145077720207254,38600,37000,-1600,6220789
4030,105560,2020-06-03,0.06482758620689655,36250,38600,2350,5291169
4031,105560,2020-06-02,0.0476878612716763,34600,36250,1650,3992096
4032,105560,2020-05-04,0.050359712230215826,34750,33000,-1750,3135974
4033,105560,2020-04-27,0.09967845659163987,31100,34200,3100,6297287
4034,105560,2020-04-06,0.05457463884430177,31150,32850,1700,1998703
4035,105560,2020-04-01,0.085383502170767,34550,31600,-2950,2918796
4036,105560,2020-03-27,0.08662613981762918,32900,35750,2850,3789110
4037,105560,2020-03-25,0.09777015437392796,29150,32000,2850,4002728
4038,105560,2020-03-24,0.054249547920433995,27650,29150,1500,2766834
4039,105560,2020-03-23,0.10372771474878444,30850,27650,-3200,2779005
4040,105560,2020-03-20,0.18426103646833014,26050,30850,4800,2772947
4041,105560,2020-03-19,0.10327022375215146,29050,26050,-3000,3226552
4042,105560,2020-03-17,0.07009345794392523,32100,29850,-2250,2376047
4043,105560,2020-03-12,0.05240793201133145,35300,33450,-1850,2428039
4044,105560,2020-03-09,0.06141522029372497,37450,35150,-2300,2015102
4045,105560,2020-02-24,0.05103280680437424,41150,39050,-2100,1872964
4046,105560,2020-01-28,0.047109207708779445,46700,44500,-2200,1494047
4047,105560,2019-04-01,0.05137395459976105,41850,44000,2150,2419101
4048,105560,2019-01-15,0.04938271604938271,44550,46750,2200,1317274
4049,105560,2018-12-27,0.049163179916317995,47800,45450,-2350,1336622
4050,105560,2018-10-30,0.055232558139534885,51600,48750,-2850,1898563
4051,105560,2018-10-11,0.04693140794223827,55400,52800,-2600,1625520
4052,105560,2018-07-13,0.045368620037807186,52900,55300,2400,1019107
4053,105560,2018-06-21,0.043557168784029036,55100,52700,-2400,1321931
4054,105560,2018-06-04,0.040152963671128104,52300,54400,2100,1480544
4055,105560,2018-05-30,0.040293040293040296,54600,52400,-2200,2116671
4056,105560,2018-02-12,0.054098360655737705,61000,64300,3300,1222428
4057,105560,2018-02-06,0.051698670605613,67700,64200,-3500,1777390
4058,105560,2018-01-23,0.0441400304414003,65700,68600,2900,899249
4059,105560,2017-12-13,0.04288164665523156,58300,60800,2500,1319487
4060,105560,2017-09-05,0.05194805194805195,53900,51100,-2800,2245667
4061,105560,2017-07-21,0.041811846689895474,57400,59800,2400,2680425
4062,105560,2017-04-17,0.04455958549222798,48250,50400,2150,2192191
4063,105560,2016-12-08,0.06093189964157706,41850,44400,2550,2204792
4064,35420,2021-03-18,0.05215123859191656,383500,403500,20000,1818409
4065,35420,2021-03-03,0.05827814569536424,377500,399500,22000,1287551
4066,35420,2021-02-24,0.04225352112676056,390500,374000,-16500,1078485
4067,35420,2021-02-15,0.05184174624829468,366500,385500,19000,1172475
4068,35420,2021-02-02,0.041666666666666664,348000,362500,14500,1951062
4069,35420,2021-01-22,0.06511627906976744,322500,343500,21000,3303950
4070,35420,2021-01-21,0.04707792207792208,308000,322500,14500,1941446
4071,35420,2021-01-08,0.07772020725388601,289500,312000,22500,3175396
4072,35420,2020-11-10,0.050335570469798654,298000,283000,-15000,1728995
4073,35420,2020-11-04,0.054770318021201414,283000,298500,15500,1623712
4074,35420,2020-10-28,0.05291005291005291,283500,298500,15000,698195
4075,35420,2020-09-23,0.0421792618629174,284500,296500,12000,984136
4076,35420,2020-09-07,0.0426179604261796,328500,314500,-14000,1308247
4077,35420,2020-08-03,0.044850498338870434,301000,314500,13500,1341104
4078,35420,2020-07-23,0.05185185185185185,270000,284000,14000,1396607
4079,35420,2020-07-20,0.04710144927536232,276000,263000,-13000,1556415
4080,35420,2020-07-16,0.04712041884816754,286500,273000,-13500,1338814
4081,35420,2020-07-10,0.04,287500,299000,11500,2120904
4082,35420,2020-06-22,0.08216432865731463,249500,270000,20500,1841479
4083,35420,2020-06-16,0.05183585313174946,231500,243500,12000,1155474
4084,35420,2020-06-15,0.04338842975206612,242000,231500,-10500,1311773
4085,35420,2020-06-08,0.04112554112554113,231000,240500,9500,1624752
4086,35420,2020-06-01,0.048672566371681415,226000,237000,11000,1140644
4087,35420,2020-05-29,0.060291060291060294,240500,226000,-14500,3114298
4088,35420,2020-05-28,0.0525164113785558,228500,240500,12000,1625154
4089,35420,2020-05-27,0.043933054393305436,239000,228500,-10500,1351505
4090,35420,2020-05-25,0.0455531453362256,230500,241000,10500,1015069
4091,35420,2020-05-06,0.06532663316582915,199000,212000,13000,992225
4092,35420,2020-04-23,0.04395604395604396,182000,190000,8000,1521478
4093,35420,2020-04-17,0.04985337243401759,170500,179000,8500,900031
4094,35420,2020-04-02,0.06441717791411043,163000,173500,10500,1086863
4095,35420,2020-04-01,0.041176470588235294,170000,163000,-7000,720283
4096,35420,2020-03-31,0.046153846153846156,162500,170000,7500,858165
4097,35420,2020-03-27,0.07540983606557378,152500,164000,11500,1217815
4098,35420,2020-03-24,0.09090909090909091,143000,156000,13000,960786
4099,35420,2020-03-23,0.07142857142857142,154000,143000,-11000,1033851
4100,35420,2020-03-20,0.06944444444444445,144000,154000,10000,997895
4101,35420,2020-03-16,0.06626506024096386,166000,155000,-11000,812823
4102,35420,2020-03-09,0.06406685236768803,179500,168000,-11500,668089
4103,35420,2020-02-28,0.04395604395604396,182000,174000,-8000,830654
4104,35420,2019-11-19,0.04481792717086835,178500,170500,-8000,1055749
4105,35420,2019-11-14,0.13924050632911392,158000,180000,22000,2042648
4106,35420,2019-10-31,0.061488673139158574,154500,164000,9500,1409619
4107,35420,2019-10-04,0.041401273885350316,157000,150500,-6500,602642
4108,35420,2019-08-20,0.046762589928057555,139000,145500,6500,556246
4109,35420,2019-07-26,0.05223880597014925,134000,141000,7000,1440686
4110,35420,2019-07-25,0.08502024291497975,123500,134000,10500,1635774
4111,35420,2019-02-26,0.04365079365079365,126000,131500,5500,591643
4112,35420,2019-01-21,0.04727272727272727,137500,131000,-6500,457161
4113,35420,2019-01-15,0.04330708661417323,127000,132500,5500,335999
4114,35420,2019-01-07,0.04780876494023904,125500,131500,6000,502619
4115,35420,2018-12-21,0.04330708661417323,127000,121500,-5500,507653
4116,35420,2018-12-19,0.045081967213114756,122000,127500,5500,385472
4117,35420,2018-12-06,0.04,125000,120000,-5000,445309
4118,35420,2018-11-26,0.08771929824561403,114000,124000,10000,805023
4119,35420,2018-11-23,0.0410958904109589,109500,114000,4500,691736
4120,35420,2018-11-02,0.04484304932735426,111500,116500,5000,1320415
4121,35420,2018-10-26,0.05042016806722689,119000,113000,-6000,1544405
4122,35420,2018-10-25,0.06299212598425197,127000,119000,-8000,1529110
4123,35420,2018-10-15,0.04225352112676056,142000,136000,-6000,642772
4124,35420,2018-02-09,0.04151838671411625,843000,808000,-35000,158070
4125,35420,2018-01-08,0.046255506607929514,908000,950000,42000,196338
4126,35420,2017-10-27,0.04642857142857143,840000,879000,39000,236645
4127,35420,2017-10-26,0.04477611940298507,804000,840000,36000,342341
4128,35420,2017-10-18,0.061197916666666664,768000,815000,47000,219631
4129,35420,2017-09-14,0.04938271604938271,729000,765000,36000,226589
4130,35420,2017-06-12,0.06770833333333333,960000,895000,-65000,198383
4131,35420,2017-06-09,0.07865168539325842,890000,960000,70000,183462
4132,35420,2017-05-11,0.050970873786407765,824000,866000,42000,174898
4133,35420,2017-04-13,0.044270833333333336,768000,802000,34000,173040
4134,35420,2017-04-11,0.05867970660146699,818000,770000,-48000,263066
4135,35420,2017-03-21,0.0647921760391198,818000,871000,53000,150195
4136,35420,2017-03-02,0.05025773195876289,776000,815000,39000,150962
4137,35420,2017-01-04,0.0560625814863103,767000,810000,43000,120359
4138,35420,2016-12-08,0.072,750000,804000,54000,134987
4139,35420,2016-12-01,0.042606516290726815,798000,764000,-34000,103862
4140,35420,2016-11-11,0.05707196029776675,806000,760000,-46000,214331
4141,35420,2016-10-13,0.04282407407407408,864000,827000,-37000,96099
4142,32350,2021-05-31,0.07021791767554479,20650,22100,1450,2037821
4143,32350,2021-05-25,0.06582278481012659,19750,21050,1300,2004908
4144,32350,2021-05-03,0.051490514905149054,18450,17500,-950,713554
4145,32350,2021-04-06,0.047244094488188976,19050,19950,900,1044732
4146,32350,2021-04-01,0.0427807486631016,18700,19500,800,680826
4147,32350,2021-03-24,0.04392764857881137,19350,20200,850,1934067
4148,32350,2021-03-22,0.04411764705882353,20400,19500,-900,1214856
4149,32350,2021-03-15,0.04922279792746114,19300,20250,950,1037149
4150,32350,2021-03-08,0.06763285024154589,20700,19300,-1400,1104766
4151,32350,2021-02-25,0.05970149253731343,20100,21300,1200,1770899
4152,32350,2021-02-24,0.046875,19200,20100,900,3655799
4153,32350,2021-02-23,0.09090909090909091,17600,19200,1600,1763831
4154,32350,2021-02-16,0.06470588235294118,17000,18100,1100,1145227
4155,32350,2021-02-01,0.07395498392282958,15550,16700,1150,1605039
4156,32350,2021-01-18,0.04075235109717868,15950,15300,-650,714826
4157,32350,2021-01-14,0.04013377926421405,14950,15550,600,1376239
4158,32350,2020-12-22,0.04472843450479233,15650,14950,-700,552073
4159,32350,2020-12-21,0.04573170731707317,16400,15650,-750,557477
4160,32350,2020-12-14,0.05813953488372093,17200,16200,-1000,534086
4161,32350,2020-10-26,0.04777070063694268,15700,14950,-750,143358
4162,32350,2020-10-07,0.04304635761589404,15100,15750,650,184606
4163,32350,2020-09-29,0.0547945205479452,14600,15400,800,254662
4164,32350,2020-09-04,0.12698412698412698,18900,16500,-2400,2308626
4165,32350,2020-08-12,0.07736389684813753,17450,18800,1350,1841625
4166,32350,2020-07-22,0.06031746031746032,15750,16700,950,1825155
4167,32350,2020-07-21,0.08247422680412371,14550,15750,1200,1112946
4168,32350,2020-06-30,0.08097165991902834,12350,13350,1000,657997
4169,32350,2020-06-16,0.07346938775510205,12250,13150,900,402284
4170,32350,2020-06-15,0.11231884057971014,13800,12250,-1550,673460
4171,32350,2020-05-29,0.05384615384615385,13000,13700,700,578193
4172,32350,2020-05-19,0.05058365758754864,12850,13500,650,859460
4173,32350,2020-05-12,0.047244094488188976,12700,12100,-600,370830
4174,32350,2020-05-08,0.041666666666666664,12000,12500,500,573870
4175,32350,2020-04-28,0.06422018348623854,10900,11600,700,879401
4176,32350,2020-04-27,0.05825242718446602,10300,10900,600,253351
4177,32350,2020-04-21,0.05357142857142857,11200,10600,-600,496556
4178,32350,2020-04-10,0.11895161290322581,9920,11100,1180,539393
4179,32350,2020-04-07,0.048034934497816595,9160,9600,440,505915
4180,32350,2020-04-06,0.06387921022067364,8610,9160,550,337675
4181,32350,2020-03-31,0.04645476772616137,8180,8560,380,373909
4182,32350,2020-03-30,0.05433526011560694,8650,8180,-470,501430
4183,32350,2020-03-26,0.04380475594493116,7990,8340,350,674917
4184,32350,2020-03-25,0.056878306878306875,7560,7990,430,490842
4185,32350,2020-03-23,0.05660377358490566,7950,7500,-450,365651
4186,32350,2020-03-20,0.06141522029372497,7490,7950,460,545964
4187,32350,2020-03-19,0.16777777777777778,9000,7490,-1510,1580513
4188,32350,2020-03-18,0.044585987261146494,9420,9000,-420,516074
4189,32350,2020-03-13,0.07632850241545894,10350,9560,-790,755785
4190,32350,2020-03-09,0.05701754385964912,11400,10750,-650,411514
4191,32350,2020-03-05,0.04954954954954955,11100,11650,550,431909
4192,32350,2020-02-28,0.05855855855855856,11100,10450,-650,758932
4193,32350,2020-02-27,0.04310344827586207,11600,11100,-500,390499
4194,32350,2020-02-24,0.09302325581395349,12900,11700,-1200,549268
4195,32350,2020-02-12,0.05204460966542751,13450,14150,700,385484
4196,32350,2020-01-28,0.08532423208191127,14650,13400,-1250,867415
4197,32350,2019-12-27,0.06792452830188679,13250,14150,900,505780
4198,32350,2019-10-31,0.04417670682730924,12450,13000,550,428666
4199,32350,2019-10-28,0.08016877637130802,11850,12800,950,2334840
4200,32350,2019-09-26,0.04054054054054054,11100,11550,450,204837
4201,32350,2019-09-18,0.04743083003952569,12650,12050,-600,4028550
4202,32350,2019-09-11,0.04460966542750929,13450,12850,-600,300194
4203,32350,2019-08-26,0.040160642570281124,12450,12950,500,357786
4204,32350,2019-06-13,0.042801556420233464,12850,13400,550,161467
4205,32350,2019-06-11,0.056451612903225805,12400,13100,700,133909
4206,32350,2019-06-07,0.058577405857740586,11950,12650,700,202286
4207,32350,2019-05-29,0.04365079365079365,12600,12050,-550,91424
4208,32350,2019-05-28,0.04132231404958678,12100,12600,500,90250
4209,32350,2019-04-12,0.04744525547445255,13700,14350,650,458167
4210,32350,2019-04-08,0.06299212598425197,12700,13500,800,599042
4211,32350,2019-03-28,0.046511627906976744,12900,12300,-600,279176
4212,32350,2019-03-13,0.10980392156862745,12750,14150,1400,808060
4213,32350,2019-02-19,0.045454545454545456,14300,14950,650,1121510
4214,32350,2019-01-07,0.05574912891986063,14350,15150,800,584874
4215,32350,2019-01-03,0.04697986577181208,14900,14200,-700,691056
4216,32350,2018-12-27,0.09363295880149813,13350,14600,1250,1175610
4217,32350,2018-12-21,0.04230769230769231,13000,13550,550,495471
4218,32350,2018-12-05,0.06028368794326241,14100,13250,-850,729306
4219,32350,2018-11-30,0.04744525547445255,13700,14350,650,923653
4220,32350,2018-11-22,0.05019305019305019,12950,13600,650,1052564
4221,32350,2018-11-21,0.06147540983606557,12200,12950,750,846707
4222,32350,2018-11-15,0.0970873786407767,10300,11300,1000,752595
4223,32350,2018-11-06,0.048458149779735685,11350,10800,-550,802770
4224,32350,2018-10-30,0.15942028985507245,13800,11600,-2200,696930
4225,32350,2018-10-24,0.04693140794223827,13850,14500,650,53804
4226,32350,2018-10-23,0.05136986301369863,14600,13850,-750,26149
4227,32350,2018-10-10,0.040498442367601244,16050,15400,-650,125889
4228,32350,2018-10-01,0.08653846153846154,15600,16950,1350,539983
4229,32350,2018-08-31,0.06051873198847262,17350,16750,-600,180598
4230,32350,2018-07-30,0.05339805825242718,20600,19500,-1100,583001
4231,32350,2018-07-27,0.04568527918781726,19700,20600,900,975210
4232,32350,2018-07-02,0.06496519721577726,21550,20150,-1400,98446
4233,32350,2018-06-26,0.04338394793926247,23050,22050,-1000,89633
4234,32350,2018-06-21,0.04573804573804574,24050,22950,-1100,166361
4235,32350,2018-06-12,0.12771084337349398,20750,23400,2650,2207749
4236,32350,2018-06-05,0.044009779951100246,20450,21350,900,431875
4237,32350,2018-05-16,0.041463414634146344,20500,19650,-850,89550
4238,32350,2018-05-02,0.04439252336448598,21400,20450,-950,217410
4239,32350,2018-04-30,0.04390243902439024,20500,21400,900,275766
4240,32350,2018-04-25,0.07311320754716981,21200,19650,-1550,215899
4241,32350,2018-04-19,0.07711442786069651,20100,21650,1550,950878
4242,32350,2018-04-13,0.07336956521739131,18400,19750,1350,435762
4243,32350,2018-04-05,0.08168316831683169,20200,18550,-1650,569915
4244,32350,2018-04-02,0.2980769230769231,15600,20250,4650,1505305
4245,32350,2018-03-27,0.061855670103092786,14550,15450,900,198360
4246,32350,2018-03-14,0.0625,16000,15000,-1000,189013
4247,32350,2018-03-09,0.11724137931034483,14500,16200,1700,979855
4248,32350,2018-03-05,0.045112781954887216,13300,13900,600,123658
4249,32350,2018-02-14,0.058823529411764705,14450,13600,-850,234995
4250,32350,2018-02-13,0.04332129963898917,13850,14450,600,519755
4251,32350,2018-02-07,0.0711743772241993,14050,13050,-1000,237953
4252,32350,2018-02-05,0.08881578947368421,15200,13850,-1350,1114685
4253,32350,2018-02-01,0.16929133858267717,12700,14850,2150,2466587
4254,32350,2018-01-24,0.05474452554744526,13700,12950,-750,255164
4255,32350,2018-01-17,0.13733905579399142,11650,13250,1600,1273454
4256,32350,2018-01-02,0.06944444444444445,10800,11550,750,129944
4257,32350,2017-12-27,0.04854368932038835,10300,10800,500,67264
4258,32350,2017-12-21,0.09292035398230089,11300,10250,-1050,149232
4259,32350,2017-12-12,0.05668016194331984,12350,11650,-700,177502
4260,32350,2017-12-08,0.08035714285714286,11200,12100,900,1085390
4261,32350,2017-12-07,0.06276150627615062,11950,11200,-750,213742
4262,32350,2017-11-28,0.06428571428571428,14000,13100,-900,3248504
4263,32350,2017-11-02,0.07326007326007326,13650,12650,-1000,487306
4264,32350,2017-10-30,0.2966507177033493,10450,13550,3100,2825966
4265,32350,2017-10-27,0.2997512437810945,8040,10450,2410,536812
4266,32350,2017-08-10,0.04671717171717172,7920,8290,370,34814
4267,32350,2017-05-18,0.06605922551252848,8780,9360,580,222615
4268,32350,2017-05-17,0.06942752740560293,8210,8780,570,268911
4269,32350,2017-02-07,0.054959785522788206,7460,7870,410,13951
4270,32350,2017-01-19,0.0427807486631016,7480,7800,320,26222
4271,32350,2016-11-24,0.044213263979193757,7690,7350,-340,33125
4272,32350,2016-10-25,0.05172413793103448,8700,9150,450,50612
4273,32350,2016-09-19,0.056043956043956046,9100,9610,510,61581
4274,32350,2016-09-08,0.047619047619047616,9870,9400,-470,159201
4275,32350,2016-08-23,0.04265402843601896,10550,10100,-450,83199
4276,32350,2016-08-08,0.2964426877470356,12650,16400,3750,650678
4277,161890,2021-04-21,0.04159733777038269,60100,57600,-2500,459975
4278,161890,2021-02-18,0.09732824427480916,52400,57500,5100,2044354
4279,161890,2021-01-18,0.052336448598130844,53500,50700,-2800,429214
4280,161890,2020-12-29,0.04266389177939646,48050,50100,2050,549834
4281,161890,2020-12-21,0.05119825708061002,45900,48250,2350,659099
4282,161890,2020-10-12,0.05251875669882101,46650,49100,2450,533412
4283,161890,2020-08-20,0.054455445544554455,50500,47750,-2750,380469
4284,161890,2020-08-18,0.06500956022944551,52300,48900,-3400,440332
4285,161890,2020-08-12,0.041749502982107355,50300,52400,2100,556064
4286,161890,2020-08-07,0.049578059071729956,47400,49750,2350,1001615
4287,161890,2020-07-30,0.0416210295728368,45650,47550,1900,696707
4288,161890,2020-06-30,0.07035175879396985,39800,42600,2800,2113544
4289,161890,2020-06-15,0.06726457399103139,44600,41600,-3000,353345
4290,161890,2020-06-11,0.040880503144654086,47700,45750,-1950,448731
4291,161890,2020-06-04,0.0510783200908059,44050,46300,2250,980949
4292,161890,2020-03-25,0.04461538461538461,32500,33950,1450,405393
4293,161890,2020-03-23,0.057057057057057055,33300,31400,-1900,205022
4294,161890,2020-03-20,0.0438871473354232,31900,33300,1400,301244
4295,161890,2020-03-19,0.06997084548104957,34300,31900,-2400,411375
4296,161890,2020-03-13,0.06417112299465241,37400,35000,-2400,488863
4297,161890,2020-03-12,0.07080745341614907,40250,37400,-2850,374788
4298,161890,2020-02-24,0.08855291576673865,46300,42200,-4100,626426
4299,161890,2020-01-28,0.09412955465587045,49400,44750,-4650,505457
4300,161890,2020-01-13,0.0860655737704918,48800,53000,4200,1243114
4301,161890,2020-01-07,0.05482456140350877,45600,48100,2500,393563
4302,161890,2020-01-06,0.04,47500,45600,-1900,267095
4303,161890,2019-11-25,0.06444188722669736,43450,46250,2800,237637
4304,161890,2019-10-30,0.04439511653718091,45050,47050,2000,429739
4305,161890,2019-10-04,0.05535499398315283,41550,39250,-2300,505181
4306,161890,2019-08-14,0.06344086021505377,46500,43550,-2950,1061414
4307,161890,2019-08-09,0.04880478087649402,50200,47750,-2450,627663
4308,161890,2019-08-08,0.04257528556593977,48150,50200,2050,211229
4309,161890,2019-08-05,0.049429657794676805,52600,50000,-2600,164166
4310,161890,2019-05-15,0.06156156156156156,66600,70700,4100,227315
4311,161890,2019-04-02,0.04218362282878412,80600,77200,-3400,244133
4312,161890,2019-03-26,0.043478260869565216,78200,81600,3400,105541
4313,161890,2019-03-18,0.04974489795918367,78400,82300,3900,213643
4314,161890,2019-02-15,0.05647382920110193,72600,76700,4100,486326
4315,161890,2019-02-14,0.1033434650455927,65800,72600,6800,768881
4316,161890,2019-01-23,0.05263157894736842,64600,68000,3400,245307
4317,161890,2019-01-17,0.04896142433234421,67400,64100,-3300,183861
4318,161890,2018-12-27,0.04661654135338346,66500,69600,3100,157920
4319,161890,2018-11-26,0.061224489795918366,63700,67600,3900,166910
4320,161890,2018-11-15,0.11010830324909747,55400,61500,6100,343442
4321,161890,2018-11-07,0.04201680672268908,59500,57000,-2500,223429
4322,161890,2018-11-02,0.056140350877192984,57000,60200,3200,100383
4323,161890,2018-11-01,0.05166051660516605,54200,57000,2800,125885
4324,161890,2018-10-29,0.07899159663865546,59500,54800,-4700,196495
4325,161890,2018-10-26,0.052547770700636945,62800,59500,-3300,148251
4326,161890,2018-10-11,0.049204052098408106,69100,65700,-3400,111406
4327,161890,2018-10-04,0.04041720990873533,76700,73600,-3100,133932
4328,161890,2018-10-01,0.05614973262032086,74800,79000,4200,253466
4329,161890,2018-08-01,0.06158357771260997,68200,72400,4200,266465
4330,161890,2018-07-05,0.04579207920792079,80800,77100,-3700,193880
4331,161890,2018-06-27,0.08850726552179657,75700,82400,6700,591719
4332,161890,2018-06-19,0.047619047619047616,75600,72000,-3600,125732
4333,161890,2018-04-02,0.05761843790012804,78100,82600,4500,488921
4334,161890,2018-03-09,0.06080206985769728,77300,82000,4700,330851
4335,161890,2018-02-22,0.04836759371221282,82700,78700,-4000,438318
4336,161890,2018-02-21,0.06572164948453608,77600,82700,5100,1401457
4337,161890,2018-02-14,0.09080188679245282,84800,77100,-7700,591026
4338,161890,2018-01-10,0.044226044226044224,81400,85000,3600,157122
4339,161890,2017-12-12,0.05581395348837209,86000,81200,-4800,197748
4340,161890,2017-11-29,0.047619047619047616,81900,85800,3900,509702
4341,161890,2017-11-15,0.0650887573964497,84500,79000,-5500,531702
4342,161890,2017-10-13,0.046357615894039736,75500,79000,3500,394677
4343,161890,2017-09-26,0.04054054054054054,66600,69300,2700,203062
4344,161890,2017-09-25,0.04992867332382311,70100,66600,-3500,191182
4345,161890,2017-09-21,0.09984639016897082,65100,71600,6500,697298
4346,161890,2017-08-16,0.05138888888888889,72000,68300,-3700,646913
4347,161890,2017-07-26,0.04667609618104668,70700,74000,3300,429388
4348,161890,2017-06-13,0.040993788819875775,80500,77200,-3300,296692
4349,161890,2017-05-12,0.04666666666666667,90000,85800,-4200,601355
4350,161890,2017-05-04,0.0460772104607721,80300,84000,3700,201678
4351,161890,2017-04-17,0.041237113402061855,77600,80800,3200,264548
4352,161890,2017-04-13,0.0673076923076923,72800,77700,4900,305541
4353,161890,2017-03-24,0.06808510638297872,70500,75300,4800,320302
4354,161890,2017-03-03,0.0560875512995896,73100,69000,-4100,281739
4355,161890,2017-03-02,0.0469361147327249,76700,73100,-3600,165038
4356,161890,2017-02-24,0.05121293800539083,74200,78000,3800,379678
4357,161890,2017-02-15,0.044715447154471545,73800,77100,3300,462573
4358,161890,2017-02-14,0.0603448275862069,69600,73800,4200,580238
4359,161890,2017-02-13,0.0529500756429652,66100,69600,3500,321734
4360,161890,2017-02-10,0.05087440381558029,62900,66100,3200,187131
4361,161890,2017-01-31,0.043674698795180725,66400,69300,2900,120434
4362,161890,2017-01-09,0.04952076677316294,62600,59500,-3100,228717
4363,161890,2017-01-02,0.06231003039513678,65800,61700,-4100,219026
4364,161890,2016-12-23,0.042748091603053436,65500,68300,2800,159345
4365,161890,2016-12-09,0.05357142857142857,67200,70800,3600,324489
4366,161890,2016-12-05,0.0467741935483871,62000,64900,2900,211690
4367,161890,2016-12-02,0.04024767801857585,64600,62000,-2600,222664
4368,161890,2016-12-01,0.04154302670623145,67400,64600,-2800,139791
4369,161890,2016-11-29,0.04580152671755725,65500,68500,3000,249566
4370,161890,2016-11-21,0.05113636363636364,70400,66800,-3600,256185
4371,161890,2016-11-15,0.04183006535947712,76500,73300,-3200,179842
4372,161890,2016-11-02,0.045121951219512194,82000,78300,-3700,173290
4373,161890,2016-10-31,0.04004711425206125,84900,81500,-3400,92774
4374,161890,2016-10-26,0.04875,80000,83900,3900,155716
4375,161890,2016-10-25,0.08256880733944955,87200,80000,-7200,272496
4376,161890,2016-08-23,0.05227272727272727,88000,92600,4600,96791
4377,161890,2016-08-08,0.04104903078677309,87700,91300,3600,254777
4378,28260,2021-05-14,0.05660377358490566,132500,140000,7500,1000628
4379,28260,2021-04-29,0.05263157894736842,133000,140000,7000,2039950
4380,28260,2021-04-13,0.04633204633204633,129500,135500,6000,1964722
4381,28260,2021-03-25,0.04219409282700422,118500,123500,5000,666583
4382,28260,2021-01-28,0.056338028169014086,142000,134000,-8000,1951990
4383,28260,2021-01-21,0.06338028169014084,142000,151000,9000,1594368
4384,28260,2021-01-18,0.06840390879478828,153500,143000,-10500,2364849
4385,28260,2021-01-14,0.04452054794520548,146000,152500,6500,1851446
4386,28260,2021-01-08,0.041379310344827586,145000,151000,6000,2268977
4387,28260,2021-01-04,0.043478260869565216,138000,144000,6000,1369767
4388,28260,2020-12-11,0.052,125000,131500,6500,1591465
4389,28260,2020-11-11,0.055793991416309016,116500,123000,6500,1551092
4390,28260,2020-10-26,0.1346153846153846,104000,118000,14000,9493136
4391,28260,2020-09-11,0.041474654377880185,108500,113000,4500,1495263
4392,28260,2020-08-31,0.04,112500,108000,-4500,1059470
4393,28260,2020-08-20,0.04979253112033195,120500,114500,-6000,978030
4394,28260,2020-08-18,0.06048387096774194,124000,116500,-7500,1289969
4395,28260,2020-08-13,0.058577405857740586,119500,126500,7000,3201899
4396,28260,2020-08-12,0.08144796380090498,110500,119500,9000,1779300
4397,28260,2020-06-16,0.10714285714285714,112000,124000,12000,2696960
4398,28260,2020-06-05,0.04672897196261682,107000,112000,5000,901377
4399,28260,2020-05-06,0.06606606606606606,99900,106500,6600,792744
4400,28260,2020-05-04,0.057547169811320756,106000,99900,-6100,625651
4401,28260,2020-04-10,0.05961754780652419,88900,94200,5300,1392526
4402,28260,2020-04-01,0.052455357142857144,89600,84900,-4700,483939
4403,28260,2020-03-25,0.07526881720430108,83700,90000,6300,765916
4404,28260,2020-03-24,0.12348993288590604,74500,83700,9200,684986
4405,28260,2020-03-23,0.07453416149068323,80500,74500,-6000,501217
4406,28260,2020-03-20,0.05366492146596859,76400,80500,4100,690277
4407,28260,2020-03-19,0.08062575210589651,83100,76400,-6700,896134
4408,28260,2020-03-18,0.05782312925170068,88200,83100,-5100,517037
4409,28260,2020-03-16,0.042689434364994665,93700,89700,-4000,472425
4410,28260,2020-03-12,0.041379310344827586,101500,97300,-4200,871598
4411,28260,2020-03-09,0.041666666666666664,108000,103500,-4500,502867
4412,28260,2020-02-06,0.04524886877828054,110500,115500,5000,608944
4413,28260,2020-01-28,0.042735042735042736,117000,112000,-5000,706005
4414,28260,2020-01-23,0.044642857142857144,112000,117000,5000,1290170
4415,28260,2020-01-20,0.04186046511627907,107500,112000,4500,544608
4416,28260,2019-12-19,0.043689320388349516,103000,107500,4500,494970
4417,28260,2019-08-29,0.040525739320920046,91300,87600,-3700,1116682
4418,28260,2019-08-12,0.04215456674473068,85400,89000,3600,364139
4419,28260,2019-04-25,0.049773755656108594,110500,105000,-5500,748703
4420,28260,2019-01-18,0.04484304932735426,111500,116500,5000,461442
4421,28260,2018-11-22,0.05951219512195122,102500,96400,-6100,1017852
4422,28260,2018-10-11,0.06504065040650407,123000,115000,-8000,964966
4423,28260,2018-09-20,0.04048582995951417,123500,128500,5000,780620
4424,28260,2018-05-02,0.05714285714285714,140000,132000,-8000,1595770
4425,28260,2018-03-29,0.04182509505703422,131500,137000,5500,1160541
4426,28260,2018-01-29,0.040293040293040296,136500,142000,5500,933019
4427,28260,2017-09-18,0.07058823529411765,127500,136500,9000,1233411
4428,28260,2017-06-22,0.041666666666666664,132000,137500,5500,589549
4429,28260,2017-04-27,0.06844106463878327,131500,122500,-9000,2296586
4430,28260,2017-03-24,0.07272727272727272,137500,127500,-10000,1834793
4431,28260,2017-03-14,0.09090909090909091,121000,132000,11000,1858384
4432,28260,2016-11-29,0.08633093525179857,139000,127000,-12000,2457320
4433,28260,2016-10-24,0.04361370716510903,160500,167500,7000,798465
4434,28260,2016-10-11,0.040123456790123455,162000,155500,-6500,1079849
4435,28260,2016-10-06,0.07894736842105263,152000,164000,12000,2175637
4436,28260,2016-08-18,0.045774647887323945,142000,148500,6500,1037609
4437,100,2021-04-12,0.042789223454833596,63100,65800,2700,645948
4438,100,2021-01-18,0.05504587155963303,76300,72100,-4200,2180383
4439,100,2021-01-14,0.041499330655957165,74700,77800,3100,1001087
4440,100,2021-01-11,0.04432855280312908,76700,73300,-3400,902778
4441,100,2021-01-04,0.05459387483355526,75100,79200,4100,1040202
4442,100,2020-12-28,0.04217687074829932,73500,76600,3100,1034267
4443,100,2020-12-22,0.0535031847133758,78500,74300,-4200,1377799
4444,100,2020-12-21,0.08575380359612725,72300,78500,6200,5494070
4445,100,2020-12-18,0.060117302052785926,68200,72300,4100,2276533
4446,100,2020-12-08,0.04011461318051576,69800,67000,-2800,1153281
4447,100,2020-12-07,0.07219662058371736,65100,69800,4700,2655829
4448,100,2020-10-28,0.044905008635578586,57900,60500,2600,220972
4449,100,2020-09-24,0.046224961479198766,64900,61900,-3000,726180
4450,100,2020-09-22,0.07361111111111111,72000,66700,-5300,1891243
4451,100,2020-09-21,0.08108108108108109,66600,72000,5400,6284923
4452,100,2020-09-15,0.045662100456621,65700,68700,3000,1481070
4453,100,2020-08-19,0.05627009646302251,62200,65700,3500,960406
4454,100,2020-08-05,0.15726495726495726,58500,67700,9200,12395002
4455,100,2020-07-24,0.0600375234521576,53300,56500,3200,7266218
4456,100,2020-06-16,0.046511627906976744,51600,54000,2400,660604
4457,100,2020-06-15,0.06181818181818182,55000,51600,-3400,1326801
4458,100,2020-06-08,0.10038610038610038,51800,57000,5200,5974675
4459,100,2020-05-11,0.05798575788402848,49150,52000,2850,2914944
4460,100,2020-05-08,0.050213675213675216,46800,49150,2350,824620
4461,100,2020-04-09,0.05263157894736842,46550,49000,2450,1819258
4462,100,2020-03-27,0.09852216748768473,203000,223000,20000,555567
4463,100,2020-03-19,0.06265060240963856,207500,194500,-13000,88336
4464,100,2020-03-12,0.05726872246696035,227000,214000,-13000,92620
4465,100,2019-12-12,0.04194260485651214,226500,236000,9500,122853
4466,100,2019-09-17,0.04794520547945205,219000,229500,10500,89548
4467,100,2019-09-10,0.04656319290465632,225500,215000,-10500,130168
4468,100,2019-08-05,0.04279279279279279,222000,212500,-9500,57582
4469,100,2019-04-10,0.04201680672268908,238000,248000,10000,68382
4470,100,2019-01-15,0.0447427293064877,223500,233500,10000,237950
4471,100,2019-01-04,0.0705596107055961,205500,220000,14500,109594
4472,100,2018-12-06,0.05652173913043478,230000,217000,-13000,150990
4473,100,2018-11-19,0.06041666666666667,240000,254500,14500,471933
4474,100,2018-11-07,0.05,250000,237500,-12500,637970
4475,100,2018-11-06,0.08225108225108226,231000,250000,19000,2285194
4476,100,2018-11-05,0.29775280898876405,178000,231000,53000,530551
4477,100,2018-11-02,0.05325443786982249,169000,178000,9000,90530
4478,100,2018-10-31,0.13659793814432988,194000,167500,-26500,330484
4479,100,2018-10-11,0.04176334106728538,215500,206500,-9000,43401
4480,100,2018-08-31,0.043668122270742356,229000,239000,10000,72966
4481,100,2018-06-19,0.059734513274336286,226000,212500,-13500,88004
4482,100,2018-06-04,0.05091649694501019,245500,233000,-12500,75859
4483,100,2018-04-18,0.05555555555555555,252000,238000,-14000,123947
4484,100,2018-04-09,0.08528784648187633,234500,254500,20000,316194
4485,100,2018-03-23,0.041189931350114416,218500,209500,-9000,69588
4486,100,2018-03-20,0.042352941176470586,212500,221500,9000,36698
4487,100,2018-02-05,0.041758241758241756,227500,218000,-9500,72233
4488,100,2018-01-29,0.042986425339366516,221000,230500,9500,158000
4489,100,2017-07-28,0.06333973128598848,260500,244000,-16500,132263
4490,100,2017-04-03,0.04719101123595506,222500,233000,10500,82508
4491,100,2017-02-23,0.05476190476190476,210000,221500,11500,128490
4492,100,2017-02-15,0.06878306878306878,189000,202000,13000,162523
4493,100,2016-12-13,0.0583756345177665,197000,208500,11500,115676
4494,100,2016-11-21,0.04047619047619048,210000,201500,-8500,74315
4495,100,2016-11-10,0.06921241050119331,209500,224000,14500,96457
4496,100,2016-10-28,0.15247524752475247,252500,214000,-38500,277694
4497,100,2016-10-14,0.04007633587786259,262000,251500,-10500,52213
4498,9830,2021-04-14,0.04239917269906929,48350,50400,2050,3902161
4499,9830,2021-03-25,0.06666666666666667,45000,48000,3000,5821647
4500,9830,2021-03-12,0.05,42000,44100,2100,2172858
4501,9830,2021-02-26,0.044538706256627786,47150,45050,-2100,2395483
4502,9830,2021-02-25,0.04314159292035398,45200,47150,1950,1934318
4503,9830,2021-02-05,0.07114624505928854,50600,54200,3600,4396197
4504,9830,2021-01-28,0.04981549815498155,54200,51500,-2700,2426414
4505,9830,2021-01-19,0.06358381502890173,51900,55200,3300,2844189
4506,9830,2021-01-12,0.05457746478873239,56800,53700,-3100,5750071
4507,9830,2021-01-07,0.041353383458646614,53200,55400,2200,9056721
4508,9830,2021-01-05,0.09552845528455285,49200,53900,4700,14113184
4509,9830,2020-12-29,0.05438401775804662,45050,47500,2450,6843784
4510,9830,2020-12-16,0.06725468577728776,45350,48400,3050,8267648
4511,9830,2020-11-11,0.05115830115830116,51800,49150,-2650,7737530
4512,9830,2020-11-09,0.08977035490605428,47900,52200,4300,15888865
4513,9830,2020-11-05,0.12295081967213115,42700,47950,5250,19428105
4514,9830,2020-11-04,0.08858057630736393,46850,42700,-4150,16978851
4515,9830,2020-11-02,0.06979405034324943,43700,46750,3050,5601799
4516,9830,2020-10-30,0.04271631982475356,45650,43700,-1950,4600153
4517,9830,2020-10-28,0.04190260475651189,44150,46000,1850,4956972
4518,9830,2020-10-27,0.048693586698337295,42100,44150,2050,5211897
4519,9830,2020-10-26,0.05393258426966292,44500,42100,-2400,3406654
4520,9830,2020-10-22,0.06,47500,44650,-2850,5287965
4521,9830,2020-10-21,0.09953703703703703,43200,47500,4300,9053186
4522,9830,2020-10-16,0.04202586206896552,46400,44450,-1950,4980817
4523,9830,2020-10-08,0.0952914798206278,44600,48850,4250,13729142
4524,9830,2020-10-07,0.054373522458628844,42300,44600,2300,6719948
4525,9830,2020-10-05,0.09622886866059818,38450,42150,3700,8537654
4526,9830,2020-09-28,0.08819345661450925,35150,38250,3100,6826054
4527,9830,2020-09-25,0.05256064690026954,37100,35150,-1950,6251598
4528,9830,2020-09-21,0.07403055229142186,42550,39400,-3150,7903616
4529,9830,2020-09-11,0.05888324873096447,49250,46350,-2900,8204101
4530,9830,2020-09-09,0.05417118093174431,46150,48650,2500,14657670
4531,9830,2020-09-08,0.059123343527013254,49050,46150,-2900,8641722
4532,9830,2020-09-04,0.061269146608315096,45700,48500,2800,23454822
4533,9830,2020-09-03,0.1554993678887484,39550,45700,6150,22636230
4534,9830,2020-08-31,0.06108897742363878,37650,39950,2300,6128511
4535,9830,2020-08-28,0.0502092050209205,35850,37650,1800,5049845
4536,9830,2020-08-25,0.11514195583596215,31700,35350,3650,8467820
4537,9830,2020-08-20,0.05443234836702955,32150,30400,-1750,4915229
4538,9830,2020-08-05,0.0625,27200,28900,1700,4866007
4539,9830,2020-08-04,0.05222437137330754,25850,27200,1350,6901336
4540,9830,2020-07-21,0.060665362035225046,25550,27100,1550,8478952
4541,9830,2020-07-20,0.06903765690376569,23900,25550,1650,5258251
4542,9830,2020-07-15,0.05263157894736842,22800,24000,1200,4409705
4543,9830,2020-07-14,0.06172839506172839,24300,22800,-1500,7112510
4544,9830,2020-07-13,0.0752212389380531,22600,24300,1700,7247577
4545,9830,2020-07-09,0.1225,20000,22450,2450,14229896
4546,9830,2020-06-26,0.04221635883905013,18950,19750,800,2034552
4547,9830,2020-06-23,0.0427807486631016,18700,19500,800,5042231
4548,9830,2020-06-16,0.10144927536231885,17250,19000,1750,3885617
4549,9830,2020-06-15,0.06756756756756757,18500,17250,-1250,3493372
4550,9830,2020-06-09,0.06686046511627906,17200,18350,1150,10652835
4551,9830,2020-06-01,0.04024767801857585,16150,16800,650,1397120
4552,9830,2020-05-26,0.055900621118012424,16100,17000,900,2319656
4553,9830,2020-05-21,0.047619047619047616,15750,16500,750,4338602
4554,9830,2020-05-19,0.06060606060606061,14850,15750,900,1987485
4555,9830,2020-05-12,0.04013377926421405,14950,15550,600,7961875
4556,9830,2020-05-11,0.045454545454545456,14300,14950,650,7973700
4557,9830,2020-05-04,0.05154639175257732,14550,13800,-750,1355893
4558,9830,2020-04-17,0.051094890510948905,13700,14400,700,1425705
4559,9830,2020-04-10,0.048327137546468404,13450,14100,650,1957413
4560,9830,2020-04-01,0.048507462686567165,13400,12750,-650,1139918
4561,9830,2020-03-25,0.18840579710144928,10350,12300,1950,2653737
4562,9830,2020-03-24,0.09989373007438895,9410,10350,940,1439012
4563,9830,2020-03-23,0.10380952380952381,10500,9410,-1090,1982452
4564,9830,2020-03-20,0.10526315789473684,9500,10500,1000,2408986
4565,9830,2020-03-19,0.18803418803418803,11700,9500,-2200,3460681
4566,9830,2020-03-18,0.1,13000,11700,-1300,1453345
4567,9830,2020-03-13,0.0958904109589041,14600,13200,-1400,3519200
4568,9830,2020-03-12,0.10153846153846154,16250,14600,-1650,2360786
4569,9830,2020-03-09,0.10164835164835165,18200,16350,-1850,2107166
4570,9830,2020-02-28,0.05053191489361702,18800,17850,-950,1402829
4571,9830,2020-02-24,0.059113300492610835,20300,19100,-1200,1594503
4572,9830,2020-02-20,0.04774535809018567,18850,19750,900,2917067
4573,9830,2020-02-06,0.07848837209302326,17200,18550,1350,1491394
4574,9830,2020-01-28,0.07049608355091384,19150,17800,-1350,1259404
4575,9830,2020-01-09,0.07317073170731707,18450,19800,1350,1562109
4576,9830,2020-01-08,0.04155844155844156,19250,18450,-800,1216990
4577,9830,2019-11-13,0.07848837209302326,17200,18550,1350,4074829
4578,9830,2019-10-30,0.04154302670623145,16850,16150,-700,1642337
4579,9830,2019-08-16,0.04046242774566474,17300,16600,-700,862261
4580,9830,2019-08-07,0.055401662049861494,18050,17050,-1000,1032635
4581,9830,2019-06-19,0.08674698795180723,20750,22550,1800,2999747
4582,9830,2019-05-22,0.04047619047619048,21000,21850,850,996198
4583,9830,2019-05-15,0.05392156862745098,20400,21500,1100,949537
4584,9830,2019-04-29,0.04738154613466334,20050,21000,950,676153
4585,9830,2019-04-18,0.0420353982300885,22600,21650,-950,863641
4586,9830,2019-04-01,0.04066985645933014,20900,21750,850,800513
4587,9830,2019-02-20,0.06422018348623854,21800,23200,1400,3490382
4588,9830,2019-01-11,0.0594059405940594,20200,21400,1200,2176714
4589,9830,2019-01-09,0.041237113402061855,19400,20200,800,770974
4590,9830,2019-01-03,0.04040404040404041,19800,19000,-800,1282979
4591,9830,2018-12-06,0.0481283422459893,18700,19600,900,3177446
4592,9830,2018-11-13,0.062146892655367235,17700,16600,-1100,2628573
4593,9830,2018-11-02,0.10091743119266056,16350,18000,1650,2459409
4594,9830,2018-10-31,0.041935483870967745,15500,16150,650,1160264
4595,9830,2018-10-29,0.08108108108108109,16650,15300,-1350,2333283
4596,9830,2018-10-26,0.040345821325648415,17350,16650,-700,912288
4597,9830,2018-10-22,0.042042042042042045,16650,17350,700,839896
4598,9830,2018-10-11,0.06685236768802229,17950,16750,-1200,1650365
4599,9830,2018-10-10,0.04774535809018567,18850,17950,-900,1547807
4600,9830,2018-09-11,0.04810126582278481,19750,18800,-950,3066919
4601,9830,2018-08-29,0.05970149253731343,20100,21300,1200,3037760
4602,9830,2018-08-03,0.055825242718446605,20600,21750,1150,1791916
4603,9830,2018-07-27,0.04411764705882353,20400,21300,900,1221621
4604,9830,2018-07-02,0.057208237986270026,21850,20600,-1250,1248493
4605,9830,2018-06-27,0.05077262693156733,22650,21500,-1150,1438092
4606,9830,2018-06-19,0.060669456066945605,23900,22450,-1450,2496210
4607,9830,2018-06-14,0.0410958904109589,25550,24500,-1050,1395185
4608,9830,2018-05-10,0.05454545454545454,27500,29000,1500,1273757
4609,9830,2018-04-05,0.050699300699300696,28600,30050,1450,924809
4610,9830,2018-03-22,0.04088586030664395,29350,30550,1200,1108297
4611,9830,2018-03-05,0.043478260869565216,32200,30800,-1400,1293571
4612,9830,2018-02-23,0.043209876543209874,32400,33800,1400,1365757
4613,9830,2018-02-19,0.040310077519379844,32250,33550,1300,731692
4614,9830,2018-01-15,0.05683563748079877,32550,34400,1850,2349331
4615,9830,2017-12-28,0.04118616144975288,30350,31600,1250,1202174
4616,9830,2017-12-11,0.046822742474916385,29900,31300,1400,1420901
4617,9830,2017-12-04,0.04671280276816609,28900,30250,1350,1006704
4618,9830,2017-11-16,0.049403747870528106,29350,30800,1450,1178656
4619,9830,2017-10-30,0.0440251572327044,31800,30400,-1400,2251692
4620,9830,2017-09-25,0.09269662921348315,35600,32300,-3300,3879110
4621,9830,2017-08-14,0.05341246290801187,33700,35500,1800,2673780
4622,9830,2017-07-31,0.040123456790123455,32400,33700,1300,1369363
4623,9830,2017-06-20,0.06379310344827586,29000,30850,1850,4455044
4624,9830,2017-05-11,0.04230769230769231,26000,27100,1100,3250927
4625,9830,2017-03-28,0.06557377049180328,24400,26000,1600,3226519
4626,9830,2017-01-31,0.04220183486238532,27250,26100,-1150,1280466
4627,9830,2017-01-17,0.06130268199233716,26100,27700,1600,3234686
4628,9830,2016-12-06,0.04468085106382979,23500,24550,1050,1467833
4629,9830,2016-11-11,0.043824701195219126,25100,24000,-1100,2322179
4630,9830,2016-11-09,0.12142857142857143,28000,24600,-3400,7755672
4631,9830,2016-11-07,0.05758157389635317,26050,27550,1500,1604588
4632,9830,2016-10-14,0.047151277013752456,25450,26650,1200,1948563
4633,36460,2021-05-03,0.06876790830945559,34900,32500,-2400,1398615
4634,36460,2021-04-29,0.043348281016442454,33450,34900,1450,1387063
4635,36460,2021-02-08,0.053125,32000,33700,1700,720646
4636,36460,2021-01-29,0.04024767801857585,32300,31000,-1300,645236
4637,36460,2021-01-28,0.04437869822485207,33800,32300,-1500,785981
4638,36460,2021-01-14,0.0629800307219662,32550,34600,2050,1723659
4639,36460,2021-01-12,0.05654281098546042,30950,32700,1750,2376805
4640,36460,2020-12-11,0.05281090289608177,29350,30900,1550,1314524
4641,36460,2020-11-10,0.0547945205479452,29200,30800,1600,912825
4642,36460,2020-11-05,0.07481751824817519,27400,29450,2050,1016864
4643,36460,2020-10-26,0.05778491171749599,31150,29350,-1800,932391
4644,36460,2020-10-21,0.08166666666666667,30000,32450,2450,1943334
4645,36460,2020-10-20,0.046104928457869634,31450,30000,-1450,1175583
4646,36460,2020-10-19,0.06972789115646258,29400,31450,2050,2582882
4647,36460,2020-10-16,0.08888888888888889,27000,29400,2400,3010505
4648,36460,2020-10-15,0.07569721115537849,25100,27000,1900,1029107
4649,36460,2020-10-05,0.04259634888438134,24650,25700,1050,417112
4650,36460,2020-09-16,0.04384133611691023,23950,25000,1050,832021
4651,36460,2020-08-20,0.04435483870967742,24800,23700,-1100,422064
4652,36460,2020-08-18,0.062381852551984876,26450,24800,-1650,530953
4653,36460,2020-08-11,0.04048582995951417,24700,25700,1000,480550
4654,36460,2020-06-16,0.10721247563352826,25650,28400,2750,489187
4655,36460,2020-06-15,0.07567567567567568,27750,25650,-2100,489953
4656,36460,2020-06-12,0.05128205128205128,29250,27750,-1500,520910
4657,36460,2020-04-13,0.05719921104536489,25350,26800,1450,811153
4658,36460,2020-04-06,0.05656108597285068,22100,23350,1250,397145
4659,36460,2020-03-25,0.06201550387596899,19350,20550,1200,577543
4660,36460,2020-03-24,0.05737704918032787,18300,19350,1050,426787
4661,36460,2020-03-23,0.05426356589147287,19350,18300,-1050,447626
4662,36460,2020-03-20,0.16566265060240964,16600,19350,2750,603641
4663,36460,2020-03-19,0.08539944903581267,18150,16600,-1550,664690
4664,36460,2020-03-18,0.08564231738035265,19850,18150,-1700,455853
4665,36460,2020-03-17,0.05924170616113744,21100,19850,-1250,579279
4666,36460,2020-03-13,0.0880503144654088,23850,21750,-2100,775512
4667,36460,2020-03-12,0.05168986083499006,25150,23850,-1300,615505
4668,36460,2020-03-09,0.044444444444444446,27000,25800,-1200,400724
4669,36460,2020-01-28,0.05007153075822604,34950,33200,-1750,459159
4670,36460,2020-01-08,0.040983606557377046,36600,35100,-1500,415248
4671,36460,2019-05-14,0.04140526976160602,39850,41500,1650,390552
4672,36460,2019-05-02,0.06933911159263272,46150,42950,-3200,1635597
4673,36460,2019-04-03,0.047058823529411764,46750,48950,2200,540088
4674,36460,2019-04-01,0.045454545454545456,45100,47150,2050,317621
4675,36460,2019-02-28,0.04752851711026616,52600,50100,-2500,366351
4676,36460,2019-01-11,0.048,50000,52400,2400,256739
4677,36460,2018-12-19,0.0517578125,51200,48550,-2650,529428
4678,36460,2018-12-10,0.04330708661417323,50800,53000,2200,239151
4679,36460,2018-11-14,0.05758157389635317,52100,49100,-3000,608420
4680,36460,2018-10-26,0.054844606946983544,54700,51700,-3000,200765
4681,36460,2018-09-27,0.04258943781942078,58700,61200,2500,462806
4682,36460,2018-08-06,0.05217391304347826,57500,54500,-3000,528215
4683,36460,2018-07-06,0.04912280701754386,57000,59800,2800,349950
4684,36460,2018-07-04,0.0451505016722408,59800,57100,-2700,436323
4685,36460,2018-07-02,0.06386292834890965,64200,60100,-4100,352264
4686,36460,2018-06-25,0.04538087520259319,61700,64500,2800,387818
4687,36460,2018-06-21,0.04430379746835443,63200,60400,-2800,281398
4688,36460,2018-06-15,0.054365733113673806,60700,64000,3300,519189
4689,36460,2018-06-14,0.0515625,64000,60700,-3300,665509
4690,36460,2018-05-25,0.05967741935483871,62000,58300,-3700,644695
4691,36460,2018-05-14,0.06028368794326241,56400,59800,3400,776472
4692,36460,2018-05-10,0.040968342644320296,53700,55900,2200,446426
4693,36460,2018-05-03,0.06357388316151202,58200,54500,-3700,496268
4694,36460,2018-05-02,0.06204379562043796,54800,58200,3400,973608
4695,36460,2018-04-23,0.056,50000,52800,2800,514427
4696,36460,2018-03-26,0.04472843450479233,46950,49050,2100,298771
4697,36460,2018-03-12,0.04338624338624339,47250,49300,2050,311788
4698,36460,2018-03-02,0.06318082788671024,45900,48800,2900,496042
4699,36460,2018-02-19,0.060879368658399095,44350,47050,2700,255282
4700,36460,2018-01-24,0.04073319755600815,49100,51100,2000,762019
4701,36460,2018-01-12,0.07270693512304251,44700,47950,3250,1038998
4702,36460,2018-01-02,0.04230317273795535,42550,44350,1800,327142
4703,36460,2017-12-15,0.04216867469879518,41500,43250,1750,309394
4704,36460,2017-11-14,0.07775119617224881,41800,45050,3250,927132
4705,36460,2017-08-11,0.04411764705882353,51000,48750,-2250,381784
4706,36460,2017-05-16,0.06269270298047276,48650,51700,3050,928708
4707,36460,2017-05-12,0.04068522483940043,46700,48600,1900,512385
4708,36460,2017-03-21,0.04153354632587859,46950,45000,-1950,561582
4709,36460,2016-12-01,0.045507584597432905,42850,44800,1950,467125
4710,36460,2016-11-22,0.04195804195804196,42900,44700,1800,297492
4711,161390,2021-05-06,0.0502092050209205,47800,50200,2400,358302
4712,161390,2021-04-28,0.048598130841121495,53500,50900,-2600,261440
4713,161390,2021-04-23,0.05198776758409786,49050,51600,2550,304626
4714,161390,2021-03-30,0.05573770491803279,45750,48300,2550,670200
4715,161390,2021-03-04,0.04572564612326044,50300,48000,-2300,377888
4716,161390,2021-03-03,0.049009384775808136,47950,50300,2350,419759
4717,161390,2021-02-26,0.06200787401574803,50800,47650,-3150,701905
4718,161390,2021-02-25,0.051759834368530024,48300,50800,2500,346426
4719,161390,2021-02-24,0.0547945205479452,51100,48300,-2800,541729
4720,161390,2021-02-19,0.04383282364933741,49050,51200,2150,476622
4721,161390,2021-02-08,0.10876803551609324,45050,49950,4900,1592149
4722,161390,2021-02-01,0.06804374240583232,41150,43950,2800,336259
4723,161390,2021-01-29,0.06050228310502283,43800,41150,-2650,539122
4724,161390,2021-01-28,0.05907626208378088,46550,43800,-2750,418934
4725,161390,2021-01-27,0.05915813424345848,43950,46550,2600,521883
4726,161390,2021-01-21,0.06398104265402843,42200,44900,2700,801204
4727,161390,2021-01-04,0.050761421319796954,39400,37400,-2000,1309364
4728,161390,2020-12-15,0.049136786188579015,37650,39500,1850,576734
4729,161390,2020-12-14,0.04804045512010114,39550,37650,-1900,346810
4730,161390,2020-12-09,0.07343124165554073,37450,40200,2750,843254
4731,161390,2020-12-03,0.05374823196605375,35350,37250,1900,651094
4732,161390,2020-12-01,0.05045871559633028,32700,34350,1650,304787
4733,161390,2020-11-30,0.04941860465116279,34400,32700,-1700,849581
4734,161390,2020-11-19,0.05740181268882175,33100,35000,1900,1259043
4735,161390,2020-11-03,0.04704097116843703,32950,31400,-1550,994258
4736,161390,2020-11-02,0.04107424960505529,31650,32950,1300,331176
4737,161390,2020-10-30,0.04090909090909091,33000,31650,-1350,440339
4738,161390,2020-09-22,0.0524822695035461,35250,33400,-1850,743130
4739,161390,2020-09-14,0.07754442649434572,30950,33350,2400,1202176
4740,161390,2020-08-26,0.04120443740095087,31550,30250,-1300,1245957
4741,161390,2020-08-25,0.09739130434782609,28750,31550,2800,4053153
4742,161390,2020-08-20,0.05392156862745098,30600,28950,-1650,523223
4743,161390,2020-08-19,0.09063893016344725,33650,30600,-3050,861264
4744,161390,2020-08-13,0.04251968503937008,31750,33100,1350,711305
4745,161390,2020-08-12,0.04612850082372323,30350,31750,1400,919613
4746,161390,2020-08-05,0.054844606946983544,27350,28850,1500,2584513
4747,161390,2020-08-04,0.08102766798418973,25300,27350,2050,1372907
4748,161390,2020-07-31,0.06630824372759857,27900,26050,-1850,1919269
4749,161390,2020-07-30,0.08771929824561403,25650,27900,2250,3301642
4750,161390,2020-07-10,0.04198473282442748,26200,25100,-1100,385925
4751,161390,2020-07-06,0.11646586345381527,24900,27800,2900,1386027
4752,161390,2020-07-02,0.045454545454545456,24200,25300,1100,498348
4753,161390,2020-06-30,0.042283298097251586,23650,24650,1000,2741159
4754,161390,2020-06-25,0.043478260869565216,25300,24200,-1100,324768
4755,161390,2020-06-17,0.05930470347648262,24450,25900,1450,761681
4756,161390,2020-06-16,0.08666666666666667,22500,24450,1950,324514
4757,161390,2020-06-15,0.048625792811839326,23650,22500,-1150,412333
4758,161390,2020-06-12,0.054,25000,23650,-1350,433550
4759,161390,2020-06-03,0.04276985743380855,24550,25600,1050,643672
4760,161390,2020-06-01,0.04477611940298507,23450,24500,1050,453634
4761,161390,2020-05-28,0.052313883299798795,24850,23550,-1300,463659
4762,161390,2020-05-26,0.05161290322580645,23250,24450,1200,721607
4763,161390,2020-05-19,0.06280193236714976,20700,22000,1300,989124
4764,161390,2020-05-11,0.04241071428571429,22400,21450,-950,461971
4765,161390,2020-05-08,0.0821256038647343,20700,22400,1700,1640497
4766,161390,2020-04-16,0.04398148148148148,21600,20650,-950,733615
4767,161390,2020-04-13,0.04888888888888889,22500,21400,-1100,426719
4768,161390,2020-04-06,0.04834605597964377,19650,20600,950,600041
4769,161390,2020-04-02,0.042666666666666665,18750,19550,800,551818
4770,161390,2020-03-31,0.06027397260273973,18250,19350,1100,702431
4771,161390,2020-03-27,0.04857142857142857,17500,18350,850,1333233
4772,161390,2020-03-26,0.05405405405405406,18500,17500,-1000,1431919
4773,161390,2020-03-25,0.08504398826979472,17050,18500,1450,657643
4774,161390,2020-03-24,0.09294871794871795,15600,17050,1450,453113
4775,161390,2020-03-23,0.07142857142857142,16800,15600,-1200,760492
4776,161390,2020-03-19,0.12234042553191489,18800,16500,-2300,701053
4777,161390,2020-03-18,0.06699751861042183,20150,18800,-1350,558474
4778,161390,2020-03-13,0.058165548098434,22350,21050,-1300,1146113
4779,161390,2020-03-12,0.05894736842105263,23750,22350,-1400,750172
4780,161390,2020-03-10,0.04665314401622718,24650,23500,-1150,712545
4781,161390,2020-02-14,0.048109965635738834,29100,27700,-1400,957658
4782,161390,2020-01-28,0.05519480519480519,30800,29100,-1700,312082
4783,161390,2019-11-12,0.04252199413489736,34100,35550,1450,343838
4784,161390,2019-11-05,0.08801213960546282,32950,35850,2900,1050396
4785,161390,2019-11-04,0.04107424960505529,31650,32950,1300,244761
4786,161390,2019-10-02,0.04229607250755287,33100,31700,-1400,558535
4787,161390,2019-09-24,0.053833605220228384,30650,32300,1650,455512
4788,161390,2019-09-11,0.051194539249146756,29300,30800,1500,671332
4789,161390,2019-05-07,0.04140526976160602,39850,38200,-1650,453891
4790,161390,2019-03-25,0.041212121212121214,41250,39550,-1700,330406
4791,161390,2019-02-13,0.0524390243902439,41000,43150,2150,373713
4792,161390,2019-01-30,0.04819277108433735,41500,43500,2000,394323
4793,161390,2019-01-17,0.04415584415584416,38500,40200,1700,542448
4794,161390,2019-01-08,0.06540880503144654,39750,37150,-2600,761130
4795,161390,2018-11-01,0.051932367149758456,41400,39250,-2150,494259
4796,161390,2018-10-30,0.07183580387685291,43850,40700,-3150,710501
4797,161390,2018-10-11,0.04201680672268908,47600,45600,-2000,438856
4798,161390,2018-09-19,0.051336898395721926,46750,49150,2400,821937
4799,161390,2018-06-27,0.043429844097995544,44900,42950,-1950,235908
4800,161390,2018-05-30,0.056291390728476824,45300,42750,-2550,718190
4801,161390,2018-04-30,0.044350580781414996,47350,49450,2100,656450
4802,161390,2018-04-19,0.043222003929273084,50900,48700,-2200,521052
4803,161390,2018-02-23,0.04262877442273535,56300,58700,2400,459323
4804,161390,2018-02-21,0.05555555555555555,54000,57000,3000,517278
4805,161390,2018-02-12,0.0498220640569395,56200,53400,-2800,515319
4806,161390,2018-02-09,0.05046728971962617,53500,56200,2700,665702
4807,161390,2017-07-31,0.058734939759036146,66400,62500,-3900,421604
4808,161390,2017-06-22,0.04231974921630094,63800,66500,2700,294241
4809,161390,2017-04-20,0.04262877442273535,56300,58700,2400,357766
4810,161390,2017-04-12,0.06578947368421052,53200,56700,3500,485763
4811,161390,2017-02-14,0.050522648083623695,57400,60300,2900,740072
4812,161390,2017-02-06,0.04923599320882852,58900,56000,-2900,692538
4813,161390,2017-02-01,0.045936395759717315,56600,59200,2600,612101
4814,161390,2017-01-10,0.06386554621848739,59500,63300,3800,394010
4815,161390,2016-12-08,0.05185185185185185,54000,56800,2800,306282
4816,161390,2016-10-13,0.046052631578947366,60800,58000,-2800,397333
4817,161390,2016-09-29,0.04588607594936709,63200,60300,-2900,305883
4818,161390,2016-09-07,0.04225352112676056,56800,59200,2400,368563
4819,161390,2016-08-17,0.06796116504854369,51500,55000,3500,784077
4820,6260,2021-06-02,0.046176046176046176,69300,72500,3200,371514
4821,6260,2021-05-06,0.0460431654676259,69500,72700,3200,277734
4822,6260,2021-05-03,0.05184174624829468,73300,69500,-3800,364069
4823,6260,2021-03-29,0.04393939393939394,66000,68900,2900,370721
4824,6260,2021-03-12,0.04595879556259905,63100,66000,2900,233840
4825,6260,2021-02-24,0.05503355704697987,74500,70400,-4100,397159
4826,6260,2021-02-22,0.05857142857142857,70000,74100,4100,713389
4827,6260,2021-01-28,0.048295454545454544,70400,67000,-3400,362659
4828,6260,2021-01-26,0.04716981132075472,74200,70700,-3500,476498
4829,6260,2021-01-21,0.0411522633744856,72900,75900,3000,634835
4830,6260,2021-01-11,0.048407643312101914,78500,74700,-3800,495757
4831,6260,2021-01-07,0.06666666666666667,73500,78400,4900,595599
4832,6260,2021-01-05,0.04827586206896552,72500,76000,3500,488812
4833,6260,2020-12-16,0.049575070821529746,70600,74100,3500,536708
4834,6260,2020-12-09,0.043478260869565216,64400,67200,2800,300976
4835,6260,2020-12-01,0.07436708860759493,63200,67900,4700,656579
4836,6260,2020-11-23,0.05351170568561873,59800,63000,3200,589951
4837,6260,2020-11-09,0.06810035842293907,55800,59600,3800,583900
4838,6260,2020-11-05,0.0745697896749522,52300,56200,3900,313027
4839,6260,2020-11-04,0.054249547920433995,55300,52300,-3000,376897
4840,6260,2020-10-26,0.04553415061295972,57100,54500,-2600,288709
4841,6260,2020-10-21,0.04838709677419355,55800,58500,2700,306430
4842,6260,2020-10-14,0.047619047619047616,60900,58000,-2900,252684
4843,6260,2020-10-05,0.0761904761904762,52500,56500,4000,295397
4844,6260,2020-09-22,0.044642857142857144,56000,53500,-2500,378464
4845,6260,2020-09-21,0.05405405405405406,59200,56000,-3200,365509
4846,6260,2020-09-17,0.04111842105263158,60800,58300,-2500,409735
4847,6260,2020-09-16,0.06027820710973725,64700,60800,-3900,432162
4848,6260,2020-09-15,0.060655737704918035,61000,64700,3700,529506
4849,6260,2020-09-08,0.09090909090909091,63800,58000,-5800,1101049
4850,6260,2020-09-07,0.07952622673434856,59100,63800,4700,2386209
4851,6260,2020-09-04,0.1831831831831832,49950,59100,9150,1724735
4852,6260,2020-09-03,0.07419354838709677,46500,49950,3450,789484
4853,6260,2020-08-31,0.06973995271867613,42300,45250,2950,858141
4854,6260,2020-08-28,0.04315659679408138,40550,42300,1750,329038
4855,6260,2020-08-25,0.041719342604298354,39550,41200,1650,134798
4856,6260,2020-08-20,0.06738868832731648,41550,38750,-2800,245825
4857,6260,2020-08-18,0.05306603773584906,42400,40150,-2250,194971
4858,6260,2020-07-22,0.09168704156479218,40900,44650,3750,691010
4859,6260,2020-07-20,0.0457516339869281,38250,40000,1750,214789
4860,6260,2020-07-15,0.04526748971193416,36450,38100,1650,220393
4861,6260,2020-07-02,0.05057803468208093,34600,36350,1750,108441
4862,6260,2020-06-16,0.05367231638418079,35400,37300,1900,132135
4863,6260,2020-06-15,0.06472919418758256,37850,35400,-2450,159123
4864,6260,2020-06-03,0.046153846153846156,39000,40800,1800,268283
4865,6260,2020-05-18,0.042335766423357665,34250,35700,1450,135076
4866,6260,2020-05-04,0.05976095617529881,37650,35400,-2250,192945
4867,6260,2020-04-13,0.05128205128205128,35100,33300,-1800,141732
4868,6260,2020-04-02,0.041736227045075125,29950,31200,1250,184046
4869,6260,2020-03-25,0.07722772277227723,25250,27200,1950,344906
4870,6260,2020-03-24,0.04771784232365145,24100,25250,1150,291793
4871,6260,2020-03-23,0.10074626865671642,26800,24100,-2700,264233
4872,6260,2020-03-19,0.08843537414965986,29400,26800,-2600,233144
4873,6260,2020-03-13,0.05443234836702955,32150,30400,-1750,272805
4874,6260,2020-03-12,0.05856515373352855,34150,32150,-2000,219119
4875,6260,2020-03-05,0.052486187845303865,36200,38100,1900,145326
4876,6260,2020-02-28,0.041223404255319146,37600,36050,-1550,138678
4877,6260,2020-02-06,0.046894803548795945,39450,41300,1850,103940
4878,6260,2020-01-28,0.04228571428571429,43750,41900,-1850,122097
4879,6260,2019-10-30,0.045,50000,47750,-2250,137088
4880,6260,2019-08-19,0.05172413793103448,40600,42700,2100,84810
4881,6260,2019-08-05,0.05855338691159587,43550,41000,-2550,170201
4882,6260,2019-07-11,0.042826552462526764,46700,48700,2000,113901
4883,6260,2019-07-01,0.04421052631578947,47500,49600,2100,168404
4884,6260,2019-04-24,0.045714285714285714,52500,50100,-2400,264710
4885,6260,2019-04-01,0.045889101338432124,52300,54700,2400,153412
4886,6260,2019-02-20,0.055357142857142855,56000,59100,3100,380156
4887,6260,2019-01-15,0.04247104247104247,51800,54000,2200,110636
4888,6260,2019-01-09,0.07946336429308566,48450,52300,3850,214645
4889,6260,2018-12-03,0.06981132075471698,53000,56700,3700,205305
4890,6260,2018-11-07,0.06502636203866433,56900,53200,-3700,221918
4891,6260,2018-11-02,0.10433070866141732,50800,56100,5300,230683
4892,6260,2018-10-11,0.041666666666666664,64800,62100,-2700,95766
4893,6260,2018-09-13,0.076103500761035,65700,70700,5000,240751
4894,6260,2018-08-13,0.05785123966942149,72600,68400,-4200,88858
4895,6260,2018-07-25,0.05647382920110193,72600,76700,4100,151322
4896,6260,2018-07-09,0.0749665327978581,74700,69100,-5600,209425
4897,6260,2018-07-02,0.04666666666666667,75000,71500,-3500,103054
4898,6260,2018-06-21,0.05739795918367347,78400,73900,-4500,290075
4899,6260,2018-06-18,0.041666666666666664,84000,80500,-3500,123301
4900,6260,2018-06-11,0.05507955936352509,81700,86200,4500,145093
4901,6260,2018-05-29,0.042175360710321866,90100,86300,-3800,126101
4902,6260,2018-05-28,0.07775119617224881,83600,90100,6500,213919
4903,6260,2018-05-10,0.04731457800511509,78200,81900,3700,159812
4904,6260,2018-04-30,0.04986522911051213,74200,77900,3700,250729
4905,6260,2018-04-18,0.0638930163447251,67300,71600,4300,215129
4906,6260,2018-04-04,0.04667609618104668,70700,67400,-3300,178174
4907,6260,2018-04-02,0.040268456375838924,74500,71500,-3000,109216
4908,6260,2018-03-12,0.04973118279569892,74400,78100,3700,125528
4909,6260,2018-03-09,0.05222929936305733,78500,74400,-4100,240013
4910,6260,2018-03-08,0.04111405835543767,75400,78500,3100,225427
4911,6260,2018-03-07,0.0443213296398892,72200,75400,3200,193827
4912,6260,2018-02-19,0.05131578947368421,76000,79900,3900,139251
4913,6260,2018-02-14,0.0584958217270195,71800,76000,4200,183632
4914,6260,2018-01-31,0.043583535108958835,82600,79000,-3600,302639
4915,6260,2018-01-19,0.040897097625329816,75800,78900,3100,155706
4916,6260,2017-12-27,0.04107648725212465,70600,73500,2900,219899
4917,6260,2017-12-06,0.04090267983074753,70900,68000,-2900,119747
4918,6260,2017-12-05,0.06456456456456457,66600,70900,4300,245867
4919,6260,2017-11-13,0.04302477183833116,76700,73400,-3300,185549
4920,6260,2017-10-17,0.05721393034825871,80400,85000,4600,179727
4921,6260,2017-09-08,0.0422360248447205,80500,83900,3400,109431
4922,6260,2017-09-01,0.04142011834319527,84500,81000,-3500,153192
4923,6260,2017-08-17,0.05569007263922518,82600,87200,4600,141953
4924,6260,2017-06-13,0.049723756906077346,72400,76000,3600,86356
4925,6260,2017-05-17,0.052554744525547446,68500,72100,3600,237976
4926,6260,2017-03-23,0.04227642276422764,61500,64100,2600,201206
4927,6260,2017-02-10,0.09345794392523364,64200,70200,6000,291992
4928,6260,2016-12-06,0.042071197411003236,61800,64400,2600,250653
4929,6260,2016-11-11,0.07526881720430108,55800,60000,4200,517043
4930,6260,2016-11-10,0.09197651663405088,51100,55800,4700,373234
4931,6260,2016-10-28,0.05272407732864675,56900,53900,-3000,248809
4932,6260,2016-08-16,0.0603290676416819,54700,58000,3300,345756
4933,120,2021-02-03,0.08908045977011494,174000,189500,15500,469408
4934,120,2021-01-18,0.04437869822485207,169000,161500,-7500,124302
4935,120,2021-01-05,0.050445103857566766,168500,177000,8500,275065
4936,120,2020-11-18,0.044585987261146494,157000,164000,7000,151690
4937,120,2020-11-10,0.040123456790123455,162000,155500,-6500,237909
4938,120,2020-10-22,0.05027932960893855,179000,170000,-9000,114299
4939,120,2020-09-22,0.0480225988700565,177000,168500,-8500,123811
4940,120,2020-09-16,0.09230769230769231,162500,177500,15000,514853
4941,120,2020-08-20,0.04276315789473684,152000,145500,-6500,92023
4942,120,2020-07-22,0.04024767801857585,161500,155000,-6500,91319
4943,120,2020-06-16,0.04823151125401929,155500,163000,7500,53450
4944,120,2020-05-18,0.04377104377104377,148500,155000,6500,232708
4945,120,2020-05-13,0.05319148936170213,141000,148500,7500,196654
4946,120,2020-05-04,0.04391891891891892,148000,141500,-6500,86017
4947,120,2020-04-16,0.07116104868913857,133500,143000,9500,168418
4948,120,2020-04-01,0.058823529411764705,136000,128000,-8000,72016
4949,120,2020-03-20,0.051181102362204724,127000,133500,6500,109678
4950,120,2020-03-18,0.05907172995780591,118500,125500,7000,112702
4951,120,2020-03-13,0.07575757575757576,132000,122000,-10000,145289
4952,120,2020-03-04,0.05185185185185185,135000,142000,7000,71964
4953,120,2020-01-28,0.04225352112676056,142000,136000,-6000,49609
4954,120,2019-10-18,0.0436241610738255,149000,155500,6500,193462
4955,120,2019-08-08,0.04580152671755725,131000,137000,6000,129505
4956,120,2019-06-26,0.07958477508650519,144500,133000,-11500,320260
4957,120,2019-06-25,0.05555555555555555,153000,144500,-8500,133333
4958,120,2019-05-31,0.059800664451827246,150500,159500,9000,74130
4959,120,2019-04-16,0.0453257790368272,176500,168500,-8000,192274
4960,120,2019-04-15,0.04747774480712166,168500,176500,8000,205268
4961,120,2019-02-08,0.06097560975609756,164000,174000,10000,173157
4962,120,2018-11-29,0.040268456375838924,149000,155000,6000,64216
4963,120,2018-11-12,0.04823151125401929,155500,148000,-7500,78325
4964,120,2018-10-31,0.04276315789473684,152000,158500,6500,103777
4965,120,2018-10-19,0.06229508196721312,152500,162000,9500,261489
4966,120,2018-10-12,0.05357142857142857,140000,147500,7500,118772
4967,120,2018-10-11,0.05405405405405406,148000,140000,-8000,112513
4968,120,2018-10-04,0.062111801242236024,161000,151000,-10000,133334
4969,120,2018-08-13,0.046511627906976744,150500,143500,-7000,115677
4970,120,2018-07-20,0.041935483870967745,155000,161500,6500,64697
4971,120,2018-07-19,0.0718562874251497,167000,155000,-12000,163439
4972,120,2018-06-11,0.048701298701298704,154000,161500,7500,119811
4973,120,2018-05-28,0.04318936877076412,150500,157000,6500,129638
4974,120,2018-05-16,0.04081632653061224,171500,164500,-7000,123020
4975,120,2018-05-11,0.054380664652567974,165500,174500,9000,251545
4976,120,2018-05-10,0.07467532467532467,154000,165500,11500,279750
4977,120,2018-04-13,0.06666666666666667,135000,144000,9000,247237
4978,120,2018-03-29,0.05363984674329502,130500,137500,7000,116257
4979,120,2018-03-19,0.0421455938697318,130500,136000,5500,271858
4980,120,2018-03-09,0.04918032786885246,122000,128000,6000,155426
4981,120,2017-12-20,0.04666666666666667,150000,143000,-7000,91757
4982,120,2017-08-08,0.044444444444444446,180000,172000,-8000,146438
4983,120,2017-04-21,0.059375,160000,169500,9500,107319
4984,120,2017-02-15,0.07987220447284345,156500,169000,12500,190723
4985,120,2016-08-02,0.04938271604938271,202500,212500,10000,74667
4986,5250,2021-05-24,0.06702412868632708,37300,34800,-2500,820119
4987,5250,2021-05-17,0.040983606557377046,36600,38100,1500,358664
4988,5250,2021-05-13,0.04161248374512354,38450,36850,-1600,423018
4989,5250,2021-05-10,0.06914893617021277,37600,40200,2600,796143
4990,5250,2021-04-28,0.040100250626566414,39900,38300,-1600,509219
4991,5250,2021-04-15,0.05680317040951123,37850,40000,2150,3580475
4992,5250,2021-04-12,0.04055944055944056,35750,37200,1450,667866
4993,5250,2021-04-09,0.08006042296072508,33100,35750,2650,2491582
4994,5250,2021-03-09,0.04299583911234397,36050,34500,-1550,427842
4995,5250,2021-02-25,0.05113636363636364,35200,37000,1800,344667
4996,5250,2021-02-18,0.05889423076923077,41600,39150,-2450,760858
4997,5250,2021-02-17,0.04805491990846682,43700,41600,-2100,749352
4998,5250,2021-02-16,0.04420549581839905,41850,43700,1850,3247843
4999,5250,2021-01-28,0.08469387755102041,49000,44850,-4150,912171
5000,5250,2021-01-25,0.05053763440860215,46500,48850,2350,1969766
5001,5250,2021-01-22,0.08518086347724621,42850,46500,3650,3788194
5002,5250,2021-01-18,0.07838983050847458,47200,43500,-3700,1712394
5003,5250,2021-01-15,0.0776255707762557,43800,47200,3400,8701399
5004,5250,2021-01-11,0.050314465408805034,47700,45300,-2400,1245323
5005,5250,2021-01-08,0.04120603015075377,49750,47700,-2050,2454725
5006,5250,2021-01-05,0.07555970149253731,53600,49550,-4050,6576780
5007,5250,2021-01-04,0.29156626506024097,41500,53600,12100,17193118
5008,5250,2020-12-30,0.15598885793871867,35900,41500,5600,15537860
5009,5250,2020-12-29,0.08295625942684766,33150,35900,2750,1640961
5010,5250,2020-12-23,0.047879616963064295,36550,34800,-1750,512251
5011,5250,2020-12-14,0.06060606060606061,36300,38500,2200,2194518
5012,5250,2020-12-07,0.0450070323488045,35550,37150,1600,3061192
5013,5250,2020-11-25,0.09259259259259259,40500,36750,-3750,3393194
5014,5250,2020-11-23,0.04396984924623116,39800,41550,1750,617657
5015,5250,2020-11-19,0.046875,41600,39650,-1950,791860
5016,5250,2020-11-17,0.20588235294117646,34000,41000,7000,8668179
5017,5250,2020-11-05,0.09714285714285714,35000,38400,3400,13872125
5018,5250,2020-11-04,0.2987012987012987,26950,35000,8050,13947437
5019,5250,2020-11-03,0.14437367303609341,23550,26950,3400,3429260
5020,5250,2020-11-02,0.04666666666666667,22500,23550,1050,302318
5021,5250,2020-10-23,0.04943820224719101,22250,23350,1100,1446240
5022,5250,2020-09-24,0.04893617021276596,23500,22350,-1150,169865
5023,5250,2020-09-22,0.05128205128205128,25350,24050,-1300,181572
5024,5250,2020-09-09,0.0757314974182444,29050,26850,-2200,404522
5025,5250,2020-09-08,0.08801498127340825,26700,29050,2350,1183324
5026,5250,2020-08-19,0.050816696914700546,27550,28950,1400,356605
5027,5250,2020-08-18,0.04835924006908463,28950,27550,-1400,331733
5028,5250,2020-08-06,0.0463258785942492,31300,29850,-1450,969770
5029,5250,2020-08-05,0.14652014652014653,27300,31300,4000,4322247
5030,5250,2020-07-23,0.042704626334519574,28100,26900,-1200,558024
5031,5250,2020-07-22,0.04655493482309125,26850,28100,1250,945219
5032,5250,2020-07-20,0.1012396694214876,24200,26650,2450,1746879
5033,5250,2020-07-13,0.08742004264392324,23450,25500,2050,909171
5034,5250,2020-06-16,0.06828193832599119,22700,24250,1550,174436
5035,5250,2020-06-15,0.058091286307053944,24100,22700,-1400,261090
5036,5250,2020-06-09,0.046255506607929514,22700,23750,1050,260563
5037,5250,2020-05-29,0.05934065934065934,22750,21400,-1350,157310
5038,5250,2020-05-11,0.06976744186046512,21500,23000,1500,268259
5039,5250,2020-04-08,0.06477732793522267,24700,23100,-1600,561944
5040,5250,2020-04-07,0.11512415349887133,22150,24700,2550,1813993
5041,5250,2020-04-02,0.05238095238095238,21000,22100,1100,585409
5042,5250,2020-04-01,0.05263157894736842,19950,21000,1050,1011400
5043,5250,2020-03-31,0.07547169811320754,18550,19950,1400,389164
5044,5250,2020-03-30,0.04507042253521127,17750,18550,800,359972
5045,5250,2020-03-24,0.04416403785488959,15850,16550,700,92592
5046,5250,2020-03-23,0.09428571428571429,17500,15850,-1650,100497
5047,5250,2020-03-20,0.174496644295302,14900,17500,2600,105034
5048,5250,2020-03-19,0.10778443113772455,16700,14900,-1800,175614
5049,5250,2020-03-12,0.04201680672268908,17850,17100,-750,165373
5050,5250,2020-02-24,0.04838709677419355,18600,17700,-900,69271
5051,5250,2020-01-08,0.050808314087759814,21650,20550,-1100,69893
5052,5250,2019-12-26,0.047058823529411764,21250,22250,1000,60278
5053,5250,2019-10-31,0.04,20000,20800,800,135332
5054,5250,2019-09-17,0.07633587786259542,19650,21150,1500,129173
5055,5250,2019-08-16,0.0431266846361186,18550,17750,-800,55903
5056,5250,2019-08-05,0.05454545454545454,19250,18200,-1050,66403
5057,5250,2019-07-29,0.05121951219512195,20500,19450,-1050,70090
5058,5250,2019-07-25,0.060810810810810814,22200,20850,-1350,103301
5059,5250,2019-07-19,0.05581395348837209,21500,22700,1200,59111
5060,5250,2019-07-11,0.0502283105022831,21900,23000,1100,66653
5061,5250,2019-05-09,0.04042553191489362,23500,22550,-950,64374
5062,5250,2019-04-03,0.04338842975206612,24200,25250,1050,49496
5063,5250,2019-02-13,0.041916167664670656,25050,26100,1050,111566
5064,5250,2019-02-11,0.06041666666666667,24000,25450,1450,174386
5065,5250,2018-11-06,0.06318082788671024,22950,24400,1450,135209
5066,5250,2018-11-02,0.06511627906976744,21500,22900,1400,72316
5067,5250,2018-10-31,0.04597701149425287,21750,20750,-1000,129602
5068,5250,2018-10-11,0.06387225548902195,25050,23450,-1600,195712
5069,5250,2018-10-02,0.04895104895104895,28600,27200,-1400,144190
5070,5250,2018-09-27,0.05778491171749599,31150,29350,-1800,387140
5071,5250,2018-08-20,0.07854984894259819,33100,30500,-2600,344285
5072,5250,2018-08-17,0.06946688206785137,30950,33100,2150,1005875
5073,5250,2018-07-13,0.054313099041533544,31300,33000,1700,47829
5074,5250,2018-06-19,0.08969210174029452,37350,34000,-3350,116563
5075,5250,2018-04-18,0.04744525547445255,41100,39150,-1950,74079
5076,5250,2018-03-23,0.04315659679408138,40550,38800,-1750,80775
5077,5250,2018-02-23,0.04015056461731493,39850,41450,1600,80920
5078,5250,2018-02-05,0.04192355117139334,40550,38850,-1700,89219
5079,5250,2018-01-04,0.05398457583547558,38900,36800,-2100,117485
5080,5250,2017-12-13,0.04155495978552279,37300,38850,1550,108774
5081,5250,2017-12-11,0.04735376044568245,35900,37600,1700,49394
5082,5250,2017-11-22,0.04600484261501211,41300,39400,-1900,245337
5083,5250,2017-11-15,0.041719342604298354,39550,41200,1650,394770
5084,5250,2017-10-16,0.053367217280813214,39350,37250,-2100,233194
5085,5250,2017-09-26,0.056338028169014086,35500,37500,2000,197262
5086,5250,2017-09-20,0.08050847457627118,35400,38250,2850,531847
5087,5250,2017-09-14,0.04154727793696275,34900,36350,1450,121071
5088,5250,2017-09-13,0.04252400548696845,36450,34900,-1550,149478
5089,5250,2017-09-11,0.04591104734576758,34850,36450,1600,277371
5090,5250,2017-08-29,0.045171339563862926,32100,33550,1450,193797
5091,5250,2017-07-26,0.0581039755351682,32700,34600,1900,259849
5092,5250,2017-07-13,0.04654895666131621,31150,29700,-1450,210454
5093,5250,2017-06-19,0.04597701149425287,30450,31850,1400,184240
5094,5250,2017-06-12,0.053811659192825115,33450,31650,-1800,326211
5095,5250,2017-05-24,0.04154302670623145,33700,35100,1400,223362
5096,5250,2017-03-21,0.10453648915187377,25350,28000,2650,469894
5097,5250,2017-03-10,0.05708661417322835,25400,26850,1450,119771
5098,5250,2017-03-08,0.04331450094161959,26550,25400,-1150,104151
5099,5250,2017-02-17,0.04938271604938271,24300,25500,1200,186692
5100,5250,2017-02-15,0.05726872246696035,22700,24000,1300,214943
5101,5250,2017-01-24,0.04772234273318872,23050,21950,-1100,128978
5102,5250,2017-01-13,0.04337899543378995,21900,22850,950,206230
5103,5250,2016-12-13,0.06466512702078522,21650,23050,1400,238843
5104,5250,2016-12-07,0.04028436018957346,21100,20250,-850,217188
5105,5250,2016-11-24,0.061124694376528114,20450,21700,1250,175558
5106,5250,2016-11-23,0.08501118568232663,22350,20450,-1900,188411
5107,5250,2016-11-10,0.09722222222222222,21600,23700,2100,196737
5108,5250,2016-11-04,0.04491725768321513,21150,22100,950,121482
5109,5250,2016-11-02,0.06422018348623854,21800,20400,-1400,217026
5110,5250,2016-10-31,0.04721030042918455,23300,22200,-1100,121556
5111,5250,2016-10-28,0.05091649694501019,24550,23300,-1250,90716
5112,5250,2016-09-30,0.05289256198347107,30250,28650,-1600,135930
5113,5250,2016-09-20,0.08860759493670886,27650,30100,2450,130557
5114,5250,2016-08-22,0.040498442367601244,32100,30800,-1300,137507
5115,6280,2021-05-24,0.06105834464043419,368500,346000,-22500,241955
5116,6280,2021-05-13,0.07881136950904392,387000,356500,-30500,250654
5117,6280,2021-04-29,0.06630581867388363,369500,345000,-24500,235229
5118,6280,2021-04-28,0.0561941251596424,391500,369500,-22000,194986
5119,6280,2021-04-15,0.10152990264255911,359500,396000,36500,1389030
5120,6280,2021-04-13,0.08676470588235294,340000,369500,29500,264159
5121,6280,2021-04-09,0.05045871559633028,327000,343500,16500,186223
5122,6280,2021-04-06,0.05263157894736842,342000,324000,-18000,183218
5123,6280,2021-03-17,0.07848837209302326,344000,371000,27000,336278
5124,6280,2021-03-12,0.059006211180124224,322000,341000,19000,160843
5125,6280,2021-03-09,0.06451612903225806,356500,333500,-23000,228183
5126,6280,2021-03-08,0.04806408544726302,374500,356500,-18000,127491
5127,6280,2021-02-25,0.05737704918032787,366000,387000,21000,148286
5128,6280,2021-02-22,0.04469987228607918,391500,374000,-17500,169630
5129,6280,2021-02-18,0.0468384074941452,427000,407000,-20000,193872
5130,6280,2021-02-03,0.07209302325581396,430000,461000,31000,383390
5131,6280,2021-01-29,0.055741360089186176,448500,423500,-25000,563336
5132,6280,2021-01-28,0.08282208588957055,489000,448500,-40500,440718
5133,6280,2021-01-26,0.09307359307359307,462000,505000,43000,1619316
5134,6280,2021-01-25,0.08705882352941176,425000,462000,37000,446940
5135,6280,2021-01-22,0.04551045510455105,406500,425000,18500,385880
5136,6280,2021-01-19,0.04228855721393035,402000,419000,17000,224230
5137,6280,2021-01-14,0.054333764553686936,386500,407500,21000,449907
5138,6280,2021-01-11,0.04374240583232078,411500,393500,-18000,289252
5139,6280,2021-01-05,0.07263157894736842,475000,440500,-34500,639277
5140,6280,2021-01-04,0.16995073891625614,406000,475000,69000,1971283
5141,6280,2020-12-30,0.04639175257731959,388000,406000,18000,784342
5142,6280,2020-12-29,0.096045197740113,354000,388000,34000,751877
5143,6280,2020-12-14,0.1006896551724138,362500,399000,36500,973087
5144,6280,2020-12-10,0.05772005772005772,346500,366500,20000,492510
5145,6280,2020-11-25,0.06174496644295302,372500,349500,-23000,579019
5146,6280,2020-11-17,0.07565337001375516,363500,391000,27500,948484
5147,6280,2020-11-11,0.08261405672009864,405500,372000,-33500,982069
5148,6280,2020-11-06,0.07792207792207792,385000,415000,30000,981563
5149,6280,2020-11-03,0.2537313432835821,301500,378000,76500,2859692
5150,6280,2020-10-29,0.07962962962962963,270000,291500,21500,1020918
5151,6280,2020-10-28,0.0546875,256000,270000,14000,474301
5152,6280,2020-10-27,0.04655493482309125,268500,256000,-12500,369537
5153,6280,2020-10-23,0.16956521739130434,230000,269000,39000,2321642
5154,6280,2020-10-22,0.04783599088838269,219500,230000,10500,889826
5155,6280,2020-09-24,0.06724511930585683,230500,215000,-15500,223351
5156,6280,2020-09-22,0.0611439842209073,253500,238000,-15500,183811
5157,6280,2020-09-09,0.10278745644599303,287000,257500,-29500,737072
5158,6280,2020-09-08,0.1411530815109344,251500,287000,35500,1477111
5159,6280,2020-08-21,0.04056437389770723,283500,272000,-11500,364127
5160,6280,2020-08-20,0.05813953488372093,301000,283500,-17500,728878
5161,6280,2020-08-19,0.06927175843694494,281500,301000,19500,447985
5162,6280,2020-08-18,0.05852842809364549,299000,281500,-17500,355437
5163,6280,2020-08-14,0.04363001745200698,286500,299000,12500,470456
5164,6280,2020-08-10,0.04864864864864865,277500,291000,13500,557323
5165,6280,2020-08-05,0.12627291242362526,245500,276500,31000,1190258
5166,6280,2020-08-03,0.05066079295154185,227000,238500,11500,532562
5167,6280,2020-07-27,0.05088495575221239,226000,237500,11500,698201
5168,6280,2020-07-22,0.10952380952380952,210000,233000,23000,1022090
5169,6280,2020-07-20,0.16844919786096257,187000,218500,31500,2020473
5170,6280,2020-07-15,0.09,200000,182000,-18000,479526
5171,6280,2020-07-13,0.15680473372781065,169000,195500,26500,1553714
5172,6280,2020-07-10,0.11920529801324503,151000,169000,18000,709550
5173,6280,2020-06-16,0.0472972972972973,148000,155000,7000,158629
5174,6280,2020-05-19,0.05063291139240506,158000,150000,-8000,186180
5175,6280,2020-05-18,0.0429042904290429,151500,158000,6500,178766
5176,6280,2020-04-08,0.045180722891566265,166000,158500,-7500,535276
5177,6280,2020-04-07,0.07792207792207792,154000,166000,12000,1489111
5178,6280,2020-04-06,0.09608540925266904,140500,154000,13500,706787
5179,6280,2020-03-31,0.06153846153846154,130000,138000,8000,296469
5180,6280,2020-03-30,0.0970464135021097,118500,130000,11500,230530
5181,6280,2020-03-27,0.048672566371681415,113000,118500,5500,233321
5182,6280,2020-03-19,0.05531914893617021,117500,111000,-6500,118832
5183,6280,2020-03-18,0.08203125,128000,117500,-10500,165490
5184,6280,2020-03-17,0.0847457627118644,118000,128000,10000,202983
5185,6280,2020-03-16,0.07272727272727272,110000,118000,8000,164716
5186,6280,2020-03-12,0.047619047619047616,115500,110000,-5500,99853
5187,6280,2020-03-11,0.05327868852459016,122000,115500,-6500,103962
5188,6280,2020-03-10,0.046875,128000,122000,-6000,123951
5189,6280,2020-03-09,0.06224066390041494,120500,128000,7500,228239
5190,6280,2020-02-28,0.046218487394957986,119000,113500,-5500,64943
5191,6280,2020-02-27,0.05309734513274336,113000,119000,6000,74164
5192,6280,2020-01-31,0.04263565891472868,129000,123500,-5500,60213
5193,6280,2020-01-29,0.0539568345323741,139000,131500,-7500,99305
5194,6280,2020-01-28,0.09448818897637795,127000,139000,12000,271908
5195,6280,2020-01-22,0.04526748971193416,121500,127000,5500,53665
5196,6280,2019-11-25,0.044897959183673466,122500,128000,5500,45832
5197,6280,2019-10-31,0.07983193277310924,119000,128500,9500,190015
5198,6280,2019-09-17,0.048672566371681415,113000,118500,5500,70793
5199,6280,2019-08-05,0.05188679245283019,106000,100500,-5500,56401
5200,6280,2019-06-04,0.048,125000,119000,-6000,136750
5201,6280,2019-01-07,0.041353383458646614,133000,138500,5500,53197
5202,6280,2019-01-03,0.04395604395604396,136500,130500,-6000,41833
5203,6280,2018-11-02,0.084,125000,135500,10500,85581
5204,6280,2018-11-01,0.04602510460251046,119500,125000,5500,81481
5205,6280,2018-10-31,0.06274509803921569,127500,119500,-8000,121214
5206,6280,2018-10-29,0.05363984674329502,130500,123500,-7000,98439
5207,6280,2018-10-11,0.058823529411764705,153000,144000,-9000,104720
5208,6280,2018-09-27,0.13613861386138615,202000,174500,-27500,569023
5209,6280,2018-08-31,0.05093833780160858,186500,196000,9500,81899
5210,6280,2018-08-17,0.055865921787709494,179000,189000,10000,208485
5211,6280,2018-06-19,0.06531531531531531,222000,207500,-14500,64383
5212,6280,2018-06-12,0.04460093896713615,213000,222500,9500,87581
5213,6280,2018-05-02,0.050808314087759814,216500,227500,11000,124207
5214,6280,2018-02-19,0.04411764705882353,204000,213000,9000,70621
5215,6280,2018-02-12,0.0549738219895288,191000,201500,10500,83189
5216,6280,2018-02-07,0.058394160583941604,205500,193500,-12000,97251
5217,6280,2018-02-05,0.07964601769911504,226000,208000,-18000,81900
5218,6280,2018-02-01,0.042283298097251586,236500,226500,-10000,77755
5219,6280,2018-01-31,0.044444444444444446,247500,236500,-11000,54337
5220,6280,2018-01-23,0.04504504504504504,222000,232000,10000,59270
5221,6280,2018-01-12,0.05069124423963134,217000,228000,11000,103263
5222,6280,2018-01-04,0.07300884955752213,226000,209500,-16500,122477
5223,6280,2017-12-22,0.054502369668246446,211000,222500,11500,26317
5224,6280,2017-12-11,0.04513064133016627,210500,220000,9500,44213
5225,6280,2017-12-01,0.044186046511627906,215000,224500,9500,35052
5226,6280,2017-11-30,0.05701754385964912,228000,215000,-13000,56559
5227,6280,2017-11-20,0.05829596412556054,223000,236000,13000,59328
5228,6280,2017-11-06,0.04784688995215311,209000,219000,10000,78998
5229,6280,2017-10-12,0.05063291139240506,197500,207500,10000,90723
5230,6280,2017-09-20,0.08,187500,202500,15000,191252
5231,6280,2017-02-01,0.04710144927536232,138000,144500,6500,33475
5232,6280,2016-12-13,0.05102040816326531,147000,154500,7500,67022
5233,6280,2016-11-23,0.0728476821192053,151000,140000,-11000,164941
5234,6280,2016-11-10,0.10810810810810811,148000,164000,16000,164498
5235,6280,2016-11-03,0.05223880597014925,134000,141000,7000,42662
5236,6280,2016-11-02,0.053003533568904596,141500,134000,-7500,49524
5237,6280,2016-10-14,0.045871559633027525,163500,156000,-7500,97633
5238,6280,2016-10-13,0.04105571847507331,170500,163500,-7000,72442
5239,361610,2021-05-18,0.043478260869565216,138000,144000,6000,1474901
5240,361610,2021-05-12,0.045307443365695796,154500,147500,-7000,4973674
5241,361610,2021-05-11,0.3867595818815331,143500,154500,11000,11320278
5242,361610,2021-05-18,0.043478260869565216,138000,144000,6000,1474901
5243,361610,2021-05-12,0.045307443365695796,154500,147500,-7000,4973674
5244,361610,2021-05-11,0.3867595818815331,143500,154500,11000,11320278
5245,361610,2021-05-18,0.043478260869565216,138000,144000,6000,1474901
5246,361610,2021-05-12,0.045307443365695796,154500,147500,-7000,4973674
5247,361610,2021-05-11,0.3867595818815331,143500,154500,11000,11320278
5248,361610,2021-05-18,0.043478260869565216,138000,144000,6000,1474901
5249,361610,2021-05-12,0.045307443365695796,154500,147500,-7000,4973674
5250,361610,2021-05-11,0.3867595818815331,143500,154500,11000,11320278
5251,361610,2021-05-18,0.043478260869565216,138000,144000,6000,1474901
5252,361610,2021-05-12,0.045307443365695796,154500,147500,-7000,4973674
5253,361610,2021-05-11,0.3867595818815331,143500,154500,11000,11320278
5254,361610,2021-05-18,0.043478260869565216,138000,144000,6000,1474901
5255,361610,2021-05-12,0.045307443365695796,154500,147500,-7000,4973674
5256,361610,2021-05-11,0.3867595818815331,143500,154500,11000,11320278
5257,361610,2021-05-18,0.043478260869565216,138000,144000,6000,1474901
5258,361610,2021-05-12,0.045307443365695796,154500,147500,-7000,4973674
5259,361610,2021-05-11,0.3867595818815331,143500,154500,11000,11320278
5260,361610,2021-05-18,0.043478260869565216,138000,144000,6000,1474901
5261,361610,2021-05-12,0.045307443365695796,154500,147500,-7000,4973674
5262,361610,2021-05-11,0.3867595818815331,143500,154500,11000,11320278
5263,361610,2021-05-18,0.043478260869565216,138000,144000,6000,1474901
5264,361610,2021-05-12,0.045307443365695796,154500,147500,-7000,4973674
5265,361610,2021-05-11,0.3867595818815331,143500,154500,11000,11320278
5266,361610,2021-05-18,0.043478260869565216,138000,144000,6000,1474901
5267,361610,2021-05-12,0.045307443365695796,154500,147500,-7000,4973674
5268,361610,2021-05-11,0.3867595818815331,143500,154500,11000,11320278
5269,361610,2021-05-18,0.043478260869565216,138000,144000,6000,1474901
5270,361610,2021-05-12,0.045307443365695796,154500,147500,-7000,4973674
5271,361610,2021-05-11,0.3867595818815331,143500,154500,11000,11320278
5272,361610,2021-05-18,0.043478260869565216,138000,144000,6000,1474901
5273,361610,2021-05-12,0.045307443365695796,154500,147500,-7000,4973674
5274,361610,2021-05-11,0.3867595818815331,143500,154500,11000,11320278
5275,361610,2021-05-18,0.043478260869565216,138000,144000,6000,1474901
5276,361610,2021-05-12,0.045307443365695796,154500,147500,-7000,4973674
5277,361610,2021-05-11,0.3867595818815331,143500,154500,11000,11320278
5278,361610,2021-05-18,0.043478260869565216,138000,144000,6000,1474901
5279,361610,2021-05-12,0.045307443365695796,154500,147500,-7000,4973674
5280,361610,2021-05-11,0.3867595818815331,143500,154500,11000,11320278
5281,361610,2021-05-18,0.043478260869565216,138000,144000,6000,1474901
5282,361610,2021-05-12,0.045307443365695796,154500,147500,-7000,4973674
5283,361610,2021-05-11,0.3867595818815331,143500,154500,11000,11320278
5284,361610,2021-05-18,0.043478260869565216,138000,144000,6000,1474901
5285,361610,2021-05-12,0.045307443365695796,154500,147500,-7000,4973674
5286,361610,2021-05-11,0.3867595818815331,143500,154500,11000,11320278
5287,361610,2021-05-18,0.043478260869565216,138000,144000,6000,1474901
5288,361610,2021-05-12,0.045307443365695796,154500,147500,-7000,4973674
5289,361610,2021-05-11,0.3867595818815331,143500,154500,11000,11320278
5290,361610,2021-05-18,0.043478260869565216,138000,144000,6000,1474901
5291,361610,2021-05-12,0.045307443365695796,154500,147500,-7000,4973674
5292,361610,2021-05-11,0.3867595818815331,143500,154500,11000,11320278
5293,361610,2021-05-18,0.043478260869565216,138000,144000,6000,1474901
5294,361610,2021-05-12,0.045307443365695796,154500,147500,-7000,4973674
5295,361610,2021-05-11,0.3867595818815331,143500,154500,11000,11320278
5296,361610,2021-05-18,0.043478260869565216,138000,144000,6000,1474901
5297,361610,2021-05-12,0.045307443365695796,154500,147500,-7000,4973674
5298,361610,2021-05-11,0.3867595818815331,143500,154500,11000,11320278
5299,361610,2021-05-18,0.043478260869565216,138000,144000,6000,1474901
5300,361610,2021-05-12,0.045307443365695796,154500,147500,-7000,4973674
5301,361610,2021-05-11,0.3867595818815331,143500,154500,11000,11320278
5302,361610,2021-05-18,0.043478260869565216,138000,144000,6000,1474901
5303,361610,2021-05-12,0.045307443365695796,154500,147500,-7000,4973674
5304,361610,2021-05-11,0.3867595818815331,143500,154500,11000,11320278
5305,361610,2021-05-18,0.043478260869565216,138000,144000,6000,1474901
5306,361610,2021-05-12,0.045307443365695796,154500,147500,-7000,4973674
5307,361610,2021-05-11,0.3867595818815331,143500,154500,11000,11320278
5308,361610,2021-05-18,0.043478260869565216,138000,144000,6000,1474901
5309,361610,2021-05-12,0.045307443365695796,154500,147500,-7000,4973674
5310,361610,2021-05-11,0.3867595818815331,143500,154500,11000,11320278
5311,361610,2021-05-18,0.043478260869565216,138000,144000,6000,1474901
5312,361610,2021-05-12,0.045307443365695796,154500,147500,-7000,4973674
5313,361610,2021-05-11,0.3867595818815331,143500,154500,11000,11320278
5314,361610,2021-05-18,0.043478260869565216,138000,144000,6000,1474901
5315,361610,2021-05-12,0.045307443365695796,154500,147500,-7000,4973674
5316,361610,2021-05-11,0.3867595818815331,143500,154500,11000,11320278
5317,361610,2021-05-18,0.043478260869565216,138000,144000,6000,1474901
5318,361610,2021-05-12,0.045307443365695796,154500,147500,-7000,4973674
5319,361610,2021-05-11,0.3867595818815331,143500,154500,11000,11320278
5320,361610,2021-05-18,0.043478260869565216,138000,144000,6000,1474901
5321,361610,2021-05-12,0.045307443365695796,154500,147500,-7000,4973674
5322,361610,2021-05-11,0.3867595818815331,143500,154500,11000,11320278
5323,361610,2021-05-18,0.043478260869565216,138000,144000,6000,1474901
5324,361610,2021-05-12,0.045307443365695796,154500,147500,-7000,4973674
5325,361610,2021-05-11,0.3867595818815331,143500,154500,11000,11320278
5326,361610,2021-05-18,0.043478260869565216,138000,144000,6000,1474901
5327,361610,2021-05-12,0.045307443365695796,154500,147500,-7000,4973674
5328,361610,2021-05-11,0.3867595818815331,143500,154500,11000,11320278
5329,361610,2021-05-18,0.043478260869565216,138000,144000,6000,1474901
5330,361610,2021-05-12,0.045307443365695796,154500,147500,-7000,4973674
5331,361610,2021-05-11,0.3867595818815331,143500,154500,11000,11320278
5332,361610,2021-05-18,0.043478260869565216,138000,144000,6000,1474901
5333,361610,2021-05-12,0.045307443365695796,154500,147500,-7000,4973674
5334,361610,2021-05-11,0.3867595818815331,143500,154500,11000,11320278
5335,361610,2021-05-18,0.043478260869565216,138000,144000,6000,1474901
5336,361610,2021-05-12,0.045307443365695796,154500,147500,-7000,4973674
5337,361610,2021-05-11,0.3867595818815331,143500,154500,11000,11320278
5338,361610,2021-05-18,0.043478260869565216,138000,144000,6000,1474901
5339,361610,2021-05-12,0.045307443365695796,154500,147500,-7000,4973674
5340,361610,2021-05-11,0.3867595818815331,143500,154500,11000,11320278
5341,361610,2021-05-18,0.043478260869565216,138000,144000,6000,1474901
5342,361610,2021-05-12,0.045307443365695796,154500,147500,-7000,4973674
5343,361610,2021-05-11,0.3867595818815331,143500,154500,11000,11320278
5344,361610,2021-05-18,0.043478260869565216,138000,144000,6000,1474901
5345,361610,2021-05-12,0.045307443365695796,154500,147500,-7000,4973674
5346,361610,2021-05-11,0.3867595818815331,143500,154500,11000,11320278
5347,361610,2021-05-18,0.043478260869565216,138000,144000,6000,1474901
5348,361610,2021-05-12,0.045307443365695796,154500,147500,-7000,4973674
5349,361610,2021-05-11,0.3867595818815331,143500,154500,11000,11320278
5350,361610,2021-05-18,0.043478260869565216,138000,144000,6000,1474901
5351,361610,2021-05-12,0.045307443365695796,154500,147500,-7000,4973674
5352,361610,2021-05-11,0.3867595818815331,143500,154500,11000,11320278
5353,361610,2021-05-18,0.043478260869565216,138000,144000,6000,1474901
5354,361610,2021-05-12,0.045307443365695796,154500,147500,-7000,4973674
5355,361610,2021-05-11,0.3867595818815331,143500,154500,11000,11320278
5356,361610,2021-05-18,0.043478260869565216,138000,144000,6000,1474901
5357,361610,2021-05-12,0.045307443365695796,154500,147500,-7000,4973674
5358,361610,2021-05-11,0.3867595818815331,143500,154500,11000,11320278
5359,361610,2021-05-18,0.043478260869565216,138000,144000,6000,1474901
5360,361610,2021-05-12,0.045307443365695796,154500,147500,-7000,4973674
5361,361610,2021-05-11,0.3867595818815331,143500,154500,11000,11320278
5362,361610,2021-05-18,0.043478260869565216,138000,144000,6000,1474901
5363,361610,2021-05-12,0.045307443365695796,154500,147500,-7000,4973674
5364,361610,2021-05-11,0.3867595818815331,143500,154500,11000,11320278
5365,361610,2021-05-18,0.043478260869565216,138000,144000,6000,1474901
5366,361610,2021-05-12,0.045307443365695796,154500,147500,-7000,4973674
5367,361610,2021-05-11,0.3867595818815331,143500,154500,11000,11320278
5368,361610,2021-05-18,0.043478260869565216,138000,144000,6000,1474901
5369,361610,2021-05-12,0.045307443365695796,154500,147500,-7000,4973674
5370,361610,2021-05-11,0.3867595818815331,143500,154500,11000,11320278
5371,361610,2021-05-18,0.043478260869565216,138000,144000,6000,1474901
5372,361610,2021-05-12,0.045307443365695796,154500,147500,-7000,4973674
5373,361610,2021-05-11,0.3867595818815331,143500,154500,11000,11320278
5374,361610,2021-05-18,0.043478260869565216,138000,144000,6000,1474901
5375,361610,2021-05-12,0.045307443365695796,154500,147500,-7000,4973674
5376,361610,2021-05-11,0.3867595818815331,143500,154500,11000,11320278
5377,361610,2021-05-18,0.043478260869565216,138000,144000,6000,1474901
5378,361610,2021-05-12,0.045307443365695796,154500,147500,-7000,4973674
5379,361610,2021-05-11,0.3867595818815331,143500,154500,11000,11320278
5380,361610,2021-05-18,0.043478260869565216,138000,144000,6000,1474901
5381,361610,2021-05-12,0.045307443365695796,154500,147500,-7000,4973674
5382,361610,2021-05-11,0.3867595818815331,143500,154500,11000,11320278
5383,361610,2021-05-18,0.043478260869565216,138000,144000,6000,1474901
5384,361610,2021-05-12,0.045307443365695796,154500,147500,-7000,4973674
5385,361610,2021-05-11,0.3867595818815331,143500,154500,11000,11320278
5386,361610,2021-05-18,0.043478260869565216,138000,144000,6000,1474901
5387,361610,2021-05-12,0.045307443365695796,154500,147500,-7000,4973674
5388,361610,2021-05-11,0.3867595818815331,143500,154500,11000,11320278
5389,361610,2021-05-18,0.043478260869565216,138000,144000,6000,1474901
5390,361610,2021-05-12,0.045307443365695796,154500,147500,-7000,4973674
5391,361610,2021-05-11,0.3867595818815331,143500,154500,11000,11320278
5392,361610,2021-05-18,0.043478260869565216,138000,144000,6000,1474901
5393,361610,2021-05-12,0.045307443365695796,154500,147500,-7000,4973674
5394,361610,2021-05-11,0.3867595818815331,143500,154500,11000,11320278
5395,361610,2021-05-18,0.043478260869565216,138000,144000,6000,1474901
5396,361610,2021-05-12,0.045307443365695796,154500,147500,-7000,4973674
5397,361610,2021-05-11,0.3867595818815331,143500,154500,11000,11320278
5398,361610,2021-05-18,0.043478260869565216,138000,144000,6000,1474901
5399,361610,2021-05-12,0.045307443365695796,154500,147500,-7000,4973674
5400,361610,2021-05-11,0.3867595818815331,143500,154500,11000,11320278
5401,361610,2021-05-18,0.043478260869565216,138000,144000,6000,1474901
5402,361610,2021-05-12,0.045307443365695796,154500,147500,-7000,4973674
5403,361610,2021-05-11,0.3867595818815331,143500,154500,11000,11320278
5404,361610,2021-05-18,0.043478260869565216,138000,144000,6000,1474901
5405,361610,2021-05-12,0.045307443365695796,154500,147500,-7000,4973674
5406,361610,2021-05-11,0.3867595818815331,143500,154500,11000,11320278
5407,361610,2021-05-18,0.043478260869565216,138000,144000,6000,1474901
5408,361610,2021-05-12,0.045307443365695796,154500,147500,-7000,4973674
5409,361610,2021-05-11,0.3867595818815331,143500,154500,11000,11320278
5410,361610,2021-05-18,0.043478260869565216,138000,144000,6000,1474901
5411,361610,2021-05-12,0.045307443365695796,154500,147500,-7000,4973674
5412,361610,2021-05-11,0.3867595818815331,143500,154500,11000,11320278
5413,361610,2021-05-18,0.043478260869565216,138000,144000,6000,1474901
5414,361610,2021-05-12,0.045307443365695796,154500,147500,-7000,4973674
5415,361610,2021-05-11,0.3867595818815331,143500,154500,11000,11320278
5416,361610,2021-05-18,0.043478260869565216,138000,144000,6000,1474901
5417,361610,2021-05-12,0.045307443365695796,154500,147500,-7000,4973674
5418,361610,2021-05-11,0.3867595818815331,143500,154500,11000,11320278
5419,361610,2021-05-18,0.043478260869565216,138000,144000,6000,1474901
5420,361610,2021-05-12,0.045307443365695796,154500,147500,-7000,4973674
5421,361610,2021-05-11,0.3867595818815331,143500,154500,11000,11320278
5422,361610,2021-05-18,0.043478260869565216,138000,144000,6000,1474901
5423,361610,2021-05-12,0.045307443365695796,154500,147500,-7000,4973674
5424,361610,2021-05-11,0.3867595818815331,143500,154500,11000,11320278
5425,361610,2021-05-18,0.043478260869565216,138000,144000,6000,1474901
5426,361610,2021-05-12,0.045307443365695796,154500,147500,-7000,4973674
5427,361610,2021-05-11,0.3867595818815331,143500,154500,11000,11320278
5428,361610,2021-05-18,0.043478260869565216,138000,144000,6000,1474901
5429,361610,2021-05-12,0.045307443365695796,154500,147500,-7000,4973674
5430,361610,2021-05-11,0.3867595818815331,143500,154500,11000,11320278
5431,361610,2021-05-18,0.043478260869565216,138000,144000,6000,1474901
5432,361610,2021-05-12,0.045307443365695796,154500,147500,-7000,4973674
5433,361610,2021-05-11,0.3867595818815331,143500,154500,11000,11320278
5434,361610,2021-05-18,0.043478260869565216,138000,144000,6000,1474901
5435,361610,2021-05-12,0.045307443365695796,154500,147500,-7000,4973674
5436,361610,2021-05-11,0.3867595818815331,143500,154500,11000,11320278
5437,361610,2021-05-18,0.043478260869565216,138000,144000,6000,1474901
5438,361610,2021-05-12,0.045307443365695796,154500,147500,-7000,4973674
5439,361610,2021-05-11,0.3867595818815331,143500,154500,11000,11320278
5440,361610,2021-05-18,0.043478260869565216,138000,144000,6000,1474901
5441,361610,2021-05-12,0.045307443365695796,154500,147500,-7000,4973674
5442,361610,2021-05-11,0.3867595818815331,143500,154500,11000,11320278
5443,361610,2021-05-18,0.043478260869565216,138000,144000,6000,1474901
5444,361610,2021-05-12,0.045307443365695796,154500,147500,-7000,4973674
5445,361610,2021-05-11,0.3867595818815331,143500,154500,11000,11320278
5446,361610,2021-05-18,0.043478260869565216,138000,144000,6000,1474901
5447,361610,2021-05-12,0.045307443365695796,154500,147500,-7000,4973674
5448,361610,2021-05-11,0.3867595818815331,143500,154500,11000,11320278
5449,361610,2021-05-18,0.043478260869565216,138000,144000,6000,1474901
5450,361610,2021-05-12,0.045307443365695796,154500,147500,-7000,4973674
5451,361610,2021-05-11,0.3867595818815331,143500,154500,11000,11320278
5452,361610,2021-05-18,0.043478260869565216,138000,144000,6000,1474901
5453,361610,2021-05-12,0.045307443365695796,154500,147500,-7000,4973674
5454,361610,2021-05-11,0.3867595818815331,143500,154500,11000,11320278
5455,361610,2021-05-18,0.043478260869565216,138000,144000,6000,1474901
5456,361610,2021-05-12,0.045307443365695796,154500,147500,-7000,4973674
5457,361610,2021-05-11,0.3867595818815331,143500,154500,11000,11320278
5458,361610,2021-05-18,0.043478260869565216,138000,144000,6000,1474901
5459,361610,2021-05-12,0.045307443365695796,154500,147500,-7000,4973674
5460,361610,2021-05-11,0.3867595818815331,143500,154500,11000,11320278
5461,361610,2021-05-18,0.043478260869565216,138000,144000,6000,1474901
5462,361610,2021-05-12,0.045307443365695796,154500,147500,-7000,4973674
5463,361610,2021-05-11,0.3867595818815331,143500,154500,11000,11320278
5464,361610,2021-05-18,0.043478260869565216,138000,144000,6000,1474901
5465,361610,2021-05-12,0.045307443365695796,154500,147500,-7000,4973674
5466,361610,2021-05-11,0.3867595818815331,143500,154500,11000,11320278
5467,361610,2021-05-18,0.043478260869565216,138000,144000,6000,1474901
5468,361610,2021-05-12,0.045307443365695796,154500,147500,-7000,4973674
5469,361610,2021-05-11,0.3867595818815331,143500,154500,11000,11320278
5470,361610,2021-05-18,0.043478260869565216,138000,144000,6000,1474901
5471,361610,2021-05-12,0.045307443365695796,154500,147500,-7000,4973674
5472,361610,2021-05-11,0.3867595818815331,143500,154500,11000,11320278
5473,361610,2021-05-18,0.043478260869565216,138000,144000,6000,1474901
5474,361610,2021-05-12,0.045307443365695796,154500,147500,-7000,4973674
5475,361610,2021-05-11,0.3867595818815331,143500,154500,11000,11320278
5476,361610,2021-05-18,0.043478260869565216,138000,144000,6000,1474901
5477,361610,2021-05-12,0.045307443365695796,154500,147500,-7000,4973674
5478,361610,2021-05-11,0.3867595818815331,143500,154500,11000,11320278
5479,361610,2021-05-18,0.043478260869565216,138000,144000,6000,1474901
5480,361610,2021-05-12,0.045307443365695796,154500,147500,-7000,4973674
5481,361610,2021-05-11,0.3867595818815331,143500,154500,11000,11320278
5482,361610,2021-05-18,0.043478260869565216,138000,144000,6000,1474901
5483,361610,2021-05-12,0.045307443365695796,154500,147500,-7000,4973674
5484,361610,2021-05-11,0.3867595818815331,143500,154500,11000,11320278
5485,361610,2021-05-18,0.043478260869565216,138000,144000,6000,1474901
5486,361610,2021-05-12,0.045307443365695796,154500,147500,-7000,4973674
5487,361610,2021-05-11,0.3867595818815331,143500,154500,11000,11320278
5488,361610,2021-05-18,0.043478260869565216,138000,144000,6000,1474901
5489,361610,2021-05-12,0.045307443365695796,154500,147500,-7000,4973674
5490,361610,2021-05-11,0.3867595818815331,143500,154500,11000,11320278
5491,361610,2021-05-18,0.043478260869565216,138000,144000,6000,1474901
5492,361610,2021-05-12,0.045307443365695796,154500,147500,-7000,4973674
5493,361610,2021-05-11,0.3867595818815331,143500,154500,11000,11320278
5494,361610,2021-05-18,0.043478260869565216,138000,144000,6000,1474901
5495,361610,2021-05-12,0.045307443365695796,154500,147500,-7000,4973674
5496,361610,2021-05-11,0.3867595818815331,143500,154500,11000,11320278
5497,361610,2021-05-18,0.043478260869565216,138000,144000,6000,1474901
5498,361610,2021-05-12,0.045307443365695796,154500,147500,-7000,4973674
5499,361610,2021-05-11,0.3867595818815331,143500,154500,11000,11320278
5500,361610,2021-05-18,0.043478260869565216,138000,144000,6000,1474901
5501,361610,2021-05-12,0.045307443365695796,154500,147500,-7000,4973674
5502,361610,2021-05-11,0.3867595818815331,143500,154500,11000,11320278
5503,361610,2021-05-18,0.043478260869565216,138000,144000,6000,1474901
5504,361610,2021-05-12,0.045307443365695796,154500,147500,-7000,4973674
5505,361610,2021-05-11,0.3867595818815331,143500,154500,11000,11320278
5506,361610,2021-05-18,0.043478260869565216,138000,144000,6000,1474901
5507,361610,2021-05-12,0.045307443365695796,154500,147500,-7000,4973674
5508,361610,2021-05-11,0.3867595818815331,143500,154500,11000,11320278
5509,361610,2021-05-18,0.043478260869565216,138000,144000,6000,1474901
5510,361610,2021-05-12,0.045307443365695796,154500,147500,-7000,4973674
5511,361610,2021-05-11,0.3867595818815331,143500,154500,11000,11320278
5512,361610,2021-05-18,0.043478260869565216,138000,144000,6000,1474901
5513,361610,2021-05-12,0.045307443365695796,154500,147500,-7000,4973674
5514,361610,2021-05-11,0.3867595818815331,143500,154500,11000,11320278
5515,361610,2021-05-18,0.043478260869565216,138000,144000,6000,1474901
5516,361610,2021-05-12,0.045307443365695796,154500,147500,-7000,4973674
5517,361610,2021-05-11,0.3867595818815331,143500,154500,11000,11320278
5518,361610,2021-05-18,0.043478260869565216,138000,144000,6000,1474901
5519,361610,2021-05-12,0.045307443365695796,154500,147500,-7000,4973674
5520,361610,2021-05-11,0.3867595818815331,143500,154500,11000,11320278
5521,361610,2021-05-18,0.043478260869565216,138000,144000,6000,1474901
5522,361610,2021-05-12,0.045307443365695796,154500,147500,-7000,4973674
5523,361610,2021-05-11,0.3867595818815331,143500,154500,11000,11320278
5524,361610,2021-05-18,0.043478260869565216,138000,144000,6000,1474901
5525,361610,2021-05-12,0.045307443365695796,154500,147500,-7000,4973674
5526,361610,2021-05-11,0.3867595818815331,143500,154500,11000,11320278
5527,361610,2021-05-18,0.043478260869565216,138000,144000,6000,1474901
5528,361610,2021-05-12,0.045307443365695796,154500,147500,-7000,4973674
5529,361610,2021-05-11,0.3867595818815331,143500,154500,11000,11320278
5530,361610,2021-05-18,0.043478260869565216,138000,144000,6000,1474901
5531,361610,2021-05-12,0.045307443365695796,154500,147500,-7000,4973674
5532,361610,2021-05-11,0.3867595818815331,143500,154500,11000,11320278
5533,361610,2021-05-18,0.043478260869565216,138000,144000,6000,1474901
5534,361610,2021-05-12,0.045307443365695796,154500,147500,-7000,4973674
5535,361610,2021-05-11,0.3867595818815331,143500,154500,11000,11320278
5536,361610,2021-05-18,0.043478260869565216,138000,144000,6000,1474901
5537,361610,2021-05-12,0.045307443365695796,154500,147500,-7000,4973674
5538,361610,2021-05-11,0.3867595818815331,143500,154500,11000,11320278
5539,361610,2021-05-18,0.043478260869565216,138000,144000,6000,1474901
5540,361610,2021-05-12,0.045307443365695796,154500,147500,-7000,4973674
5541,361610,2021-05-11,0.3867595818815331,143500,154500,11000,11320278
5542,361610,2021-05-18,0.043478260869565216,138000,144000,6000,1474901
5543,361610,2021-05-12,0.045307443365695796,154500,147500,-7000,4973674
5544,361610,2021-05-11,0.3867595818815331,143500,154500,11000,11320278
5545,361610,2021-05-18,0.043478260869565216,138000,144000,6000,1474901
5546,361610,2021-05-12,0.045307443365695796,154500,147500,-7000,4973674
5547,361610,2021-05-11,0.3867595818815331,143500,154500,11000,11320278
5548,361610,2021-05-18,0.043478260869565216,138000,144000,6000,1474901
5549,361610,2021-05-12,0.045307443365695796,154500,147500,-7000,4973674
5550,361610,2021-05-11,0.3867595818815331,143500,154500,11000,11320278
5551,361610,2021-05-18,0.043478260869565216,138000,144000,6000,1474901
5552,361610,2021-05-12,0.045307443365695796,154500,147500,-7000,4973674
5553,361610,2021-05-11,0.3867595818815331,143500,154500,11000,11320278
5554,361610,2021-05-18,0.043478260869565216,138000,144000,6000,1474901
5555,361610,2021-05-12,0.045307443365695796,154500,147500,-7000,4973674
5556,361610,2021-05-11,0.3867595818815331,143500,154500,11000,11320278
5557,361610,2021-05-18,0.043478260869565216,138000,144000,6000,1474901
5558,361610,2021-05-12,0.045307443365695796,154500,147500,-7000,4973674
5559,361610,2021-05-11,0.3867595818815331,143500,154500,11000,11320278
5560,361610,2021-05-18,0.043478260869565216,138000,144000,6000,1474901
5561,361610,2021-05-12,0.045307443365695796,154500,147500,-7000,4973674
5562,361610,2021-05-11,0.3867595818815331,143500,154500,11000,11320278
5563,361610,2021-05-18,0.043478260869565216,138000,144000,6000,1474901
5564,361610,2021-05-12,0.045307443365695796,154500,147500,-7000,4973674
5565,361610,2021-05-11,0.3867595818815331,143500,154500,11000,11320278
5566,361610,2021-05-18,0.043478260869565216,138000,144000,6000,1474901
5567,361610,2021-05-12,0.045307443365695796,154500,147500,-7000,4973674
5568,361610,2021-05-11,0.3867595818815331,143500,154500,11000,11320278
5569,361610,2021-05-18,0.043478260869565216,138000,144000,6000,1474901
5570,361610,2021-05-12,0.045307443365695796,154500,147500,-7000,4973674
5571,361610,2021-05-11,0.3867595818815331,143500,154500,11000,11320278
5572,361610,2021-05-18,0.043478260869565216,138000,144000,6000,1474901
5573,361610,2021-05-12,0.045307443365695796,154500,147500,-7000,4973674
5574,361610,2021-05-11,0.3867595818815331,143500,154500,11000,11320278
5575,361610,2021-05-18,0.043478260869565216,138000,144000,6000,1474901
5576,361610,2021-05-12,0.045307443365695796,154500,147500,-7000,4973674
5577,361610,2021-05-11,0.3867595818815331,143500,154500,11000,11320278
5578,361610,2021-05-18,0.043478260869565216,138000,144000,6000,1474901
5579,361610,2021-05-12,0.045307443365695796,154500,147500,-7000,4973674
5580,361610,2021-05-11,0.3867595818815331,143500,154500,11000,11320278
5581,361610,2021-05-18,0.043478260869565216,138000,144000,6000,1474901
5582,361610,2021-05-12,0.045307443365695796,154500,147500,-7000,4973674
5583,361610,2021-05-11,0.3867595818815331,143500,154500,11000,11320278
5584,361610,2021-05-18,0.043478260869565216,138000,144000,6000,1474901
5585,361610,2021-05-12,0.045307443365695796,154500,147500,-7000,4973674
5586,361610,2021-05-11,0.3867595818815331,143500,154500,11000,11320278
5587,361610,2021-05-18,0.043478260869565216,138000,144000,6000,1474901
5588,361610,2021-05-12,0.045307443365695796,154500,147500,-7000,4973674
5589,361610,2021-05-11,0.3867595818815331,143500,154500,11000,11320278
5590,361610,2021-05-18,0.043478260869565216,138000,144000,6000,1474901
5591,361610,2021-05-12,0.045307443365695796,154500,147500,-7000,4973674
5592,7310,2020-11-11,0.04220183486238532,545000,568000,23000,17622
5593,7310,2020-08-28,0.05,580000,609000,29000,12069
5594,7310,2020-06-16,0.04918032786885246,549000,576000,27000,7139
5595,7310,2020-06-15,0.05670103092783505,582000,549000,-33000,12241
5596,7310,2020-05-15,0.10299625468164794,534000,589000,55000,33378
5597,7310,2020-04-06,0.07495069033530571,507000,545000,38000,17628
5598,7310,2020-04-02,0.0455026455026455,472500,494000,21500,7116
5599,7310,2020-03-24,0.05510907003444317,435500,459500,24000,6335
5600,7310,2020-03-23,0.05939524838012959,463000,435500,-27500,5658
5601,7310,2020-03-20,0.06682027649769585,434000,463000,29000,9719
5602,7310,2020-03-12,0.045174537987679675,487000,465000,-22000,11914
5603,7310,2020-03-04,0.05198776758409786,490500,516000,25500,13686
5604,7310,2020-02-25,0.04595588235294118,544000,519000,-25000,15490
5605,7310,2020-02-24,0.0625,512000,544000,32000,31966
5606,7310,2020-02-06,0.061752988047808766,502000,533000,31000,7062
5607,7310,2019-01-04,0.05785123966942149,726000,768000,42000,9335
5608,7310,2018-10-24,0.05053598774885146,653000,686000,33000,7244
5609,7310,2018-08-14,0.05997693194925029,867000,815000,-52000,5567
5610,7310,2018-06-22,0.047503045066991476,821000,860000,39000,6826
5611,7310,2018-06-07,0.05200945626477541,846000,890000,44000,13220
5612,7310,2018-06-01,0.05802469135802469,810000,857000,47000,21285
5613,7310,2018-05-16,0.049531459170013385,747000,784000,37000,7726
5614,7310,2018-04-03,0.0407055630936228,737000,767000,30000,13330
5615,7310,2018-03-08,0.06801736613603473,691000,738000,47000,15307
5616,7310,2017-11-20,0.046894803548795945,789000,826000,37000,22021
5617,7310,2017-11-17,0.04920212765957447,752000,789000,37000,17901
5618,7310,2017-10-18,0.04,750000,780000,30000,11702
5619,7310,2017-07-24,0.07248322147651007,745000,799000,54000,53654
5620,7310,2017-06-08,0.04096385542168675,830000,864000,34000,20808
5621,7310,2017-05-10,0.04057591623036649,764000,795000,31000,13768
5622,7310,2017-03-24,0.05142857142857143,700000,736000,36000,12663
5623,7310,2017-02-06,0.09913793103448276,696000,765000,69000,29577
5624,7310,2017-02-03,0.04035874439461883,669000,696000,27000,15101
5625,7310,2016-11-29,0.04380664652567976,662000,691000,29000,5523
5626,7310,2016-11-15,0.10835913312693499,646000,716000,70000,16922
5627,7310,2016-11-03,0.06666666666666667,615000,656000,41000,6394
5628,7310,2016-11-02,0.04503105590062112,644000,615000,-29000,6364
5629,7310,2016-09-20,0.05738880918220947,697000,737000,40000,14282
5630,7310,2016-09-07,0.04225352112676056,710000,680000,-30000,11695
5631,6800,2021-05-12,0.04225352112676056,10650,10200,-450,4638973
5632,6800,2021-05-10,0.058823529411764705,10200,10800,600,9102554
5633,6800,2021-05-06,0.04338842975206612,9680,10100,420,3072217
5634,6800,2021-01-05,0.042105263157894736,9500,9900,400,4213078
5635,6800,2020-12-01,0.06540084388185655,9480,10100,620,6220266
5636,6800,2020-11-30,0.04914744232698094,9970,9480,-490,5120909
5637,6800,2020-11-11,0.05739514348785872,9060,9580,520,4253446
5638,6800,2020-09-22,0.040586245772266064,8870,8510,-360,2984344
5639,6800,2020-08-20,0.040992448759439054,9270,8890,-380,5406199
5640,6800,2020-08-10,0.0771850170261067,8810,9490,680,9216565
5641,6800,2020-08-05,0.04918032786885246,8540,8960,420,6962066
5642,6800,2020-08-04,0.06483790523690773,8020,8540,520,6792951
5643,6800,2020-07-31,0.057640750670241284,7460,7890,430,6002025
5644,6800,2020-07-17,0.04491413474240423,7570,7910,340,5462291
5645,6800,2020-07-15,0.04667609618104668,7070,7400,330,4946484
5646,6800,2020-07-13,0.04525547445255475,6850,7160,310,5858403
5647,6800,2020-06-25,0.04727793696275072,6980,6650,-330,3610969
5648,6800,2020-06-16,0.06329113924050633,6320,6720,400,3761634
5649,6800,2020-06-15,0.07602339181286549,6840,6320,-520,4175382
5650,6800,2020-06-03,0.07430340557275542,6460,6940,480,9158624
5651,6800,2020-05-29,0.043410852713178294,6450,6170,-280,9966883
5652,6800,2020-05-28,0.04707792207792208,6160,6450,290,7651448
5653,6800,2020-05-22,0.044293015332197615,5870,5610,-260,3626474
5654,6800,2020-05-19,0.0600375234521576,5330,5650,320,5154711
5655,6800,2020-04-29,0.048598130841121495,5350,5610,260,8511707
5656,6800,2020-04-27,0.04466019417475728,5150,5380,230,3807428
5657,6800,2020-04-17,0.07509881422924901,5060,5440,380,8448983
5658,6800,2020-04-06,0.04065040650406504,4920,5120,200,3772042
5659,6800,2020-04-01,0.07115749525616698,5270,4895,-375,5245398
5660,6800,2020-03-25,0.19664268585131894,4170,4990,820,9379585
5661,6800,2020-03-24,0.1599443671766342,3595,4170,575,7099214
5662,6800,2020-03-23,0.09786700125470514,3985,3595,-390,7702606
5663,6800,2020-03-20,0.10694444444444444,3600,3985,385,8484456
5664,6800,2020-03-19,0.2052980132450331,4530,3600,-930,10119912
5665,6800,2020-03-18,0.10297029702970296,5050,4530,-520,5423802
5666,6800,2020-03-17,0.05783582089552239,5360,5050,-310,4446265
5667,6800,2020-03-13,0.05,5800,5510,-290,4486498
5668,6800,2020-03-12,0.047619047619047616,6090,5800,-290,4142758
5669,6800,2020-03-09,0.046224961479198766,6490,6190,-300,2834246
5670,6800,2020-02-06,0.0420899854862119,6890,7180,290,2328672
5671,6800,2020-01-28,0.05026455026455026,7560,7180,-380,2642995
5672,6800,2020-01-14,0.040268456375838924,7450,7750,300,4135800
5673,6800,2019-11-04,0.04360056258790436,7110,7420,310,2345234
5674,6800,2019-08-30,0.0449438202247191,7120,7440,320,1659651
5675,6800,2019-08-09,0.04113475177304964,7050,7340,290,1981435
5676,6800,2019-01-24,0.04755244755244755,7150,7490,340,5297098
5677,6800,2019-01-15,0.04606240713224369,6730,7040,310,4298158
5678,6800,2019-01-07,0.0484375,6400,6710,310,2599575
5679,6800,2018-11-06,0.042899408284023666,6760,7050,290,3179272
5680,6800,2018-11-02,0.07751937984496124,6450,6950,500,3605496
5681,6800,2018-10-11,0.0693717277486911,7640,7110,-530,4563308
5682,6800,2018-08-13,0.04150943396226415,7950,7620,-330,3961139
5683,6800,2018-07-02,0.046948356807511735,8520,8120,-400,3240268
5684,6800,2018-05-30,0.048879837067209775,9820,9340,-480,4680330
5685,6800,2018-05-11,0.05345911949685535,9540,10050,510,7460206
5686,6800,2018-03-23,0.049163179916317995,9560,9090,-470,4821340
5687,6800,2018-03-09,0.050920910075839654,9230,9700,470,5252509
5688,6800,2018-03-06,0.0436241610738255,8940,9330,390,3338487
5689,6800,2018-01-23,0.09164969450101833,9820,10500,680,8053335
5690,6800,2017-12-18,0.1346153846153846,10400,9000,-1400,18243412
5691,6800,2017-12-15,0.045871559633027525,10900,10400,-500,7305919
5692,6800,2017-11-22,0.06220095693779904,10450,11100,650,12474819
5693,6800,2017-11-15,0.04477611940298507,10050,10500,450,6504939
5694,6800,2017-10-18,0.04128440366972477,10900,10450,-450,3455422
5695,6800,2017-10-12,0.04455445544554455,10100,10550,450,6041312
5696,6800,2017-09-18,0.04411764705882353,10200,10650,450,5529504
5697,6800,2017-09-07,0.04831932773109244,9520,9980,460,2994815
5698,6800,2017-08-03,0.04524886877828054,11050,10550,-500,6219174
5699,6800,2017-07-28,0.044642857142857144,11200,10700,-500,5977846
5700,6800,2017-06-29,0.056338028169014086,10650,11250,600,12223296
5701,6800,2017-06-09,0.05858170606372045,9730,10300,570,11849953
5702,6800,2017-02-06,0.05847953216374269,8550,9050,500,10594749
5703,6800,2017-01-26,0.04637336504161712,8410,8800,390,6423039
5704,6800,2017-01-17,0.05575326215895611,8430,8900,470,4900806
5705,6800,2017-01-11,0.05125,8000,8410,410,4428570
5706,6800,2017-01-04,0.04041720990873533,7670,7980,310,4203488
5707,6800,2016-11-21,0.053735255570117955,7630,7220,-410,3032409
5708,6800,2016-08-02,0.0407040704070407,9090,8720,-370,3262504
5709,660,2021-05-11,0.05384615384615385,130000,123000,-7000,9882491
5710,660,2021-04-21,0.04332129963898917,138500,132500,-6000,5120577
5711,660,2021-04-01,0.06037735849056604,132500,140500,8000,5833436
5712,660,2021-02-26,0.04713804713804714,148500,141500,-7000,10843268
5713,660,2021-02-25,0.09191176470588236,136000,148500,12500,9936495
5714,660,2021-02-19,0.05555555555555555,126000,133000,7000,6986526
5715,660,2021-02-15,0.047619047619047616,126000,132000,6000,5384526
5716,660,2021-02-02,0.04,125000,130000,5000,4880067
5717,660,2021-01-28,0.042801556420233464,128500,123000,-5500,6270829
5718,660,2021-01-26,0.044444444444444446,135000,129000,-6000,6270106
5719,660,2021-01-25,0.05058365758754864,128500,135000,6500,5061864
5720,660,2021-01-04,0.06329113924050633,118500,126000,7500,7995016
5721,660,2020-12-09,0.04782608695652174,115000,120500,5500,5490760
5722,660,2020-12-02,0.0845771144278607,100500,109000,8500,7488361
5723,660,2020-11-16,0.09253065774804906,89700,98000,8300,9274278
5724,660,2020-09-03,0.0423841059602649,75500,78700,3200,7002529
5725,660,2020-08-20,0.042666666666666665,75000,71800,-3200,7260223
5726,660,2020-06-16,0.041463414634146344,82000,85400,3400,3518785
5727,660,2020-06-03,0.06482593037214886,83300,88700,5400,11642239
5728,660,2020-04-06,0.04396984924623116,79600,83100,3500,5784159
5729,660,2020-04-01,0.058823529411764705,83300,78400,-4900,6845675
5730,660,2020-03-26,0.04497041420118343,84500,80700,-3800,7895289
5731,660,2020-03-25,0.07369758576874205,78700,84500,5800,8787217
5732,660,2020-03-24,0.1340057636887608,69400,78700,9300,7247345
5733,660,2020-03-23,0.07219251336898395,74800,69400,-5400,8192363
5734,660,2020-03-20,0.08405797101449275,69000,74800,5800,8750101
5735,660,2020-03-19,0.0560875512995896,73100,69000,-4100,11140367
5736,660,2020-03-18,0.09079601990049752,80400,73100,-7300,7949482
5737,660,2020-03-11,0.04040404040404041,89100,85500,-3600,5226251
5738,660,2020-03-09,0.061555075593952485,92600,86900,-5700,6196552
5739,660,2020-03-02,0.04778156996587031,87900,92100,4200,6382279
5740,660,2020-02-28,0.052801724137931036,92800,87900,-4900,8171939
5741,660,2019-12-17,0.04740406320541761,88600,92800,4200,5070618
5742,660,2019-12-13,0.0539568345323741,83400,87900,4500,5831965
5743,660,2019-10-18,0.044444444444444446,81000,77400,-3600,13625664
5744,660,2019-08-30,0.05593451568894952,73300,77400,4100,3839246
5745,660,2019-08-06,0.04509283819628647,75400,72000,-3400,5008247
5746,660,2019-07-10,0.044412607449856735,69800,72900,3100,4346179
5747,660,2019-06-19,0.05993690851735016,63400,67200,3800,6230370
5748,660,2019-05-09,0.053549190535491904,80300,76000,-4300,5939278
5749,660,2019-04-03,0.04581151832460733,76400,79900,3500,4674142
5750,660,2019-03-25,0.04204993429697766,76100,72900,-3200,3752230
5751,660,2019-03-21,0.07659574468085106,70500,75900,5400,10030131
5752,660,2019-02-28,0.050203527815468114,73700,70000,-3700,7869451
5753,660,2019-02-15,0.046511627906976744,77400,73800,-3600,4154616
5754,660,2019-02-08,0.041720990873533245,76700,73500,-3200,4012485
5755,660,2019-01-25,0.05815602836879433,70500,74600,4100,7163871
5756,660,2019-01-24,0.05538922155688623,66800,70500,3700,6914092
5757,660,2019-01-14,0.04608294930875576,65100,62100,-3000,3282892
5758,660,2019-01-09,0.07432432432432433,59200,63600,4400,4928656
5759,660,2019-01-03,0.04785478547854786,60600,57700,-2900,3337621
5760,660,2018-12-14,0.05648854961832061,65500,61800,-3700,5617675
5761,660,2018-11-02,0.0629575402635432,68300,72600,4300,5334082
5762,660,2018-10-12,0.04927536231884058,69000,72400,3400,4882184
5763,660,2018-09-14,0.042953020134228186,74500,77700,3200,4124842
5764,660,2018-08-21,0.049531459170013385,74700,78400,3700,5663191
5765,660,2018-08-06,0.0468187274909964,83300,79400,-3900,5910100
5766,660,2018-07-23,0.07053469852104664,87900,81700,-6200,7076375
5767,660,2018-06-25,0.05251396648044693,89500,84800,-4700,4420542
5768,660,2018-06-20,0.04399524375743163,84100,87800,3700,4183210
5769,660,2018-05-23,0.06958473625140292,89100,95300,6200,10378915
5770,660,2018-04-26,0.04975728155339806,82400,86500,4100,7551747
5771,660,2018-03-23,0.062076749435665914,88600,83100,-5500,7310739
5772,660,2018-03-13,0.06007067137809187,84900,90000,5100,8775741
5773,660,2018-03-06,0.05236270753512133,78300,82400,4100,7588369
5774,660,2018-02-13,0.042953020134228186,74500,77700,3200,7814367
5775,660,2018-01-25,0.04696132596685083,72400,75800,3400,8758929
5776,660,2018-01-10,0.05201560468140442,76900,72900,-4000,9123901
5777,660,2017-11-30,0.06796116504854369,82400,76800,-5600,11213748
5778,660,2017-10-23,0.04310344827586207,81200,84700,3500,5388391
5779,660,2017-10-10,0.06996381182147166,82900,88700,5800,7956055
5780,660,2017-09-26,0.04866743916570104,86300,82100,-4200,11035272
5781,660,2017-08-14,0.06026058631921824,61400,65100,3700,5239246
5782,660,2017-08-11,0.046583850931677016,64400,61400,-3000,6664578
5783,660,2017-07-28,0.05555555555555555,68400,64600,-3800,8093780
5784,660,2017-07-26,0.05113636363636364,70400,66800,-3600,9659618
5785,660,2017-03-17,0.048830111902339775,49150,46750,-2400,8098258
5786,660,2017-03-06,0.04777070063694268,47100,49350,2250,5045970
5787,660,2017-02-24,0.053784860557768925,50200,47500,-2700,7707747
5788,660,2017-02-14,0.04437869822485207,50700,48450,-2250,8593878
5789,660,2017-02-10,0.051233396584440226,52700,50000,-2700,9120878
5790,660,2016-11-22,0.04785276073619632,40750,42700,1950,3306186
5791,660,2016-11-09,0.04457831325301205,41500,39650,-1850,5779291
5792,660,2016-10-26,0.04506699147381242,41050,42900,1850,6364037
5793,660,2016-09-27,0.04177215189873418,39500,41150,1650,4001505
5794,660,2016-09-12,0.05006418485237484,38950,37000,-1950,4885896
5795,150,2021-06-03,0.04555555555555556,90000,85900,-4100,258722
5796,150,2021-06-02,0.07270560190703218,83900,90000,6100,403484
5797,150,2021-06-01,0.04004576659038902,87400,83900,-3500,263498
5798,150,2021-05-27,0.04878048780487805,82000,86000,4000,335102
5799,150,2021-05-24,0.049664429530201344,74500,78200,3700,250163
5800,150,2021-05-21,0.04118404118404118,77700,74500,-3200,302263
5801,150,2021-05-20,0.08217270194986072,71800,77700,5900,273040
5802,150,2021-05-12,0.05352112676056338,71000,67200,-3800,225187
5803,150,2021-05-10,0.07350689127105667,65300,70100,4800,267434
5804,150,2021-05-04,0.048558421851289835,65900,62700,-3200,178237
5805,150,2021-05-03,0.04272151898734177,63200,65900,2700,354628
5806,150,2021-04-29,0.04220779220779221,61600,64200,2600,412950
5807,150,2021-04-28,0.09608540925266904,56200,61600,5400,1076502
5808,150,2021-01-29,0.05514705882352941,54400,51400,-3000,169712
5809,150,2021-01-22,0.06363636363636363,55000,58500,3500,424348
5810,150,2021-01-18,0.0576271186440678,59000,55600,-3400,288788
5811,150,2021-01-15,0.04424778761061947,56500,59000,2500,1215883
5812,150,2021-01-14,0.1254980079681275,50200,56500,6300,814103
5813,150,2021-01-11,0.05762081784386617,53800,50700,-3100,328376
5814,150,2020-12-29,0.059033989266547404,55900,52600,-3300,235421
5815,150,2020-12-11,0.06427221172022685,52900,56300,3400,392376
5816,150,2020-11-24,0.07351460221550855,49650,53300,3650,343948
5817,150,2020-10-26,0.04257528556593977,48150,46100,-2050,62137
5818,150,2020-10-12,0.04112554112554113,46200,48100,1900,106447
5819,150,2020-09-28,0.0518018018018018,44400,46700,2300,84941
5820,150,2020-09-09,0.04878048780487805,53300,50700,-2600,285628
5821,150,2020-09-08,0.07142857142857142,57400,53300,-4100,800664
5822,150,2020-09-07,0.26850828729281767,45250,57400,12150,1651663
5823,150,2020-08-31,0.07027649769585254,43400,46450,3050,326981
5824,150,2020-08-20,0.06074240719910011,44450,41750,-2700,159795
5825,150,2020-08-18,0.042483660130718956,45900,43950,-1950,106368
5826,150,2020-07-30,0.06359649122807018,45600,48500,2900,333304
5827,150,2020-07-29,0.07674144037780402,42350,45600,3250,354438
5828,150,2020-07-24,0.040313549832026875,44650,42850,-1800,152915
5829,150,2020-07-23,0.05502645502645503,47250,44650,-2600,218996
5830,150,2020-07-21,0.17208182912154033,41550,48700,7150,1627475
5831,150,2020-07-20,0.08062418725617686,38450,41550,3100,355258
5832,150,2020-06-25,0.04449938195302843,40450,38650,-1800,76825
5833,150,2020-06-17,0.08198489751887811,46350,42550,-3800,332994
5834,150,2020-06-16,0.15875,40000,46350,6350,541916
5835,150,2020-06-15,0.06103286384976526,42600,40000,-2600,145824
5836,150,2020-06-11,0.07021276595744681,47000,43700,-3300,266832
5837,150,2020-06-09,0.04060913705583756,49250,47250,-2000,328212
5838,150,2020-06-08,0.10549943883277217,44550,49250,4700,684824
5839,150,2020-06-05,0.12927756653992395,39450,44550,5100,1066872
5840,150,2020-05-19,0.04397163120567376,35250,36800,1550,120304
5841,150,2020-05-15,0.06535947712418301,38250,35750,-2500,256963
5842,150,2020-05-04,0.04584882280049566,40350,38500,-1850,125954
5843,150,2020-04-28,0.08111702127659574,37600,40650,3050,267451
5844,150,2020-04-16,0.0421455938697318,39150,37500,-1650,171479
5845,150,2020-04-09,0.08638743455497382,38200,41500,3300,293091
5846,150,2020-04-01,0.04790419161676647,33400,35000,1600,521830
5847,150,2020-03-31,0.059154929577464786,35500,33400,-2100,347969
5848,150,2020-03-30,0.08857509627727857,38950,35500,-3450,316367
5849,150,2020-03-27,0.06420765027322405,36600,38950,2350,294236
5850,150,2020-03-25,0.08128834355828221,32600,35250,2650,228536
5851,150,2020-03-24,0.20517560073937152,27050,32600,5550,129758
5852,150,2020-03-20,0.07293666026871401,26050,27950,1900,190652
5853,150,2020-03-19,0.19598765432098766,32400,26050,-6350,286987
5854,150,2020-03-18,0.09749303621169916,35900,32400,-3500,153797
5855,150,2020-03-17,0.043941411451398134,37550,35900,-1650,181710
5856,150,2020-03-13,0.13198573127229488,42050,36500,-5550,445066
5857,150,2020-03-12,0.09277238403451996,46350,42050,-4300,367920
5858,150,2020-03-11,0.16786355475763015,55700,46350,-9350,644998
5859,150,2020-02-28,0.05102040816326531,58800,55800,-3000,105963
5860,150,2019-12-10,0.04747320061255743,65300,68400,3100,107411
5861,150,2019-09-26,0.04433497536945813,101500,106000,4500,353315
5862,150,2019-09-25,0.0514018691588785,107000,101500,-5500,188041
5863,150,2019-09-10,0.043478260869565216,103500,108000,4500,154248
5864,150,2019-08-05,0.052216748768472904,101500,96200,-5300,100992
5865,150,2019-07-26,0.05102040816326531,98000,103000,5000,256734
5866,150,2019-06-14,0.05456453305351522,95300,100500,5200,119688
5867,150,2019-05-28,0.051,100000,94900,-5100,996341
5868,150,2019-04-16,0.08121827411167512,98500,106500,8000,369716
5869,150,2019-03-28,0.04697286012526096,95800,91300,-4500,106508
5870,150,2019-02-14,0.07464114832535886,104500,96700,-7800,508271
5871,150,2019-02-13,0.0752212389380531,113000,104500,-8500,248996
5872,150,2019-01-18,0.07272727272727272,110000,118000,8000,195112
5873,150,2019-01-02,0.06278026905829596,111500,104500,-7000,67723
5874,150,2018-12-17,0.044534412955465584,123500,118000,-5500,58919
5875,150,2018-11-28,0.040160642570281124,124500,119500,-5000,157521
5876,150,2018-11-02,0.046413502109704644,118500,124000,5500,64090
5877,150,2018-09-11,0.07936507936507936,126000,136000,10000,316760
5878,150,2018-08-28,0.046511627906976744,107500,112500,5000,96024
5879,150,2018-08-03,0.04807692307692308,104000,109000,5000,116887
5880,150,2018-04-30,0.05217391304347826,115000,121000,6000,167540
5881,150,2018-02-09,0.05092592592592592,108000,113500,5500,127934
5882,150,2018-01-18,0.045081967213114756,122000,116500,-5500,87167
5883,150,2018-01-10,0.05042016806722689,119000,125000,6000,146525
5884,150,2017-12-27,0.07228915662650602,124500,115500,-9000,136674
5885,150,2017-12-20,0.05106382978723404,117500,123500,6000,80053
5886,150,2017-12-05,0.07723577235772358,123000,132500,9500,66423
5887,150,2017-11-15,0.048507462686567165,134000,127500,-6500,83894
5888,150,2017-09-15,0.040740740740740744,135000,140500,5500,51275
5889,150,2017-09-13,0.0421455938697318,130500,136000,5500,120351
5890,150,2017-08-17,0.043137254901960784,127500,133000,5500,59221
5891,150,2017-08-01,0.09745762711864407,118000,129500,11500,124508
5892,150,2017-06-09,0.10666666666666667,112500,124500,12000,241801
5893,150,2017-05-23,0.04672897196261682,107000,112000,5000,162638
5894,150,2017-02-28,0.05247524752475247,101000,95700,-5300,233067
5895,150,2016-12-28,0.05217391304347826,115000,109000,-6000,79495
5896,150,2016-11-11,0.06542056074766354,107000,114000,7000,145031
5897,150,2016-11-10,0.07537688442211055,99500,107000,7500,117412
5898,150,2016-10-07,0.05188679245283019,106000,100500,-5500,140599
5899,150,2016-08-22,0.046413502109704644,118500,113000,-5500,85111
5900,150,2016-08-05,0.056074766355140186,107000,113000,6000,129277
5901,111770,2021-05-21,0.059003051881993895,49150,46250,-2900,294400
5902,111770,2021-05-18,0.040339702760084924,47100,49000,1900,282454
5903,111770,2021-05-13,0.04045643153526971,48200,46250,-1950,262358
5904,111770,2021-05-10,0.09859154929577464,42600,46800,4200,455571
5905,111770,2021-05-06,0.041044776119402986,40200,41850,1650,167514
5906,111770,2021-05-03,0.06378132118451026,43900,41100,-2800,205924
5907,111770,2021-04-20,0.05721393034825871,40200,42500,2300,340471
5908,111770,2021-03-18,0.04177215189873418,39500,41150,1650,232643
5909,111770,2021-03-08,0.05944055944055944,42900,40350,-2550,232670
5910,111770,2021-02-25,0.06744487678339818,38550,41150,2600,200938
5911,111770,2021-02-24,0.04697156983930779,40450,38550,-1900,227133
5912,111770,2021-01-05,0.04180064308681672,31100,32400,1300,273065
5913,111770,2020-12-11,0.07028753993610223,31300,33500,2200,465279
5914,111770,2020-12-02,0.044481054365733116,30350,31700,1350,280376
5915,111770,2020-11-16,0.06495726495726496,29250,31150,1900,456654
5916,111770,2020-11-10,0.0642361111111111,28800,30650,1850,353762
5917,111770,2020-10-29,0.04560260586319218,30700,29300,-1400,174323
5918,111770,2020-10-28,0.05317324185248713,29150,30700,1550,122942
5919,111770,2020-10-26,0.04952076677316294,31300,29750,-1550,93331
5920,111770,2020-10-21,0.05679862306368331,29050,30700,1650,551189
5921,111770,2020-09-24,0.06618962432915922,27950,26100,-1850,304494
5922,111770,2020-09-08,0.04043545878693624,32150,30850,-1300,177654
5923,111770,2020-09-07,0.07885906040268456,29800,32150,2350,357587
5924,111770,2020-08-31,0.06440677966101695,29500,31400,1900,546551
5925,111770,2020-08-26,0.04020100502512563,29850,28650,-1200,293326
5926,111770,2020-08-24,0.07142857142857142,28000,30000,2000,659663
5927,111770,2020-08-21,0.13360323886639677,24700,28000,3300,788018
5928,111770,2020-08-20,0.060836501901140684,26300,24700,-1600,242358
5929,111770,2020-08-12,0.042884990253411304,25650,26750,1100,347891
5930,111770,2020-08-10,0.052854122621564484,23650,24900,1250,320605
5931,111770,2020-06-25,0.046296296296296294,27000,25750,-1250,230078
5932,111770,2020-06-22,0.04006968641114982,28700,27550,-1150,186822
5933,111770,2020-06-16,0.058394160583941604,27400,29000,1600,136033
5934,111770,2020-06-15,0.0711864406779661,29500,27400,-2100,190305
5935,111770,2020-06-12,0.045307443365695796,30900,29500,-1400,171598
5936,111770,2020-06-04,0.041116005873715125,34050,32650,-1400,282341
5937,111770,2020-06-02,0.06451612903225806,32550,34650,2100,338659
5938,111770,2020-06-01,0.06199021207177814,30650,32550,1900,272410
5939,111770,2020-05-28,0.0589171974522293,31400,29550,-1850,246544
5940,111770,2020-05-22,0.040492957746478875,28400,29550,1150,572141
5941,111770,2020-05-21,0.07984790874524715,26300,28400,2100,507400
5942,111770,2020-05-18,0.07331975560081466,24550,26350,1800,320305
5943,111770,2020-05-12,0.04085603112840467,25700,24650,-1050,142304
5944,111770,2020-04-28,0.04198473282442748,26200,27300,1100,230126
5945,111770,2020-04-27,0.06720977596741344,24550,26200,1650,274391
5946,111770,2020-04-16,0.04938271604938271,24300,23100,-1200,328044
5947,111770,2020-04-09,0.05970149253731343,23450,24850,1400,154214
5948,111770,2020-04-07,0.04112554112554113,23100,24050,950,178703
5949,111770,2020-03-26,0.05289672544080604,19850,20900,1050,295158
5950,111770,2020-03-25,0.06720430107526881,18600,19850,1250,337818
5951,111770,2020-03-23,0.11510791366906475,20850,18450,-2400,147012
5952,111770,2020-03-20,0.18803418803418803,17550,20850,3300,250659
5953,111770,2020-03-19,0.17798594847775176,21350,17550,-3800,403089
5954,111770,2020-03-17,0.055793991416309016,23300,22000,-1300,168940
5955,111770,2020-03-12,0.05904761904761905,26250,24700,-1550,284438
5956,111770,2020-03-09,0.08094435075885328,29650,27250,-2400,319714
5957,111770,2020-03-06,0.04508856682769726,31050,29650,-1400,204749
5958,111770,2020-02-06,0.06440677966101695,29500,31400,1900,225387
5959,111770,2020-01-28,0.05206738131699847,32650,30950,-1700,183164
5960,111770,2020-01-09,0.04160246533127889,32450,33800,1350,209342
5961,111770,2019-12-09,0.04201680672268908,35700,34200,-1500,196935
5962,111770,2019-11-15,0.047345767575322814,34850,36500,1650,247600
5963,111770,2019-11-04,0.04781997187060478,35550,37250,1700,124979
5964,111770,2019-09-20,0.04727793696275072,34900,36550,1650,166831
5965,111770,2019-08-14,0.0423728813559322,35400,36900,1500,183874
5966,111770,2019-08-13,0.06146926536731634,33350,35400,2050,120538
5967,111770,2019-06-05,0.05774278215223097,38100,40300,2200,145244
5968,111770,2019-05-30,0.043478260869565216,40250,38500,-1750,301954
5969,111770,2019-05-20,0.04702970297029703,40400,42300,1900,323929
5970,111770,2019-05-16,0.11354309165526676,36550,40700,4150,626016
5971,111770,2019-05-09,0.04580152671755725,39300,37500,-1800,143136
5972,111770,2019-05-08,0.04105960264900662,37750,39300,1550,219293
5973,111770,2019-04-11,0.0506155950752394,36550,38400,1850,298096
5974,111770,2019-04-05,0.04782608695652174,34500,36150,1650,296726
5975,111770,2019-04-04,0.04387291981845688,33050,34500,1450,220323
5976,111770,2019-03-12,0.05573248407643312,31400,33150,1750,188229
5977,111770,2019-03-08,0.06596701649175413,33350,31150,-2200,463817
5978,111770,2019-03-05,0.07320441988950276,36200,33550,-2650,435959
5979,111770,2019-02-13,0.06095791001451379,34450,36550,2100,205905
5980,111770,2019-01-11,0.05576679340937896,39450,37250,-2200,198573
5981,111770,2019-01-09,0.0492676431424767,37550,39400,1850,209262
5982,111770,2019-01-08,0.05329593267882188,35650,37550,1900,127837
5983,111770,2019-01-03,0.0607661822985469,37850,35550,-2300,159117
5984,111770,2018-12-28,0.04638472032742155,36650,38350,1700,151588
5985,111770,2018-11-27,0.05781057810578106,40650,38300,-2350,219994
5986,111770,2018-11-19,0.046008119079837616,36950,38650,1700,162299
5987,111770,2018-11-15,0.0502092050209205,35850,37650,1800,175496
5988,111770,2018-10-31,0.04685212298682284,34150,35750,1600,229730
5989,111770,2018-10-29,0.056818181818181816,35200,33200,-2000,117101
5990,111770,2018-10-05,0.04,40000,38400,-1600,161991
5991,111770,2018-10-04,0.04849279161205767,38150,40000,1850,220422
5992,111770,2018-09-11,0.08011049723756906,36200,39100,2900,385990
5993,111770,2018-08-16,0.05329153605015674,31900,33600,1700,464302
5994,111770,2018-08-14,0.08503401360544217,29400,31900,2500,360984
5995,111770,2018-07-19,0.04700162074554295,30850,29400,-1450,193064
5996,111770,2018-06-20,0.04671532846715328,34250,35850,1600,296561
5997,111770,2018-06-11,0.059602649006622516,30200,32000,1800,141465
5998,111770,2018-05-16,0.046031746031746035,31500,32950,1450,249134
5999,111770,2018-03-23,0.04569420035149385,28450,27150,-1300,85283
6000,111770,2018-03-05,0.05944055944055944,28600,26900,-1700,158903
6001,111770,2018-02-01,0.04231974921630094,31900,33250,1350,237360
6002,111770,2017-11-15,0.05760709010339734,33850,31900,-1950,399443
6003,111770,2017-10-31,0.07651006711409396,37250,34400,-2850,326984
6004,111770,2017-10-30,0.04781997187060478,35550,37250,1700,207644
6005,111770,2017-10-24,0.09752321981424149,32300,35450,3150,340727
6006,111770,2017-10-11,0.04938271604938271,32400,34000,1600,152179
6007,111770,2017-09-26,0.04213938411669368,30850,32150,1300,70424
6008,111770,2017-08-09,0.04032258064516129,31000,32250,1250,245026
6009,111770,2017-07-21,0.041428571428571426,35000,33550,-1450,158460
6010,111770,2017-05-30,0.059420289855072465,34500,36550,2050,383471
6011,111770,2017-04-11,0.0471841704718417,32850,34400,1550,183758
6012,111770,2017-04-07,0.049689440993788817,32200,33800,1600,229615
6013,111770,2017-03-07,0.050488599348534204,30700,32250,1550,224308
6014,111770,2017-02-27,0.04477611940298507,30150,31500,1350,626942
6015,111770,2017-02-13,0.0686106346483705,29150,31150,2000,541963
6016,111770,2017-02-10,0.05045045045045045,27750,29150,1400,660921
6017,111770,2017-02-07,0.04267161410018553,26950,28100,1150,280074
6018,111770,2017-01-03,0.0496,31250,29700,-1550,260688
6019,111770,2016-12-23,0.07731958762886598,29100,31350,2250,283024
6020,111770,2016-12-13,0.0549645390070922,28200,29750,1550,357092
6021,111770,2016-12-12,0.04059040590405904,27100,28200,1100,272622
6022,111770,2016-11-09,0.04092526690391459,28100,26950,-1150,723942
6023,111770,2016-11-07,0.13935681470137826,32650,28100,-4550,1383652
6024,111770,2016-10-14,0.050666666666666665,37500,35600,-1900,322725
6025,111770,2016-09-22,0.058577405857740586,35850,37950,2100,484181
6026,111770,2016-09-05,0.04457652303120357,33650,35150,1500,223639
6027,111770,2016-08-22,0.06047819971870605,35550,33400,-2150,571535
6028,111770,2016-08-09,0.049531459170013385,37350,39200,1850,311360
6029,111770,2016-08-02,0.043115438108484005,35950,37500,1550,313784
6030,97950,2021-05-25,0.04983388704318937,451500,474000,22500,119605
6031,97950,2021-05-11,0.04367816091954023,435000,454000,19000,353489
6032,97950,2021-05-07,0.04785276073619632,407500,427000,19500,199457
6033,97950,2021-02-24,0.04107981220657277,426000,408500,-17500,124623
6034,97950,2021-02-09,0.0517051705170517,454500,431000,-23500,221723
6035,97950,2021-01-29,0.05333333333333334,450000,426000,-24000,113415
6036,97950,2021-01-25,0.06200676437429538,443500,471000,27500,156650
6037,97950,2021-01-08,0.06790123456790123,405000,432500,27500,288067
6038,97950,2021-01-05,0.07802340702210664,384500,414500,30000,334236
6039,97950,2020-11-04,0.06611570247933884,363000,387000,24000,93504
6040,97950,2020-09-10,0.0692410119840213,375500,401500,26000,172970
6041,97950,2020-08-12,0.06538895152198422,443500,414500,-29000,277899
6042,97950,2020-08-03,0.07253886010362694,386000,414000,28000,216845
6043,97950,2020-07-31,0.051771117166212535,367000,386000,19000,147404
6044,97950,2020-07-09,0.055248618784530384,362000,382000,20000,137719
6045,97950,2020-07-02,0.051622418879056046,339000,356500,17500,107583
6046,97950,2020-06-16,0.0631911532385466,316500,336500,20000,130120
6047,97950,2020-06-10,0.07855973813420622,305500,329500,24000,207335
6048,97950,2020-05-19,0.04383116883116883,308000,294500,-13500,159699
6049,97950,2020-05-12,0.051188299817184646,273500,287500,14000,115839
6050,97950,2020-05-06,0.05719557195571956,271000,286500,15500,106384
6051,97950,2020-04-27,0.05791505791505792,259000,274000,15000,122239
6052,97950,2020-04-23,0.059322033898305086,236000,250000,14000,103721
6053,97950,2020-04-06,0.0650759219088937,230500,245500,15000,83605
6054,97950,2020-04-02,0.06542056074766354,214000,228000,14000,80386
6055,97950,2020-03-30,0.04914004914004914,203500,213500,10000,65338
6056,97950,2020-03-25,0.06282722513089005,191000,203000,12000,98228
6057,97950,2020-03-24,0.1072463768115942,172500,191000,18500,97920
6058,97950,2020-03-23,0.08244680851063829,188000,172500,-15500,84035
6059,97950,2020-03-20,0.2129032258064516,155000,188000,33000,191267
6060,97950,2020-03-19,0.2619047619047619,210000,155000,-55000,263704
6061,97950,2020-03-13,0.05531914893617021,235000,222000,-13000,108516
6062,97950,2020-03-12,0.044715447154471545,246000,235000,-11000,83591
6063,97950,2020-02-28,0.05791505791505792,259000,244000,-15000,75193
6064,97950,2020-02-12,0.045098039215686274,255000,266500,11500,92748
6065,97950,2020-02-11,0.045081967213114756,244000,255000,11000,85958
6066,97950,2019-12-10,0.05845511482254697,239500,253500,14000,94999
6067,97950,2019-11-12,0.07563025210084033,238000,256000,18000,151898
6068,97950,2019-10-02,0.04535637149028078,231500,221000,-10500,90728
6069,97950,2019-08-09,0.08823529411764706,272000,248000,-24000,226654
6070,97950,2019-01-04,0.042682926829268296,328000,342000,14000,51429
6071,97950,2018-11-15,0.05856515373352855,341500,361500,20000,82231
6072,97950,2018-10-11,0.04,325000,312000,-13000,64661
6073,97950,2018-06-07,0.04120879120879121,364000,379000,15000,164708
6074,97950,2018-05-10,0.05116959064327485,342000,359500,17500,188281
6075,97950,2018-02-23,0.05216095380029806,335500,353000,17500,116816
6076,97950,2018-02-09,0.048672566371681415,339000,322500,-16500,134942
6077,97950,2017-12-19,0.07026348808030113,398500,370500,-28000,231869
6078,97950,2017-12-15,0.059445178335535004,378500,401000,22500,45427
6079,97950,2017-12-14,0.05610972568578554,401000,378500,-22500,62211
6080,97950,2017-11-20,0.04140526976160602,398500,415000,16500,110912
6081,97950,2017-11-09,0.0738255033557047,372500,400000,27500,271286
6082,97950,2017-11-03,0.047685834502103785,356500,373500,17000,57673
6083,97950,2017-02-10,0.05106382978723404,352500,370500,18000,78725
6084,97950,2017-02-06,0.042134831460674156,356000,371000,15000,92238
6085,97950,2016-11-29,0.04377564979480164,365500,381500,16000,83067
6086,97950,2016-11-03,0.06942392909896603,338500,362000,23500,92023
6087,670,2021-05-13,0.053691275167785234,745000,705000,-40000,4940
6088,670,2021-05-10,0.06571428571428571,700000,746000,46000,4788
6089,670,2021-05-06,0.046199701937406856,671000,702000,31000,2789
6090,670,2021-04-30,0.04366197183098591,710000,679000,-31000,4398
6091,670,2021-04-27,0.04179566563467492,646000,673000,27000,4436
6092,670,2021-02-26,0.043209876543209874,648000,620000,-28000,3199
6093,670,2021-02-23,0.04628099173553719,605000,633000,28000,11072
6094,670,2021-02-22,0.055846422338568937,573000,605000,32000,8183
6095,670,2021-02-17,0.045207956600361664,553000,578000,25000,7512
6096,670,2021-01-11,0.05410122164048865,573000,542000,-31000,4899
6097,670,2021-01-05,0.04814814814814815,540000,566000,26000,4895
6098,670,2020-08-20,0.057729941291585124,511000,481500,-29500,4691
6099,670,2020-08-12,0.044802867383512544,558000,533000,-25000,4688
6100,670,2020-08-07,0.06776556776556776,546000,583000,37000,8873
6101,670,2020-07-31,0.04220183486238532,545000,522000,-23000,2449
6102,670,2020-07-27,0.05588822355289421,501000,529000,28000,4199
6103,670,2020-07-22,0.04918032786885246,488000,512000,24000,6933
6104,670,2020-06-15,0.043824701195219126,502000,480000,-22000,2696
6105,670,2020-05-14,0.043151969981238276,533000,510000,-23000,2473
6106,670,2020-05-11,0.05534351145038168,524000,553000,29000,3898
6107,670,2020-05-04,0.04126679462571977,521000,499500,-21500,2480
6108,670,2020-04-07,0.0607621009268795,485500,515000,29500,2607
6109,670,2020-03-25,0.07202881152460984,416500,446500,30000,3509
6110,670,2020-03-24,0.08463541666666667,384000,416500,32500,3555
6111,670,2020-03-23,0.12228571428571429,437500,384000,-53500,3109
6112,670,2020-03-20,0.08024691358024691,405000,437500,32500,5724
6113,670,2020-03-19,0.09899888765294772,449500,405000,-44500,3173
6114,670,2020-03-18,0.06935817805383022,483000,449500,-33500,2031
6115,670,2020-03-17,0.05108055009823183,509000,483000,-26000,2209
6116,670,2020-03-11,0.04753199268738574,547000,521000,-26000,2745
6117,670,2020-02-24,0.048286604361370715,642000,611000,-31000,1664
6118,670,2019-12-13,0.04552352048558422,659000,629000,-30000,3290
6119,670,2019-11-04,0.05737704918032787,610000,645000,35000,985
6120,670,2019-10-18,0.049069373942470386,591000,620000,29000,4161
6121,670,2019-06-13,0.04702627939142462,723000,757000,34000,2667
6122,670,2019-06-03,0.07670454545454546,704000,758000,54000,3810
6123,670,2019-05-07,0.041223404255319146,752000,721000,-31000,2791
6124,670,2019-04-05,0.04433497536945813,812000,848000,36000,2435
6125,670,2018-12-18,0.05867014341590613,767000,722000,-45000,3114
6126,670,2018-11-02,0.0421875,640000,667000,27000,2380
6127,670,2018-10-11,0.05416116248348745,757000,716000,-41000,1729
6128,670,2018-07-04,0.045572916666666664,768000,733000,-35000,3221
6129,670,2018-05-14,0.0429732868757259,861000,898000,37000,3372
6130,670,2018-01-22,0.045368620037807186,1058000,1010000,-48000,5540
6131,670,2018-01-09,0.040627885503231764,1083000,1127000,44000,3224
6132,670,2017-12-05,0.0624390243902439,1025000,1089000,64000,15485
6133,670,2017-12-04,0.14583333333333334,1200000,1025000,-175000,18257
6134,670,2017-11-15,0.05705996131528046,1034000,1093000,59000,5971
6135,670,2017-10-27,0.05320108205590622,1109000,1168000,59000,3103
6136,670,2017-06-26,0.04303086997193639,1069000,1115000,46000,3619
6137,670,2017-03-30,0.06904231625835189,898000,960000,62000,6715
6138,670,2016-09-05,0.048507462686567165,1072000,1124000,52000,1812
6139,12450,2021-05-25,0.12528735632183907,43500,48950,5450,5914845
6140,12450,2021-05-06,0.05100671140939597,37250,39150,1900,540969
6141,12450,2021-03-11,0.11336032388663968,37050,41250,4200,1940345
6142,12450,2021-02-26,0.05141388174807198,38900,36900,-2000,1013867
6143,12450,2021-02-24,0.05693069306930693,40400,38100,-2300,1010963
6144,12450,2021-02-10,0.05997552019583843,40850,43300,2450,1351918
6145,12450,2021-02-04,0.04609929078014184,42300,44250,1950,2641000
6146,12450,2021-01-28,0.04812206572769953,42600,40550,-2050,1182716
6147,12450,2021-01-27,0.04484304932735426,44600,42600,-2000,1361488
6148,12450,2021-01-25,0.07894736842105263,39900,43050,3150,1797615
6149,12450,2021-01-22,0.052256532066508314,42100,39900,-2200,1300089
6150,12450,2021-01-20,0.04980842911877394,39150,41100,1950,2832400
6151,12450,2021-01-18,0.07649513212795549,35950,38700,2750,4354287
6152,12450,2021-01-15,0.10615384615384615,32500,35950,3450,3417300
6153,12450,2021-01-12,0.055031446540880505,31800,33550,1750,2251689
6154,12450,2021-01-08,0.0633116883116883,30800,32750,1950,2066290
6155,12450,2021-01-04,0.0456140350877193,28500,29800,1300,908760
6156,12450,2020-11-10,0.04364326375711575,26350,27500,1150,789689
6157,12450,2020-10-23,0.04431599229287091,25950,27100,1150,585770
6158,12450,2020-09-03,0.0914179104477612,26800,29250,2450,2721162
6159,12450,2020-08-18,0.04981549815498155,27100,25750,-1350,659799
6160,12450,2020-08-10,0.050880626223091974,25550,26850,1300,1199916
6161,12450,2020-07-27,0.04602510460251046,23900,25000,1100,1351751
6162,12450,2020-06-26,0.043568464730290454,24100,25150,1050,564237
6163,12450,2020-06-24,0.05555555555555555,26100,24650,-1450,1057966
6164,12450,2020-06-19,0.08732876712328767,29200,26650,-2550,3757564
6165,12450,2020-06-17,0.13714285714285715,26250,29850,3600,11721235
6166,12450,2020-06-15,0.0673469387755102,24500,26150,1650,3745454
6167,12450,2020-05-27,0.0425531914893617,23500,24500,1000,642701
6168,12450,2020-05-14,0.043209876543209874,24300,23250,-1050,495053
6169,12450,2020-05-04,0.09479553903345725,26900,24350,-2550,791292
6170,12450,2020-04-28,0.05182341650671785,26050,27400,1350,2733936
6171,12450,2020-04-24,0.05979381443298969,24250,25700,1450,2860903
6172,12450,2020-04-21,0.053418803418803416,23400,24650,1250,5908661
6173,12450,2020-04-14,0.04555808656036447,21950,22950,1000,317221
6174,12450,2020-04-13,0.05591397849462366,23250,21950,-1300,299188
6175,12450,2020-04-07,0.10669975186104218,20150,22300,2150,837639
6176,12450,2020-03-26,0.057692307692307696,18200,19250,1050,662070
6177,12450,2020-03-25,0.09309309309309309,16650,18200,1550,654279
6178,12450,2020-03-24,0.11,15000,16650,1650,465924
6179,12450,2020-03-23,0.1044776119402985,16750,15000,-1750,462930
6180,12450,2020-03-20,0.06687898089171974,15700,16750,1050,717128
6181,12450,2020-03-19,0.14905149051490515,18450,15700,-2750,706180
6182,12450,2020-03-18,0.08663366336633663,20200,18450,-1750,369689
6183,12450,2020-03-16,0.047619047619047616,22050,21000,-1050,326383
6184,12450,2020-03-13,0.07547169811320754,23850,22050,-1800,797717
6185,12450,2020-03-12,0.06470588235294118,25500,23850,-1650,476674
6186,12450,2020-03-09,0.051418439716312055,28200,26750,-1450,358557
6187,12450,2020-02-28,0.054982817869415807,29100,27500,-1600,498985
6188,12450,2020-02-24,0.09597523219814241,32300,29200,-3100,680532
6189,12450,2020-01-28,0.06116642958748222,35150,33000,-2150,295585
6190,12450,2019-11-12,0.04,36250,37700,1450,741215
6191,12450,2019-10-08,0.044444444444444446,40500,42300,1800,483555
6192,12450,2019-10-07,0.053738317757009345,42800,40500,-2300,502641
6193,12450,2019-09-27,0.044340723453908985,42850,40950,-1900,349971
6194,12450,2019-09-04,0.05067985166872682,40450,42500,2050,743263
6195,12450,2019-08-13,0.16612377850162866,30700,35800,5100,2869361
6196,12450,2019-05-22,0.06745362563237774,29650,31650,2000,436100
6197,12450,2019-03-18,0.04,33750,35100,1350,576039
6198,12450,2019-01-18,0.0452418096723869,32050,30600,-1450,736861
6199,12450,2018-11-26,0.055900621118012424,32200,34000,1800,344704
6200,12450,2018-11-15,0.069164265129683,34700,32300,-2400,992402
6201,12450,2018-11-14,0.057926829268292686,32800,34700,1900,1125375
6202,12450,2018-11-06,0.0462046204620462,30300,31700,1400,686053
6203,12450,2018-11-05,0.05025996533795494,28850,30300,1450,445425
6204,12450,2018-11-02,0.06066176470588235,27200,28850,1650,354398
6205,12450,2018-11-01,0.043936731107205626,28450,27200,-1250,620250
6206,12450,2018-10-04,0.06463878326996197,26300,28000,1700,618480
6207,12450,2018-10-02,0.0499001996007984,25050,26300,1250,599394
6208,12450,2018-09-28,0.11498257839721254,28700,25400,-3300,1476297
6209,12450,2018-09-27,0.09333333333333334,26250,28700,2450,935114
6210,12450,2018-09-07,0.054901960784313725,25500,26900,1400,562949
6211,12450,2018-08-28,0.05394190871369295,24100,25400,1300,525817
6212,12450,2018-08-14,0.05145413870246085,22350,23500,1150,370767
6213,12450,2018-07-20,0.058823529411764705,22100,23400,1300,613095
6214,12450,2018-07-19,0.04329004329004329,23100,22100,-1000,339881
6215,12450,2018-07-09,0.040632054176072234,22150,23050,900,340864
6216,12450,2018-07-05,0.04424778761061947,22600,21600,-1000,632066
6217,12450,2018-07-02,0.04051172707889126,23450,22500,-950,498775
6218,12450,2018-06-18,0.058823529411764705,30600,28800,-1800,435627
6219,12450,2018-06-14,0.04383116883116883,30800,29450,-1350,607834
6220,12450,2018-06-11,0.0514820592823713,32050,30400,-1650,556540
6221,12450,2018-05-29,0.12095400340715502,29350,32900,3550,2925895
6222,12450,2018-05-18,0.046511627906976744,27950,29250,1300,531265
6223,12450,2018-05-09,0.05063291139240506,27650,29050,1400,1509889
6224,12450,2018-05-08,0.06551059730250482,25950,27650,1700,1681071
6225,12450,2018-05-04,0.08577405857740586,23900,25950,2050,1440785
6226,12450,2018-04-30,0.07662835249042145,26100,24100,-2000,1121364
6227,12450,2018-04-26,0.043912175648702596,25050,26150,1100,467908
6228,12450,2018-03-21,0.043029259896729774,29050,30300,1250,738960
6229,12450,2018-03-02,0.04288164665523156,29150,27900,-1250,633606
6230,12450,2018-02-26,0.04601769911504425,28250,29550,1300,813890
6231,12450,2018-02-19,0.04159132007233273,27650,28800,1150,378145
6232,12450,2018-02-05,0.04704097116843703,32950,31400,-1550,1027684
6233,12450,2017-10-27,0.05510752688172043,37200,39250,2050,1168692
6234,12450,2017-10-19,0.11747430249632893,34050,38050,4000,1461571
6235,12450,2017-09-22,0.05160390516039052,35850,34000,-1850,812491
6236,12450,2017-08-21,0.056303549571603426,40850,38550,-2300,1290666
6237,12450,2017-08-18,0.046094750320102434,39050,40850,1800,1062198
6238,12450,2017-08-04,0.04874651810584958,35900,37650,1750,843214
6239,12450,2017-08-03,0.06510416666666667,38400,35900,-2500,1436086
6240,12450,2017-07-14,0.0640279394644936,42950,40200,-2750,844068
6241,12450,2017-03-23,0.04891304347826087,46000,48250,2250,1064249
6242,12450,2017-02-22,0.056422569027611044,41650,44000,2350,1054394
6243,12450,2017-02-01,0.047961630695443645,41700,43700,2000,548913
6244,12450,2017-01-03,0.049162011173184354,44750,46950,2200,977418
6245,12450,2016-12-12,0.04929577464788732,42600,44700,2100,888893
6246,12450,2016-12-02,0.0738327904451683,46050,42650,-3400,2013516
6247,12450,2016-11-30,0.05621301775147929,50700,47850,-2850,4339688
6248,12450,2016-11-24,0.04716981132075472,53000,50500,-2500,959877
6249,12450,2016-11-14,0.04046242774566474,51900,54000,2100,949513
6250,12450,2016-11-10,0.049484536082474224,48500,50900,2400,1741500
6251,12450,2016-11-09,0.04189044038668099,46550,48500,1950,5754038
6252,12450,2016-11-01,0.2115987460815047,63800,50300,-13500,4064546
6253,12450,2016-10-24,0.04017857142857143,67200,64500,-2700,480686
6254,12450,2016-08-29,0.042328042328042326,56700,59100,2400,413749
6255,42660,2021-06-01,0.09940652818991098,33700,37050,3350,1727706
6256,42660,2021-05-20,0.0546448087431694,36600,34600,-2000,742026
6257,42660,2021-05-10,0.06308724832214765,37250,39600,2350,1487804
6258,42660,2021-04-30,0.05763688760806916,34700,36700,2000,2140561
6259,42660,2021-04-29,0.07931570762052877,32150,34700,2550,1694175
6260,42660,2021-04-26,0.06712564543889846,29050,31000,1950,1307440
6261,42660,2021-03-26,0.06954887218045112,26600,28450,1850,1309490
6262,42660,2021-03-12,0.047524752475247525,25250,26450,1200,692857
6263,42660,2021-02-01,0.04703476482617587,24450,25600,1150,261473
6264,42660,2021-01-29,0.05048543689320388,25750,24450,-1300,416750
6265,42660,2020-11-23,0.060784313725490195,25500,27050,1550,2212852
6266,42660,2020-11-16,0.08057851239669421,24200,26150,1950,1739443
6267,42660,2020-11-09,0.05530973451327434,22600,23850,1250,621940
6268,42660,2020-09-29,0.043859649122807015,22800,23800,1000,404465
6269,42660,2020-09-10,0.05088495575221239,22600,23750,1150,549400
6270,42660,2020-09-07,0.042316258351893093,22450,23400,950,493575
6271,42660,2020-08-20,0.06157112526539278,23550,22100,-1450,502721
6272,42660,2020-08-18,0.08382066276803118,25650,23500,-2150,704736
6273,42660,2020-08-11,0.08686440677966102,23600,25650,2050,1219173
6274,42660,2020-07-21,0.047311827956989246,23250,24350,1100,492707
6275,42660,2020-07-13,0.042505592841163314,22350,23300,950,312027
6276,42660,2020-07-10,0.0407725321888412,23300,22350,-950,429207
6277,42660,2020-07-01,0.07948243992606285,27050,24900,-2150,1028686
6278,42660,2020-06-29,0.05078125,25600,26900,1300,1098850
6279,42660,2020-06-16,0.06623931623931624,23400,24950,1550,849619
6280,42660,2020-06-15,0.10344827586206896,26100,23400,-2700,984564
6281,42660,2020-06-08,0.046125461254612546,27100,28350,1250,3537538
6282,42660,2020-06-04,0.059625212947189095,29350,27600,-1750,2429705
6283,42660,2020-06-03,0.07116788321167883,27400,29350,1950,4178023
6284,42660,2020-06-02,0.1440501043841336,23950,27400,3450,4417417
6285,42660,2020-06-01,0.09862385321100918,21800,23950,2150,1048534
6286,42660,2020-05-29,0.0430622009569378,20900,21800,900,923044
6287,42660,2020-05-27,0.10704960835509138,19150,21200,2050,1871491
6288,42660,2020-05-26,0.04076086956521739,18400,19150,750,803098
6289,42660,2020-05-25,0.08235294117647059,17000,18400,1400,1041965
6290,42660,2020-05-19,0.042042042042042045,16650,17350,700,514234
6291,42660,2020-04-22,0.051515151515151514,16500,17350,850,474714
6292,42660,2020-04-13,0.04678362573099415,17100,16300,-800,356497
6293,42660,2020-04-10,0.05555555555555555,16200,17100,900,644232
6294,42660,2020-04-09,0.0728476821192053,15100,16200,1100,435261
6295,42660,2020-04-07,0.05172413793103448,14500,15250,750,500151
6296,42660,2020-04-06,0.04693140794223827,13850,14500,650,357290
6297,42660,2020-04-02,0.06060606060606061,13200,14000,800,442345
6298,42660,2020-03-27,0.07317073170731707,12300,13200,900,811940
6299,42660,2020-03-25,0.0735930735930736,11550,12400,850,1191737
6300,42660,2020-03-23,0.10040160642570281,12450,11200,-1250,521951
6301,42660,2020-03-19,0.14285714285714285,14000,12000,-2000,443469
6302,42660,2020-03-18,0.0967741935483871,15500,14000,-1500,335676
6303,42660,2020-03-16,0.061946902654867256,16950,15900,-1050,236901
6304,42660,2020-03-13,0.07880434782608696,18400,16950,-1450,532857
6305,42660,2020-03-12,0.07769423558897243,19950,18400,-1550,344850
6306,42660,2020-03-09,0.07207207207207207,22200,20600,-1600,250940
6307,42660,2020-03-06,0.04103671706263499,23150,22200,-950,160938
6308,42660,2020-02-24,0.05578512396694215,24200,22850,-1350,209050
6309,42660,2020-02-06,0.07291666666666667,24000,25750,1750,337768
6310,42660,2020-01-28,0.04826254826254826,25900,24650,-1250,198795
6311,42660,2019-09-09,0.0415944540727903,28850,30050,1200,251308
6312,42660,2019-08-30,0.05,26000,27300,1300,227306
6313,42660,2019-08-19,0.10580912863070539,24100,26650,2550,405600
6314,42660,2019-08-06,0.05893909626719057,25450,23950,-1500,516472
6315,42660,2019-08-05,0.04681647940074907,26700,25450,-1250,303314
6316,42660,2019-08-02,0.06315789473684211,28500,26700,-1800,250843
6317,42660,2019-07-25,0.0457516339869281,30600,29200,-1400,168173
6318,42660,2019-04-01,0.04830053667262969,27950,29300,1350,307663
6319,42660,2019-02-01,0.08648648648648649,37000,33800,-3200,3094450
6320,42660,2019-01-28,0.04052098408104197,34550,35950,1400,941710
6321,42660,2019-01-21,0.06416275430359937,31950,34000,2050,1102090
6322,42660,2019-01-08,0.042682926829268296,32800,31400,-1400,639906
6323,42660,2018-12-27,0.06923076923076923,32500,34750,2250,660947
6324,42660,2018-12-26,0.048316251830161056,34150,32500,-1650,677213
6325,42660,2018-12-19,0.06864064602960969,37150,34600,-2550,1099961
6326,42660,2018-12-12,0.08888888888888889,33750,36750,3000,776744
6327,42660,2018-12-06,0.050505050505050504,34650,32900,-1750,625779
6328,42660,2018-11-19,0.04704301075268817,37200,35450,-1750,1228288
6329,42660,2018-11-15,0.048034934497816595,34350,36000,1650,737598
6330,42660,2018-11-08,0.04111842105263158,30400,31650,1250,511681
6331,42660,2018-11-06,0.07560137457044673,29100,31300,2200,688069
6332,42660,2018-11-02,0.04753521126760563,28400,29750,1350,226537
6333,42660,2018-10-31,0.05026929982046679,27850,29250,1400,538720
6334,42660,2018-10-26,0.061224489795918366,29400,27600,-1800,668482
6335,42660,2018-10-17,0.05373134328358209,33500,31700,-1800,2620577
6336,42660,2018-10-11,0.06930693069306931,35350,32900,-2450,657536
6337,42660,2018-10-08,0.06368563685636856,36900,34550,-2350,761775
6338,42660,2018-10-02,0.05397727272727273,35200,37100,1900,757294
6339,42660,2018-09-27,0.04484304932735426,33450,34950,1500,652572
6340,42660,2018-09-17,0.04,31250,32500,1250,552735
6341,42660,2018-08-20,0.09003831417624521,26100,28450,2350,1895683
6342,42660,2018-07-26,0.08441558441558442,23100,25050,1950,936794
6343,42660,2018-07-24,0.0408997955010225,24450,23450,-1000,836602
6344,42660,2018-07-23,0.04935622317596566,23300,24450,1150,523394
6345,42660,2018-07-06,0.060362173038229376,24850,26350,1500,754100
6346,42660,2018-07-02,0.05925925925925926,27000,25400,-1600,553030
6347,42660,2018-06-25,0.0499001996007984,25050,26300,1250,647872
6348,42660,2018-06-22,0.050314465408805034,23850,25050,1200,489856
6349,42660,2018-06-18,0.058027079303675046,25850,24350,-1500,901451
6350,42660,2018-06-14,0.05595667870036101,27700,26150,-1550,2570168
6351,42660,2018-06-11,0.04887218045112782,26600,27900,1300,1202754
6352,42660,2018-05-14,0.04247104247104247,25900,27000,1100,720489
6353,42660,2018-04-30,0.047619047619047616,25200,24000,-1200,1256428
6354,42660,2018-04-25,0.051233396584440226,26350,25000,-1350,654020
6355,42660,2018-04-05,0.072265625,25600,27450,1850,1298023
6356,42660,2018-04-03,0.045112781954887216,26600,25400,-1200,1033372
6357,42660,2018-03-20,0.0533596837944664,25300,26650,1350,1204514
6358,42660,2018-03-15,0.0531496062992126,25400,26750,1350,1052395
6359,42660,2018-03-14,0.06445672191528545,27150,25400,-1750,1142877
6360,42660,2018-03-06,0.10359408033826638,23650,26100,2450,1267727
6361,42660,2018-02-23,0.07692307692307693,22750,24500,1750,1670749
6362,42660,2018-02-21,0.06103286384976526,21300,22600,1300,730556
6363,42660,2018-02-19,0.08977556109725686,20050,21850,1800,858005
6364,42660,2018-02-14,0.05804749340369393,18950,20050,1100,306984
6365,42660,2018-02-12,0.05339805825242718,20600,19500,-1100,1020228
6366,42660,2018-02-07,0.05,22000,20900,-1100,686588
6367,42660,2018-02-05,0.057815845824411134,23350,22000,-1350,789143
6368,42660,2018-01-30,0.05790645879732739,22450,23750,1300,1859129
6369,42660,2018-01-25,0.06818181818181818,19800,21150,1350,1587988
6370,42660,2018-01-22,0.0718232044198895,18100,19400,1300,1091237
6371,42660,2018-01-17,0.04473684210526316,19000,18150,-850,728905
6372,42660,2018-01-15,0.10404624277456648,17300,19100,1800,1839224
6373,42660,2018-01-12,0.0880503144654088,15900,17300,1400,905957
6374,42660,2018-01-04,0.040697674418604654,17200,16500,-700,526458
6375,42660,2018-01-03,0.12052117263843648,15350,17200,1850,819973
6376,42660,2018-01-02,0.10431654676258993,13900,15350,1450,382063
6377,42660,2017-12-27,0.06333333333333334,15000,14050,-950,402003
6378,42660,2017-12-20,0.04100946372239748,15850,15200,-650,343135
6379,42660,2017-11-30,0.04664723032069971,17150,17950,800,997827
6380,42660,2017-11-10,0.05952380952380952,21000,19750,-1250,1264200
6381,42660,2017-11-08,0.09042553191489362,18800,20500,1700,2632812
6382,42660,2017-11-07,0.044444444444444446,18000,18800,800,972138
6383,42660,2017-11-06,0.058823529411764705,17000,18000,1000,1427696
6384,42660,2017-10-31,0.05412371134020619,19400,18350,-1050,1872129
6385,42660,2017-10-30,0.06696428571428571,44800,19400,-25400,11060393
6386,3240,2021-05-28,0.052100840336134456,1190000,1252000,62000,2816
6387,3240,2021-05-10,0.05321100917431193,1090000,1148000,58000,1973
6388,3240,2021-05-06,0.052132701421800945,1055000,1110000,55000,2028
6389,3240,2021-04-27,0.04111986001749781,1143000,1096000,-47000,2042
6390,3240,2021-04-23,0.04655493482309125,1074000,1124000,50000,2110
6391,3240,2021-04-20,0.043521266073194856,1011000,1055000,44000,2608
6392,3240,2021-02-03,0.08879023307436182,901000,981000,80000,6890
6393,3240,2021-02-01,0.11203814064362336,839000,933000,94000,8221
6394,3240,2021-01-08,0.04579207920792079,808000,845000,37000,4029
6395,3240,2020-11-30,0.0735826296743064,829000,768000,-61000,4181
6396,3240,2020-11-18,0.06743002544529263,786000,839000,53000,4009
6397,3240,2020-11-11,0.053315994798439535,769000,810000,41000,5822
6398,3240,2020-11-02,0.056338028169014086,710000,750000,40000,2439
6399,3240,2020-06-16,0.06534090909090909,704000,750000,46000,1819
6400,3240,2020-06-15,0.05630026809651475,746000,704000,-42000,3143
6401,3240,2020-06-12,0.04846938775510204,784000,746000,-38000,2488
6402,3240,2020-06-05,0.05249343832020997,762000,802000,40000,3206
6403,3240,2020-04-29,0.044386422976501305,766000,800000,34000,3814
6404,3240,2020-04-21,0.04342105263157895,760000,727000,-33000,2702
6405,3240,2020-04-07,0.0736196319018405,652000,700000,48000,2520
6406,3240,2020-03-25,0.12777777777777777,540000,609000,69000,3526
6407,3240,2020-03-24,0.06719367588932806,506000,540000,34000,2222
6408,3240,2020-03-23,0.12607944732297063,579000,506000,-73000,2480
6409,3240,2020-03-20,0.16733870967741934,496000,579000,83000,3103
6410,3240,2020-03-19,0.12367491166077739,566000,496000,-70000,3096
6411,3240,2020-03-16,0.052050473186119876,634000,601000,-33000,2714
6412,3240,2020-03-13,0.08776978417266187,695000,634000,-61000,2853
6413,3240,2020-03-12,0.041379310344827586,725000,695000,-30000,2104
6414,3240,2020-03-09,0.050761421319796954,788000,748000,-40000,1551
6415,3240,2020-01-28,0.04554655870445344,988000,943000,-45000,1906
6416,3240,2019-09-16,0.044802867383512544,1116000,1166000,50000,701
6417,3240,2019-09-03,0.0525328330206379,1066000,1122000,56000,1354
6418,3240,2019-08-28,0.04162537165510406,1009000,1051000,42000,755
6419,3240,2019-08-12,0.043875685557586835,1094000,1046000,-48000,707
6420,3240,2019-08-07,0.057091882247992866,1121000,1057000,-64000,2807
6421,3240,2019-05-30,0.046296296296296294,1404000,1339000,-65000,1578
6422,3240,2019-04-04,0.04326018808777429,1595000,1664000,69000,1057
6423,3240,2019-03-15,0.10207939508506617,1587000,1749000,162000,3694
6424,3240,2019-03-13,0.04398447606727038,1546000,1614000,68000,1610
6425,3240,2019-02-15,0.04780114722753346,1569000,1494000,-75000,939
6426,3240,2019-02-14,0.05514458641560188,1487000,1569000,82000,1166
6427,3240,2018-11-01,0.04403794037940379,1476000,1411000,-65000,1011
6428,3240,2018-10-11,0.05083732057416268,1672000,1587000,-85000,1545
6429,3240,2018-09-12,0.04085480829666876,1591000,1656000,65000,1645
6430,3240,2018-07-09,0.058333333333333334,1440000,1524000,84000,2430
6431,3240,2018-07-06,0.042722664735698766,1381000,1440000,59000,938
6432,3240,2018-06-11,0.0641025641025641,1326000,1411000,85000,2282
6433,3240,2018-05-10,0.04363905325443787,1352000,1411000,59000,1687
6434,3240,2018-05-08,0.047323506594259115,1289000,1350000,61000,1345
6435,3240,2018-04-02,0.060461416070007955,1257000,1333000,76000,1673
6436,3240,2018-03-28,0.04409317803660566,1202000,1255000,53000,1821
6437,3240,2018-02-13,0.044182621502209134,1358000,1298000,-60000,958
6438,3240,2018-02-09,0.05660377358490566,1325000,1400000,75000,1654
6439,3240,2018-01-24,0.04943820224719101,1335000,1401000,66000,1122
6440,3240,2018-01-04,0.055011303692539565,1327000,1254000,-73000,1195
6441,3240,2017-12-26,0.046493301812450746,1269000,1328000,59000,1241
6442,3240,2017-12-15,0.04905335628227195,1162000,1219000,57000,1166
6443,3240,2017-12-01,0.04334121355397951,1269000,1214000,-55000,1271
6444,3240,2017-11-03,0.05060034305317324,1166000,1225000,59000,1202
6445,3240,2017-10-19,0.04114490161001789,1118000,1164000,46000,979
6446,3240,2017-09-29,0.04085422469823584,1077000,1121000,44000,1025
6447,3240,2017-09-22,0.0410958904109589,1168000,1120000,-48000,854
6448,3240,2017-07-19,0.04826418289585097,1181000,1238000,57000,1221
6449,3240,2017-07-18,0.06974637681159421,1104000,1181000,77000,981
6450,3240,2017-07-13,0.05167464114832536,1045000,1099000,54000,2175
6451,3240,2017-06-09,0.04103852596314908,1194000,1145000,-49000,2293
6452,3240,2017-06-08,0.06322350845948353,1123000,1194000,71000,3325
6453,3240,2017-05-25,0.05386875612144956,1021000,1076000,55000,2063
6454,3240,2017-05-16,0.08232711306256861,911000,986000,75000,3523
6455,3240,2017-05-11,0.04424778761061947,904000,944000,40000,1583
6456,3240,2017-01-12,0.05190677966101695,944000,993000,49000,731
6457,3240,2016-12-07,0.0527448869752422,929000,978000,49000,1400
6458,3240,2016-11-10,0.05046948356807512,852000,895000,43000,996
6459,3240,2016-08-18,0.04456521739130435,920000,879000,-41000,1551
6460,68270,2021-05-07,0.055445544554455446,252500,266500,14000,1301011
6461,68270,2021-05-04,0.04208416833667335,249500,260000,10500,1828139
6462,68270,2021-05-03,0.06203007518796992,266000,249500,-16500,1931130
6463,68270,2021-03-29,0.052547770700636945,314000,330500,16500,1786627
6464,68270,2021-02-25,0.09219858156028368,282000,308000,26000,1378139
6465,68270,2021-02-24,0.0472972972972973,296000,282000,-14000,1494863
6466,68270,2021-02-23,0.04361873990306947,309500,296000,-13500,1261921
6467,68270,2021-02-02,0.04177897574123989,371000,355500,-15500,2321590
6468,68270,2021-02-01,0.14506172839506173,324000,371000,47000,6018601
6469,68270,2021-01-18,0.04559270516717325,329000,314000,-15000,2601181
6470,68270,2021-01-15,0.06666666666666667,352500,329000,-23500,3398281
6471,68270,2021-01-14,0.07601572739187418,381500,352500,-29000,3425555
6472,68270,2020-12-29,0.09895052473763119,333500,360500,27000,5725005
6473,68270,2020-12-28,0.04028776978417266,347500,333500,-14000,7295632
6474,68270,2020-12-08,0.1325898389095415,403500,350000,-53500,4600980
6475,68270,2020-12-07,0.06184210526315789,380000,403500,23500,3465337
6476,68270,2020-12-04,0.08262108262108261,351000,380000,29000,4734606
6477,68270,2020-11-25,0.0945273631840796,301500,330000,28500,10726012
6478,68270,2020-11-11,0.07233273056057866,276500,296500,20000,2765598
6479,68270,2020-11-04,0.0444015444015444,259000,270500,11500,1326699
6480,68270,2020-11-03,0.05930470347648262,244500,259000,14500,1016373
6481,68270,2020-10-30,0.04743083003952569,253000,241000,-12000,825115
6482,68270,2020-10-29,0.04329896907216495,242500,253000,10500,986149
6483,68270,2020-10-12,0.04389312977099236,262000,273500,11500,774825
6484,68270,2020-09-24,0.06015037593984962,266000,250000,-16000,1321525
6485,68270,2020-09-21,0.044596912521440824,291500,278500,-13000,1074281
6486,68270,2020-09-09,0.06132075471698113,318000,298500,-19500,2482466
6487,68270,2020-09-08,0.04262295081967213,305000,318000,13000,2698135
6488,68270,2020-08-05,0.04304635761589404,302000,315000,13000,1063211
6489,68270,2020-07-29,0.050393700787401574,317500,301500,-16000,1903406
6490,68270,2020-07-17,0.04126984126984127,315000,328000,13000,1241089
6491,68270,2020-07-09,0.04012841091492777,311500,324000,12500,1637528
6492,68270,2020-06-23,0.0723905723905724,297000,318500,21500,4485322
6493,68270,2020-06-16,0.07116788321167883,274000,293500,19500,2041007
6494,68270,2020-06-15,0.07899159663865546,297500,274000,-23500,3141867
6495,68270,2020-06-11,0.07262569832402235,268500,288000,19500,3934710
6496,68270,2020-06-04,0.08571428571428572,227500,247000,19500,3037387
6497,68270,2020-06-01,0.06557377049180328,213500,227500,14000,3410255
6498,68270,2020-04-06,0.0663265306122449,196000,209000,13000,2778989
6499,68270,2020-04-01,0.13537117903930132,229000,198000,-31000,5208192
6500,68270,2020-03-31,0.23783783783783785,185000,229000,44000,11131989
6501,68270,2020-03-24,0.05142857142857143,175000,184000,9000,3903710
6502,68270,2020-03-23,0.14754098360655737,152500,175000,22500,6685918
6503,68270,2020-03-20,0.08928571428571429,140000,152500,12500,2019176
6504,68270,2020-03-19,0.10828025477707007,157000,140000,-17000,2890238
6505,68270,2020-03-18,0.06547619047619048,168000,157000,-11000,1214771
6506,68270,2020-03-10,0.040229885057471264,174000,181000,7000,1203990
6507,68270,2020-03-05,0.04297994269340974,174500,182000,7500,908489
6508,68270,2020-02-24,0.04519774011299435,177000,169000,-8000,768670
6509,68270,2020-02-06,0.0486322188449848,164500,172500,8000,831467
6510,68270,2019-12-17,0.052941176470588235,170000,179000,9000,956542
6511,68270,2019-11-21,0.04065040650406504,184500,177000,-7500,865834
6512,68270,2019-10-22,0.0521978021978022,182000,191500,9500,1075991
6513,68270,2019-10-01,0.057926829268292686,164000,173500,9500,1232784
6514,68270,2019-09-20,0.04154302670623145,168500,175500,7000,595515
6515,68270,2019-09-04,0.04361370716510903,160500,167500,7000,809996
6516,68270,2019-08-28,0.07586206896551724,145000,156000,11000,1109554
6517,68270,2019-08-26,0.066006600660066,151500,141500,-10000,1170629
6518,68270,2019-08-05,0.11009174311926606,163500,145500,-18000,3101964
6519,68270,2019-08-02,0.04105571847507331,170500,163500,-7000,1247036
6520,68270,2019-07-09,0.06553398058252427,206000,192500,-13500,1473892
6521,68270,2019-05-28,0.06896551724137931,174000,186000,12000,932491
6522,68270,2019-05-10,0.04047619047619048,210000,201500,-8500,698530
6523,68270,2019-04-19,0.07125307125307126,203500,218000,14500,1295363
6524,68270,2019-04-09,0.04603580562659847,195500,204500,9000,1026289
6525,68270,2019-04-02,0.04395604395604396,182000,190000,8000,668630
6526,68270,2019-03-27,0.04935064935064935,192500,183000,-9500,1552642
6527,68270,2019-01-24,0.04,200000,208000,8000,969990
6528,68270,2019-01-04,0.04513064133016627,210500,220000,9500,1132255
6529,68270,2018-12-26,0.0831353919239905,210500,228000,17500,3780004
6530,68270,2018-12-24,0.04318181818181818,220000,210500,-9500,1606964
6531,68270,2018-12-14,0.04367816091954023,217500,208000,-9500,1178385
6532,68270,2018-12-11,0.10020449897750511,244500,220000,-24500,2243098
6533,68270,2018-12-07,0.04246284501061571,235500,245500,10000,773137
6534,68270,2018-11-26,0.08823529411764706,221000,240500,19500,1063237
6535,68270,2018-11-15,0.05048076923076923,208000,218500,10500,1313803
6536,68270,2018-11-12,0.11982570806100218,229500,202000,-27500,3313401
6537,68270,2018-11-01,0.04597701149425287,217500,227500,10000,1902740
6538,68270,2018-10-29,0.043859649122807015,228000,218000,-10000,1450889
6539,68270,2018-10-25,0.04878048780487805,225500,236500,11000,3582663
6540,68270,2018-10-24,0.08519269776876268,246500,225500,-21000,2674768
6541,68270,2018-10-23,0.08193668528864059,268500,246500,-22000,7124769
6542,68270,2018-10-19,0.04798464491362764,260500,273000,12500,787000
6543,68270,2018-10-15,0.04735883424408015,274500,261500,-13000,948682
6544,68270,2018-10-11,0.05235602094240838,286500,271500,-15000,1789042
6545,68270,2018-09-04,0.04868913857677903,267000,280000,13000,994506
6546,68270,2018-08-13,0.042279411764705885,272000,260500,-11500,988487
6547,68270,2018-07-31,0.05232558139534884,258000,271500,13500,725339
6548,68270,2018-07-25,0.052830188679245285,265000,251000,-14000,1947928
6549,68270,2018-07-23,0.06304728546409807,285500,267500,-18000,1208156
6550,68270,2018-07-12,0.04159132007233273,276500,288000,11500,779938
6551,68270,2018-06-19,0.05737704918032787,305000,287500,-17500,1278723
6552,68270,2018-06-15,0.06607142857142857,280000,298500,18500,1851466
6553,68270,2018-05-23,0.046296296296296294,270000,257500,-12500,997007
6554,68270,2018-05-15,0.050980392156862744,255000,268000,13000,1489555
6555,68270,2018-05-09,0.09745762711864407,236000,259000,23000,2553475
6556,68270,2018-05-08,0.056,250000,236000,-14000,1422120
6557,68270,2018-05-04,0.04580152671755725,262000,250000,-12000,1087480
6558,68270,2018-05-02,0.04428044280442804,271000,259000,-12000,1284374
6559,68270,2018-04-27,0.07587548638132295,257000,276500,19500,1351327
6560,68270,2018-04-23,0.0687732342007435,269000,250500,-18500,1984284
6561,68270,2018-04-19,0.0632688927943761,284500,266500,-18000,2211139
6562,68270,2018-04-09,0.04794520547945205,292000,306000,14000,1134927
6563,68270,2018-03-29,0.09499136442141623,289500,317000,27500,1955696
6564,68270,2018-03-15,0.052202283849918436,306500,322500,16000,2002241
6565,68270,2018-03-09,0.07909604519774012,354000,326000,-28000,3558669
6566,68270,2018-03-08,0.08923076923076922,325000,354000,29000,7741422
6567,68270,2018-03-07,0.12162162162162163,370000,325000,-45000,7588080
6568,68270,2018-03-02,0.053824362606232294,353000,372000,19000,1964092
6569,68270,2018-02-27,0.07503828483920368,326500,351000,24500,2097880
6570,68270,2018-02-14,0.06292517006802721,294000,312500,18500,1715961
6571,68270,2018-02-12,0.050347222222222224,288000,302500,14500,2112316
6572,68270,2018-02-09,0.06079587324981577,271400,288000,16600,2965646
6573,68270,2018-02-08,0.06015625,256000,271400,15400,7760386
6574,68270,2018-02-07,0.0992258972554539,284200,256000,-28200,3326704
6575,68270,2018-02-05,0.051094890510948905,301400,286000,-15400,1378628
6576,68270,2018-02-01,0.050364269876465,315700,299800,-15900,1909895
6577,68270,2018-01-29,0.09433333333333334,300000,328300,28300,2153908
6578,68270,2018-01-23,0.06557377049180328,280600,299000,18400,2243840
6579,68270,2018-01-19,0.09865330410272471,319300,287800,-31500,3755567
6580,68270,2018-01-17,0.09758203799654577,347400,313500,-33900,3483413
6581,68270,2018-01-12,0.11237785016286644,307000,341500,34500,5792144
6582,68270,2018-01-08,0.1333832896215811,266900,302500,35600,4298770
6583,68270,2018-01-05,0.0676,250000,266900,16900,1920918
6584,68270,2018-01-03,0.09207613988490483,225900,246700,20800,2411162
6585,68270,2017-12-27,0.1476923076923077,195000,220000,25000,4011320
6586,68270,2017-12-11,0.04538500764915859,196100,205000,8900,950807
6587,68270,2017-12-01,0.05647176411794103,200100,211400,11300,1390393
6588,68270,2017-11-16,0.050359712230215826,208500,219000,10500,3714562
6589,68270,2017-11-15,0.08087091757387248,192900,208500,15600,4800414
6590,68270,2017-11-13,0.07770845150311968,176300,190000,13700,2963242
6591,68270,2017-11-07,0.046857142857142854,175000,166800,-8200,2577921
6592,68270,2017-10-26,0.049171270718232046,181000,172100,-8900,2263821
6593,68270,2017-10-25,0.05185961236249345,190900,181000,-9900,2864225
6594,68270,2017-10-24,0.07066741446999439,178300,190900,12600,2191965
6595,68270,2017-10-19,0.08797501301405518,192100,175200,-16900,4579716
6596,68270,2017-10-17,0.08982376350198977,175900,191700,15800,4993268
6597,68270,2017-10-13,0.09085051546391752,155200,169300,14100,5130496
6598,68270,2017-10-12,0.06301369863013699,146000,155200,9200,1972627
6599,68270,2017-09-27,0.047017543859649125,142500,149200,6700,1625868
6600,68270,2017-09-20,0.05161290322580645,139500,146700,7200,2764852
6601,68270,2017-09-18,0.08379013312451057,127700,138400,10700,4023490
6602,68270,2017-09-15,0.06861924686192468,119500,127700,8200,3049757
6603,68270,2017-08-22,0.058823529411764705,110500,117000,6500,1920005
6604,68270,2017-08-07,0.05458089668615984,102600,108200,5600,1206218
6605,68270,2017-06-20,0.053456221198156684,108500,114300,5800,2484286
6606,68270,2017-06-19,0.040268456375838924,104300,108500,4200,1270529
6607,68270,2017-05-08,0.05216426193118757,90100,94800,4700,1203072
6608,68270,2017-03-17,0.04361370716510903,96300,92100,-4200,1176971
6609,68270,2016-12-28,0.04891815616180621,106300,106500,200,1624840
6610,68270,2016-11-10,0.04607843137254902,102000,106700,4700,928468
6611,68270,2016-11-09,0.05468025949953661,107900,102000,-5900,2248235
6612,68270,2016-10-18,0.07,100000,107000,7000,1023872
6613,68270,2016-08-10,0.05042016806722689,107100,112500,5400,2025488
6614,42670,2021-06-02,0.09022556390977443,13300,14500,1200,19591771
6615,42670,2021-05-31,0.04435483870967742,12400,12950,550,11992608
6616,42670,2021-05-28,0.05531914893617021,11750,12400,650,14373798
6617,42670,2021-05-13,0.04090909090909091,11000,10550,-450,4801289
6618,42670,2021-05-11,0.04128440366972477,10900,11350,450,14154086
6619,42670,2021-05-03,0.05092592592592592,10800,10250,-550,5959635
6620,42670,2021-04-01,0.06607929515418502,11350,10600,-750,7763356
6621,42670,2021-03-29,0.0975609756097561,10250,11250,1000,22752864
6622,42670,2021-03-25,0.05759162303664921,9550,10100,550,23996748
6623,42670,2021-03-23,0.057692307692307696,9880,9310,-570,14863431
6624,42670,2021-03-22,0.218249075215783,8110,9880,1770,62580004
6625,42670,2021-02-01,0.07475490196078431,8160,8770,610,11273586
6626,42670,2021-01-15,0.04398148148148148,8640,8260,-380,6562871
6627,42670,2021-01-13,0.04814814814814815,8100,8490,390,8397976
6628,42670,2020-12-14,0.04190919674039581,8590,8230,-360,6488161
6629,42670,2020-12-10,0.0638036809815951,8150,8670,520,22855766
6630,42670,2020-11-25,0.053469852104664393,8790,8320,-470,12188171
6631,42670,2020-11-24,0.047670639219934995,9230,8790,-440,12806795
6632,42670,2020-11-23,0.0417607223476298,8860,9230,370,8729943
6633,42670,2020-09-22,0.1375921375921376,8140,9260,1120,128207788
6634,42670,2020-08-20,0.04607046070460705,7380,7720,340,30331867
6635,42670,2020-08-18,0.07711757269279393,7910,7300,-610,7438307
6636,42670,2020-08-03,0.05063291139240506,7110,7470,360,13652678
6637,42670,2020-07-22,0.09296482412060302,7960,7220,-740,62527985
6638,42670,2020-07-21,0.25354330708661416,6350,7960,1610,110041784
6639,42670,2020-07-10,0.0421216848673947,6410,6140,-270,4986046
6640,42670,2020-07-01,0.05241379310344828,7250,6870,-380,7222222
6641,42670,2020-06-30,0.06774668630338733,6790,7250,460,17249692
6642,42670,2020-06-18,0.08489388264669163,8010,7330,-680,21193004
6643,42670,2020-06-17,0.07085561497326204,7480,8010,530,88519880
6644,42670,2020-06-16,0.2986111111111111,5760,7480,1720,51073794
6645,42670,2020-06-15,0.06645056726094004,6170,5760,-410,8640884
6646,42670,2020-06-12,0.05945121951219512,6560,6170,-390,6067728
6647,42670,2020-06-08,0.04892966360856269,6540,6860,320,23620188
6648,42670,2020-06-03,0.12815884476534295,5540,6250,710,43558257
6649,42670,2020-06-01,0.057692307692307696,5200,5500,300,5456417
6650,42670,2020-05-22,0.0535405872193437,5790,5480,-310,5280992
6651,42670,2020-05-15,0.12708333333333333,4800,5410,610,38619904
6652,42670,2020-05-11,0.08918617614269789,4485,4885,400,13258746
6653,42670,2020-04-27,0.043795620437956206,4110,4290,180,1753934
6654,42670,2020-04-20,0.07100591715976332,4225,4525,300,9560181
6655,42670,2020-04-16,0.047149122807017545,4560,4345,-215,4476501
6656,42670,2020-04-06,0.06991260923845194,4005,4285,280,8411291
6657,42670,2020-04-03,0.09876543209876543,3645,4005,360,11779605
6658,42670,2020-04-01,0.13513513513513514,3145,3570,425,15531184
6659,42670,2020-03-25,0.06545454545454546,2750,2930,180,3558988
6660,42670,2020-03-24,0.08481262327416174,2535,2750,215,2703985
6661,42670,2020-03-23,0.0913978494623656,2790,2535,-255,3332863
6662,42670,2020-03-20,0.08984375,2560,2790,230,3660865
6663,42670,2020-03-19,0.12027491408934708,2910,2560,-350,3725438
6664,42670,2020-03-18,0.05519480519480519,3080,2910,-170,2282900
6665,42670,2020-03-13,0.0872093023255814,3440,3140,-300,6505944
6666,42670,2020-03-12,0.0740242261103634,3715,3440,-275,3850813
6667,42670,2020-03-11,0.043758043758043756,3885,3715,-170,4189611
6668,42670,2020-03-09,0.06115107913669065,4170,3915,-255,2661135
6669,42670,2020-03-06,0.04247990815154994,4355,4170,-185,1490765
6670,42670,2020-02-28,0.0410958904109589,4380,4200,-180,1901237
6671,42670,2020-02-24,0.04138702460850112,4470,4285,-185,2347861
6672,42670,2020-01-28,0.04875717017208413,5230,4975,-255,2206175
6673,42670,2020-01-08,0.04364326375711575,5270,5040,-230,1776678
6674,42670,2019-10-31,0.05201342281879195,5960,5650,-310,4103542
6675,42670,2019-10-14,0.04159733777038269,6010,6260,250,1070604
6676,42670,2019-09-16,0.04258675078864353,6340,6610,270,2215130
6677,42670,2019-08-19,0.05154639175257732,5820,6120,300,1574295
6678,42670,2019-08-05,0.06467661691542288,6030,5640,-390,2262735
6679,42670,2019-06-28,0.06466165413533835,6650,6220,-430,3473101
6680,42670,2019-02-14,0.053231939163498096,7890,7470,-420,7820860
6681,42670,2019-02-13,0.05734767025089606,8370,7890,-480,6337019
6682,42670,2019-01-09,0.06510416666666667,7680,8180,500,2912827
6683,42670,2018-11-02,0.056962025316455694,7900,8350,450,3324757
6684,42670,2018-10-30,0.044848484848484846,8250,7880,-370,4892711
6685,42670,2018-10-11,0.0761904761904762,9450,8730,-720,3199119
6686,42670,2018-10-10,0.05215646940822467,9970,9450,-520,2980588
6687,42670,2018-09-19,0.0593311758360302,9270,9820,550,5672319
6688,42670,2018-08-03,0.061224489795918366,9800,10400,600,2827385
6689,42670,2018-07-24,0.04880694143167028,9220,9670,450,2973418
6690,42670,2018-07-06,0.044444444444444446,9000,9400,400,2203244
6691,42670,2018-07-02,0.04564315352697095,9640,9200,-440,2261090
6692,42670,2018-06-25,0.05324813631522897,9390,9890,500,3038396
6693,42670,2018-06-11,0.052884615384615384,10400,10950,550,6770463
6694,42670,2018-05-29,0.05309734513274336,11300,10700,-600,3917725
6695,42670,2018-05-28,0.08133971291866028,10450,11300,850,7671514
6696,42670,2018-05-14,0.04608294930875576,10850,11350,500,7213451
6697,42670,2018-05-10,0.07920792079207921,10100,10900,800,8010567
6698,42670,2018-04-30,0.09508547008547008,9360,10250,890,11531016
6699,42670,2018-04-25,0.04860392967942089,9670,9200,-470,4066896
6700,42670,2018-04-24,0.04090419806243272,9290,9670,380,3464554
6701,42670,2018-04-04,0.04700352526439483,8510,8110,-400,6657237
6702,42670,2018-04-02,0.12306101344364012,9670,8480,-1190,13194648
6703,42670,2018-03-26,0.05786026200873363,9160,9690,530,4043615
6704,42670,2018-03-23,0.051759834368530024,9660,9160,-500,2466063
6705,42670,2018-03-07,0.05075593952483801,9260,8790,-470,4140153
6706,42670,2018-02-28,0.040082219938335044,9730,9340,-390,2290010
6707,42670,2018-02-22,0.043689320388349516,10300,9850,-450,4844136
6708,42670,2018-01-09,0.07581967213114754,9760,10500,740,10469876
6709,42670,2018-01-02,0.04487917146144994,8690,9080,390,3017579
6710,42670,2017-12-04,0.04391891891891892,8880,9270,390,3293972
6711,42670,2017-11-13,0.04183673469387755,9800,9390,-410,3620956
6712,42670,2017-10-13,0.06728538283062645,8620,9200,580,10229811
6713,42670,2017-09-07,0.051094890510948905,8220,8640,420,5689692
6714,42670,2017-08-04,0.045012165450121655,8220,8590,370,4183580
6715,42670,2017-08-01,0.05707196029776675,8060,8520,460,6389427
6716,42670,2017-07-31,0.042690815006468305,7730,8060,330,2680364
6717,42670,2017-07-28,0.04094292803970223,8060,7730,-330,2581617
6718,42670,2017-06-26,0.0447585394581861,8490,8110,-380,3241534
6719,42670,2017-06-19,0.04519774011299435,8850,8450,-400,3077044
6720,42670,2017-05-29,0.13540510543840178,9010,7790,-1220,14175215
6721,42670,2017-04-26,0.04559915164369035,9430,9860,430,3597164
6722,42670,2017-04-05,0.05366922234392114,9130,9620,490,2674975
6723,42670,2017-03-22,0.04532019704433497,10150,9690,-460,3258107
6724,42670,2017-03-16,0.04334038054968287,9460,9870,410,4572066
6725,42670,2017-03-07,0.046840958605664486,9180,9610,430,6394262
6726,42670,2017-02-27,0.04143337066069429,8930,9300,370,4691734
6727,42670,2017-02-22,0.052878965922444184,8510,8960,450,4670087
6728,42670,2017-02-16,0.057777777777777775,9000,8480,-520,5649573
6729,42670,2017-02-10,0.05112960760998811,8410,8840,430,3747294
6730,42670,2016-12-20,0.045346062052505964,8380,8760,380,6140551
6731,42670,2016-12-08,0.04580152671755725,7860,8220,360,5046142
6732,42670,2016-12-05,0.049479166666666664,7680,8060,380,4813338
6733,42670,2016-11-18,0.14345549738219895,9550,8180,-1370,23086920
6734,42670,2016-11-14,0.16606498194945848,8310,9690,1380,36640185
6735,42670,2016-11-11,0.04005006257822278,7990,8310,320,8402291
6736,42670,2016-11-10,0.14798850574712644,6960,7990,1030,17913361
6737,42670,2016-11-09,0.06827309236947791,7470,6960,-510,6182757
6738,42670,2016-10-12,0.048034934497816595,6870,7200,330,4472645
6739,42670,2016-10-11,0.04583333333333333,7200,6870,-330,6436373
6740,42670,2016-10-10,0.07216494845360824,7760,7200,-560,12647741
6741,42670,2016-10-07,0.05596107055961071,8220,7760,-460,5491717
6742,42670,2016-10-06,0.044472681067344345,7870,8220,350,3743217
6743,42670,2016-09-20,0.04664391353811149,8790,8380,-410,3844929
6744,42670,2016-09-12,0.057777777777777775,9000,8480,-520,4800981
6745,42670,2016-09-07,0.04122497055359246,8490,8840,350,5268340
6746,42670,2016-09-05,0.0425273390036452,8230,8580,350,3875260
6747,42670,2016-08-29,0.04854368932038835,8240,7840,-400,3526876
6748,42670,2016-08-05,0.0610079575596817,7540,8000,460,4095321
6749,138930,2021-05-06,0.05756358768406961,7470,7900,430,4275860
6750,138930,2021-04-30,0.04781420765027322,7320,7670,350,5125163
6751,138930,2021-03-08,0.052715654952076675,6260,6590,330,4057949
6752,138930,2021-03-03,0.06397306397306397,5940,6320,380,5323786
6753,138930,2020-12-29,0.0628099173553719,6050,5670,-380,3592648
6754,138930,2020-12-02,0.043706293706293704,5720,5970,250,4963645
6755,138930,2020-08-20,0.048507462686567165,5360,5100,-260,1589009
6756,138930,2020-06-16,0.050980392156862744,5100,5360,260,1731490
6757,138930,2020-06-11,0.044802867383512544,5580,5330,-250,2290961
6758,138930,2020-06-03,0.05090909090909091,5500,5780,280,3619388
6759,138930,2020-06-02,0.06382978723404255,5170,5500,330,2743947
6760,138930,2020-05-19,0.07829977628635347,4470,4820,350,2265836
6761,138930,2020-05-04,0.040594059405940595,5050,4845,-205,2286802
6762,138930,2020-04-27,0.05177993527508091,4635,4875,240,2139177
6763,138930,2020-04-06,0.05389908256880734,4360,4595,235,1079789
6764,138930,2020-03-25,0.09007832898172324,3830,4175,345,2744519
6765,138930,2020-03-24,0.049315068493150684,3650,3830,180,2078158
6766,138930,2020-03-23,0.08060453400503778,3970,3650,-320,1516667
6767,138930,2020-03-18,0.08731082654249127,4295,3920,-375,2653320
6768,138930,2020-03-17,0.06324972737186478,4585,4295,-290,2217662
6769,138930,2020-03-16,0.043795620437956206,4795,4585,-210,1734833
6770,138930,2020-03-13,0.05795677799607073,5090,4795,-295,2318097
6771,138930,2020-03-12,0.06605504587155964,5450,5090,-360,2728553
6772,138930,2020-03-09,0.060240963855421686,5810,5460,-350,1348899
6773,138930,2020-02-24,0.04608294930875576,6510,6210,-300,896940
6774,138930,2020-01-28,0.04558011049723757,7240,6910,-330,1024385
6775,138930,2019-12-05,0.04680851063829787,7050,7380,330,2045984
6776,138930,2019-03-15,0.05603448275862069,6960,7350,390,3249912
6777,138930,2019-01-02,0.045020463847203276,7330,7000,-330,1474391
6778,138930,2018-11-30,0.04005006257822278,7990,7670,-320,1903328
6779,138930,2018-10-11,0.04756380510440835,8620,8210,-410,1286711
6780,138930,2018-06-21,0.0429769392033543,9540,9130,-410,1460431
6781,138930,2018-03-23,0.04017857142857143,11200,10750,-450,1027678
6782,138930,2018-02-06,0.04225352112676056,10650,10200,-450,1754997
6783,138930,2017-11-02,0.051515151515151514,9900,9390,-510,3689676
6784,138930,2017-07-31,0.041474654377880185,10850,11300,450,1281791
6785,138930,2016-11-11,0.047097480832420595,9130,9560,430,2837049
6786,5300,2021-05-27,0.04100946372239748,158500,165000,6500,65358
6787,5300,2021-05-17,0.05105105105105105,166500,158000,-8500,106530
6788,5300,2021-05-12,0.040372670807453416,161000,167500,6500,175648
6789,5300,2021-05-11,0.08783783783783784,148000,161000,13000,132904
6790,5300,2021-05-03,0.060714285714285714,140000,148500,8500,90071
6791,5300,2021-04-29,0.06273062730627306,135500,144000,8500,137422
6792,5300,2021-04-21,0.056179775280898875,133500,141000,7500,94114
6793,5300,2021-03-29,0.09448818897637795,127000,139000,12000,175285
6794,5300,2021-03-03,0.07017543859649122,114000,122000,8000,58145
6795,5300,2021-02-08,0.04365079365079365,126000,131500,5500,67109
6796,5300,2021-02-02,0.06329113924050633,118500,126000,7500,55843
6797,5300,2021-01-29,0.053061224489795916,122500,116000,-6500,50054
6798,5300,2021-01-14,0.05785123966942149,121000,128000,7000,99492
6799,5300,2021-01-12,0.044444444444444446,112500,117500,5000,145227
6800,5300,2020-12-23,0.04205607476635514,107000,111500,4500,61964
6801,5300,2020-11-17,0.07444444444444444,90000,96700,6700,197154
6802,5300,2020-08-20,0.04613841524573721,99700,95100,-4600,51820
6803,5300,2020-07-20,0.04477611940298507,100500,105000,4500,52448
6804,5300,2020-06-16,0.0684931506849315,109500,117000,7500,101780
6805,5300,2020-06-15,0.07352941176470588,102000,109500,7500,183169
6806,5300,2020-04-27,0.04975124378109453,100500,105500,5000,45073
6807,5300,2020-04-07,0.09100877192982457,91200,99500,8300,80836
6808,5300,2020-03-23,0.07724867724867725,94500,87200,-7300,18872
6809,5300,2020-03-20,0.16666666666666666,81000,94500,13500,19007
6810,5300,2020-03-19,0.1,90000,81000,-9000,37778
6811,5300,2020-01-28,0.057034220532319393,131500,124000,-7500,26963
6812,5300,2019-10-30,0.06060606060606061,148500,139500,-9000,27549
6813,5300,2019-08-09,0.04332129963898917,138500,132500,-6000,43460
6814,5300,2019-08-02,0.040955631399317405,146500,140500,-6000,22078
6815,5300,2019-07-30,0.06622516556291391,151000,141000,-10000,46381
6816,5300,2019-05-28,0.06686046511627906,172000,183500,11500,46397
6817,5300,2019-05-23,0.05246913580246913,162000,170500,8500,29701
6818,5300,2019-05-16,0.06349206349206349,157500,167500,10000,32684
6819,5300,2019-04-24,0.05572198921509886,1669000,1762000,93000,5320
6820,5300,2019-03-12,0.04361179361179361,1628000,1699000,71000,6497
6821,5300,2019-01-18,0.04855072463768116,1380000,1447000,67000,2769
6822,5300,2018-11-15,0.04609375,1280000,1339000,59000,1399
6823,5300,2018-10-24,0.08464419475655431,1335000,1448000,113000,2237
6824,5300,2018-10-12,0.041428571428571426,1400000,1342000,-58000,1561
6825,5300,2018-04-03,0.0627831715210356,1545000,1642000,97000,3782
6826,5300,2018-02-09,0.06857523302263649,1502000,1605000,103000,6402
6827,5300,2018-02-07,0.042756860242501596,1567000,1500000,-67000,2517
6828,5300,2018-02-01,0.04221635883905013,1516000,1580000,64000,2730
6829,5300,2018-01-22,0.0719002201027146,1363000,1461000,98000,5011
6830,5300,2017-11-08,0.04330708661417323,1270000,1325000,55000,6741
6831,5300,2017-11-01,0.052060737527114966,1383000,1311000,-72000,12063
6832,5300,2017-10-31,0.06384615384615384,1300000,1383000,83000,13549
6833,5300,2017-09-27,0.04982456140350877,1425000,1354000,-71000,14712
6834,5300,2017-04-28,0.07603305785123966,1815000,1677000,-138000,11854
6835,5300,2017-04-27,0.10873549175320708,1637000,1815000,178000,23891
6836,5300,2017-04-21,0.04353562005277045,1516000,1582000,66000,10795
6837,5300,2017-04-20,0.06013986013986014,1430000,1516000,86000,9108
6838,20150,2021-04-09,0.043010752688172046,74400,77600,3200,469161
6839,20150,2021-03-26,0.0453125,64000,66900,2900,398818
6840,20150,2021-03-11,0.04,62500,65000,2500,797481
6841,20150,2021-03-08,0.05646359583952452,67300,63500,-3800,435472
6842,20150,2021-03-04,0.04148783977110158,69900,67000,-2900,427609
6843,20150,2021-02-26,0.04246575342465753,73000,69900,-3100,817974
6844,20150,2021-02-24,0.05352480417754569,76600,72500,-4100,679201
6845,20150,2021-02-23,0.0425,80000,76600,-3400,621823
6846,20150,2021-02-03,0.046357615894039736,75500,79000,3500,1205920
6847,20150,2021-02-02,0.06789250353606789,70700,75500,4800,903917
6848,20150,2021-01-22,0.048859934853420196,61400,64400,3000,1061737
6849,20150,2021-01-19,0.054481546572934976,56900,60000,3100,727055
6850,20150,2021-01-08,0.07224334600760456,52600,56400,3800,1681455
6851,20150,2020-12-11,0.046486486486486484,46250,48400,2150,988388
6852,20150,2020-11-27,0.043429844097995544,44900,46850,1950,729144
6853,20150,2020-09-28,0.04033214709371293,42150,43850,1700,215853
6854,20150,2020-09-24,0.08198489751887811,46350,42550,-3800,528297
6855,20150,2020-08-24,0.04426559356136821,49700,51900,2200,446970
6856,20150,2020-08-20,0.06679389312977099,52400,48900,-3500,757945
6857,20150,2020-08-18,0.05740740740740741,54000,50900,-3100,713134
6858,20150,2020-08-03,0.08875739644970414,50700,55200,4500,2490868
6859,20150,2020-06-25,0.08941418293936279,48650,53000,4350,4541445
6860,20150,2020-06-16,0.08080808080808081,44550,48150,3600,677575
6861,20150,2020-06-15,0.046038543897216275,46700,44550,-2150,852438
6862,20150,2020-05-27,0.04819277108433735,49800,47400,-2400,948717
6863,20150,2020-05-20,0.059887005649717516,44250,46900,2650,813567
6864,20150,2020-05-13,0.08005082592121983,39350,42500,3150,1925740
6865,20150,2020-04-17,0.06135770234986945,38300,40650,2350,1577286
6866,20150,2020-04-16,0.07584269662921349,35600,38300,2700,1314387
6867,20150,2020-04-14,0.04552129221732746,34050,35600,1550,641833
6868,20150,2020-04-13,0.05939226519337017,36200,34050,-2150,713305
6869,20150,2020-04-08,0.05697151424287856,33350,35250,1900,1962604
6870,20150,2020-03-25,0.11690647482014388,27800,31050,3250,1734685
6871,20150,2020-03-24,0.16317991631799164,23900,27800,3900,1691246
6872,20150,2020-03-23,0.04590818363273453,25050,23900,-1150,1085539
6873,20150,2020-03-20,0.11086474501108648,22550,25050,2500,1569859
6874,20150,2020-03-19,0.21428571428571427,28700,22550,-6150,2306945
6875,20150,2020-03-18,0.13943028485757122,33350,28700,-4650,1267427
6876,20150,2020-03-16,0.06858710562414266,36450,33950,-2500,808511
6877,20150,2020-03-13,0.07604562737642585,39450,36450,-3000,1431418
6878,20150,2020-03-12,0.05847255369928401,41900,39450,-2450,1095180
6879,20150,2020-03-11,0.04772727272727273,44000,41900,-2100,701605
6880,20150,2020-03-09,0.06316916488222699,46700,43750,-2950,731563
6881,20150,2020-02-28,0.05214723926380368,48900,46350,-2550,709456
6882,20150,2020-02-03,0.04791666666666667,48000,50300,2300,796443
6883,20150,2020-01-10,0.061843640606767794,42850,45500,2650,1123255
6884,20150,2020-01-09,0.051533742331288344,40750,42850,2100,601337
6885,20150,2019-12-04,0.06944444444444445,39600,36850,-2750,727280
6886,20150,2019-11-19,0.040522875816993466,38250,39800,1550,425398
6887,20150,2019-11-08,0.06597671410090557,38650,41200,2550,902548
6888,20150,2019-10-28,0.06815020862308763,35950,38400,2450,753308
6889,20150,2019-09-25,0.0685785536159601,40100,37350,-2750,993179
6890,20150,2019-09-16,0.04119850187265917,40050,41700,1650,419941
6891,20150,2019-09-09,0.04529201430274136,41950,40050,-1900,595121
6892,20150,2019-08-08,0.06030855539971949,35650,37800,2150,408375
6893,20150,2019-07-25,0.04265997490589712,39850,38150,-1700,548726
6894,20150,2019-07-01,0.04551539491298527,37350,39050,1700,693773
6895,20150,2019-06-03,0.053237410071942444,34750,36600,1850,534878
6896,20150,2019-05-30,0.08566978193146417,32100,34850,2750,953582
6897,20150,2019-05-09,0.07862068965517241,36250,33400,-2850,827363
6898,20150,2019-03-28,0.05012853470437018,38900,36950,-1950,553025
6899,20150,2019-03-25,0.04656862745098039,40800,38900,-1900,450679
6900,20150,2019-03-21,0.06130268199233716,39150,41550,2400,1281314
6901,20150,2019-02-07,0.05218446601941747,41200,43350,2150,686054
6902,20150,2019-01-25,0.07402597402597402,38500,41350,2850,1175167
6903,20150,2019-01-17,0.05831265508684864,40300,37950,-2350,706940
6904,20150,2019-01-07,0.05874499332443257,37450,39650,2200,569644
6905,20150,2018-12-21,0.044472681067344345,39350,41100,1750,975757
6906,20150,2018-12-19,0.06989247311827956,37200,39800,2600,1097628
6907,20150,2018-12-14,0.04177545691906005,38300,36700,-1600,415555
6908,20150,2018-12-12,0.0670391061452514,35800,38200,2400,643683
6909,20150,2018-12-10,0.0685640362225097,38650,36000,-2650,659456
6910,20150,2018-11-28,0.08574879227053141,41400,37850,-3550,2514559
6911,20150,2018-11-23,0.10393873085339168,45700,40950,-4750,3009075
6912,20150,2018-11-13,0.05172413793103448,46400,48800,2400,503206
6913,20150,2018-10-30,0.052570093457943924,42800,45050,2250,623534
6914,20150,2018-10-29,0.05414364640883978,45250,42800,-2450,638612
6915,20150,2018-10-26,0.044350580781414996,47350,45250,-2100,588648
6916,20150,2018-10-23,0.06140350877192982,51300,48150,-3150,653061
6917,20150,2018-10-22,0.05555555555555555,48600,51300,2700,551826
6918,20150,2018-10-12,0.0700218818380744,45700,48900,3200,672473
6919,20150,2018-10-11,0.053830227743271224,48300,45700,-2600,555407
6920,20150,2018-10-05,0.04230769230769231,52000,49800,-2200,615349
6921,20150,2018-09-04,0.05850091407678245,54700,57900,3200,1365634
6922,20150,2018-08-31,0.04482758620689655,58000,55400,-2600,3975818
6923,20150,2018-08-27,0.07116788321167883,54800,58700,3900,1328341
6924,20150,2018-08-24,0.04182509505703422,52600,54800,2200,1628869
6925,20150,2018-08-16,0.06981519507186858,48700,52100,3400,698581
6926,20150,2018-08-06,0.04428044280442804,54200,51800,-2400,394624
6927,20150,2018-07-26,0.040229885057471264,52200,54300,2100,587701
6928,20150,2018-07-23,0.05075187969924812,53200,50500,-2700,867404
6929,20150,2018-07-19,0.07692307692307693,49400,53200,3800,1826315
6930,20150,2018-07-12,0.069593147751606,46700,49950,3250,1456020
6931,20150,2018-07-11,0.06987399770904926,43650,46700,3050,1366214
6932,20150,2018-07-06,0.042839657282741736,40850,42600,1750,443946
6933,20150,2018-06-26,0.06220095693779904,41800,44400,2600,919747
6934,20150,2018-06-20,0.08865710560625815,38350,41750,3400,777967
6935,20150,2018-06-19,0.0448318804483188,40150,38350,-1800,575564
6936,20150,2018-06-18,0.0508274231678487,42300,40150,-2150,914715
6937,20150,2018-06-07,0.04954367666232073,38350,40250,1900,986997
6938,20150,2018-06-04,0.046008119079837616,36950,38650,1700,1329804
6939,20150,2018-06-01,0.06637806637806638,34650,36950,2300,865379
6940,20150,2018-05-09,0.06739811912225706,31900,34050,2150,407762
6941,20150,2018-04-04,0.052054794520547946,36500,34600,-1900,485930
6942,20150,2018-03-26,0.04878048780487805,36900,38700,1800,522918
6943,20150,2018-03-14,0.06073446327683616,35400,37550,2150,814312
6944,20150,2018-03-06,0.08087091757387248,32150,34750,2600,654988
6945,20150,2018-02-07,0.04148783977110158,34950,33500,-1450,424947
6946,20150,2018-02-05,0.043184885290148446,37050,35450,-1600,534040
6947,20150,2018-02-02,0.04633204633204633,38850,37050,-1800,576359
6948,20150,2018-01-19,0.04193138500635324,39350,37700,-1650,844140
6949,20150,2018-01-16,0.0633245382585752,37900,40300,2400,1923143
6950,20150,2017-12-27,0.06128133704735376,35900,38100,2200,731996
6951,20150,2017-12-22,0.04941860465116279,34400,36100,1700,471425
6952,20150,2017-12-04,0.058301647655259824,39450,37150,-2300,750347
6953,20150,2017-11-28,0.05596107055961071,41100,38800,-2300,1209530
6954,20150,2017-11-22,0.057441253263707574,38300,40500,2200,2272059
6955,20150,2017-11-16,0.046831955922865015,36300,38000,1700,1631541
6956,20150,2017-11-09,0.14392803598200898,33350,38150,4800,3742627
6957,20150,2017-11-08,0.04709576138147567,31850,33350,1500,1003664
6958,20150,2017-11-06,0.04141104294478527,32600,31250,-1350,717752
6959,20150,2017-11-03,0.050946142649199416,34350,32600,-1750,1318484
6960,20150,2017-10-30,0.05555555555555555,33300,31450,-1850,805507
6961,20150,2017-09-27,0.045714285714285714,35000,36600,1600,803448
6962,20150,2017-09-22,0.07733333333333334,37500,34600,-2900,1930316
6963,20150,2017-09-21,0.04580152671755725,39300,37500,-1800,1695731
6964,20150,2017-09-20,0.06761565836298933,42150,39300,-2850,1408858
6965,20150,2017-09-15,0.045819014891179836,43650,41650,-2000,3016896
6966,20150,2017-09-13,0.08588957055214724,40750,44250,3500,2598597
6967,20150,2017-09-11,0.0685640362225097,38650,41300,2650,1660406
6968,20150,2017-08-23,0.11139896373056994,38600,42900,4300,2811847
6969,20150,2017-08-16,0.0821917808219178,36500,39500,3000,1231625
6970,20150,2017-08-09,0.0735873850197109,38050,35250,-2800,857060
6971,20150,2017-08-02,0.048582995951417005,37050,38850,1800,765726
6972,20150,2017-07-26,0.05405405405405406,38850,36750,-2100,1420978
6973,20150,2017-07-25,0.040740740740740744,40500,38850,-1650,935346
6974,20150,2017-07-24,0.10610079575596817,37700,40500,2800,2256640
6975,20150,2017-07-18,0.05170387779083431,42550,40350,-2200,2729812
6976,20150,2017-07-17,0.15,37000,42550,5550,1641281
6977,20150,2017-07-10,0.041968162083936326,34550,36000,1450,1964820
6978,20150,2017-07-07,0.1056,31250,34550,3300,1824348
6979,20150,2017-06-26,0.12020905923344948,28700,32150,3450,1622406
6980,20150,2017-06-21,0.07692307692307693,26650,28700,2050,880059
6981,20150,2017-06-16,0.04,26250,27300,1050,1507530
6982,20150,2017-06-15,0.07581967213114754,24400,26250,1850,1221799
6983,20150,2017-06-14,0.09417040358744394,22300,24400,2100,984190
6984,20150,2017-06-12,0.04139433551198257,22950,22000,-950,447074
6985,20150,2017-06-07,0.06278026905829596,22300,23700,1400,575368
6986,20150,2017-05-16,0.06483790523690773,20050,21350,1300,1160911
6987,20150,2017-05-10,0.06111111111111111,18000,19100,1100,1501803
6988,20150,2017-03-17,0.08417508417508418,14850,16100,1250,1468654
6989,20150,2017-03-03,0.05263157894736842,15200,14400,-800,431675
6990,20150,2017-02-17,0.04054054054054054,14800,15400,600,857182
6991,20150,2017-02-01,0.1349206349206349,12600,14300,1700,1520311
6992,20150,2017-01-18,0.05761316872427984,12150,12850,700,583574
6993,20150,2017-01-02,0.08243727598566308,13950,12800,-1150,646882
6994,20150,2016-12-15,0.04182509505703422,13150,13700,550,792653
6995,20150,2016-12-12,0.05138339920948617,12650,13300,650,479045
6996,20150,2016-12-08,0.07692307692307693,11700,12600,900,496890
6997,20150,2016-12-06,0.048458149779735685,11350,11900,550,328763
6998,20150,2016-11-25,0.05217391304347826,11500,12100,600,384318
6999,20150,2016-11-22,0.05241935483870968,12400,11750,-650,588935
7000,20150,2016-11-21,0.04247104247104247,12950,12400,-550,237877
7001,20150,2016-11-17,0.051181102362204724,12700,13350,650,575587
7002,20150,2016-11-10,0.08185053380782918,14050,12900,-1150,1649435
7003,20150,2016-11-09,0.08469055374592833,15350,14050,-1300,897039
7004,20150,2016-11-08,0.06402439024390244,16400,15350,-1050,590212
7005,20150,2016-11-07,0.044585987261146494,15700,16400,700,213620
7006,20150,2016-11-02,0.06116207951070336,16350,15350,-1000,324227
7007,20150,2016-10-04,0.09404388714733543,15950,17450,1500,790944
7008,20150,2016-09-12,0.045871559633027525,16350,15600,-750,230769
7009,20150,2016-08-30,0.046511627906976744,17200,18000,800,396183
7010,20150,2016-08-29,0.04178272980501393,17950,17200,-750,294390
7011,20150,2016-08-08,0.04,16250,16900,650,529380
7012,51900,2021-04-23,0.047182175622542594,1526000,1598000,72000,88636
7013,51900,2021-01-25,0.07298335467349552,1562000,1676000,114000,111499
7014,51900,2020-08-21,0.042,1500000,1563000,63000,36757
7015,51900,2020-08-18,0.04153354632587859,1565000,1500000,-65000,50554
7016,51900,2020-08-11,0.08858131487889273,1445000,1573000,128000,93232
7017,51900,2020-07-21,0.04844814534443603,1321000,1385000,64000,77971
7018,51900,2020-06-26,0.04698512137823023,1277000,1337000,60000,48453
7019,51900,2020-06-25,0.05055762081784387,1345000,1277000,-68000,45849
7020,51900,2020-06-23,0.04509493670886076,1264000,1321000,57000,52597
7021,51900,2020-06-15,0.04150943396226415,1325000,1270000,-55000,47831
7022,51900,2020-04-23,0.0800299177262528,1337000,1444000,107000,148170
7023,51900,2020-04-17,0.04869857262804366,1191000,1249000,58000,62084
7024,51900,2020-04-06,0.0506872852233677,1164000,1223000,59000,60263
7025,51900,2020-04-02,0.059757236227824466,1071000,1135000,64000,56498
7026,51900,2020-04-01,0.04375,1120000,1071000,-49000,66300
7027,51900,2020-03-24,0.07317073170731707,1066000,1144000,78000,69628
7028,51900,2020-03-16,0.043859649122807015,1140000,1090000,-50000,66839
7029,51900,2020-03-12,0.047619047619047616,1218000,1160000,-58000,89277
7030,51900,2020-02-24,0.06304985337243402,1364000,1278000,-86000,67766
7031,51900,2020-01-28,0.07116382505559674,1349000,1253000,-96000,98803
7032,51900,2020-01-13,0.045420699925539834,1343000,1404000,61000,49449
7033,51900,2020-01-07,0.07526020816653323,1249000,1343000,94000,62787
7034,51900,2019-10-08,0.043478260869565216,1265000,1320000,55000,43337
7035,51900,2019-09-03,0.04765957446808511,1175000,1231000,56000,43123
7036,51900,2019-07-26,0.06422018348623854,1308000,1224000,-84000,77045
7037,51900,2019-03-13,0.040912667191188044,1271000,1323000,52000,45163
7038,51900,2019-02-20,0.05473856209150327,1224000,1291000,67000,57740
7039,51900,2019-01-30,0.04477611940298507,1206000,1260000,54000,50277
7040,51900,2019-01-25,0.05526315789473684,1140000,1203000,63000,78685
7041,51900,2019-01-15,0.043557168784029036,1102000,1150000,48000,44161
7042,51900,2018-11-15,0.07685185185185185,1080000,1163000,83000,55402
7043,51900,2018-11-09,0.048027444253859346,1166000,1110000,-56000,77679
7044,51900,2018-11-01,0.0871647509578544,1044000,1135000,91000,64566
7045,51900,2018-10-29,0.05339366515837104,1105000,1046000,-59000,45211
7046,51900,2018-10-25,0.0410958904109589,1095000,1140000,45000,73811
7047,51900,2018-10-12,0.06208213944603629,1047000,1112000,65000,67214
7048,51900,2018-10-11,0.08157894736842106,1140000,1047000,-93000,85540
7049,51900,2018-10-10,0.04201680672268908,1190000,1140000,-50000,37869
7050,51900,2018-10-04,0.07710100231303008,1297000,1197000,-100000,65853
7051,51900,2018-09-27,0.04926108374384237,1218000,1278000,60000,47830
7052,51900,2018-09-14,0.051607445008460234,1182000,1243000,61000,35288
7053,51900,2018-08-23,0.052100840336134456,1190000,1252000,62000,55157
7054,51900,2018-08-01,0.04297520661157025,1210000,1262000,52000,50303
7055,51900,2018-07-25,0.05559729526671676,1331000,1257000,-74000,79239
7056,51900,2018-07-24,0.04556166535742341,1273000,1331000,58000,44286
7057,51900,2018-07-10,0.040268456375838924,1341000,1287000,-54000,46498
7058,51900,2018-07-03,0.045064377682403435,1398000,1335000,-63000,84971
7059,51900,2018-06-20,0.049680624556423,1409000,1479000,70000,33455
7060,51900,2018-05-24,0.051364365971107544,1246000,1310000,64000,27795
7061,51900,2018-05-03,0.05611510791366906,1390000,1312000,-78000,22844
7062,51900,2018-04-30,0.05628373168851195,1297000,1370000,73000,42548
7063,51900,2018-03-08,0.040740740740740744,1080000,1124000,44000,55455
7064,51900,2018-01-24,0.04326123128119801,1202000,1150000,-52000,140552
7065,51900,2018-01-10,0.06445993031358885,1148000,1222000,74000,53136
7066,51900,2017-10-26,0.05950266429840142,1126000,1193000,67000,75956
7067,51900,2017-10-24,0.06497175141242938,1062000,1131000,69000,63698
7068,51900,2017-10-13,0.04512820512820513,975000,1019000,44000,67005
7069,51900,2017-09-29,0.04932735426008968,892000,936000,44000,64022
7070,51900,2017-09-22,0.05022321428571429,896000,851000,-45000,61567
7071,51900,2017-05-04,0.07764705882352942,850000,916000,66000,77210
7072,51900,2017-04-17,0.044642857142857144,784000,819000,35000,45294
7073,51900,2017-03-03,0.08217592592592593,864000,793000,-71000,130170
7074,51900,2017-01-02,0.046674445740956826,857000,817000,-40000,39687
7075,51900,2016-10-31,0.04428904428904429,858000,820000,-38000,58560
7076,51900,2016-10-25,0.08342361863488625,923000,846000,-77000,236944
7077,51900,2016-10-07,0.054140127388535034,942000,891000,-51000,98516
7078,51900,2016-09-29,0.04426559356136821,994000,950000,-44000,88348
7079,51900,2016-08-23,0.06465517241379311,928000,988000,60000,100777
7080,51900,2016-08-05,0.0446521287642783,963000,920000,-43000,106934
7081,4800,2021-05-03,0.08148893360160966,99400,107500,8100,537149
7082,4800,2021-04-28,0.050204918032786885,97600,102500,4900,313451
7083,4800,2021-04-21,0.05680600214362272,93300,98600,5300,322214
7084,4800,2021-03-15,0.056790123456790124,81000,85600,4600,240803
7085,4800,2021-02-24,0.04572098475967175,85300,81400,-3900,216652
7086,4800,2021-02-03,0.08010012515644556,79900,86300,6400,1903007
7087,4800,2021-02-01,0.06873315363881402,74200,79300,5100,646975
7088,4800,2020-12-29,0.049443757725587144,80900,76900,-4000,292426
7089,4800,2020-11-24,0.04230769230769231,78000,81300,3300,135319
7090,4800,2020-09-08,0.06303030303030303,82500,77300,-5200,428875
7091,4800,2020-09-04,0.19264705882352942,68000,81100,13100,1349850
7092,4800,2020-08-20,0.04277286135693215,67800,64900,-2900,133446
7093,4800,2020-08-18,0.05027932960893855,71600,68000,-3600,115736
7094,4800,2020-07-27,0.05822416302765648,68700,72700,4000,258125
7095,4800,2020-07-24,0.04090909090909091,66000,68700,2700,129237
7096,4800,2020-07-15,0.05152979066022544,62100,65300,3200,161777
7097,4800,2020-06-15,0.05680119581464873,66900,63100,-3800,114264
7098,4800,2020-03-25,0.09818181818181818,55000,60400,5400,124865
7099,4800,2020-03-24,0.07421875,51200,55000,3800,108459
7100,4800,2020-03-23,0.10332749562171628,57100,51200,-5900,116781
7101,4800,2020-03-20,0.14773869346733667,49750,57100,7350,230722
7102,4800,2020-03-19,0.16526845637583892,59600,49750,-9850,222224
7103,4800,2020-03-18,0.08166409861325115,64900,59600,-5300,115775
7104,4800,2020-02-06,0.06294706723891273,69900,74300,4400,146283
7105,4800,2019-12-27,0.05575326215895611,84300,79600,-4700,299642
7106,4800,2019-08-06,0.04710144927536232,82800,86700,3900,119165
7107,4800,2019-07-23,0.043701799485861184,77800,81200,3400,217813
7108,4800,2019-07-18,0.06233062330623306,73800,78400,4600,132870
7109,4800,2019-05-29,0.044585987261146494,78500,75000,-3500,99408
7110,4800,2019-05-02,0.06391478029294274,75100,79900,4800,274380
7111,4800,2019-04-17,0.04654255319148936,75200,78700,3500,145142
7112,4800,2019-02-07,0.04477611940298507,67000,70000,3000,241513
7113,4800,2019-02-01,0.04285714285714286,70000,67000,-3000,357618
7114,4800,2019-01-30,0.09235668789808917,62800,68600,5800,515588
7115,4800,2019-01-29,0.04666666666666667,60000,62800,2800,311884
7116,4800,2019-01-23,0.06690777576853527,55300,59000,3700,474372
7117,4800,2019-01-18,0.08134920634920635,50400,54500,4100,437434
7118,4800,2019-01-15,0.05070993914807302,49300,51800,2500,229513
7119,4800,2019-01-02,0.041,50000,47950,-2050,358877
7120,4800,2018-12-28,0.06890130353817504,53700,50000,-3700,566289
7121,4800,2018-12-27,0.09747899159663866,59500,53700,-5800,564287
7122,4800,2018-12-19,0.08021390374331551,56100,60600,4500,481906
7123,4800,2018-12-12,0.047151277013752456,50900,53300,2400,301892
7124,4800,2018-11-29,0.06924643584521385,49100,52500,3400,467781
7125,4800,2018-10-31,0.04693877551020408,49000,51300,2300,426006
7126,4800,2018-10-30,0.084070796460177,45200,49000,3800,810993
7127,4800,2018-10-29,0.06982248520710059,42250,45200,2950,1697330
7128,4800,2018-10-26,0.0673289183222958,45300,42250,-3050,304315
7129,4800,2018-10-25,0.05230125523012552,47800,45300,-2500,183973
7130,4800,2018-10-24,0.06815642458100558,44750,47800,3050,333345
7131,4800,2018-10-23,0.0417558886509636,46700,44750,-1950,118704
7132,4800,2018-10-11,0.07789473684210527,47500,43800,-3700,280855
7133,4800,2018-09-11,0.04357541899441341,44750,46700,1950,251462
7134,4800,2018-08-30,0.05744431418522861,42650,45100,2450,551846
7135,4800,2018-07-30,0.040840140023337225,42850,44600,1750,310148
7136,4800,2018-07-23,0.04449388209121246,44950,42950,-2000,498405
7137,4800,2018-07-19,0.05912863070539419,48200,45350,-2850,1030478
7138,4800,2018-07-18,0.07129094412331406,51900,48200,-3700,1170083
7139,4800,2018-07-16,0.09380530973451327,56500,51200,-5300,2486389
7140,4800,2018-07-13,0.1701492537313433,134000,56500,-77500,6091316
7141,4800,2018-05-28,0.06538461538461539,130000,138500,8500,543691
7142,4800,2018-05-02,0.04182509505703422,131500,137000,5500,430937
7143,4800,2018-04-30,0.04365079365079365,126000,131500,5500,248860
7144,4800,2018-04-12,0.04564315352697095,120500,126000,5500,237728
7145,4800,2018-03-23,0.04,125000,120000,-5000,215575
7146,4800,2018-02-21,0.044715447154471545,123000,128500,5500,161515
7147,4800,2018-02-09,0.040160642570281124,124500,119500,-5000,253266
7148,4800,2018-01-29,0.0421455938697318,130500,136000,5500,360714
7149,4800,2018-01-08,0.04195804195804196,143000,137000,-6000,298257
7150,4800,2018-01-03,0.06115107913669065,139000,147500,8500,672529
7151,4800,2017-12-14,0.045112781954887216,133000,139000,6000,315111
7152,4800,2017-11-16,0.05952380952380952,126000,133500,7500,326272
7153,4800,2017-09-05,0.045454545454545456,154000,161000,7000,265233
7154,4800,2017-08-16,0.05263157894736842,171000,162000,-9000,355548
7155,4800,2017-07-27,0.04100946372239748,158500,165000,6500,318555
7156,4800,2017-07-04,0.06358381502890173,173000,162000,-11000,283880
7157,4800,2017-05-22,0.04950495049504951,151500,159000,7500,337128
7158,4800,2017-04-26,0.07777777777777778,135000,145500,10500,500952
7159,4800,2016-10-04,0.05,130000,136500,6500,261875
7160,4800,2016-08-09,0.05263157894736842,133000,140000,7000,203614
7161,51905,2021-01-28,0.04054054054054054,740000,710000,-30000,11316
7162,51905,2021-01-25,0.05782792665726375,709000,750000,41000,28681
7163,51905,2020-08-18,0.06777493606138107,782000,729000,-53000,6007
7164,51905,2020-08-11,0.0410958904109589,730000,760000,30000,15554
7165,51905,2020-06-30,0.050724637681159424,690000,725000,35000,9372
7166,51905,2020-06-15,0.05698778833107191,737000,695000,-42000,6771
7167,51905,2020-05-04,0.049586776859504134,726000,690000,-36000,9679
7168,51905,2020-04-23,0.05988857938718663,718000,761000,43000,9100
7169,51905,2020-04-17,0.046511627906976744,645000,675000,30000,4922
7170,51905,2020-04-06,0.040498442367601244,642000,668000,26000,7903
7171,51905,2020-03-13,0.04632152588555858,734000,700000,-34000,10398
7172,51905,2020-03-12,0.06496815286624204,785000,734000,-51000,5401
7173,51905,2020-02-28,0.05419354838709677,775000,733000,-42000,4639
7174,51905,2020-02-24,0.06097560975609756,820000,770000,-50000,2438
7175,51905,2020-01-29,0.0504774897680764,733000,770000,37000,2783
7176,51905,2020-01-28,0.09057071960297766,806000,733000,-73000,3148
7177,51905,2020-01-21,0.05548996458087367,847000,800000,-47000,2119
7178,51905,2020-01-13,0.05449936628643853,789000,832000,43000,2930
7179,51905,2020-01-07,0.0457516339869281,765000,800000,35000,5105
7180,51905,2019-08-06,0.04,775000,744000,-31000,3088
7181,51905,2019-07-31,0.04145077720207254,772000,804000,32000,2832
7182,51905,2019-07-26,0.06242350061199511,817000,766000,-51000,2011
7183,51905,2019-06-04,0.05858310626702997,734000,777000,43000,5855
7184,51905,2019-05-09,0.06496815286624204,785000,734000,-51000,1861
7185,51905,2019-03-15,0.06459948320413436,774000,824000,50000,3126
7186,51905,2019-02-20,0.043909348441926344,706000,737000,31000,3350
7187,51905,2018-11-30,0.04285714285714286,700000,670000,-30000,4608
7188,51905,2018-11-01,0.05874316939890711,732000,689000,-43000,2214
7189,51905,2018-10-31,0.16560509554140126,628000,732000,104000,2754
7190,51905,2018-10-12,0.054628224582701064,659000,695000,36000,2544
7191,51905,2018-10-11,0.07573632538569425,713000,659000,-54000,3877
7192,51905,2018-10-05,0.06835443037974684,790000,736000,-54000,6680
7193,51905,2018-10-01,0.048507462686567165,804000,843000,39000,6019
7194,51905,2018-09-27,0.046875,768000,804000,36000,3526
7195,51905,2018-08-23,0.04393939393939394,660000,689000,29000,1295
7196,51905,2018-07-25,0.040787623066104076,711000,682000,-29000,1172
7197,51905,2018-07-19,0.04801097393689986,729000,694000,-35000,1094
7198,51905,2018-07-13,0.04992867332382311,701000,736000,35000,990
7199,51905,2018-06-20,0.053497942386831275,729000,768000,39000,3382
7200,51905,2018-05-03,0.041237113402061855,776000,744000,-32000,1072
7201,51905,2018-04-02,0.04317548746518106,718000,749000,31000,1426
7202,51905,2018-02-19,0.05537459283387622,614000,648000,34000,1307
7203,51905,2018-01-24,0.04384724186704385,707000,676000,-31000,3694
7204,51905,2018-01-10,0.048034934497816595,687000,720000,33000,2011
7205,51905,2017-10-10,0.07023411371237458,598000,640000,42000,4971
7206,51905,2017-05-08,0.05,580000,609000,29000,5874
7207,51905,2017-05-04,0.07606679035250463,539000,580000,41000,5861
7208,51905,2017-03-03,0.07894736842105263,570000,525000,-45000,6256
7209,51905,2017-02-10,0.04380952380952381,525000,548000,23000,3903
7210,51905,2017-01-06,0.045714285714285714,525000,549000,24000,3501
7211,51905,2017-01-04,0.05252918287937743,514000,541000,27000,3268
7212,51905,2017-01-02,0.08880994671403197,563000,513000,-50000,4304
7213,51905,2016-11-11,0.04183266932270916,502000,481000,-21000,4566
7214,51905,2016-10-26,0.04942528735632184,435000,456500,21500,12413
7215,51905,2016-10-25,0.05125408942202835,458500,435000,-23500,19526
7216,51905,2016-10-05,0.04519230769230769,520000,496500,-23500,6107
7217,51905,2016-09-08,0.047619047619047616,525000,550000,25000,7855
7218,51905,2016-08-31,0.0595903165735568,537000,569000,32000,9777
7219,51905,2016-08-23,0.0684931506849315,511000,546000,35000,6129
7220,51905,2016-08-05,0.05330882352941176,544000,515000,-29000,20064
7221,47810,2021-03-23,0.042666666666666665,37500,35900,-1600,1547311
7222,47810,2021-03-19,0.04526166902404526,35350,36950,1600,1797497
7223,47810,2021-03-11,0.07165109034267912,32100,34400,2300,1763532
7224,47810,2021-02-26,0.05832147937411095,35150,33100,-2050,2022812
7225,47810,2021-02-24,0.05509641873278237,36300,34300,-2000,1795775
7226,47810,2021-02-04,0.1329479768786127,34600,39200,4600,11773559
7227,47810,2021-02-02,0.05625,32000,33800,1800,2829109
7228,47810,2021-01-25,0.05967741935483871,31000,32850,1850,2295295
7229,47810,2021-01-20,0.051580698835274545,30050,31600,1550,3814580
7230,47810,2021-01-18,0.07027027027027027,27750,29700,1950,4369224
7231,47810,2021-01-04,0.04263565891472868,25800,26900,1100,1568992
7232,47810,2020-12-11,0.04583333333333333,24000,25100,1100,1849269
7233,47810,2020-11-11,0.06465517241379311,23200,24700,1500,1759417
7234,47810,2020-08-20,0.04384133611691023,23950,22900,-1050,773324
7235,47810,2020-08-18,0.04618473895582329,24900,23750,-1150,779871
7236,47810,2020-06-17,0.049800796812749,25100,26350,1250,3434205
7237,47810,2020-06-12,0.04230769230769231,26000,24900,-1100,850731
7238,47810,2020-05-27,0.05979381443298969,24250,25700,1450,1928534
7239,47810,2020-05-04,0.07017543859649122,25650,23850,-1800,1373770
7240,47810,2020-04-24,0.056016597510373446,24100,25450,1350,3553804
7241,47810,2020-04-21,0.05508474576271186,23600,24900,1300,7928199
7242,47810,2020-04-20,0.04424778761061947,22600,23600,1000,1117443
7243,47810,2020-04-13,0.043478260869565216,23000,22000,-1000,548489
7244,47810,2020-04-07,0.05995203836930456,20850,22100,1250,1094423
7245,47810,2020-03-25,0.17134831460674158,17800,20850,3050,1551938
7246,47810,2020-03-24,0.08868501529051988,16350,17800,1450,573719
7247,47810,2020-03-23,0.09166666666666666,18000,16350,-1650,984506
7248,47810,2020-03-20,0.0975609756097561,16400,18000,1600,872172
7249,47810,2020-03-19,0.11827956989247312,18600,16400,-2200,1294787
7250,47810,2020-03-18,0.05583756345177665,19700,18600,-1100,645476
7251,47810,2020-03-13,0.06444444444444444,22500,21050,-1450,1151590
7252,47810,2020-03-12,0.058577405857740586,23900,22500,-1400,854536
7253,47810,2020-03-09,0.04816955684007707,25950,24700,-1250,475175
7254,47810,2020-02-28,0.051756007393715345,27050,25650,-1400,1135203
7255,47810,2020-02-24,0.05565217391304348,28750,27150,-1600,689537
7256,47810,2019-09-24,0.04878048780487805,41000,39000,-2000,1143727
7257,47810,2019-09-04,0.046365914786967416,39900,41750,1850,994768
7258,47810,2019-08-08,0.04507042253521127,35500,37100,1600,826625
7259,47810,2019-07-30,0.04131054131054131,35100,36550,1450,959873
7260,47810,2019-07-16,0.04264705882352941,34000,35450,1450,373872
7261,47810,2019-05-03,0.07072135785007072,35350,32850,-2500,1621207
7262,47810,2019-02-14,0.05547226386806597,33350,35200,1850,1897778
7263,47810,2018-11-19,0.06785137318255251,30950,33050,2100,1585861
7264,47810,2018-11-15,0.05674846625766871,32600,30750,-1850,2595791
7265,47810,2018-11-02,0.05460750853242321,29300,30900,1600,738506
7266,47810,2018-10-11,0.05116279069767442,32250,30600,-1650,1708254
7267,47810,2018-10-01,0.05270655270655271,35100,33250,-1850,6405737
7268,47810,2018-09-28,0.298,50000,35100,-14900,13510259
7269,47810,2018-09-27,0.08108108108108109,46250,50000,3750,3044692
7270,47810,2018-08-17,0.04330708661417323,38100,39750,1650,1293668
7271,47810,2018-07-19,0.06531204644412192,34450,32200,-2250,3768499
7272,47810,2018-07-18,0.09342105263157895,38000,34450,-3550,4119910
7273,47810,2018-07-13,0.05459057071960298,40300,38100,-2200,3009444
7274,47810,2018-07-11,0.06511627906976744,43000,40200,-2800,8817167
7275,47810,2018-06-20,0.05174353205849269,44450,42150,-2300,1491938
7276,47810,2018-06-07,0.07432432432432433,44400,47700,3300,1701333
7277,47810,2018-05-29,0.04482758620689655,43500,45450,1950,1126529
7278,47810,2018-05-10,0.04853273137697517,44300,42150,-2150,999401
7279,47810,2018-05-04,0.06455399061032864,42600,45350,2750,1240485
7280,47810,2018-05-02,0.04282407407407408,43200,41350,-1850,1060746
7281,47810,2018-04-30,0.04318936877076412,45150,43200,-1950,951630
7282,47810,2018-03-23,0.04563106796116505,51500,49150,-2350,830126
7283,47810,2018-03-21,0.06693711967545639,49300,52600,3300,1948321
7284,47810,2018-03-12,0.04041450777202073,48250,50200,1950,478997
7285,47810,2018-02-19,0.05370569280343716,46550,49050,2500,903051
7286,47810,2018-01-17,0.060784313725490195,51000,54100,3100,2386198
7287,47810,2018-01-16,0.060291060291060294,48100,51000,2900,1040424
7288,47810,2017-12-08,0.05430327868852459,48800,46150,-2650,1342291
7289,47810,2017-11-16,0.053465346534653464,50500,53200,2700,1083343
7290,47810,2017-11-13,0.045368620037807186,52900,50500,-2400,1562566
7291,47810,2017-10-24,0.04585537918871252,56700,54100,-2600,1942534
7292,47810,2017-10-19,0.17819706498951782,47700,56200,8500,6381889
7293,47810,2017-10-10,0.09153318077803203,43700,47700,4000,2181642
7294,47810,2017-09-21,0.05844155844155844,46200,43500,-2700,1803887
7295,47810,2017-09-07,0.08041958041958042,42900,46350,3450,2019094
7296,47810,2017-08-28,0.058823529411764705,43350,45900,2550,3131464
7297,47810,2017-08-25,0.04457831325301205,41500,43350,1850,2389239
7298,47810,2017-08-16,0.16124661246612465,36900,42850,5950,10090088
7299,47810,2017-08-14,0.045278137128072445,38650,36900,-1750,3327931
7300,47810,2017-08-07,0.04871794871794872,39000,40900,1900,3811337
7301,47810,2017-08-03,0.12100456621004566,43800,38500,-5300,10303863
7302,47810,2017-08-02,0.1657142857142857,52500,43800,-8700,4726187
7303,47810,2017-07-19,0.04692387904066736,47950,50200,2250,3387718
7304,47810,2017-07-18,0.059803921568627454,51000,47950,-3050,5613751
7305,47810,2017-07-17,0.11458333333333333,57600,51000,-6600,4510461
7306,47810,2017-07-14,0.05573770491803279,61000,57600,-3400,2611346
7307,47810,2017-04-18,0.05789473684210526,57000,60300,3300,1370057
7308,47810,2017-02-03,0.06584992343032159,65300,61000,-4300,2205497
7309,47810,2017-02-02,0.04313099041533546,62600,65300,2700,697098
7310,47810,2016-12-12,0.05521472392638037,65200,68800,3600,599067
7311,47810,2016-11-17,0.06153846153846154,65000,69000,4000,851685
7312,47810,2016-11-15,0.06540697674418605,68800,64300,-4500,1098940
7313,47810,2016-11-10,0.1109375,64000,71100,7100,2052261
7314,47810,2016-11-02,0.05305466237942122,62200,58900,-3300,1753310
7315,47810,2016-11-01,0.040123456790123455,64800,62200,-2600,1051006
7316,47810,2016-10-31,0.045655375552282766,67900,64800,-3100,705888
7317,47810,2016-10-26,0.04827586206896552,72500,69000,-3500,936590
7318,47810,2016-10-13,0.050387596899224806,77400,73500,-3900,1113560
7319,47810,2016-09-23,0.04710144927536232,82800,78900,-3900,1868863
7320,47810,2016-08-30,0.07440100882723834,79300,85200,5900,1591023
7321,51910,2021-05-26,0.06726457399103139,892000,832000,-60000,760533
7322,51910,2021-05-12,0.052689352360043906,911000,863000,-48000,494315
7323,51910,2021-04-29,0.06853932584269663,890000,951000,61000,1405704
7324,51910,2021-04-13,0.06242350061199511,817000,868000,51000,713786
7325,51910,2021-03-16,0.07763975155279502,966000,891000,-75000,941008
7326,51910,2021-03-11,0.05387205387205387,891000,939000,48000,601480
7327,51910,2021-03-05,0.04508670520231214,865000,904000,39000,548940
7328,51910,2021-03-02,0.07220216606498195,831000,891000,60000,697301
7329,51910,2021-02-26,0.06629213483146068,890000,831000,-59000,656689
7330,51910,2021-01-07,0.08089887640449438,890000,962000,72000,706912
7331,51910,2021-01-04,0.07888349514563107,824000,889000,65000,858451
7332,51910,2020-11-24,0.06818181818181818,748000,799000,51000,858347
7333,51910,2020-11-10,0.043596730245231606,734000,702000,-32000,563688
7334,51910,2020-11-06,0.06351550960118169,677000,720000,43000,1268197
7335,51910,2020-11-05,0.04153846153846154,650000,677000,27000,446583
7336,51910,2020-11-03,0.052969502407704656,623000,656000,33000,638480
7337,51910,2020-10-30,0.06144393241167435,651000,611000,-40000,820454
7338,51910,2020-10-13,0.041666666666666664,672000,644000,-28000,678451
7339,51910,2020-09-29,0.04472843450479233,626000,654000,28000,677451
7340,51910,2020-09-21,0.05855855855855856,666000,627000,-39000,1239438
7341,51910,2020-09-17,0.0611353711790393,687000,645000,-42000,3408145
7342,51910,2020-09-16,0.05371900826446281,726000,687000,-39000,958233
7343,51910,2020-08-26,0.061711079943899017,713000,757000,44000,1094918
7344,51910,2020-08-21,0.047976011994003,667000,699000,32000,1078744
7345,51910,2020-08-14,0.050203527815468114,737000,700000,-37000,1160403
7346,51910,2020-08-11,0.05277777777777778,720000,758000,38000,1087515
7347,51910,2020-08-07,0.09705882352941177,680000,746000,66000,1399982
7348,51910,2020-08-05,0.04361370716510903,642000,670000,28000,917661
7349,51910,2020-08-03,0.11795774647887323,568000,635000,67000,1715295
7350,51910,2020-07-31,0.07169811320754717,530000,568000,38000,1376453
7351,51910,2020-07-09,0.050682261208576995,513000,539000,26000,819218
7352,51910,2020-06-19,0.04276985743380855,491000,512000,21000,738862
7353,51910,2020-06-16,0.13901869158878505,428000,487500,59500,1156149
7354,51910,2020-06-15,0.0735930735930736,462000,428000,-34000,851192
7355,51910,2020-06-11,0.05227272727272727,440000,463000,23000,1250374
7356,51910,2020-06-04,0.04244694132334582,400500,417500,17000,966577
7357,51910,2020-05-27,0.04468599033816425,414000,395500,-18500,622426
7358,51910,2020-05-26,0.06290115532734275,389500,414000,24500,958956
7359,51910,2020-05-21,0.041379310344827586,362500,377500,15000,1033430
7360,51910,2020-05-13,0.04142011834319527,338000,352000,14000,861294
7361,51910,2020-05-04,0.043824701195219126,376500,360000,-16500,669179
7362,51910,2020-04-17,0.056851311953352766,343000,362500,19500,753764
7363,51910,2020-04-16,0.05053598774885146,326500,343000,16500,621763
7364,51910,2020-04-07,0.04215851602023609,296500,309000,12500,717617
7365,51910,2020-04-01,0.04262295081967213,305000,292000,-13000,599459
7366,51910,2020-03-25,0.06770833333333333,288000,307500,19500,803831
7367,51910,2020-03-24,0.07462686567164178,268000,288000,20000,966345
7368,51910,2020-03-20,0.18478260869565216,230000,272500,42500,1306067
7369,51910,2020-03-19,0.17857142857142858,280000,230000,-50000,1394682
7370,51910,2020-03-18,0.0864600326264274,306500,280000,-26500,946373
7371,51910,2020-03-16,0.08223201174743025,340500,312500,-28000,747892
7372,51910,2020-03-12,0.06438356164383562,365000,341500,-23500,1041370
7373,51910,2020-03-09,0.065,400000,374000,-26000,611394
7374,51910,2020-02-28,0.05154639175257732,388000,368000,-20000,643995
7375,51910,2020-02-11,0.06847545219638243,387000,413500,26500,983089
7376,51910,2020-02-04,0.08428571428571428,350000,379500,29500,995237
7377,51910,2020-01-20,0.06306306306306306,333000,354000,21000,556519
7378,51910,2020-01-10,0.06035889070146819,306500,325000,18500,610981
7379,51910,2019-12-04,0.0420032310177706,309500,296500,-13000,316394
7380,51910,2019-09-25,0.0672782874617737,327000,305000,-22000,962072
7381,51910,2019-08-14,0.04692556634304207,309000,323500,14500,192588
7382,51910,2019-08-05,0.048265460030165915,331500,315500,-16000,234602
7383,51910,2019-07-25,0.04950495049504951,353500,336000,-17500,488905
7384,51910,2019-03-21,0.05234159779614325,363000,382000,19000,422078
7385,51910,2018-12-21,0.04215116279069767,344000,358500,14500,397305
7386,51910,2018-12-03,0.056439942112879886,345500,365000,19500,327930
7387,51910,2018-11-02,0.05604719764011799,339000,358000,19000,239187
7388,51910,2018-10-26,0.045655375552282766,339500,324000,-15500,320435
7389,51910,2018-10-19,0.04100946372239748,317000,330000,13000,241703
7390,51910,2018-10-04,0.06657223796033994,353000,329500,-23500,487014
7391,51910,2018-10-02,0.04206241519674356,368500,353000,-15500,271022
7392,51910,2018-08-03,0.042666666666666665,375000,391000,16000,424377
7393,51910,2018-07-25,0.09379727685325265,330500,361500,31000,1134542
7394,51910,2018-07-02,0.047976011994003,333500,317500,-16000,370321
7395,51910,2018-06-19,0.04638472032742155,366500,349500,-17000,295137
7396,51910,2018-06-04,0.0771513353115727,337000,363000,26000,512468
7397,51910,2018-05-02,0.058333333333333334,360000,339000,-21000,523971
7398,51910,2018-04-25,0.05874499332443257,374500,352500,-22000,496231
7399,51910,2018-03-28,0.04218362282878412,403000,386000,-17000,292609
7400,51910,2018-03-09,0.050387596899224806,387000,406500,19500,364917
7401,51910,2018-02-02,0.043010752688172046,418500,400500,-18000,468545
7402,51910,2018-01-08,0.04814814814814815,405000,424500,19500,321484
7403,51910,2017-09-22,0.05141388174807198,389000,369000,-20000,568634
7404,51910,2017-09-13,0.04487179487179487,390000,407500,17500,448119
7405,51910,2017-09-11,0.052348993288590606,372500,392000,19500,337307
7406,51910,2017-08-22,0.04011461318051576,349000,363000,14000,317416
7407,51910,2017-08-04,0.041033434650455926,329000,342500,13500,509506
7408,51910,2017-07-13,0.048414023372287146,299500,314000,14500,896560
7409,51910,2017-03-21,0.04240282685512368,283000,295000,12000,526655
7410,51910,2017-02-01,0.04007633587786259,262000,272500,10500,249084
7411,51910,2017-01-11,0.04672897196261682,267500,280000,12500,559100
7412,51910,2016-11-24,0.06396588486140725,234500,219500,-15000,808712
7413,51910,2016-11-09,0.041584158415841586,252500,242000,-10500,472018
7414,51910,2016-09-06,0.05805243445692884,267000,251500,-15500,773416
7415,10950,2021-06-01,0.0673076923076923,93600,99900,6300,1053604
7416,10950,2021-05-06,0.04143947655398037,91700,95500,3800,1176342
7417,10950,2021-04-28,0.04609929078014184,84600,88500,3900,2130496
7418,10950,2021-04-26,0.08076923076923077,78000,84300,6300,1853225
7419,10950,2021-03-10,0.04431818181818182,88000,84100,-3900,490441
7420,10950,2021-02-25,0.05137395459976105,83700,88000,4300,691270
7421,10950,2021-02-24,0.07206208425720621,90200,83700,-6500,1145734
7422,10950,2021-02-23,0.04157043879907621,86600,90200,3600,1473558
7423,10950,2021-02-18,0.052222222222222225,90000,85300,-4700,1145797
7424,10950,2021-02-15,0.07255139056831923,82700,88700,6000,1647003
7425,10950,2021-02-08,0.07506702412868632,74600,80200,5600,2617749
7426,10950,2021-01-13,0.0426098535286285,75100,78300,3200,1452058
7427,10950,2021-01-06,0.04096045197740113,70800,73700,2900,2229599
7428,10950,2020-11-24,0.06766917293233082,66500,71000,4500,2247850
7429,10950,2020-11-16,0.047021943573667714,63800,66800,3000,867344
7430,10950,2020-11-10,0.14680483592400692,57900,66400,8500,3897879
7431,10950,2020-10-07,0.044859813084112146,53500,55900,2400,525364
7432,10950,2020-10-05,0.04844961240310078,51600,54100,2500,395165
7433,10950,2020-08-11,0.04234527687296417,61400,64000,2600,1738419
7434,10950,2020-06-15,0.04486251808972504,69100,66000,-3100,679845
7435,10950,2020-05-26,0.05377906976744186,68800,72500,3700,1417308
7436,10950,2020-05-19,0.08383233532934131,66800,72400,5600,2064535
7437,10950,2020-04-23,0.05743740795287187,67900,71800,3900,1505615
7438,10950,2020-04-13,0.040756914119359534,68700,65900,-2800,710862
7439,10950,2020-04-06,0.08121019108280254,62800,67900,5100,1931543
7440,10950,2020-04-03,0.048484848484848485,66000,62800,-3200,3054664
7441,10950,2020-04-02,0.2,55000,66000,11000,2752887
7442,10950,2020-03-25,0.13229571984435798,51400,58200,6800,1184123
7443,10950,2020-03-24,0.05979381443298969,48500,51400,2900,818508
7444,10950,2020-03-23,0.07969639468690702,52700,48500,-4200,610326
7445,10950,2020-03-20,0.056112224448897796,49900,52700,2800,840312
7446,10950,2020-03-19,0.13518197573656845,57700,49900,-7800,843521
7447,10950,2020-03-12,0.056,62500,59000,-3500,784837
7448,10950,2020-03-10,0.056896551724137934,58000,61300,3300,1214591
7449,10950,2020-03-09,0.09797822706065319,64300,58000,-6300,1265350
7450,10950,2020-03-06,0.051622418879056046,67800,64300,-3500,653980
7451,10950,2020-01-28,0.05562422744128554,80900,76400,-4500,622315
7452,10950,2020-01-08,0.041349292709466814,91900,88100,-3800,444611
7453,10950,2019-10-24,0.04455445544554455,101000,105500,4500,581286
7454,10950,2019-08-30,0.0638063806380638,90900,96700,5800,697142
7455,10950,2019-08-13,0.040586245772266064,88700,85100,-3600,458215
7456,10950,2019-07-04,0.04327485380116959,85500,89200,3700,550182
7457,10950,2019-06-10,0.04039167686658507,81700,85000,3300,442514
7458,10950,2019-04-15,0.048859934853420196,92100,96600,4500,829793
7459,10950,2019-03-11,0.040498442367601244,96300,92400,-3900,969225
7460,10950,2019-03-08,0.05588235294117647,102000,96300,-5700,1327758
7461,10950,2019-01-29,0.04040404040404041,99000,103000,4000,534198
7462,10950,2019-01-02,0.06550665301944729,97700,91300,-6400,665046
7463,10950,2018-12-03,0.04072398190045249,110500,115000,4500,389970
7464,10950,2018-11-30,0.04245283018867924,106000,110500,4500,554115
7465,10950,2018-11-14,0.05309734513274336,113000,107000,-6000,587354
7466,10950,2018-11-09,0.041666666666666664,120000,115000,-5000,409974
7467,10950,2018-11-01,0.04032258064516129,124000,119000,-5000,294561
7468,10950,2018-10-29,0.044,125000,119500,-5500,384974
7469,10950,2018-10-26,0.0421455938697318,130500,125000,-5500,376884
7470,10950,2018-10-19,0.048507462686567165,134000,127500,-6500,868584
7471,10950,2018-10-17,0.05533596837944664,126500,133500,7000,400906
7472,10950,2018-09-27,0.0421455938697318,130500,136000,5500,433655
7473,10950,2018-07-16,0.0593607305936073,109500,116000,6500,613808
7474,10950,2018-07-02,0.0639269406392694,109500,102500,-7000,605343
7475,10950,2018-04-25,0.043478260869565216,115000,110000,-5000,742930
7476,10950,2018-02-19,0.061946902654867256,113000,120000,7000,228518
7477,10950,2018-01-29,0.06926406926406926,115500,123500,8000,875023
7478,10950,2018-01-22,0.04424778761061947,113000,118000,5000,587223
7479,10950,2017-12-27,0.05220883534136546,124500,118000,-6500,626559
7480,10950,2017-09-26,0.041666666666666664,120000,125000,5000,380422
7481,10950,2017-08-04,0.04888888888888889,112500,118000,5500,330005
7482,10950,2017-07-26,0.04090909090909091,110000,114500,4500,643341
7483,10950,2017-07-20,0.043478260869565216,103500,108000,4500,534479
7484,10950,2017-05-11,0.049019607843137254,102000,107000,5000,403123
7485,10950,2017-03-13,0.0642939150401837,87100,92700,5600,966788
7486,10950,2016-11-10,0.048426150121065374,82600,86600,4000,616673
7487,10950,2016-10-26,0.040380047505938245,84200,80800,-3400,301998
7488,10950,2016-08-23,0.04376657824933687,75400,72100,-3300,858798
7489,271560,2021-02-26,0.04460966542750929,134500,128500,-6000,164445
7490,271560,2021-02-25,0.054901960784313725,127500,134500,7000,120821
7491,271560,2021-02-24,0.0449438202247191,133500,127500,-6000,163842
7492,271560,2021-02-17,0.057034220532319393,131500,139000,7500,425574
7493,271560,2021-02-16,0.06477732793522267,123500,131500,8000,259119
7494,271560,2020-12-14,0.047619047619047616,126000,132000,6000,269766
7495,271560,2020-11-18,0.08771929824561403,114000,124000,10000,448569
7496,271560,2020-11-04,0.04424778761061947,113000,118000,5000,181830
7497,271560,2020-10-30,0.06465517241379311,116000,108500,-7500,217014
7498,271560,2020-09-24,0.04477611940298507,134000,128000,-6000,87342
7499,271560,2020-09-22,0.06164383561643835,146000,137000,-9000,115557
7500,271560,2020-09-17,0.05,140000,147000,7000,212246
7501,271560,2020-08-18,0.04430379746835443,158000,151000,-7000,149539
7502,271560,2020-08-13,0.05351170568561873,149500,157500,8000,180264
7503,271560,2020-07-15,0.055944055944055944,143000,135000,-8000,295805
7504,271560,2020-07-06,0.04642857142857143,140000,146500,6500,114712
7505,271560,2020-06-17,0.05,130000,136500,6500,242122
7506,271560,2020-06-15,0.06909090909090909,137500,128000,-9500,193045
7507,271560,2020-05-26,0.046263345195729534,140500,134000,-6500,151862
7508,271560,2020-05-25,0.06037735849056604,132500,140500,8000,185784
7509,271560,2020-05-18,0.075,140000,129500,-10500,363838
7510,271560,2020-05-15,0.04868913857677903,133500,140000,6500,202683
7511,271560,2020-04-23,0.05063291139240506,118500,124500,6000,246839
7512,271560,2020-04-22,0.05333333333333334,112500,118500,6000,176746
7513,271560,2020-04-14,0.04824561403508772,114000,119500,5500,278329
7514,271560,2020-04-09,0.041666666666666664,120000,115000,-5000,236313
7515,271560,2020-04-02,0.04090909090909091,110000,114500,4500,106172
7516,271560,2020-04-01,0.043478260869565216,115000,110000,-5000,126300
7517,271560,2020-03-31,0.05504587155963303,109000,115000,6000,192613
7518,271560,2020-03-25,0.0842754367934224,97300,105500,8200,200822
7519,271560,2020-03-23,0.07156862745098039,102000,94700,-7300,135945
7520,271560,2020-03-17,0.04477611940298507,100500,105000,4500,195308
7521,271560,2020-03-16,0.04361370716510903,96300,100500,4200,191633
7522,271560,2020-03-10,0.04338842975206612,96800,101000,4200,115635
7523,271560,2020-02-25,0.04231166150670795,96900,101000,4100,126265
7524,271560,2020-02-24,0.06376811594202898,103500,96900,-6600,122362
7525,271560,2020-02-20,0.05092592592592592,108000,102500,-5500,161730
7526,271560,2020-02-06,0.06310679611650485,103000,109500,6500,212644
7527,271560,2020-01-28,0.055299539170506916,108500,102500,-6000,161312
7528,271560,2020-01-13,0.04739336492890995,105500,110500,5000,126239
7529,271560,2019-12-03,0.04390243902439024,102500,107000,4500,103137
7530,271560,2019-11-26,0.04205607476635514,107000,102500,-4500,186544
7531,271560,2019-11-01,0.0660377358490566,106000,113000,7000,374004
7532,271560,2019-05-17,0.0496054114994363,88700,84300,-4400,435301
7533,271560,2019-05-16,0.07023060796645703,95400,88700,-6700,386236
7534,271560,2019-05-09,0.056862745098039215,102000,96200,-5800,172178
7535,271560,2019-05-08,0.05154639175257732,97000,102000,5000,424227
7536,271560,2019-04-12,0.05268292682926829,102500,97100,-5400,499014
7537,271560,2019-02-14,0.04035874439461883,111500,116000,4500,165955
7538,271560,2019-01-24,0.04184100418410042,119500,114500,-5000,282625
7539,271560,2019-01-10,0.04838709677419355,124000,118000,-6000,143620
7540,271560,2019-01-03,0.06306306306306306,111000,118000,7000,154677
7541,271560,2019-01-02,0.075,120000,111000,-9000,172930
7542,271560,2018-12-28,0.05263157894736842,114000,120000,6000,108932
7543,271560,2018-12-12,0.05263157894736842,114000,120000,6000,191761
7544,271560,2018-11-26,0.04017857142857143,112000,116500,4500,251697
7545,271560,2018-11-21,0.07281553398058252,103000,110500,7500,336391
7546,271560,2018-11-09,0.046632124352331605,96500,92000,-4500,156026
7547,271560,2018-11-07,0.09142212189616253,88600,96700,8100,716517
7548,271560,2018-10-23,0.04504504504504504,111000,106000,-5000,100671
7549,271560,2018-10-12,0.06921487603305786,96800,103500,6700,134038
7550,271560,2018-10-02,0.04205607476635514,107000,102500,-4500,121451
7551,271560,2018-09-12,0.08900523560209424,95500,104000,8500,314585
7552,271560,2018-09-07,0.05550239234449761,104500,98700,-5800,455755
7553,271560,2018-08-21,0.04285714285714286,105000,109500,4500,156163
7554,271560,2018-08-16,0.1059322033898305,118000,105500,-12500,506283
7555,271560,2018-07-24,0.045627376425855515,131500,137500,6000,127614
7556,271560,2018-07-20,0.04428044280442804,135500,129500,-6000,157052
7557,271560,2018-07-17,0.04878048780487805,143500,136500,-7000,144827
7558,271560,2018-06-26,0.04516129032258064,155000,148000,-7000,196362
7559,271560,2018-06-04,0.07434944237918216,134500,144500,10000,134899
7560,271560,2018-05-17,0.04150943396226415,132500,127000,-5500,166805
7561,271560,2018-05-16,0.06,125000,132500,7500,208081
7562,271560,2018-05-15,0.06015037593984962,133000,125000,-8000,154392
7563,271560,2018-05-09,0.052,125000,131500,6500,111853
7564,271560,2018-05-03,0.047058823529411764,127500,121500,-6000,59074
7565,271560,2018-04-26,0.048,125000,119000,-6000,105844
7566,271560,2018-04-19,0.05813953488372093,129000,121500,-7500,76753
7567,271560,2018-04-04,0.055350553505535055,135500,128000,-7500,155672
7568,271560,2018-03-15,0.07339449541284404,109000,117000,8000,99174
7569,271560,2018-03-09,0.05357142857142857,112000,118000,6000,79537
7570,271560,2018-03-08,0.051643192488262914,106500,112000,5500,113625
7571,271560,2018-02-28,0.04,112500,108000,-4500,94441
7572,271560,2018-02-21,0.06103286384976526,106500,113000,6500,146949
7573,271560,2018-02-14,0.05,110000,104500,-5500,373256
7574,271560,2018-02-12,0.06060606060606061,115500,108500,-7000,134903
7575,271560,2018-02-09,0.04149377593360996,120500,115500,-5000,140674
7576,271560,2017-12-26,0.04405286343612335,113500,108500,-5000,112219
7577,271560,2017-12-21,0.04310344827586207,116000,111000,-5000,66789
7578,271560,2017-12-01,0.048034934497816595,114500,120000,5500,154816
7579,271560,2017-11-30,0.084,125000,114500,-10500,218274
7580,271560,2017-11-28,0.07627118644067797,118000,127000,9000,188897
7581,271560,2017-11-27,0.04424778761061947,113000,118000,5000,153777
7582,271560,2017-11-24,0.05439330543933055,119500,113000,-6500,123943
7583,271560,2017-11-03,0.05092592592592592,108000,113500,5500,120532
7584,271560,2017-10-30,0.04975124378109453,100500,105500,5000,146117
7585,271560,2017-10-26,0.06236786469344609,94600,100500,5900,241723
7586,271560,2017-10-11,0.042105263157894736,95000,91000,-4000,161332
7587,271560,2017-09-11,0.050400916380297825,87300,91700,4400,98648
7588,271560,2017-08-16,0.06599552572706935,89400,95300,5900,239188
7589,271560,2017-07-20,0.04846335697399527,84600,80500,-4100,183151
7590,271560,2017-07-11,0.05909090909090909,88000,82800,-5200,422303
7591,271560,2017-07-10,0.0692588092345079,82300,88000,5700,840451
7592,271560,2017-07-07,0.05962732919254658,80500,82300,1800,1619864
7593,271560,2017-07-20,0.04846335697399527,84600,80500,-4100,183151
7594,271560,2017-07-11,0.05909090909090909,88000,82800,-5200,422303
7595,271560,2017-07-10,0.0692588092345079,82300,88000,5700,840451
7596,271560,2017-07-07,0.05962732919254658,80500,82300,1800,1619864
7597,271560,2017-07-20,0.04846335697399527,84600,80500,-4100,183151
7598,271560,2017-07-11,0.05909090909090909,88000,82800,-5200,422303
7599,271560,2017-07-10,0.0692588092345079,82300,88000,5700,840451
7600,271560,2017-07-07,0.05962732919254658,80500,82300,1800,1619864
7601,271560,2017-07-20,0.04846335697399527,84600,80500,-4100,183151
7602,271560,2017-07-11,0.05909090909090909,88000,82800,-5200,422303
7603,271560,2017-07-10,0.0692588092345079,82300,88000,5700,840451
7604,271560,2017-07-07,0.05962732919254658,80500,82300,1800,1619864
7605,271560,2017-07-20,0.04846335697399527,84600,80500,-4100,183151
7606,271560,2017-07-11,0.05909090909090909,88000,82800,-5200,422303
7607,271560,2017-07-10,0.0692588092345079,82300,88000,5700,840451
7608,271560,2017-07-07,0.05962732919254658,80500,82300,1800,1619864
7609,271560,2017-07-20,0.04846335697399527,84600,80500,-4100,183151
7610,271560,2017-07-11,0.05909090909090909,88000,82800,-5200,422303
7611,271560,2017-07-10,0.0692588092345079,82300,88000,5700,840451
7612,271560,2017-07-07,0.05962732919254658,80500,82300,1800,1619864
7613,271560,2017-07-20,0.04846335697399527,84600,80500,-4100,183151
7614,271560,2017-07-11,0.05909090909090909,88000,82800,-5200,422303
7615,271560,2017-07-10,0.0692588092345079,82300,88000,5700,840451
7616,271560,2017-07-07,0.05962732919254658,80500,82300,1800,1619864
7617,271560,2017-07-20,0.04846335697399527,84600,80500,-4100,183151
7618,271560,2017-07-11,0.05909090909090909,88000,82800,-5200,422303
7619,271560,2017-07-10,0.0692588092345079,82300,88000,5700,840451
7620,271560,2017-07-07,0.05962732919254658,80500,82300,1800,1619864
7621,271560,2017-07-20,0.04846335697399527,84600,80500,-4100,183151
7622,271560,2017-07-11,0.05909090909090909,88000,82800,-5200,422303
7623,271560,2017-07-10,0.0692588092345079,82300,88000,5700,840451
7624,271560,2017-07-07,0.05962732919254658,80500,82300,1800,1619864
7625,271560,2017-07-20,0.04846335697399527,84600,80500,-4100,183151
7626,271560,2017-07-11,0.05909090909090909,88000,82800,-5200,422303
7627,271560,2017-07-10,0.0692588092345079,82300,88000,5700,840451
7628,271560,2017-07-07,0.05962732919254658,80500,82300,1800,1619864
7629,271560,2017-07-20,0.04846335697399527,84600,80500,-4100,183151
7630,271560,2017-07-11,0.05909090909090909,88000,82800,-5200,422303
7631,271560,2017-07-10,0.0692588092345079,82300,88000,5700,840451
7632,271560,2017-07-07,0.05962732919254658,80500,82300,1800,1619864
7633,271560,2017-07-20,0.04846335697399527,84600,80500,-4100,183151
7634,271560,2017-07-11,0.05909090909090909,88000,82800,-5200,422303
7635,271560,2017-07-10,0.0692588092345079,82300,88000,5700,840451
7636,271560,2017-07-07,0.05962732919254658,80500,82300,1800,1619864
7637,271560,2017-07-20,0.04846335697399527,84600,80500,-4100,183151
7638,271560,2017-07-11,0.05909090909090909,88000,82800,-5200,422303
7639,271560,2017-07-10,0.0692588092345079,82300,88000,5700,840451
7640,271560,2017-07-07,0.05962732919254658,80500,82300,1800,1619864
7641,271560,2017-07-20,0.04846335697399527,84600,80500,-4100,183151
7642,271560,2017-07-11,0.05909090909090909,88000,82800,-5200,422303
7643,271560,2017-07-10,0.0692588092345079,82300,88000,5700,840451
7644,271560,2017-07-07,0.05962732919254658,80500,82300,1800,1619864
7645,271560,2017-07-20,0.04846335697399527,84600,80500,-4100,183151
7646,271560,2017-07-11,0.05909090909090909,88000,82800,-5200,422303
7647,271560,2017-07-10,0.0692588092345079,82300,88000,5700,840451
7648,271560,2017-07-07,0.05962732919254658,80500,82300,1800,1619864
7649,271560,2017-07-20,0.04846335697399527,84600,80500,-4100,183151
7650,271560,2017-07-11,0.05909090909090909,88000,82800,-5200,422303
7651,271560,2017-07-10,0.0692588092345079,82300,88000,5700,840451
7652,271560,2017-07-07,0.05962732919254658,80500,82300,1800,1619864
7653,271560,2017-07-20,0.04846335697399527,84600,80500,-4100,183151
7654,271560,2017-07-11,0.05909090909090909,88000,82800,-5200,422303
7655,271560,2017-07-10,0.0692588092345079,82300,88000,5700,840451
7656,271560,2017-07-07,0.05962732919254658,80500,82300,1800,1619864
7657,271560,2017-07-20,0.04846335697399527,84600,80500,-4100,183151
7658,271560,2017-07-11,0.05909090909090909,88000,82800,-5200,422303
7659,271560,2017-07-10,0.0692588092345079,82300,88000,5700,840451
7660,271560,2017-07-07,0.05962732919254658,80500,82300,1800,1619864
7661,271560,2017-07-20,0.04846335697399527,84600,80500,-4100,183151
7662,271560,2017-07-11,0.05909090909090909,88000,82800,-5200,422303
7663,271560,2017-07-10,0.0692588092345079,82300,88000,5700,840451
7664,271560,2017-07-07,0.05962732919254658,80500,82300,1800,1619864
7665,271560,2017-07-20,0.04846335697399527,84600,80500,-4100,183151
7666,271560,2017-07-11,0.05909090909090909,88000,82800,-5200,422303
7667,271560,2017-07-10,0.0692588092345079,82300,88000,5700,840451
7668,271560,2017-07-07,0.05962732919254658,80500,82300,1800,1619864
7669,271560,2017-07-20,0.04846335697399527,84600,80500,-4100,183151
7670,271560,2017-07-11,0.05909090909090909,88000,82800,-5200,422303
7671,271560,2017-07-10,0.0692588092345079,82300,88000,5700,840451
7672,271560,2017-07-07,0.05962732919254658,80500,82300,1800,1619864
7673,271560,2017-07-20,0.04846335697399527,84600,80500,-4100,183151
7674,271560,2017-07-11,0.05909090909090909,88000,82800,-5200,422303
7675,271560,2017-07-10,0.0692588092345079,82300,88000,5700,840451
7676,271560,2017-07-07,0.05962732919254658,80500,82300,1800,1619864
7677,271560,2017-07-20,0.04846335697399527,84600,80500,-4100,183151
7678,271560,2017-07-11,0.05909090909090909,88000,82800,-5200,422303
7679,271560,2017-07-10,0.0692588092345079,82300,88000,5700,840451
7680,271560,2017-07-07,0.05962732919254658,80500,82300,1800,1619864
7681,271560,2017-07-20,0.04846335697399527,84600,80500,-4100,183151
7682,271560,2017-07-11,0.05909090909090909,88000,82800,-5200,422303
7683,271560,2017-07-10,0.0692588092345079,82300,88000,5700,840451
7684,5830,2021-05-06,0.041666666666666664,48000,50000,2000,290144
7685,5830,2021-02-25,0.04671717171717172,39600,41450,1850,448522
7686,5830,2021-02-22,0.06315789473684211,38000,40400,2400,1071937
7687,5830,2020-08-20,0.061394380853277836,48050,45100,-2950,270688
7688,5830,2020-08-19,0.046840958605664486,45900,48050,2150,264669
7689,5830,2020-08-18,0.05360824742268041,48500,45900,-2600,333794
7690,5830,2020-08-11,0.09808342728297632,44350,48700,4350,473612
7691,5830,2020-06-12,0.04275286757038582,47950,45900,-2050,366051
7692,5830,2020-06-11,0.05237154150197629,50600,47950,-2650,389221
7693,5830,2020-06-02,0.06349206349206349,44100,46900,2800,398180
7694,5830,2020-05-29,0.04088397790055249,45250,43400,-1850,1081359
7695,5830,2020-05-21,0.0407098121085595,47900,45950,-1950,523205
7696,5830,2020-05-19,0.06936416184971098,51900,48300,-3600,555616
7697,5830,2020-05-15,0.056016597510373446,48200,50900,2700,438791
7698,5830,2020-05-13,0.040793825799338476,45350,47200,1850,271045
7699,5830,2020-04-27,0.0611764705882353,42500,45100,2600,262434
7700,5830,2020-04-23,0.043583535108958835,41300,43100,1800,346294
7701,5830,2020-04-21,0.0598404255319149,37600,39850,2250,414350
7702,5830,2020-04-14,0.0427807486631016,37400,39000,1600,254540
7703,5830,2020-04-10,0.040502793296089384,35800,37250,1450,465729
7704,5830,2020-04-02,0.07264296754250386,32350,34700,2350,449745
7705,5830,2020-04-01,0.06906474820143885,34750,32350,-2400,429379
7706,5830,2020-03-31,0.041979010494752625,33350,34750,1400,406077
7707,5830,2020-03-25,0.08680555555555555,28800,31300,2500,575367
7708,5830,2020-03-20,0.20168067226890757,23800,28600,4800,995328
7709,5830,2020-03-19,0.08986615678776291,26150,23800,-2350,632258
7710,5830,2020-03-18,0.05765765765765766,27750,26150,-1600,535056
7711,5830,2020-03-17,0.07345575959933222,29950,27750,-2200,589516
7712,5830,2020-03-13,0.06615384615384616,32500,30350,-2150,809595
7713,5830,2020-03-12,0.053857350800582245,34350,32500,-1850,864992
7714,5830,2020-03-10,0.05787348586810229,37150,35000,-2150,706472
7715,5830,2020-03-09,0.04865556978233035,39050,37150,-1900,325168
7716,5830,2020-03-06,0.04171779141104295,40750,39050,-1700,446737
7717,5830,2020-01-02,0.04206500956022945,52300,50100,-2200,194505
7718,5830,2019-12-20,0.04529616724738676,57400,54800,-2600,404523
7719,5830,2019-12-12,0.08974358974358974,54600,59500,4900,423194
7720,5830,2019-11-27,0.05321100917431193,54500,57400,2900,215147
7721,5830,2019-11-15,0.05162523900573614,52300,55000,2700,219825
7722,5830,2019-11-07,0.05825242718446602,51500,54500,3000,200516
7723,5830,2019-11-04,0.04208416833667335,49900,52000,2100,134273
7724,5830,2019-10-11,0.061224489795918366,49000,52000,3000,187912
7725,5830,2019-08-12,0.07170172084130019,52300,48550,-3750,326540
7726,5830,2019-07-03,0.06782608695652174,57500,53600,-3900,347286
7727,5830,2019-05-13,0.06092124814264487,67300,63200,-4100,308557
7728,5830,2018-11-12,0.05698005698005698,70200,74200,4000,266592
7729,5830,2018-11-01,0.0584958217270195,71800,67600,-4200,275833
7730,5830,2018-10-31,0.05433186490455213,68100,71800,3700,247234
7731,5830,2018-10-30,0.04488078541374474,71300,68100,-3200,261203
7732,5830,2018-09-27,0.07196401799100449,66700,71500,4800,394816
7733,5830,2018-08-27,0.04236006051437216,66100,63300,-2800,309476
7734,5830,2018-08-06,0.046153846153846156,65000,68000,3000,406095
7735,5830,2018-06-21,0.047244094488188976,63500,60500,-3000,270313
7736,5830,2018-06-18,0.051666666666666666,60000,63100,3100,477428
7737,5830,2017-09-22,0.0453257790368272,70600,73800,3200,251877
7738,5830,2017-08-01,0.04119850187265917,80100,83400,3300,258091
7739,5830,2016-12-21,0.07204610951008646,69400,64400,-5000,484364
7740,5830,2016-11-10,0.05187319884726225,69400,73000,3600,241724
7741,31430,2021-05-31,0.04888888888888889,225000,236000,11000,86963
7742,31430,2021-05-13,0.04319654427645788,231500,221500,-10000,114655
7743,31430,2021-05-11,0.0410958904109589,219000,228000,9000,164872
7744,31430,2021-05-10,0.06310679611650485,206000,219000,13000,244510
7745,31430,2021-04-05,0.04050632911392405,197500,205500,8000,62437
7746,31430,2021-03-15,0.04081632653061224,196000,204000,8000,56500
7747,31430,2021-03-03,0.04199475065616798,190500,198500,8000,175251
7748,31430,2021-02-25,0.04632152588555858,183500,192000,8500,60580
7749,31430,2021-02-24,0.044270833333333336,192000,183500,-8500,82858
7750,31430,2021-02-23,0.04065040650406504,184500,192000,7500,117694
7751,31430,2021-01-29,0.04456824512534819,179500,171500,-8000,73345
7752,31430,2021-01-25,0.061971830985915494,177500,188500,11000,191769
7753,31430,2021-01-13,0.047619047619047616,168000,176000,8000,176650
7754,31430,2020-12-09,0.05787781350482315,155500,164500,9000,175373
7755,31430,2020-11-24,0.049019607843137254,153000,160500,7500,101247
7756,31430,2020-11-10,0.04152249134948097,144500,150500,6000,82648
7757,31430,2020-10-21,0.04081632653061224,147000,153000,6000,61541
7758,31430,2020-09-11,0.0576271186440678,147500,156000,8500,146555
7759,31430,2020-09-08,0.06382978723404255,141000,150000,9000,117459
7760,31430,2020-09-02,0.04727272727272727,137500,144000,6500,84446
7761,31430,2020-08-27,0.04195804195804196,143000,137000,-6000,88536
7762,31430,2020-08-20,0.04040404040404041,148500,142500,-6000,84222
7763,31430,2020-08-18,0.1027190332326284,165500,148500,-17000,135034
7764,31430,2020-07-03,0.056291390728476824,151000,159500,8500,106125
7765,31430,2020-07-01,0.04777070063694268,157000,149500,-7500,130655
7766,31430,2020-06-30,0.05016722408026756,149500,157000,7500,351693
7767,31430,2020-06-25,0.051118210862619806,156500,148500,-8000,161128
7768,31430,2020-06-22,0.049132947976878616,173000,164500,-8500,115042
7769,31430,2020-06-15,0.06315789473684211,190000,178000,-12000,77737
7770,31430,2020-06-12,0.042821158690176324,198500,190000,-8500,66878
7771,31430,2020-05-18,0.04404145077720207,193000,201500,8500,40397
7772,31430,2020-05-11,0.04295942720763723,209500,200500,-9000,76674
7773,31430,2020-04-28,0.047961630695443645,208500,218500,10000,88862
7774,31430,2020-04-17,0.05102040816326531,196000,206000,10000,127520
7775,31430,2020-04-08,0.050666666666666665,187500,197000,9500,131321
7776,31430,2020-03-30,0.046153846153846156,195000,186000,-9000,90526
7777,31430,2020-03-25,0.056,187500,198000,10500,65573
7778,31430,2020-03-24,0.05042016806722689,178500,187500,9000,60527
7779,31430,2020-03-23,0.10972568578553615,200500,178500,-22000,76834
7780,31430,2020-03-12,0.04488778054862843,200500,191500,-9000,60088
7781,31430,2020-03-05,0.07611548556430446,190500,205000,14500,119616
7782,31430,2020-03-04,0.049586776859504134,181500,190500,9000,62982
7783,31430,2020-02-28,0.04177545691906005,191500,183500,-8000,50926
7784,31430,2020-02-25,0.042666666666666665,187500,195500,8000,56153
7785,31430,2020-02-24,0.05063291139240506,197500,187500,-10000,69137
7786,31430,2020-02-05,0.051643192488262914,213000,202000,-11000,167327
7787,31430,2020-01-28,0.13278008298755187,241000,209000,-32000,227010
7788,31430,2020-01-23,0.054901960784313725,255000,241000,-14000,99826
7789,31430,2020-01-13,0.045816733067729085,251000,262500,11500,80132
7790,31430,2020-01-07,0.08830022075055188,226500,246500,20000,140800
7791,31430,2019-12-12,0.04121475054229935,230500,221000,-9500,497274
7792,31430,2019-12-10,0.058004640371229696,215500,228000,12500,55658
7793,31430,2019-12-06,0.06235011990407674,208500,221500,13000,56422
7794,31430,2019-11-28,0.040100250626566414,199500,207500,8000,60115
7795,31430,2019-11-25,0.05804749340369393,189500,200500,11000,54224
7796,31430,2019-10-29,0.0440771349862259,181500,189500,8000,49236
7797,31430,2019-09-26,0.04825737265415549,186500,195500,9000,97070
7798,31430,2019-09-24,0.04709141274238227,180500,189000,8500,69786
7799,31430,2019-09-09,0.0782122905027933,179000,193000,14000,96888
7800,31430,2019-09-05,0.04381443298969072,194000,185500,-8500,59221
7801,31430,2019-09-03,0.05420054200542006,184500,194500,10000,75091
7802,31430,2019-08-30,0.042134831460674156,178000,185500,7500,71524
7803,31430,2019-08-26,0.08446866485013624,183500,168000,-15500,63747
7804,31430,2019-08-20,0.047337278106508875,169000,177000,8000,52298
7805,31430,2019-08-16,0.048295454545454544,176000,167500,-8500,35478
7806,31430,2019-08-12,0.08108108108108109,166500,180000,13500,59502
7807,31430,2019-08-09,0.040345821325648415,173500,166500,-7000,40253
7808,31430,2019-08-08,0.11935483870967742,155000,173500,18500,68087
7809,31430,2019-08-07,0.05198776758409786,163500,155000,-8500,57066
7810,31430,2019-08-05,0.059154929577464786,177500,167000,-10500,27045
7811,31430,2019-07-31,0.05555555555555555,180000,170000,-10000,45453
7812,31430,2019-07-09,0.07052896725440806,198500,184500,-14000,69439
7813,31430,2019-07-02,0.06046511627906977,215000,202000,-13000,79870
7814,31430,2019-06-27,0.05583756345177665,197000,208000,11000,83719
7815,31430,2019-06-14,0.06768558951965066,229000,213500,-15500,213830
7816,31430,2019-06-13,0.04979253112033195,241000,229000,-12000,268447
7817,31430,2019-06-04,0.043151969981238276,266500,255000,-11500,111452
7818,31430,2019-05-30,0.044169611307420496,283000,270500,-12500,99863
7819,31430,2019-05-23,0.050505050505050504,297000,282000,-15000,85909
7820,31430,2019-05-13,0.06209150326797386,306000,287000,-19000,95493
7821,31430,2019-05-10,0.04794520547945205,292000,306000,14000,85306
7822,31430,2019-04-10,0.0633116883116883,308000,327500,19500,58665
7823,31430,2019-04-08,0.040336134453781515,297500,309500,12000,46507
7824,31430,2019-03-21,0.055379746835443035,316000,298500,-17500,134769
7825,31430,2019-03-20,0.0429042904290429,303000,316000,13000,49294
7826,31430,2019-03-11,0.05714285714285714,262500,277500,15000,64358
7827,31430,2019-03-07,0.08651911468812877,248500,270000,21500,107937
7828,31430,2019-03-05,0.05458515283842795,229000,241500,12500,70744
7829,31430,2019-02-25,0.05542725173210162,216500,228500,12000,56948
7830,31430,2019-02-19,0.05275779376498801,208500,219500,11000,107345
7831,31430,2019-01-31,0.051094890510948905,205500,216000,10500,103814
7832,31430,2019-01-23,0.08616187989556136,191500,208000,16500,139199
7833,31430,2019-01-22,0.07887323943661972,177500,191500,14000,140572
7834,31430,2019-01-17,0.0547945205479452,182500,172500,-10000,64276
7835,31430,2019-01-14,0.04310344827586207,174000,181500,7500,69836
7836,31430,2019-01-02,0.08483290488431877,194500,178000,-16500,65304
7837,31430,2018-12-27,0.058823529411764705,178500,189000,10500,51751
7838,31430,2018-12-17,0.0427807486631016,187000,195000,8000,50999
7839,31430,2018-12-14,0.04591836734693878,196000,187000,-9000,51909
7840,31430,2018-12-13,0.07103825136612021,183000,196000,13000,98267
7841,31430,2018-12-12,0.07331378299120235,170500,183000,12500,97494
7842,31430,2018-12-06,0.052486187845303865,181000,171500,-9500,50465
7843,31430,2018-12-04,0.05507246376811594,172500,182000,9500,88865
7844,31430,2018-11-28,0.040983606557377046,183000,175500,-7500,56548
7845,31430,2018-11-21,0.06321839080459771,174000,185000,11000,97981
7846,31430,2018-11-19,0.047337278106508875,169000,177000,8000,85906
7847,31430,2018-11-15,0.16216216216216217,148000,172000,24000,233440
7848,31430,2018-11-12,0.04234527687296417,153500,147000,-6500,63156
7849,31430,2018-11-09,0.04361370716510903,160500,153500,-7000,177908
7850,31430,2018-11-08,0.0664451827242525,150500,160500,10000,83821
7851,31430,2018-11-05,0.06134969325153374,163000,153000,-10000,61421
7852,31430,2018-11-02,0.04823151125401929,155500,163000,7500,76898
7853,31430,2018-11-01,0.05423728813559322,147500,155500,8000,82926
7854,31430,2018-10-30,0.060714285714285714,140000,148500,8500,85431
7855,31430,2018-10-29,0.06976744186046512,150500,140000,-10500,85653
7856,31430,2018-10-26,0.044444444444444446,157500,150500,-7000,110643
7857,31430,2018-10-23,0.08146067415730338,178000,163500,-14500,121196
7858,31430,2018-10-10,0.05555555555555555,198000,187000,-11000,93352
7859,31430,2018-10-04,0.05191873589164785,221500,210000,-11500,150096
7860,31430,2018-09-21,0.04434589800443459,225500,235500,10000,117870
7861,31430,2018-09-11,0.07425742574257425,202000,217000,15000,63056
7862,31430,2018-08-27,0.04846938775510204,196000,205500,9500,78585
7863,31430,2018-08-16,0.047619047619047616,168000,176000,8000,77597
7864,31430,2018-08-14,0.05,160000,168000,8000,51361
7865,31430,2018-08-10,0.05459770114942529,174000,164500,-9500,112323
7866,31430,2018-08-07,0.047752808988764044,178000,169500,-8500,131094
7867,31430,2018-08-01,0.04057971014492753,172500,179500,7000,105629
7868,31430,2018-07-24,0.05187319884726225,173500,182500,9000,56134
7869,31430,2018-07-17,0.0425531914893617,188000,180000,-8000,69801
7870,31430,2018-07-13,0.05434782608695652,184000,194000,10000,95438
7871,31430,2018-07-12,0.042492917847025496,176500,184000,7500,58466
7872,31430,2018-07-10,0.045584045584045586,175500,183500,8000,109625
7873,31430,2018-07-09,0.11363636363636363,198000,175500,-22500,241401
7874,31430,2018-07-03,0.0514018691588785,214000,203000,-11000,174130
7875,31430,2018-07-02,0.054187192118226604,203000,214000,11000,123854
7876,31430,2018-06-29,0.043701799485861184,194500,203000,8500,66769
7877,31430,2018-06-21,0.11079545454545454,176000,195500,19500,241897
7878,31430,2018-06-20,0.07317073170731707,164000,176000,12000,82427
7879,31430,2018-06-18,0.052941176470588235,170000,161000,-9000,48608
7880,31430,2018-06-12,0.047337278106508875,169000,177000,8000,60920
7881,31430,2018-06-04,0.058997050147492625,169500,179500,10000,52359
7882,31430,2018-05-23,0.05379746835443038,158000,166500,8500,51987
7883,31430,2018-05-15,0.04590163934426229,152500,159500,7000,48717
7884,31430,2018-05-11,0.043478260869565216,149500,156000,6500,97914
7885,31430,2018-05-10,0.1198501872659176,133500,149500,16000,75813
7886,31430,2018-05-08,0.043795620437956206,137000,131000,-6000,28234
7887,31430,2018-05-02,0.055970149253731345,134000,141500,7500,64894
7888,31430,2018-04-25,0.05511811023622047,127000,134000,7000,98222
7889,31430,2018-04-16,0.09055118110236221,127000,138500,11500,76084
7890,31430,2018-04-11,0.07860262008733625,114500,123500,9000,67855
7891,31430,2018-04-03,0.07211538461538461,104000,111500,7500,117817
7892,31430,2018-04-02,0.08220603537981269,96100,104000,7900,101277
7893,31430,2018-03-30,0.07977528089887641,89000,96100,7100,80098
7894,31430,2018-03-28,0.04352941176470588,85000,88700,3700,36291
7895,31430,2018-03-13,0.044444444444444446,90000,86000,-4000,24677
7896,31430,2018-03-12,0.046511627906976744,86000,90000,4000,31058
7897,31430,2018-02-13,0.04192355117139334,81100,77700,-3400,37743
7898,31430,2018-02-05,0.05191873589164785,88600,84000,-4600,36450
7899,31430,2018-02-01,0.04904306220095694,83600,87700,4100,40517
7900,31430,2018-01-24,0.04197530864197531,81000,84400,3400,95267
7901,31430,2018-01-22,0.050314465408805034,79500,83500,4000,126250
7902,31430,2018-01-09,0.040787623066104076,71100,74000,2900,40737
7903,31430,2017-11-27,0.059154929577464786,71000,75200,4200,148659
7904,31430,2017-11-20,0.04375,64000,66800,2800,53663
7905,31430,2017-11-03,0.04326123128119801,60100,62700,2600,24777
7906,31430,2017-09-21,0.07051282051282051,62400,58000,-4400,85372
7907,31430,2017-08-16,0.04113924050632911,63200,65800,2600,22551
7908,31430,2017-08-11,0.051094890510948905,68500,65000,-3500,48379
7909,31430,2017-05-31,0.07084468664850137,73400,78600,5200,62278
7910,31430,2017-04-19,0.07046070460704607,73800,79000,5200,67399
7911,31430,2017-03-23,0.056,62500,66000,3500,60840
7912,31430,2016-11-09,0.04240766073871409,73100,70000,-3100,54279
7913,31430,2016-11-07,0.04712041884816754,76400,72800,-3600,55253
7914,31430,2016-10-11,0.07672301690507152,76900,82800,5900,88003
7915,31430,2016-09-29,0.04533333333333334,75000,78400,3400,95169
7916,31430,2016-09-23,0.04878048780487805,69700,73100,3400,41698
7917,31430,2016-08-29,0.04068241469816273,76200,73100,-3100,24698
7918,31430,2016-08-26,0.05394190871369295,72300,76200,3900,33422
7919,31430,2016-08-08,0.04581151832460733,76400,79900,3500,43488
7920,51915,2021-05-27,0.046511627906976744,387000,369000,-18000,94591
7921,51915,2021-05-26,0.06859205776173286,415500,387000,-28500,69977
7922,51915,2021-05-12,0.046511627906976744,430000,410000,-20000,30516
7923,51915,2021-05-03,0.04264870931537598,445500,426500,-19000,23346
7924,51915,2021-04-29,0.05924170616113744,422000,447000,25000,129711
7925,51915,2021-04-13,0.04358974358974359,390000,407000,17000,53901
7926,51915,2021-03-17,0.04076433121019108,392500,376500,-16000,73718
7927,51915,2021-03-16,0.059880239520958084,417500,392500,-25000,102618
7928,51915,2021-03-02,0.051347881899871634,389500,409500,20000,46025
7929,51915,2021-02-26,0.06144578313253012,415000,389500,-25500,69959
7930,51915,2021-02-23,0.04004576659038902,437000,419500,-17500,40894
7931,51915,2021-01-11,0.043478260869565216,460000,480000,20000,195789
7932,51915,2021-01-08,0.10047846889952153,418000,460000,42000,173227
7933,51915,2021-01-07,0.06768837803320563,391500,418000,26500,145550
7934,51915,2020-12-22,0.04187817258883249,394000,377500,-16500,53502
7935,51915,2020-11-30,0.042953020134228186,372500,356500,-16000,99252
7936,51915,2020-11-06,0.04504504504504504,333000,348000,15000,133013
7937,51915,2020-11-05,0.040625,320000,333000,13000,54426
7938,51915,2020-10-30,0.043209876543209874,324000,310000,-14000,61219
7939,51915,2020-10-15,0.045454545454545456,308000,322000,14000,84349
7940,51915,2020-10-12,0.040059347181008904,337000,323500,-13500,79260
7941,51915,2020-09-29,0.06833333333333333,300000,320500,20500,101992
7942,51915,2020-09-21,0.07266982622432859,316500,293500,-23000,196240
7943,51915,2020-09-17,0.09130434782608696,345000,313500,-31500,627821
7944,51915,2020-09-16,0.0547945205479452,365000,345000,-20000,132302
7945,51915,2020-08-31,0.04580152671755725,393000,375000,-18000,156130
7946,51915,2020-08-26,0.04691689008042895,373000,390500,17500,183692
7947,51915,2020-08-21,0.08419497784342689,338500,367000,28500,176030
7948,51915,2020-08-18,0.05525606469002695,371000,350500,-20500,185533
7949,51915,2020-08-14,0.05477707006369427,392500,371000,-21500,154943
7950,51915,2020-08-07,0.15188172043010753,372000,428500,56500,555242
7951,51915,2020-08-05,0.06764705882352941,340000,363000,23000,333709
7952,51915,2020-08-04,0.0932475884244373,311000,340000,29000,398884
7953,51915,2020-08-03,0.16917293233082706,266000,311000,45000,469814
7954,51915,2020-07-16,0.04081632653061224,269500,258500,-11000,68313
7955,51915,2020-07-09,0.04460966542750929,269000,281000,12000,116361
7956,51915,2020-07-07,0.04054054054054054,259000,269500,10500,96897
7957,51915,2020-06-25,0.04021937842778794,273500,262500,-11000,89052
7958,51915,2020-06-19,0.04339622641509434,265000,276500,11500,214188
7959,51915,2020-06-16,0.15690866510538642,213500,247000,33500,283206
7960,51915,2020-06-15,0.09533898305084745,236000,213500,-22500,169002
7961,51915,2020-06-11,0.102803738317757,214000,236000,22000,321714
7962,51915,2020-06-10,0.0594059405940594,202000,214000,12000,112966
7963,51915,2020-06-05,0.04509283819628647,188500,197000,8500,76124
7964,51915,2020-05-26,0.08235294117647059,170000,184000,14000,89261
7965,51915,2020-04-17,0.0778816199376947,160500,173000,12500,43057
7966,51915,2020-04-16,0.04220779220779221,154000,160500,6500,38151
7967,51915,2020-04-01,0.05405405405405406,148000,140000,-8000,38847
7968,51915,2020-03-25,0.10588235294117647,127500,141000,13500,43478
7969,51915,2020-03-24,0.11842105263157894,114000,127500,13500,44943
7970,51915,2020-03-23,0.05,120000,114000,-6000,43526
7971,51915,2020-03-20,0.14832535885167464,104500,120000,15500,70469
7972,51915,2020-03-19,0.17716535433070865,127000,104500,-22500,65475
7973,51915,2020-03-18,0.11188811188811189,143000,127000,-16000,38163
7974,51915,2020-03-17,0.052980132450331126,151000,143000,-8000,53480
7975,51915,2020-03-16,0.06790123456790123,162000,151000,-11000,51838
7976,51915,2020-03-13,0.06086956521739131,172500,162000,-10500,69156
7977,51915,2020-03-12,0.041666666666666664,180000,172500,-7500,56059
7978,51915,2020-03-09,0.06329113924050633,197500,185000,-12500,52144
7979,51915,2020-02-11,0.040100250626566414,199500,207500,8000,125584
7980,51915,2020-02-04,0.0684931506849315,182500,195000,12500,75159
7981,51915,2020-01-28,0.06005221932114883,191500,180000,-11500,30516
7982,51915,2020-01-20,0.04748603351955307,179000,187500,8500,49594
7983,51915,2019-09-25,0.04986149584487535,180500,171500,-9000,43420
7984,51915,2019-08-05,0.058823529411764705,178500,168000,-10500,23680
7985,51915,2019-03-21,0.052109181141439205,201500,212000,10500,27069
7986,51915,2019-01-31,0.04028436018957346,211000,202500,-8500,23634
7987,51915,2019-01-18,0.04,200000,208000,8000,12680
7988,51915,2018-12-21,0.05483028720626632,191500,202000,10500,45466
7989,51915,2018-12-03,0.04603580562659847,195500,204500,9000,9629
7990,51915,2018-10-31,0.04450261780104712,191000,199500,8500,15624
7991,51915,2018-10-19,0.052486187845303865,181000,190500,9500,10635
7992,51915,2018-07-25,0.04938271604938271,202500,212500,10000,33078
7993,51915,2018-07-02,0.04218362282878412,201500,193000,-8500,9545
7994,51915,2018-06-27,0.05476190476190476,210000,198500,-11500,17231
7995,51915,2018-06-04,0.053164556962025315,197500,208000,10500,16007
7996,51915,2018-05-30,0.04976303317535545,211000,200500,-10500,10048
7997,51915,2018-03-28,0.054466230936819175,229500,217000,-12500,24173
7998,51915,2018-03-09,0.056338028169014086,213000,225000,12000,17754
7999,51915,2018-02-07,0.04395604395604396,227500,217500,-10000,17040
8000,51915,2017-10-16,0.04056795131845842,246500,236500,-10000,31063
8001,51915,2017-09-22,0.040697674418604654,258000,247500,-10500,24216
8002,51915,2017-09-13,0.045283018867924525,265000,277000,12000,31908
8003,51915,2017-09-11,0.045364891518737675,253500,265000,11500,46082
8004,51915,2017-08-30,0.055666003976143144,251500,265500,14000,37527
8005,51915,2017-08-04,0.043478260869565216,230000,240000,10000,31678
8006,51915,2017-07-13,0.051597051597051594,203500,214000,10500,28535
8007,51915,2017-03-21,0.05322128851540616,178500,188000,9500,22532
8008,51915,2017-01-31,0.05263157894736842,180500,171000,-9500,24771
8009,51915,2017-01-26,0.040345821325648415,173500,180500,7000,23880
8010,51915,2017-01-11,0.04481792717086835,178500,186500,8000,30345
8011,51915,2017-01-02,0.04456824512534819,179500,171500,-8000,13097
8012,51915,2016-09-13,0.051829268292682924,164000,155500,-8500,27423
8013,51915,2016-08-05,0.04120879120879121,182000,174500,-7500,20948
8014,375500,2021-05-17,0.04659498207885305,139500,133000,-6500,431460
8015,375500,2021-04-27,0.04150943396226415,132500,138000,5500,390860
8016,375500,2021-03-09,0.0514018691588785,107000,112500,5500,436668
8017,375500,2021-02-26,0.04721030042918455,116500,111000,-5500,770923
8018,375500,2021-02-25,0.1201923076923077,104000,116500,12500,732921
8019,375500,2021-02-24,0.058823529411764705,110500,104000,-6500,599492
8020,375500,2021-02-01,0.05829596412556054,111500,118000,6500,641899
8021,375500,2021-01-29,0.07083333333333333,120000,111500,-8500,1105949
8022,375500,2021-01-27,0.07114624505928854,126500,117500,-9000,1082796
8023,375500,2021-01-25,0.04583333333333333,120000,127500,7500,3005049
8024,375500,2021-02-01,0.05829596412556054,111500,118000,6500,641899
8025,375500,2021-01-29,0.07083333333333333,120000,111500,-8500,1105949
8026,375500,2021-01-27,0.07114624505928854,126500,117500,-9000,1082796
8027,375500,2021-01-25,0.04583333333333333,120000,127500,7500,3005049
8028,375500,2021-02-01,0.05829596412556054,111500,118000,6500,641899
8029,375500,2021-01-29,0.07083333333333333,120000,111500,-8500,1105949
8030,375500,2021-01-27,0.07114624505928854,126500,117500,-9000,1082796
8031,375500,2021-01-25,0.04583333333333333,120000,127500,7500,3005049
8032,375500,2021-02-01,0.05829596412556054,111500,118000,6500,641899
8033,375500,2021-01-29,0.07083333333333333,120000,111500,-8500,1105949
8034,375500,2021-01-27,0.07114624505928854,126500,117500,-9000,1082796
8035,375500,2021-01-25,0.04583333333333333,120000,127500,7500,3005049
8036,375500,2021-02-01,0.05829596412556054,111500,118000,6500,641899
8037,375500,2021-01-29,0.07083333333333333,120000,111500,-8500,1105949
8038,375500,2021-01-27,0.07114624505928854,126500,117500,-9000,1082796
8039,375500,2021-01-25,0.04583333333333333,120000,127500,7500,3005049
8040,375500,2021-02-01,0.05829596412556054,111500,118000,6500,641899
8041,375500,2021-01-29,0.07083333333333333,120000,111500,-8500,1105949
8042,375500,2021-01-27,0.07114624505928854,126500,117500,-9000,1082796
8043,375500,2021-01-25,0.04583333333333333,120000,127500,7500,3005049
8044,375500,2021-02-01,0.05829596412556054,111500,118000,6500,641899
8045,375500,2021-01-29,0.07083333333333333,120000,111500,-8500,1105949
8046,375500,2021-01-27,0.07114624505928854,126500,117500,-9000,1082796
8047,375500,2021-01-25,0.04583333333333333,120000,127500,7500,3005049
8048,375500,2021-02-01,0.05829596412556054,111500,118000,6500,641899
8049,375500,2021-01-29,0.07083333333333333,120000,111500,-8500,1105949
8050,375500,2021-01-27,0.07114624505928854,126500,117500,-9000,1082796
8051,375500,2021-01-25,0.04583333333333333,120000,127500,7500,3005049
8052,375500,2021-02-01,0.05829596412556054,111500,118000,6500,641899
8053,375500,2021-01-29,0.07083333333333333,120000,111500,-8500,1105949
8054,375500,2021-01-27,0.07114624505928854,126500,117500,-9000,1082796
8055,375500,2021-01-25,0.04583333333333333,120000,127500,7500,3005049
8056,375500,2021-02-01,0.05829596412556054,111500,118000,6500,641899
8057,375500,2021-01-29,0.07083333333333333,120000,111500,-8500,1105949
8058,375500,2021-01-27,0.07114624505928854,126500,117500,-9000,1082796
8059,375500,2021-01-25,0.04583333333333333,120000,127500,7500,3005049
8060,375500,2021-02-01,0.05829596412556054,111500,118000,6500,641899
8061,375500,2021-01-29,0.07083333333333333,120000,111500,-8500,1105949
8062,375500,2021-01-27,0.07114624505928854,126500,117500,-9000,1082796
8063,375500,2021-01-25,0.04583333333333333,120000,127500,7500,3005049
8064,375500,2021-02-01,0.05829596412556054,111500,118000,6500,641899
8065,375500,2021-01-29,0.07083333333333333,120000,111500,-8500,1105949
8066,375500,2021-01-27,0.07114624505928854,126500,117500,-9000,1082796
8067,375500,2021-01-25,0.04583333333333333,120000,127500,7500,3005049
8068,375500,2021-02-01,0.05829596412556054,111500,118000,6500,641899
8069,375500,2021-01-29,0.07083333333333333,120000,111500,-8500,1105949
8070,375500,2021-01-27,0.07114624505928854,126500,117500,-9000,1082796
8071,375500,2021-01-25,0.04583333333333333,120000,127500,7500,3005049
8072,375500,2021-02-01,0.05829596412556054,111500,118000,6500,641899
8073,375500,2021-01-29,0.07083333333333333,120000,111500,-8500,1105949
8074,375500,2021-01-27,0.07114624505928854,126500,117500,-9000,1082796
8075,375500,2021-01-25,0.04583333333333333,120000,127500,7500,3005049
8076,375500,2021-02-01,0.05829596412556054,111500,118000,6500,641899
8077,375500,2021-01-29,0.07083333333333333,120000,111500,-8500,1105949
8078,375500,2021-01-27,0.07114624505928854,126500,117500,-9000,1082796
8079,375500,2021-01-25,0.04583333333333333,120000,127500,7500,3005049
8080,375500,2021-02-01,0.05829596412556054,111500,118000,6500,641899
8081,375500,2021-01-29,0.07083333333333333,120000,111500,-8500,1105949
8082,375500,2021-01-27,0.07114624505928854,126500,117500,-9000,1082796
8083,375500,2021-01-25,0.04583333333333333,120000,127500,7500,3005049
8084,375500,2021-02-01,0.05829596412556054,111500,118000,6500,641899
8085,375500,2021-01-29,0.07083333333333333,120000,111500,-8500,1105949
8086,375500,2021-01-27,0.07114624505928854,126500,117500,-9000,1082796
8087,375500,2021-01-25,0.04583333333333333,120000,127500,7500,3005049
8088,375500,2021-02-01,0.05829596412556054,111500,118000,6500,641899
8089,375500,2021-01-29,0.07083333333333333,120000,111500,-8500,1105949
8090,375500,2021-01-27,0.07114624505928854,126500,117500,-9000,1082796
8091,375500,2021-01-25,0.04583333333333333,120000,127500,7500,3005049
8092,375500,2021-02-01,0.05829596412556054,111500,118000,6500,641899
8093,375500,2021-01-29,0.07083333333333333,120000,111500,-8500,1105949
8094,375500,2021-01-27,0.07114624505928854,126500,117500,-9000,1082796
8095,375500,2021-01-25,0.04583333333333333,120000,127500,7500,3005049
8096,375500,2021-02-01,0.05829596412556054,111500,118000,6500,641899
8097,375500,2021-01-29,0.07083333333333333,120000,111500,-8500,1105949
8098,375500,2021-01-27,0.07114624505928854,126500,117500,-9000,1082796
8099,375500,2021-01-25,0.04583333333333333,120000,127500,7500,3005049
8100,375500,2021-02-01,0.05829596412556054,111500,118000,6500,641899
8101,375500,2021-01-29,0.07083333333333333,120000,111500,-8500,1105949
8102,375500,2021-01-27,0.07114624505928854,126500,117500,-9000,1082796
8103,375500,2021-01-25,0.04583333333333333,120000,127500,7500,3005049
8104,375500,2021-02-01,0.05829596412556054,111500,118000,6500,641899
8105,375500,2021-01-29,0.07083333333333333,120000,111500,-8500,1105949
8106,375500,2021-01-27,0.07114624505928854,126500,117500,-9000,1082796
8107,375500,2021-01-25,0.04583333333333333,120000,127500,7500,3005049
8108,375500,2021-02-01,0.05829596412556054,111500,118000,6500,641899
8109,375500,2021-01-29,0.07083333333333333,120000,111500,-8500,1105949
8110,375500,2021-01-27,0.07114624505928854,126500,117500,-9000,1082796
8111,375500,2021-01-25,0.04583333333333333,120000,127500,7500,3005049
8112,375500,2021-02-01,0.05829596412556054,111500,118000,6500,641899
8113,375500,2021-01-29,0.07083333333333333,120000,111500,-8500,1105949
8114,375500,2021-01-27,0.07114624505928854,126500,117500,-9000,1082796
8115,375500,2021-01-25,0.04583333333333333,120000,127500,7500,3005049
8116,375500,2021-02-01,0.05829596412556054,111500,118000,6500,641899
8117,375500,2021-01-29,0.07083333333333333,120000,111500,-8500,1105949
8118,375500,2021-01-27,0.07114624505928854,126500,117500,-9000,1082796
8119,375500,2021-01-25,0.04583333333333333,120000,127500,7500,3005049
8120,375500,2021-02-01,0.05829596412556054,111500,118000,6500,641899
8121,375500,2021-01-29,0.07083333333333333,120000,111500,-8500,1105949
8122,375500,2021-01-27,0.07114624505928854,126500,117500,-9000,1082796
8123,375500,2021-01-25,0.04583333333333333,120000,127500,7500,3005049
8124,375500,2021-02-01,0.05829596412556054,111500,118000,6500,641899
8125,375500,2021-01-29,0.07083333333333333,120000,111500,-8500,1105949
8126,375500,2021-01-27,0.07114624505928854,126500,117500,-9000,1082796
8127,375500,2021-01-25,0.04583333333333333,120000,127500,7500,3005049
8128,375500,2021-02-01,0.05829596412556054,111500,118000,6500,641899
8129,375500,2021-01-29,0.07083333333333333,120000,111500,-8500,1105949
8130,375500,2021-01-27,0.07114624505928854,126500,117500,-9000,1082796
8131,375500,2021-01-25,0.04583333333333333,120000,127500,7500,3005049
8132,375500,2021-02-01,0.05829596412556054,111500,118000,6500,641899
8133,375500,2021-01-29,0.07083333333333333,120000,111500,-8500,1105949
8134,375500,2021-01-27,0.07114624505928854,126500,117500,-9000,1082796
8135,375500,2021-01-25,0.04583333333333333,120000,127500,7500,3005049
8136,375500,2021-02-01,0.05829596412556054,111500,118000,6500,641899
8137,375500,2021-01-29,0.07083333333333333,120000,111500,-8500,1105949
8138,375500,2021-01-27,0.07114624505928854,126500,117500,-9000,1082796
8139,375500,2021-01-25,0.04583333333333333,120000,127500,7500,3005049
8140,375500,2021-02-01,0.05829596412556054,111500,118000,6500,641899
8141,375500,2021-01-29,0.07083333333333333,120000,111500,-8500,1105949
8142,375500,2021-01-27,0.07114624505928854,126500,117500,-9000,1082796
8143,375500,2021-01-25,0.04583333333333333,120000,127500,7500,3005049
8144,375500,2021-02-01,0.05829596412556054,111500,118000,6500,641899
8145,375500,2021-01-29,0.07083333333333333,120000,111500,-8500,1105949
8146,375500,2021-01-27,0.07114624505928854,126500,117500,-9000,1082796
8147,375500,2021-01-25,0.04583333333333333,120000,127500,7500,3005049
8148,375500,2021-02-01,0.05829596412556054,111500,118000,6500,641899
8149,375500,2021-01-29,0.07083333333333333,120000,111500,-8500,1105949
8150,375500,2021-01-27,0.07114624505928854,126500,117500,-9000,1082796
8151,375500,2021-01-25,0.04583333333333333,120000,127500,7500,3005049
8152,375500,2021-02-01,0.05829596412556054,111500,118000,6500,641899
8153,375500,2021-01-29,0.07083333333333333,120000,111500,-8500,1105949
8154,375500,2021-01-27,0.07114624505928854,126500,117500,-9000,1082796
8155,375500,2021-01-25,0.04583333333333333,120000,127500,7500,3005049
8156,375500,2021-02-01,0.05829596412556054,111500,118000,6500,641899
8157,375500,2021-01-29,0.07083333333333333,120000,111500,-8500,1105949
8158,375500,2021-01-27,0.07114624505928854,126500,117500,-9000,1082796
8159,375500,2021-01-25,0.04583333333333333,120000,127500,7500,3005049
8160,375500,2021-02-01,0.05829596412556054,111500,118000,6500,641899
8161,375500,2021-01-29,0.07083333333333333,120000,111500,-8500,1105949
8162,375500,2021-01-27,0.07114624505928854,126500,117500,-9000,1082796
8163,375500,2021-01-25,0.04583333333333333,120000,127500,7500,3005049
8164,375500,2021-02-01,0.05829596412556054,111500,118000,6500,641899
8165,375500,2021-01-29,0.07083333333333333,120000,111500,-8500,1105949
8166,375500,2021-01-27,0.07114624505928854,126500,117500,-9000,1082796
8167,375500,2021-01-25,0.04583333333333333,120000,127500,7500,3005049
8168,375500,2021-02-01,0.05829596412556054,111500,118000,6500,641899
8169,375500,2021-01-29,0.07083333333333333,120000,111500,-8500,1105949
8170,375500,2021-01-27,0.07114624505928854,126500,117500,-9000,1082796
8171,375500,2021-01-25,0.04583333333333333,120000,127500,7500,3005049
8172,375500,2021-02-01,0.05829596412556054,111500,118000,6500,641899
8173,375500,2021-01-29,0.07083333333333333,120000,111500,-8500,1105949
8174,375500,2021-01-27,0.07114624505928854,126500,117500,-9000,1082796
8175,375500,2021-01-25,0.04583333333333333,120000,127500,7500,3005049
8176,375500,2021-02-01,0.05829596412556054,111500,118000,6500,641899
8177,375500,2021-01-29,0.07083333333333333,120000,111500,-8500,1105949
8178,375500,2021-01-27,0.07114624505928854,126500,117500,-9000,1082796
8179,375500,2021-01-25,0.04583333333333333,120000,127500,7500,3005049
8180,375500,2021-02-01,0.05829596412556054,111500,118000,6500,641899
8181,375500,2021-01-29,0.07083333333333333,120000,111500,-8500,1105949
8182,375500,2021-01-27,0.07114624505928854,126500,117500,-9000,1082796
8183,375500,2021-01-25,0.04583333333333333,120000,127500,7500,3005049
8184,375500,2021-02-01,0.05829596412556054,111500,118000,6500,641899
8185,375500,2021-01-29,0.07083333333333333,120000,111500,-8500,1105949
8186,375500,2021-01-27,0.07114624505928854,126500,117500,-9000,1082796
8187,375500,2021-01-25,0.04583333333333333,120000,127500,7500,3005049
8188,375500,2021-02-01,0.05829596412556054,111500,118000,6500,641899
8189,375500,2021-01-29,0.07083333333333333,120000,111500,-8500,1105949
8190,375500,2021-01-27,0.07114624505928854,126500,117500,-9000,1082796
8191,375500,2021-01-25,0.04583333333333333,120000,127500,7500,3005049
8192,375500,2021-02-01,0.05829596412556054,111500,118000,6500,641899
8193,375500,2021-01-29,0.07083333333333333,120000,111500,-8500,1105949
8194,375500,2021-01-27,0.07114624505928854,126500,117500,-9000,1082796
8195,375500,2021-01-25,0.04583333333333333,120000,127500,7500,3005049
8196,375500,2021-02-01,0.05829596412556054,111500,118000,6500,641899
8197,375500,2021-01-29,0.07083333333333333,120000,111500,-8500,1105949
8198,375500,2021-01-27,0.07114624505928854,126500,117500,-9000,1082796
8199,375500,2021-01-25,0.04583333333333333,120000,127500,7500,3005049
8200,375500,2021-02-01,0.05829596412556054,111500,118000,6500,641899
8201,375500,2021-01-29,0.07083333333333333,120000,111500,-8500,1105949
8202,375500,2021-01-27,0.07114624505928854,126500,117500,-9000,1082796
8203,375500,2021-01-25,0.04583333333333333,120000,127500,7500,3005049
8204,375500,2021-02-01,0.05829596412556054,111500,118000,6500,641899
8205,375500,2021-01-29,0.07083333333333333,120000,111500,-8500,1105949
8206,375500,2021-01-27,0.07114624505928854,126500,117500,-9000,1082796
8207,375500,2021-01-25,0.04583333333333333,120000,127500,7500,3005049
8208,375500,2021-02-01,0.05829596412556054,111500,118000,6500,641899
8209,375500,2021-01-29,0.07083333333333333,120000,111500,-8500,1105949
8210,375500,2021-01-27,0.07114624505928854,126500,117500,-9000,1082796
8211,375500,2021-01-25,0.04583333333333333,120000,127500,7500,3005049
8212,375500,2021-02-01,0.05829596412556054,111500,118000,6500,641899
8213,375500,2021-01-29,0.07083333333333333,120000,111500,-8500,1105949
8214,375500,2021-01-27,0.07114624505928854,126500,117500,-9000,1082796
8215,375500,2021-01-25,0.04583333333333333,120000,127500,7500,3005049
8216,375500,2021-02-01,0.05829596412556054,111500,118000,6500,641899
8217,375500,2021-01-29,0.07083333333333333,120000,111500,-8500,1105949
8218,375500,2021-01-27,0.07114624505928854,126500,117500,-9000,1082796
8219,375500,2021-01-25,0.04583333333333333,120000,127500,7500,3005049
8220,375500,2021-02-01,0.05829596412556054,111500,118000,6500,641899
8221,375500,2021-01-29,0.07083333333333333,120000,111500,-8500,1105949
8222,375500,2021-01-27,0.07114624505928854,126500,117500,-9000,1082796
8223,375500,2021-01-25,0.04583333333333333,120000,127500,7500,3005049
8224,375500,2021-02-01,0.05829596412556054,111500,118000,6500,641899
8225,375500,2021-01-29,0.07083333333333333,120000,111500,-8500,1105949
8226,375500,2021-01-27,0.07114624505928854,126500,117500,-9000,1082796
8227,375500,2021-01-25,0.04583333333333333,120000,127500,7500,3005049
8228,375500,2021-02-01,0.05829596412556054,111500,118000,6500,641899
8229,375500,2021-01-29,0.07083333333333333,120000,111500,-8500,1105949
8230,375500,2021-01-27,0.07114624505928854,126500,117500,-9000,1082796
8231,375500,2021-01-25,0.04583333333333333,120000,127500,7500,3005049
8232,375500,2021-02-01,0.05829596412556054,111500,118000,6500,641899
8233,375500,2021-01-29,0.07083333333333333,120000,111500,-8500,1105949
8234,375500,2021-01-27,0.07114624505928854,126500,117500,-9000,1082796
8235,375500,2021-01-25,0.04583333333333333,120000,127500,7500,3005049
8236,375500,2021-02-01,0.05829596412556054,111500,118000,6500,641899
8237,375500,2021-01-29,0.07083333333333333,120000,111500,-8500,1105949
8238,375500,2021-01-27,0.07114624505928854,126500,117500,-9000,1082796
8239,375500,2021-01-25,0.04583333333333333,120000,127500,7500,3005049
8240,375500,2021-02-01,0.05829596412556054,111500,118000,6500,641899
8241,375500,2021-01-29,0.07083333333333333,120000,111500,-8500,1105949
8242,375500,2021-01-27,0.07114624505928854,126500,117500,-9000,1082796
8243,375500,2021-01-25,0.04583333333333333,120000,127500,7500,3005049
8244,375500,2021-02-01,0.05829596412556054,111500,118000,6500,641899
8245,375500,2021-01-29,0.07083333333333333,120000,111500,-8500,1105949
8246,375500,2021-01-27,0.07114624505928854,126500,117500,-9000,1082796
8247,375500,2021-01-25,0.04583333333333333,120000,127500,7500,3005049
8248,375500,2021-02-01,0.05829596412556054,111500,118000,6500,641899
8249,375500,2021-01-29,0.07083333333333333,120000,111500,-8500,1105949
8250,375500,2021-01-27,0.07114624505928854,126500,117500,-9000,1082796
8251,375500,2021-01-25,0.04583333333333333,120000,127500,7500,3005049
8252,375500,2021-02-01,0.05829596412556054,111500,118000,6500,641899
8253,375500,2021-01-29,0.07083333333333333,120000,111500,-8500,1105949
8254,375500,2021-01-27,0.07114624505928854,126500,117500,-9000,1082796
8255,375500,2021-01-25,0.04583333333333333,120000,127500,7500,3005049
8256,375500,2021-02-01,0.05829596412556054,111500,118000,6500,641899
8257,375500,2021-01-29,0.07083333333333333,120000,111500,-8500,1105949
8258,375500,2021-01-27,0.07114624505928854,126500,117500,-9000,1082796
8259,375500,2021-01-25,0.04583333333333333,120000,127500,7500,3005049
8260,375500,2021-02-01,0.05829596412556054,111500,118000,6500,641899
8261,375500,2021-01-29,0.07083333333333333,120000,111500,-8500,1105949
8262,375500,2021-01-27,0.07114624505928854,126500,117500,-9000,1082796
8263,375500,2021-01-25,0.04583333333333333,120000,127500,7500,3005049
8264,375500,2021-02-01,0.05829596412556054,111500,118000,6500,641899
8265,375500,2021-01-29,0.07083333333333333,120000,111500,-8500,1105949
8266,375500,2021-01-27,0.07114624505928854,126500,117500,-9000,1082796
8267,375500,2021-01-25,0.04583333333333333,120000,127500,7500,3005049
8268,375500,2021-02-01,0.05829596412556054,111500,118000,6500,641899
8269,375500,2021-01-29,0.07083333333333333,120000,111500,-8500,1105949
8270,375500,2021-01-27,0.07114624505928854,126500,117500,-9000,1082796
8271,375500,2021-01-25,0.04583333333333333,120000,127500,7500,3005049
8272,375500,2021-02-01,0.05829596412556054,111500,118000,6500,641899
8273,375500,2021-01-29,0.07083333333333333,120000,111500,-8500,1105949
8274,375500,2021-01-27,0.07114624505928854,126500,117500,-9000,1082796
8275,375500,2021-01-25,0.04583333333333333,120000,127500,7500,3005049
8276,375500,2021-02-01,0.05829596412556054,111500,118000,6500,641899
8277,375500,2021-01-29,0.07083333333333333,120000,111500,-8500,1105949
8278,375500,2021-01-27,0.07114624505928854,126500,117500,-9000,1082796
8279,375500,2021-01-25,0.04583333333333333,120000,127500,7500,3005049
8280,375500,2021-02-01,0.05829596412556054,111500,118000,6500,641899
8281,375500,2021-01-29,0.07083333333333333,120000,111500,-8500,1105949
8282,375500,2021-01-27,0.07114624505928854,126500,117500,-9000,1082796
8283,375500,2021-01-25,0.04583333333333333,120000,127500,7500,3005049
8284,375500,2021-02-01,0.05829596412556054,111500,118000,6500,641899
8285,375500,2021-01-29,0.07083333333333333,120000,111500,-8500,1105949
8286,375500,2021-01-27,0.07114624505928854,126500,117500,-9000,1082796
8287,375500,2021-01-25,0.04583333333333333,120000,127500,7500,3005049
8288,375500,2021-02-01,0.05829596412556054,111500,118000,6500,641899
8289,375500,2021-01-29,0.07083333333333333,120000,111500,-8500,1105949
8290,375500,2021-01-27,0.07114624505928854,126500,117500,-9000,1082796
8291,375500,2021-01-25,0.04583333333333333,120000,127500,7500,3005049
8292,375500,2021-02-01,0.05829596412556054,111500,118000,6500,641899
8293,375500,2021-01-29,0.07083333333333333,120000,111500,-8500,1105949
8294,375500,2021-01-27,0.07114624505928854,126500,117500,-9000,1082796
8295,375500,2021-01-25,0.04583333333333333,120000,127500,7500,3005049
8296,375500,2021-02-01,0.05829596412556054,111500,118000,6500,641899
8297,375500,2021-01-29,0.07083333333333333,120000,111500,-8500,1105949
8298,375500,2021-01-27,0.07114624505928854,126500,117500,-9000,1082796
8299,375500,2021-01-25,0.04583333333333333,120000,127500,7500,3005049
8300,375500,2021-02-01,0.05829596412556054,111500,118000,6500,641899
8301,375500,2021-01-29,0.07083333333333333,120000,111500,-8500,1105949
8302,375500,2021-01-27,0.07114624505928854,126500,117500,-9000,1082796
8303,375500,2021-01-25,0.04583333333333333,120000,127500,7500,3005049
8304,375500,2021-02-01,0.05829596412556054,111500,118000,6500,641899
8305,375500,2021-01-29,0.07083333333333333,120000,111500,-8500,1105949
8306,375500,2021-01-27,0.07114624505928854,126500,117500,-9000,1082796
8307,375500,2021-01-25,0.04583333333333333,120000,127500,7500,3005049
8308,375500,2021-02-01,0.05829596412556054,111500,118000,6500,641899
8309,375500,2021-01-29,0.07083333333333333,120000,111500,-8500,1105949
8310,375500,2021-01-27,0.07114624505928854,126500,117500,-9000,1082796
8311,375500,2021-01-25,0.04583333333333333,120000,127500,7500,3005049
8312,375500,2021-02-01,0.05829596412556054,111500,118000,6500,641899
8313,375500,2021-01-29,0.07083333333333333,120000,111500,-8500,1105949
8314,375500,2021-01-27,0.07114624505928854,126500,117500,-9000,1082796
8315,375500,2021-01-25,0.04583333333333333,120000,127500,7500,3005049
8316,375500,2021-02-01,0.05829596412556054,111500,118000,6500,641899
8317,375500,2021-01-29,0.07083333333333333,120000,111500,-8500,1105949
8318,375500,2021-01-27,0.07114624505928854,126500,117500,-9000,1082796
8319,375500,2021-01-25,0.04583333333333333,120000,127500,7500,3005049
8320,375500,2021-02-01,0.05829596412556054,111500,118000,6500,641899
8321,375500,2021-01-29,0.07083333333333333,120000,111500,-8500,1105949
8322,375500,2021-01-27,0.07114624505928854,126500,117500,-9000,1082796
8323,375500,2021-01-25,0.04583333333333333,120000,127500,7500,3005049
8324,375500,2021-02-01,0.05829596412556054,111500,118000,6500,641899
8325,375500,2021-01-29,0.07083333333333333,120000,111500,-8500,1105949
8326,375500,2021-01-27,0.07114624505928854,126500,117500,-9000,1082796
8327,375500,2021-01-25,0.04583333333333333,120000,127500,7500,3005049
8328,375500,2021-02-01,0.05829596412556054,111500,118000,6500,641899
8329,375500,2021-01-29,0.07083333333333333,120000,111500,-8500,1105949
8330,375500,2021-01-27,0.07114624505928854,126500,117500,-9000,1082796
8331,375500,2021-01-25,0.04583333333333333,120000,127500,7500,3005049
8332,375500,2021-02-01,0.05829596412556054,111500,118000,6500,641899
8333,375500,2021-01-29,0.07083333333333333,120000,111500,-8500,1105949
8334,375500,2021-01-27,0.07114624505928854,126500,117500,-9000,1082796
8335,375500,2021-01-25,0.04583333333333333,120000,127500,7500,3005049
8336,375500,2021-02-01,0.05829596412556054,111500,118000,6500,641899
8337,375500,2021-01-29,0.07083333333333333,120000,111500,-8500,1105949
8338,375500,2021-01-27,0.07114624505928854,126500,117500,-9000,1082796
8339,375500,2021-01-25,0.04583333333333333,120000,127500,7500,3005049
8340,375500,2021-02-01,0.05829596412556054,111500,118000,6500,641899
8341,375500,2021-01-29,0.07083333333333333,120000,111500,-8500,1105949
8342,375500,2021-01-27,0.07114624505928854,126500,117500,-9000,1082796
8343,375500,2021-01-25,0.04583333333333333,120000,127500,7500,3005049
8344,375500,2021-02-01,0.05829596412556054,111500,118000,6500,641899
8345,375500,2021-01-29,0.07083333333333333,120000,111500,-8500,1105949
8346,375500,2021-01-27,0.07114624505928854,126500,117500,-9000,1082796
8347,375500,2021-01-25,0.04583333333333333,120000,127500,7500,3005049
8348,375500,2021-02-01,0.05829596412556054,111500,118000,6500,641899
8349,375500,2021-01-29,0.07083333333333333,120000,111500,-8500,1105949
8350,375500,2021-01-27,0.07114624505928854,126500,117500,-9000,1082796
8351,375500,2021-01-25,0.04583333333333333,120000,127500,7500,3005049
8352,375500,2021-02-01,0.05829596412556054,111500,118000,6500,641899
8353,375500,2021-01-29,0.07083333333333333,120000,111500,-8500,1105949
8354,375500,2021-01-27,0.07114624505928854,126500,117500,-9000,1082796
8355,375500,2021-01-25,0.04583333333333333,120000,127500,7500,3005049
8356,375500,2021-02-01,0.05829596412556054,111500,118000,6500,641899
8357,375500,2021-01-29,0.07083333333333333,120000,111500,-8500,1105949
8358,375500,2021-01-27,0.07114624505928854,126500,117500,-9000,1082796
8359,375500,2021-01-25,0.04583333333333333,120000,127500,7500,3005049
8360,375500,2021-02-01,0.05829596412556054,111500,118000,6500,641899
8361,375500,2021-01-29,0.07083333333333333,120000,111500,-8500,1105949
8362,375500,2021-01-27,0.07114624505928854,126500,117500,-9000,1082796
8363,375500,2021-01-25,0.04583333333333333,120000,127500,7500,3005049
8364,375500,2021-02-01,0.05829596412556054,111500,118000,6500,641899
8365,375500,2021-01-29,0.07083333333333333,120000,111500,-8500,1105949
8366,375500,2021-01-27,0.07114624505928854,126500,117500,-9000,1082796
8367,375500,2021-01-25,0.04583333333333333,120000,127500,7500,3005049
8368,375500,2021-02-01,0.05829596412556054,111500,118000,6500,641899
8369,375500,2021-01-29,0.07083333333333333,120000,111500,-8500,1105949
8370,375500,2021-01-27,0.07114624505928854,126500,117500,-9000,1082796
8371,375500,2021-01-25,0.04583333333333333,120000,127500,7500,3005049
8372,375500,2021-02-01,0.05829596412556054,111500,118000,6500,641899
8373,375500,2021-01-29,0.07083333333333333,120000,111500,-8500,1105949
8374,375500,2021-01-27,0.07114624505928854,126500,117500,-9000,1082796
8375,375500,2021-01-25,0.04583333333333333,120000,127500,7500,3005049
8376,375500,2021-02-01,0.05829596412556054,111500,118000,6500,641899
8377,375500,2021-01-29,0.07083333333333333,120000,111500,-8500,1105949
8378,375500,2021-01-27,0.07114624505928854,126500,117500,-9000,1082796
8379,375500,2021-01-25,0.04583333333333333,120000,127500,7500,3005049
8380,375500,2021-02-01,0.05829596412556054,111500,118000,6500,641899
8381,375500,2021-01-29,0.07083333333333333,120000,111500,-8500,1105949
8382,375500,2021-01-27,0.07114624505928854,126500,117500,-9000,1082796
8383,375500,2021-01-25,0.04583333333333333,120000,127500,7500,3005049
8384,375500,2021-02-01,0.05829596412556054,111500,118000,6500,641899
8385,375500,2021-01-29,0.07083333333333333,120000,111500,-8500,1105949
8386,375500,2021-01-27,0.07114624505928854,126500,117500,-9000,1082796
8387,375500,2021-01-25,0.04583333333333333,120000,127500,7500,3005049
8388,375500,2021-02-01,0.05829596412556054,111500,118000,6500,641899
8389,375500,2021-01-29,0.07083333333333333,120000,111500,-8500,1105949
8390,375500,2021-01-27,0.07114624505928854,126500,117500,-9000,1082796
8391,375500,2021-01-25,0.04583333333333333,120000,127500,7500,3005049
8392,375500,2021-02-01,0.05829596412556054,111500,118000,6500,641899
8393,375500,2021-01-29,0.07083333333333333,120000,111500,-8500,1105949
8394,375500,2021-01-27,0.07114624505928854,126500,117500,-9000,1082796
8395,375500,2021-01-25,0.04583333333333333,120000,127500,7500,3005049
8396,375500,2021-02-01,0.05829596412556054,111500,118000,6500,641899
8397,375500,2021-01-29,0.07083333333333333,120000,111500,-8500,1105949
8398,375500,2021-01-27,0.07114624505928854,126500,117500,-9000,1082796
8399,375500,2021-01-25,0.04583333333333333,120000,127500,7500,3005049
8400,375500,2021-02-01,0.05829596412556054,111500,118000,6500,641899
8401,375500,2021-01-29,0.07083333333333333,120000,111500,-8500,1105949
8402,375500,2021-01-27,0.07114624505928854,126500,117500,-9000,1082796
8403,375500,2021-01-25,0.04583333333333333,120000,127500,7500,3005049
8404,375500,2021-02-01,0.05829596412556054,111500,118000,6500,641899
8405,375500,2021-01-29,0.07083333333333333,120000,111500,-8500,1105949
8406,375500,2021-01-27,0.07114624505928854,126500,117500,-9000,1082796
8407,375500,2021-01-25,0.04583333333333333,120000,127500,7500,3005049
8408,375500,2021-02-01,0.05829596412556054,111500,118000,6500,641899
8409,375500,2021-01-29,0.07083333333333333,120000,111500,-8500,1105949
8410,375500,2021-01-27,0.07114624505928854,126500,117500,-9000,1082796
8411,375500,2021-01-25,0.04583333333333333,120000,127500,7500,3005049
8412,375500,2021-02-01,0.05829596412556054,111500,118000,6500,641899
8413,375500,2021-01-29,0.07083333333333333,120000,111500,-8500,1105949
8414,375500,2021-01-27,0.07114624505928854,126500,117500,-9000,1082796
8415,375500,2021-01-25,0.04583333333333333,120000,127500,7500,3005049
8416,375500,2021-02-01,0.05829596412556054,111500,118000,6500,641899
8417,375500,2021-01-29,0.07083333333333333,120000,111500,-8500,1105949
8418,375500,2021-01-27,0.07114624505928854,126500,117500,-9000,1082796
8419,375500,2021-01-25,0.04583333333333333,120000,127500,7500,3005049
8420,375500,2021-02-01,0.05829596412556054,111500,118000,6500,641899
8421,375500,2021-01-29,0.07083333333333333,120000,111500,-8500,1105949
8422,375500,2021-01-27,0.07114624505928854,126500,117500,-9000,1082796
8423,375500,2021-01-25,0.04583333333333333,120000,127500,7500,3005049
8424,375500,2021-02-01,0.05829596412556054,111500,118000,6500,641899
8425,375500,2021-01-29,0.07083333333333333,120000,111500,-8500,1105949
8426,375500,2021-01-27,0.07114624505928854,126500,117500,-9000,1082796
8427,375500,2021-01-25,0.04583333333333333,120000,127500,7500,3005049
8428,375500,2021-02-01,0.05829596412556054,111500,118000,6500,641899
8429,375500,2021-01-29,0.07083333333333333,120000,111500,-8500,1105949
8430,375500,2021-01-27,0.07114624505928854,126500,117500,-9000,1082796
8431,375500,2021-01-25,0.04583333333333333,120000,127500,7500,3005049
8432,375500,2021-02-01,0.05829596412556054,111500,118000,6500,641899
8433,375500,2021-01-29,0.07083333333333333,120000,111500,-8500,1105949
8434,375500,2021-01-27,0.07114624505928854,126500,117500,-9000,1082796
8435,375500,2021-01-25,0.04583333333333333,120000,127500,7500,3005049
8436,375500,2021-02-01,0.05829596412556054,111500,118000,6500,641899
8437,375500,2021-01-29,0.07083333333333333,120000,111500,-8500,1105949
8438,375500,2021-01-27,0.07114624505928854,126500,117500,-9000,1082796
8439,375500,2021-01-25,0.04583333333333333,120000,127500,7500,3005049
8440,375500,2021-02-01,0.05829596412556054,111500,118000,6500,641899
8441,375500,2021-01-29,0.07083333333333333,120000,111500,-8500,1105949
8442,375500,2021-01-27,0.07114624505928854,126500,117500,-9000,1082796
8443,375500,2021-01-25,0.04583333333333333,120000,127500,7500,3005049
8444,375500,2021-02-01,0.05829596412556054,111500,118000,6500,641899
8445,375500,2021-01-29,0.07083333333333333,120000,111500,-8500,1105949
8446,375500,2021-01-27,0.07114624505928854,126500,117500,-9000,1082796
8447,375500,2021-01-25,0.04583333333333333,120000,127500,7500,3005049
8448,375500,2021-02-01,0.05829596412556054,111500,118000,6500,641899
8449,375500,2021-01-29,0.07083333333333333,120000,111500,-8500,1105949
8450,375500,2021-01-27,0.07114624505928854,126500,117500,-9000,1082796
8451,375500,2021-01-25,0.04583333333333333,120000,127500,7500,3005049
8452,375500,2021-02-01,0.05829596412556054,111500,118000,6500,641899
8453,375500,2021-01-29,0.07083333333333333,120000,111500,-8500,1105949
8454,375500,2021-01-27,0.07114624505928854,126500,117500,-9000,1082796
8455,375500,2021-01-25,0.04583333333333333,120000,127500,7500,3005049
8456,375500,2021-02-01,0.05829596412556054,111500,118000,6500,641899
8457,375500,2021-01-29,0.07083333333333333,120000,111500,-8500,1105949
8458,375500,2021-01-27,0.07114624505928854,126500,117500,-9000,1082796
8459,375500,2021-01-25,0.04583333333333333,120000,127500,7500,3005049
8460,375500,2021-02-01,0.05829596412556054,111500,118000,6500,641899
8461,375500,2021-01-29,0.07083333333333333,120000,111500,-8500,1105949
8462,375500,2021-01-27,0.07114624505928854,126500,117500,-9000,1082796
8463,42700,2021-06-03,0.05757575757575758,33000,34900,1900,2379427
8464,42700,2021-05-27,0.059748427672955975,31800,33700,1900,988557
8465,42700,2021-05-24,0.049635036496350364,34250,32550,-1700,933280
8466,42700,2021-05-18,0.045871559633027525,32700,34200,1500,1294112
8467,42700,2021-05-14,0.095,30000,32850,2850,2050356
8468,42700,2021-05-13,0.05362776025236593,31700,30000,-1700,1258659
8469,42700,2021-04-29,0.04,35000,33600,-1400,1990236
8470,42700,2021-04-28,0.08256880733944955,38150,35000,-3150,2057001
8471,42700,2021-04-26,0.06433566433566433,35750,38050,2300,1617750
8472,42700,2021-04-23,0.051470588235294115,34000,35750,1750,1561390
8473,42700,2021-04-05,0.1169811320754717,26500,29600,3100,5801383
8474,42700,2021-04-01,0.06762295081967214,24400,26050,1650,1781210
8475,42700,2021-03-23,0.04206500956022945,26150,25050,-1100,923223
8476,42700,2021-03-18,0.04439746300211417,23650,24700,1050,1108441
8477,42700,2021-03-15,0.04405286343612335,22700,23700,1000,1053035
8478,42700,2021-03-11,0.08663366336633663,20200,21950,1750,861079
8479,42700,2021-02-24,0.05286343612334802,22700,21500,-1200,1314180
8480,42700,2021-02-23,0.058091286307053944,24100,22700,-1400,1380044
8481,42700,2021-02-19,0.12268518518518519,21600,24250,2650,10339907
8482,42700,2021-02-15,0.06201550387596899,19350,20550,1200,1135182
8483,42700,2021-02-01,0.06878306878306878,18900,20200,1300,866041
8484,42700,2021-01-29,0.045454545454545456,19800,18900,-900,778157
8485,42700,2021-01-27,0.0498812351543943,21050,20000,-1050,893733
8486,42700,2021-01-18,0.0610079575596817,18850,20000,1150,3088776
8487,42700,2021-01-15,0.06497175141242938,17700,18850,1150,7994829
8488,42700,2020-12-29,0.08484848484848485,16500,17900,1400,1485125
8489,42700,2020-12-21,0.046012269938650305,16300,17050,750,1069395
8490,42700,2020-12-17,0.05345911949685535,15900,16750,850,2901563
8491,42700,2020-12-16,0.11971830985915492,14200,15900,1700,3124324
8492,42700,2020-12-08,0.06746031746031746,12600,13450,850,2955553
8493,42700,2020-11-19,0.044715447154471545,12300,12850,550,1279869
8494,42700,2020-11-16,0.08189655172413793,11600,12550,950,2869763
8495,42700,2020-11-13,0.04504504504504504,11100,11600,500,670736
8496,42700,2020-10-29,0.04830917874396135,10350,10850,500,599232
8497,42700,2020-10-23,0.05092592592592592,10800,10250,-550,669169
8498,42700,2020-10-12,0.05714285714285714,10500,11100,600,843797
8499,42700,2020-09-28,0.045454545454545456,9900,10350,450,253746
8500,42700,2020-09-08,0.0761904761904762,10500,11300,800,2386744
8501,42700,2020-08-20,0.0824074074074074,10800,9910,-890,1165998
8502,42700,2020-08-18,0.05,11000,10450,-550,780412
8503,42700,2020-08-12,0.040983606557377046,12200,11700,-500,5498280
8504,42700,2020-07-21,0.16024973985431842,9610,11150,1540,9822948
8505,42700,2020-07-17,0.10101010101010101,8910,9810,900,4747288
8506,42700,2020-07-08,0.056818181818181816,7920,8370,450,1203748
8507,42700,2020-07-03,0.07065217391304347,7360,7880,520,675714
8508,42700,2020-06-15,0.06403940886699508,8120,7600,-520,602759
8509,42700,2020-05-28,0.0425531914893617,9400,9000,-400,563211
8510,42700,2020-05-27,0.04081632653061224,9800,9400,-400,577332
8511,42700,2020-05-25,0.07766990291262135,9270,9990,720,1324121
8512,42700,2020-05-20,0.11888111888111888,8580,9600,1020,4665545
8513,42700,2020-05-08,0.0441527446300716,8380,8750,370,499565
8514,42700,2020-05-07,0.05144291091593475,7970,8380,410,325237
8515,42700,2020-04-17,0.06267029972752043,7340,7800,460,512513
8516,42700,2020-04-07,0.06543385490753911,7030,7490,460,506536
8517,42700,2020-03-25,0.12151067323481117,6090,6830,740,465857
8518,42700,2020-03-24,0.0855614973262032,5610,6090,480,414274
8519,42700,2020-03-23,0.0757825370675453,6070,5610,-460,319987
8520,42700,2020-03-20,0.15180265654648956,5270,6070,800,638207
8521,42700,2020-03-19,0.19047619047619047,6510,5270,-1240,446896
8522,42700,2020-03-18,0.06465517241379311,6960,6510,-450,238027
8523,42700,2020-03-16,0.05033112582781457,7550,7170,-380,264906
8524,42700,2020-03-13,0.04671717171717172,7920,7550,-370,617541
8525,42700,2020-03-12,0.07368421052631578,8550,7920,-630,436659
8526,42700,2020-03-11,0.048943270300333706,8990,8550,-440,230337
8527,42700,2020-03-09,0.044468546637744036,9220,8810,-410,238220
8528,42700,2020-03-02,0.053117782909930716,8660,9120,460,303635
8529,42700,2020-02-28,0.04939626783754116,9110,8660,-450,431721
8530,42700,2020-02-27,0.058884297520661155,9680,9110,-570,351920
8531,42700,2020-02-25,0.05223068552774755,9190,9670,480,311201
8532,42700,2020-02-13,0.06002143622722401,9330,9890,560,1396365
8533,42700,2020-01-31,0.046052631578947366,9120,8700,-420,817061
8534,42700,2020-01-28,0.04133064516129032,9920,9510,-410,822448
8535,42700,2020-01-23,0.04311251314405889,9510,9920,410,1394861
8536,42700,2020-01-22,0.05432372505543237,9020,9510,490,3979330
8537,42700,2020-01-16,0.061611374407582936,8440,8960,520,669926
8538,42700,2020-01-09,0.06369426751592357,7850,8350,500,616267
8539,42700,2019-12-17,0.06512890094979647,7370,7850,480,1289746
8540,42700,2019-12-16,0.06349206349206349,6930,7370,440,1326390
8541,42700,2019-12-13,0.1,6300,6930,630,3514800
8542,42700,2019-11-25,0.04262295081967213,6100,6360,260,79334
8543,42700,2019-11-20,0.05089820359281437,6680,6340,-340,283813
8544,42700,2019-10-14,0.04938271604938271,6480,6800,320,158318
8545,42700,2019-09-09,0.04923076923076923,6500,6180,-320,241636
8546,42700,2019-09-05,0.061788617886178863,6150,6530,380,444476
8547,42700,2019-09-04,0.044142614601018676,5890,6150,260,232799
8548,42700,2019-08-30,0.05128205128205128,5460,5740,280,136942
8549,42700,2019-08-26,0.0564373897707231,5670,5350,-320,186272
8550,42700,2019-08-13,0.04436860068259386,5860,6120,260,156686
8551,42700,2019-08-06,0.09090909090909091,6050,5500,-550,324542
8552,42700,2019-08-05,0.07350689127105667,6530,6050,-480,212217
8553,42700,2019-07-29,0.05604719764011799,6780,6400,-380,161967
8554,42700,2019-07-08,0.088,7500,6840,-660,509528
8555,42700,2019-06-19,0.04908835904628331,7130,7480,350,424645
8556,42700,2019-05-09,0.04982618771726535,8630,8200,-430,529422
8557,42700,2019-04-23,0.07268464243845252,8530,9150,620,1329248
8558,42700,2019-04-17,0.06859205776173286,8310,8880,570,1164248
8559,42700,2019-03-25,0.04107981220657277,8520,8170,-350,134954
8560,42700,2019-03-15,0.05889014722536806,8830,8310,-520,368341
8561,42700,2019-03-14,0.09417596034696406,8070,8830,760,666355
8562,42700,2019-02-28,0.04387990762124711,8660,8280,-380,327500
8563,42700,2019-02-12,0.08684546615581099,7830,8510,680,514909
8564,42700,2019-01-31,0.04177545691906005,7660,7980,320,1069313
8565,42700,2019-01-03,0.07190412782956059,7510,6970,-540,331118
8566,42700,2018-12-10,0.05365296803652968,8760,8290,-470,315468
8567,42700,2018-12-07,0.04285714285714286,8400,8760,360,197029
8568,42700,2018-12-03,0.08029197080291971,8220,8880,660,419484
8569,42700,2018-11-28,0.0414572864321608,7960,8290,330,218776
8570,42700,2018-11-20,0.07551487414187644,8740,8080,-660,583694
8571,42700,2018-11-07,0.04515418502202643,9080,8670,-410,238865
8572,42700,2018-10-15,0.042810098792535674,9110,9500,390,228573
8573,42700,2018-10-12,0.05807200929152149,8610,9110,500,170000
8574,42700,2018-10-11,0.07419354838709677,9300,8610,-690,231237
8575,42700,2018-10-02,0.04878048780487805,10250,9750,-500,236853
8576,42700,2018-09-19,0.0821256038647343,10350,11200,850,2251717
8577,42700,2018-08-27,0.04824561403508772,11400,11950,550,712134
8578,42700,2018-08-24,0.0410958904109589,10950,11400,450,983728
8579,42700,2018-08-22,0.1111111111111111,9900,11000,1100,1249446
8580,42700,2018-07-31,0.04926108374384237,10150,10650,500,458124
8581,42700,2018-07-13,0.0764904386951631,8890,9570,680,346296
8582,42700,2018-07-10,0.05741626794258373,8360,8840,480,178817
8583,42700,2018-06-28,0.05828571428571429,8750,8240,-510,232944
8584,42700,2018-05-29,0.04040404040404041,9900,9500,-400,313668
8585,42700,2018-04-04,0.04285714285714286,10500,10050,-450,424557
8586,42700,2018-04-02,0.04888888888888889,11250,10700,-550,309257
8587,42700,2018-03-26,0.05092592592592592,10800,11350,550,288928
8588,42700,2018-03-22,0.04186046511627907,10750,11200,450,377652
8589,42700,2018-03-07,0.05405405405405406,11100,10500,-600,332072
8590,42700,2018-03-05,0.05172413793103448,11600,11000,-600,395867
8591,42700,2018-02-14,0.04888888888888889,11250,11800,550,202565
8592,42700,2018-02-08,0.1380952380952381,10500,11950,1450,782860
8593,42700,2018-02-07,0.05405405405405406,11100,10500,-600,495842
8594,42700,2018-01-16,0.04072398190045249,11050,11500,450,316985
8595,42700,2017-12-21,0.05371900826446281,12100,11450,-650,262126
8596,42700,2017-12-19,0.04741379310344827,11600,12150,550,514490
8597,42700,2017-12-11,0.04128440366972477,10900,11350,450,357169
8598,42700,2017-11-22,0.13215859030837004,11350,12850,1500,3742341
8599,42700,2017-11-21,0.06572769953051644,10650,11350,700,764799
8600,42700,2017-11-10,0.04821802935010482,9540,10000,460,589945
8601,42700,2017-11-09,0.046,10000,9540,-460,574334
8602,42700,2017-11-08,0.0559662090813094,9470,10000,530,586178
8603,42700,2017-10-27,0.05382131324004306,9290,9790,500,618740
8604,42700,2017-10-20,0.04030501089324619,9180,9550,370,964694
8605,42700,2017-10-17,0.049596309111880045,8670,9100,430,1758788
8606,42700,2017-09-28,0.07581227436823104,8310,8940,630,1523958
8607,42700,2017-09-25,0.04677623261694058,7910,8280,370,235114
8608,42700,2017-09-07,0.049689440993788817,8050,8450,400,563287
8609,42700,2017-08-30,0.061224489795918366,7350,7800,450,350443
8610,42700,2017-08-03,0.045077105575326216,8430,8050,-380,503861
8611,42700,2017-07-24,0.06172839506172839,8910,9460,550,2811971
8612,42700,2017-07-21,0.04088785046728972,8560,8910,350,1454792
8613,42700,2017-07-04,0.047044632086851626,8290,8680,390,649738
8614,42700,2017-06-27,0.04107981220657277,8520,8870,350,1453150
8615,42700,2017-06-14,0.05429864253393665,8840,8360,-480,1413432
8616,42700,2017-06-08,0.16195372750642673,7780,9040,1260,5453451
8617,42700,2017-05-15,0.04221635883905013,7580,7900,320,644892
8618,42700,2017-04-11,0.04178272980501393,17950,18700,750,236974
8619,42700,2017-04-03,0.04451038575667656,16850,17600,750,133265
8620,42700,2017-01-13,0.06968641114982578,14350,15350,1000,490584
8621,42700,2016-12-26,0.041379310344827586,14500,15100,600,180823
8622,42700,2016-12-16,0.05223880597014925,13400,14100,700,167395
8623,42700,2016-12-08,0.05263157894736842,12350,13000,650,96963
8624,42700,2016-11-10,0.04119850187265917,13350,13900,550,63823
8625,42700,2016-11-09,0.05319148936170213,14100,13350,-750,154469
8626,42700,2016-10-21,0.04529616724738676,14350,15000,650,142069
8627,42700,2016-09-19,0.05474452554744526,13700,14450,750,107136
8628,42700,2016-08-29,0.04516129032258064,15500,14800,-700,80773
8629,42700,2016-08-18,0.07692307692307693,14300,15400,1100,274145
8630,1230,2021-05-26,0.06540084388185655,23700,22150,-1550,3732584
8631,1230,2021-05-20,0.04950495049504951,25250,24000,-1250,3089788
8632,1230,2021-05-18,0.07905982905982906,23400,25250,1850,5334664
8633,1230,2021-05-13,0.09981167608286252,26550,23900,-2650,5165520
8634,1230,2021-05-11,0.048638132295719845,25700,26950,1250,6737916
8635,1230,2021-05-10,0.05327868852459016,24400,25700,1300,4248285
8636,1230,2021-05-07,0.042735042735042736,23400,24400,1000,4199878
8637,1230,2021-05-06,0.051685393258426963,22250,23400,1150,4210310
8638,1230,2021-05-03,0.08768267223382047,23950,21850,-2100,5969767
8639,1230,2021-04-30,0.07884615384615384,26000,23950,-2050,5051958
8640,1230,2021-04-27,0.06976744186046512,23650,25300,1650,12328098
8641,1230,2021-04-23,0.14390243902439023,20500,23450,2950,9352887
8642,1230,2021-04-21,0.04909560723514212,19350,20300,950,4728714
8643,1230,2021-04-15,0.04473684210526316,19000,19850,850,3345967
8644,1230,2021-04-13,0.04395604395604396,18200,19000,800,6107032
8645,1230,2021-04-12,0.04597701149425287,17400,18200,800,2889727
8646,1230,2021-04-08,0.07301587301587302,15750,16900,1150,6062153
8647,1230,2021-04-07,0.06060606060606061,14850,15750,900,2763922
8648,1230,2021-04-05,0.12121212121212122,13200,14800,1600,4618450
8649,1230,2021-03-29,0.11065573770491803,12200,13550,1350,5342467
8650,1230,2021-03-26,0.07964601769911504,11300,12200,900,2348872
8651,1230,2021-03-22,0.0547945205479452,10950,11550,600,1698225
8652,1230,2021-03-11,0.04726890756302521,9520,9970,450,2165838
8653,1230,2021-03-05,0.04468085106382979,9400,9820,420,2663764
8654,1230,2021-03-03,0.05102040816326531,8820,9270,450,7169711
8655,1230,2021-02-25,0.0872093023255814,8600,9350,750,4568939
8656,1230,2021-02-22,0.0508274231678487,8460,8890,430,2286717
8657,1230,2021-02-02,0.04230769230769231,7800,8130,330,713475
8658,1230,2021-01-28,0.0438489646772229,8210,7850,-360,991426
8659,1230,2021-01-27,0.04866743916570104,8630,8210,-420,1383532
8660,1230,2021-01-19,0.04265402843601896,8440,8800,360,1084100
8661,1230,2021-01-18,0.04632768361581921,8850,8440,-410,1141895
8662,1230,2021-01-05,0.05184331797235023,8680,9130,450,5632321
8663,1230,2021-01-04,0.06896551724137931,8120,8680,560,2833807
8664,1230,2020-12-22,0.0488997555012225,8180,7780,-400,856420
8665,1230,2020-12-09,0.07956104252400549,7290,7870,580,2113992
8666,1230,2020-11-23,0.13983050847457626,7080,8070,990,7383075
8667,1230,2020-11-16,0.0626865671641791,6700,7120,420,1471346
8668,1230,2020-11-09,0.046801872074883,6410,6710,300,779588
8669,1230,2020-10-08,0.061046511627906974,6880,7300,420,4232707
8670,1230,2020-10-05,0.0946372239747634,6340,6940,600,4388050
8671,1230,2020-09-25,0.044407894736842105,6080,6350,270,883346
8672,1230,2020-08-25,0.05705229793977813,6310,6670,360,1657026
8673,1230,2020-08-20,0.045813586097946286,6330,6040,-290,795960
8674,1230,2020-08-18,0.05581395348837209,6450,6090,-360,1308643
8675,1230,2020-08-06,0.04926108374384237,6090,6390,300,2140866
8676,1230,2020-07-20,0.043029259896729774,5810,6060,250,1183631
8677,1230,2020-07-15,0.04092526690391459,5620,5850,230,2377650
8678,1230,2020-06-25,0.07241379310344828,5800,5380,-420,1459718
8679,1230,2020-06-16,0.06164383561643835,5840,6200,360,2883158
8680,1230,2020-06-15,0.16212338593974174,6970,5840,-1130,4757037
8681,1230,2020-06-12,0.07804232804232804,7560,6970,-590,3963664
8682,1230,2020-06-10,0.044755244755244755,7150,7470,320,1882392
8683,1230,2020-06-05,0.1532258064516129,6200,7150,950,31027572
8684,1230,2020-06-04,0.08391608391608392,5720,6200,480,13906088
8685,1230,2020-06-03,0.3,4400,5720,1320,11488684
8686,1230,2020-05-26,0.06435643564356436,4040,4300,260,3332773
8687,1230,2020-05-04,0.05418138987043581,4245,4015,-230,561465
8688,1230,2020-04-29,0.0468557336621455,4055,4245,190,525036
8689,1230,2020-04-10,0.04521963824289406,3870,4045,175,735460
8690,1230,2020-04-06,0.05233380480905234,3535,3720,185,526818
8691,1230,2020-03-25,0.06901840490797546,3260,3485,225,643323
8692,1230,2020-03-24,0.07590759075907591,3030,3260,230,475718
8693,1230,2020-03-23,0.13428571428571429,3500,3030,-470,790815
8694,1230,2020-03-20,0.2589928057553957,2780,3500,720,744596
8695,1230,2020-03-19,0.14461538461538462,3250,2780,-470,1444120
8696,1230,2020-03-18,0.06204906204906205,3465,3250,-215,1041366
8697,1230,2020-03-17,0.04281767955801105,3620,3465,-155,1151515
8698,1230,2020-03-12,0.04192355117139334,4055,3885,-170,966189
8699,1230,2020-03-09,0.08183856502242152,4460,4095,-365,822190
8700,1230,2020-03-06,0.048025613660619,4685,4460,-225,691106
8701,1230,2020-02-24,0.04016477857878476,4855,4660,-195,462426
8702,1230,2020-02-20,0.05608365019011407,5260,4965,-295,577848
8703,1230,2020-02-06,0.07028112449799197,4980,5330,350,459856
8704,1230,2020-01-28,0.08058608058608059,5460,5020,-440,719470
8705,1230,2020-01-08,0.04569420035149385,5690,5430,-260,524098
8706,1230,2019-11-26,0.06890756302521009,5950,6360,410,517918
8707,1230,2019-09-10,0.04186795491143317,6210,6470,260,306882
8708,1230,2019-08-30,0.052083333333333336,5760,6060,300,302490
8709,1230,2019-08-26,0.04723127035830619,6140,5850,-290,504765
8710,1230,2019-08-05,0.07017543859649122,6270,5830,-440,549553
8711,1230,2019-07-05,0.04552129221732746,6810,7120,310,570552
8712,1230,2019-05-13,0.044733044733044736,6930,6620,-310,506438
8713,1230,2019-04-24,0.04472049689440994,8050,7690,-360,384175
8714,1230,2019-03-15,0.040342298288508556,8180,8510,330,626286
8715,1230,2019-02-28,0.043173862310385065,8570,8200,-370,316637
8716,1230,2019-02-20,0.047044632086851626,8290,8680,390,563447
8717,1230,2019-02-18,0.04460966542750929,8070,8430,360,435430
8718,1230,2019-02-08,0.04540162980209546,8590,8200,-390,274351
8719,1230,2019-01-30,0.06532663316582915,7960,8480,520,704141
8720,1230,2019-01-09,0.052917232021709636,7370,7760,390,779922
8721,1230,2018-12-21,0.05084745762711865,7670,7280,-390,510903
8722,1230,2018-12-13,0.0444743935309973,7420,7750,330,673146
8723,1230,2018-12-03,0.08053691275167785,7450,8050,600,873031
8724,1230,2018-11-07,0.05603985056039851,8030,7580,-450,557838
8725,1230,2018-11-05,0.04084158415841584,8080,7750,-330,551836
8726,1230,2018-11-02,0.09336941813261164,7390,8080,690,472987
8727,1230,2018-11-01,0.04526166902404526,7070,7390,320,422071
8728,1230,2018-10-11,0.04744069912609238,8010,7630,-380,542069
8729,1230,2018-10-10,0.0407185628742515,8350,8010,-340,446043
8730,1230,2018-10-04,0.06174200661521499,9070,8510,-560,862248
8731,1230,2018-09-19,0.04424778761061947,9040,9440,400,982618
8732,1230,2018-09-11,0.07869884575026233,9530,8780,-750,1321520
8733,1230,2018-08-29,0.15053763440860216,8370,9630,1260,5566192
8734,1230,2018-08-28,0.04625,8000,8370,370,383139
8735,1230,2018-08-20,0.062261753494282084,7870,8360,490,534057
8736,1230,2018-08-06,0.05012853470437018,7780,8170,390,558926
8737,1230,2018-07-23,0.04551920341394026,7030,7350,320,377536
8738,1230,2018-07-06,0.04281767955801105,7240,7550,310,415452
8739,1230,2018-07-02,0.061611374407582936,8440,7920,-520,553045
8740,1230,2018-06-19,0.05360824742268041,9700,9180,-520,567713
8741,1230,2018-06-14,0.044976076555023926,10450,9980,-470,717861
8742,1230,2018-05-30,0.04716981132075472,10600,10100,-500,719564
8743,1230,2018-05-28,0.11510791366906475,9730,10850,1120,1525428
8744,1230,2018-05-16,0.0547945205479452,10950,10350,-600,796976
8745,1230,2018-05-14,0.05263157894736842,10450,11000,550,1240205
8746,1230,2018-05-09,0.04265402843601896,10550,10100,-450,780420
8747,1230,2018-04-30,0.1011011011011011,9990,11000,1010,1907960
8748,1230,2018-04-19,0.06806282722513089,9550,10200,650,1163881
8749,1230,2018-04-18,0.04030501089324619,9180,9550,370,761376
8750,1230,2018-04-09,0.06048387096774194,9920,9320,-600,1284702
8751,1230,2018-03-27,0.054455445544554455,10100,10650,550,733890
8752,1230,2018-03-23,0.040776699029126215,10300,9880,-420,1394856
8753,1230,2018-03-19,0.05,10000,10500,500,1831975
8754,1230,2018-03-08,0.05102040816326531,9800,10300,500,474716
8755,1230,2018-03-02,0.05116279069767442,10750,10200,-550,707983
8756,1230,2018-02-05,0.04819277108433735,12450,11850,-600,558396
8757,1230,2018-01-29,0.04564315352697095,12050,12600,550,1070750
8758,1230,2018-01-11,0.05905511811023622,12700,11950,-750,994945
8759,1230,2018-01-10,0.040983606557377046,12200,12700,500,988801
8760,1230,2018-01-03,0.04524886877828054,11050,11550,500,841602
8761,1230,2017-12-18,0.08936170212765958,11750,10700,-1050,1218774
8762,1230,2017-12-06,0.0411522633744856,12150,11650,-500,1014448
8763,1230,2017-12-05,0.05652173913043478,11500,12150,650,1550806
8764,1230,2017-12-04,0.04072398190045249,11050,11500,450,623223
8765,1230,2017-10-27,0.04672897196261682,10700,11200,500,492969
8766,1230,2017-10-26,0.05309734513274336,11300,10700,-600,623638
8767,1230,2017-10-16,0.05069124423963134,10850,11400,550,1018292
8768,1230,2017-10-13,0.06372549019607843,10200,10850,650,748181
8769,1230,2017-10-10,0.04205607476635514,10700,10250,-450,682742
8770,1230,2017-09-22,0.05504587155963303,10900,10300,-600,1110695
8771,1230,2017-09-20,0.05084745762711865,11800,11200,-600,571374
8772,1230,2017-09-06,0.04048582995951417,12350,11850,-500,580842
8773,1230,2017-08-17,0.05511811023622047,12700,13400,700,804358
8774,1230,2017-08-14,0.05714285714285714,14000,13200,-800,1389493
8775,1230,2017-08-07,0.05964912280701754,14250,15100,850,1103686
8776,1230,2017-08-01,0.041811846689895474,14350,14950,600,576975
8777,1230,2017-07-24,0.0472972972972973,14800,14100,-700,923275
8778,1230,2017-07-04,0.044444444444444446,15750,15050,-700,1755700
8779,1230,2017-07-03,0.07508532423208192,14650,15750,1100,2324849
8780,1230,2017-06-28,0.09737827715355805,13350,14650,1300,2887288
8781,1230,2017-06-23,0.040160642570281124,12450,12950,500,684509
8782,1230,2017-05-22,0.07391304347826087,11500,12350,850,1061628
8783,1230,2017-04-03,0.0546875,12800,12100,-700,1010017
8784,1230,2017-03-15,0.04365079365079365,12600,13150,550,1376140
8785,1230,2017-03-08,0.04081632653061224,12250,12750,500,825199
8786,1230,2017-03-03,0.04032258064516129,12400,11900,-500,717649
8787,1230,2017-02-27,0.049586776859504134,12100,12700,600,726707
8788,1230,2017-02-01,0.045081967213114756,12200,12750,550,472286
8789,1230,2017-01-25,0.0625,12800,12000,-800,893476
8790,1230,2017-01-11,0.11587982832618025,11650,13000,1350,1937374
8791,1230,2017-01-02,0.05429864253393665,11050,11650,600,507800
8792,1230,2016-12-29,0.04329004329004329,11550,11050,-500,508792
8793,1230,2016-12-21,0.04310344827586207,11600,12100,500,690104
8794,1230,2016-12-06,0.1372745490981964,9980,11350,1370,2873993
8795,1230,2016-11-22,0.04145077720207254,9650,10050,400,772561
8796,1230,2016-11-14,0.04864864864864865,9250,9700,450,856672
8797,1230,2016-11-10,0.06946107784431138,8350,8930,580,537673
8798,1230,2016-11-07,0.07806691449814127,8070,8700,630,637291
8799,1230,2016-10-18,0.0403530895334174,7930,8250,320,255482
8800,1230,2016-09-12,0.042175360710321866,9010,8630,-380,286607
8801,1230,2016-09-07,0.05930232558139535,8600,9110,510,683929
8802,1230,2016-08-09,0.0418552036199095,8840,9210,370,404787
8803,1740,2021-03-12,0.06679389312977099,5240,5590,350,12133241
8804,1740,2021-02-09,0.0427807486631016,5610,5370,-240,1891664
8805,1740,2021-01-21,0.0773109243697479,5950,5490,-460,8680732
8806,1740,2021-01-20,0.19718309859154928,4970,5950,980,4454180
8807,1740,2020-08-20,0.045454545454545456,5280,5040,-240,893529
8808,1740,2020-08-18,0.04036697247706422,5450,5230,-220,896849
8809,1740,2020-08-06,0.06906906906906907,4995,5340,345,1833826
8810,1740,2020-06-16,0.06832298136645963,4830,5160,330,720401
8811,1740,2020-06-15,0.047337278106508875,5070,4830,-240,1141273
8812,1740,2020-05-26,0.04500978473581213,5110,5340,230,1214244
8813,1740,2020-04-23,0.04681647940074907,5340,5590,250,3769298
8814,1740,2020-04-22,0.04296875,5120,5340,220,2466892
8815,1740,2020-04-07,0.04994686503719448,4705,4940,235,1909468
8816,1740,2020-03-24,0.05621621621621622,4625,4885,260,2459028
8817,1740,2020-03-20,0.1569115815691158,4015,4645,630,3015413
8818,1740,2020-03-19,0.12622415669205658,4595,4015,-580,3164024
8819,1740,2020-03-13,0.0560081466395112,4910,4635,-275,4142245
8820,1740,2020-03-09,0.05128205128205128,5460,5180,-280,3295439
8821,1740,2020-03-05,0.14465408805031446,4770,5460,690,18345648
8822,1740,2020-03-04,0.057649667405764965,4510,4770,260,1857250
8823,1740,2020-02-24,0.044372294372294376,4620,4415,-205,1909260
8824,1740,2019-11-22,0.04424778761061947,5650,5900,250,1538299
8825,1740,2019-11-15,0.04426229508196721,6100,5830,-270,2317910
8826,1740,2019-10-25,0.04283054003724395,5370,5600,230,2747952
8827,1740,2019-10-22,0.04365079365079365,5040,5260,220,1862152
8828,1740,2019-09-24,0.04936014625228519,5470,5740,270,3841396
8829,1740,2019-08-19,0.07959183673469387,4900,5290,390,1390479
8830,1740,2019-08-01,0.06613226452905811,4990,5320,330,2212705
8831,1740,2019-07-05,0.0425531914893617,5170,5390,220,1474197
8832,1740,2019-06-04,0.04449152542372881,4720,4930,210,1362165
8833,1740,2019-05-09,0.04121863799283154,5580,5350,-230,1957042
8834,1740,2019-05-07,0.044596912521440824,5830,5570,-260,1923560
8835,1740,2019-04-17,0.041990668740279936,6430,6160,-270,8537499
8836,1740,2019-04-16,0.07525083612040134,5980,6430,450,26520949
8837,1740,2019-04-10,0.04241435562805873,6130,5870,-260,3156857
8838,1740,2019-02-01,0.04384485666104553,5930,6190,260,3166502
8839,1740,2019-01-03,0.059845559845559844,5180,5490,310,4795141
8840,1740,2018-12-27,0.056112224448897796,4990,5270,280,1943731
8841,1740,2018-11-21,0.052127659574468084,4700,4945,245,2201264
8842,1740,2018-10-29,0.04756637168141593,4520,4305,-215,1154031
8843,1740,2018-10-11,0.0472972972972973,5180,4935,-245,2414513
8844,1740,2018-09-27,0.05182341650671785,5210,5480,270,4360064
8845,1740,2018-09-21,0.052525252525252523,4950,5210,260,2901312
8846,1740,2018-09-19,0.057692307692307696,5200,4900,-300,3135410
8847,1740,2018-09-05,0.05627705627705628,4620,4880,260,4341809
8848,1740,2018-07-30,0.040793825799338476,4535,4720,185,1105539
8849,1740,2018-07-12,0.05088495575221239,4520,4750,230,2293681
8850,1740,2018-06-01,0.04934541792547835,4965,5210,245,4349889
8851,1740,2018-05-03,0.08,5750,5290,-460,5853326
8852,1740,2017-09-26,0.040697674418604654,6880,7160,280,1758064
8853,1740,2017-08-11,0.04296296296296296,6750,7040,290,10611579
8854,1740,2017-08-08,0.0528,6250,6580,330,5135230
8855,1740,2017-05-10,0.04,7750,7440,-310,4038263
8856,1740,2017-05-08,0.04084158415841584,8080,7750,-330,2644568
8857,1740,2017-04-27,0.041025641025641026,7800,8120,320,2319490
8858,1740,2017-02-07,0.06465517241379311,6960,7410,450,4498536
8859,1740,2017-02-06,0.05454545454545454,6600,6960,360,1484999
8860,1740,2016-11-09,0.0469208211143695,6820,6500,-320,2086456
8861,1740,2016-09-29,0.06761006289308176,6360,6790,430,4831378
8862,720,2021-05-27,0.06427221172022685,52900,56300,3400,3790619
8863,720,2021-04-30,0.0718232044198895,54300,50400,-3900,2564460
8864,720,2021-03-12,0.05025125628140704,39800,41800,2000,945381
8865,720,2021-02-26,0.0421179302045728,41550,39800,-1750,1018432
8866,720,2021-02-01,0.08074534161490683,40250,43500,3250,1510418
8867,720,2021-01-29,0.0462085308056872,42200,40250,-1950,1721424
8868,720,2021-01-19,0.04878048780487805,43050,45150,2100,2158846
8869,720,2021-01-15,0.04357541899441341,44750,42800,-1950,1874022
8870,720,2021-01-11,0.07560975609756097,41000,44100,3100,6595915
8871,720,2021-01-05,0.048366013071895426,38250,40100,1850,4010166
8872,720,2020-12-10,0.042119565217391304,36800,38350,1550,4034397
8873,720,2020-12-04,0.04721030042918455,34950,36600,1650,3229954
8874,720,2020-11-30,0.042735042735042736,35100,33600,-1500,1448489
8875,720,2020-08-20,0.05014749262536873,33900,32200,-1700,1503859
8876,720,2020-08-18,0.05555555555555555,36000,34000,-2000,1387948
8877,720,2020-08-11,0.05805515239477504,34450,36450,2000,4053870
8878,720,2020-06-23,0.040502793296089384,35800,34350,-1450,2579502
8879,720,2020-06-22,0.07507507507507508,33300,35800,2500,11307283
8880,720,2020-06-16,0.06060606060606061,31350,33250,1900,753850
8881,720,2020-06-15,0.0752212389380531,33900,31350,-2550,996594
8882,720,2020-06-12,0.04507042253521127,35500,33900,-1600,945605
8883,720,2020-06-03,0.05420827389443652,35050,36950,1900,2749367
8884,720,2020-05-27,0.04296296296296296,33750,35200,1450,1613356
8885,720,2020-05-26,0.041666666666666664,32400,33750,1350,1434923
8886,720,2020-04-24,0.050359712230215826,34750,33000,-1750,1333616
8887,720,2020-04-14,0.0420032310177706,30950,32250,1300,1095785
8888,720,2020-04-09,0.05410122164048865,28650,30200,1550,1081463
8889,720,2020-04-06,0.040892193308550186,26900,28000,1100,1015865
8890,720,2020-04-02,0.06395348837209303,25800,27450,1650,1270336
8891,720,2020-04-01,0.060109289617486336,27450,25800,-1650,1102830
8892,720,2020-03-31,0.07647058823529412,25500,27450,1950,2999864
8893,720,2020-03-25,0.12072892938496584,21950,24600,2650,1902036
8894,720,2020-03-24,0.12276214833759591,19550,21950,2400,1297187
8895,720,2020-03-23,0.07783018867924528,21200,19550,-1650,1117661
8896,720,2020-03-20,0.09844559585492228,19300,21200,1900,1887135
8897,720,2020-03-19,0.1734475374732334,23350,19300,-4050,2750825
8898,720,2020-03-18,0.1053639846743295,26100,23350,-2750,1681585
8899,720,2020-03-16,0.04247787610619469,28250,27050,-1200,969795
8900,720,2020-03-13,0.04882154882154882,29700,28250,-1450,1808030
8901,720,2020-03-12,0.06456692913385827,31750,29700,-2050,1435817
8902,720,2020-03-09,0.0679886685552408,35300,32900,-2400,1167994
8903,720,2020-02-24,0.054570259208731244,36650,34650,-2000,921320
8904,720,2020-02-06,0.055771725032425425,38550,40700,2150,786307
8905,720,2020-01-28,0.04551045510455105,40650,38800,-1850,616097
8906,720,2020-01-13,0.04639175257731959,38800,40600,1800,890218
8907,720,2020-01-08,0.05163727959697733,39700,37650,-2050,1269380
8908,720,2019-10-07,0.0457516339869281,45900,43800,-2100,865675
8909,720,2019-09-25,0.04253112033195021,48200,46150,-2050,714347
8910,720,2019-09-16,0.06755260243632337,45150,48200,3050,1591498
8911,720,2019-09-10,0.05826397146254459,42050,44500,2450,1260933
8912,720,2019-08-05,0.0513126491646778,41900,39750,-2150,953283
8913,720,2019-07-09,0.050595238095238096,50400,47850,-2550,1035148
8914,720,2019-07-03,0.04735883424408015,54900,52300,-2600,628663
8915,720,2019-06-24,0.040740740740740744,54000,56200,2200,640543
8916,720,2019-05-15,0.061555075593952485,46300,49150,2850,789859
8917,720,2019-05-09,0.05128205128205128,50700,48100,-2600,953836
8918,720,2019-04-26,0.043052837573385516,51100,53300,2200,912207
8919,720,2019-03-29,0.05952380952380952,50400,53400,3000,1320678
8920,720,2019-03-04,0.050699300699300696,57200,54300,-2900,2350983
8921,720,2019-02-28,0.08038585209003216,62200,57200,-5000,1900149
8922,720,2018-12-27,0.040697674418604654,51600,53700,2100,826958
8923,720,2018-12-19,0.04280821917808219,58400,55900,-2500,1264834
8924,720,2018-12-03,0.04909090909090909,55000,57700,2700,1015875
8925,720,2018-11-19,0.04247104247104247,51800,54000,2200,965861
8926,720,2018-11-08,0.06583072100313479,47850,51000,3150,1462126
8927,720,2018-11-02,0.09899888765294772,44950,49400,4450,1453516
8928,720,2018-10-29,0.057569296375266525,46900,44200,-2700,1527749
8929,720,2018-10-26,0.04577822990844354,49150,46900,-2250,1842714
8930,720,2018-10-22,0.054249547920433995,55300,52300,-3000,1314999
8931,720,2018-10-11,0.0658578856152513,57700,53900,-3800,1918123
8932,720,2018-10-10,0.10542635658914729,64500,57700,-6800,2570789
8933,720,2018-10-05,0.040697674418604654,68800,66000,-2800,1233457
8934,720,2018-09-21,0.041666666666666664,64800,67500,2700,1811770
8935,720,2018-09-10,0.07849293563579278,63700,68700,5000,2340749
8936,720,2018-09-07,0.04597701149425287,60900,63700,2800,1495669
8937,720,2018-08-27,0.053208137715179966,63900,60500,-3400,1898985
8938,720,2018-08-13,0.05098684210526316,60800,57700,-3100,1891097
8939,720,2018-08-06,0.04194630872483222,59600,57100,-2500,917534
8940,720,2018-07-30,0.05,56000,58800,2800,1620963
8941,720,2018-07-24,0.078,50000,53900,3900,2951316
8942,720,2018-07-11,0.04222648752399232,52100,54300,2200,1898801
8943,720,2018-07-09,0.08093525179856115,55600,51100,-4500,2661263
8944,720,2018-07-06,0.047080979284369114,53100,55600,2500,1799602
8945,720,2018-07-02,0.06086956521739131,57500,54000,-3500,2079104
8946,720,2018-06-29,0.051188299817184646,54700,57500,2800,3064322
8947,720,2018-06-28,0.04203152364273205,57100,54700,-2400,2518686
8948,720,2018-06-27,0.054635761589403975,60400,57100,-3300,3387257
8949,720,2018-06-26,0.04126984126984127,63000,60400,-2600,2075554
8950,720,2018-06-19,0.04508856682769726,62100,59300,-2800,3215191
8951,720,2018-06-14,0.08620689655172414,69600,63600,-6000,5394396
8952,720,2018-06-11,0.07589285714285714,67200,72300,5100,4398104
8953,720,2018-06-05,0.048600883652430045,67900,71200,3300,4864801
8954,720,2018-06-01,0.05013550135501355,73800,70100,-3700,5274043
8955,720,2018-05-29,0.05436156763590392,79100,74800,-4300,10387106
8956,720,2018-05-28,0.2988505747126437,60900,79100,18200,16081258
8957,720,2018-05-25,0.09777777777777778,67500,60900,-6600,9601681
8958,720,2018-05-16,0.06351351351351352,74000,69300,-4700,9894362
8959,720,2018-05-14,0.13819875776397517,64400,73300,8900,13176579
8960,720,2018-05-08,0.042488619119878605,65900,63100,-2800,5749831
8961,720,2018-05-04,0.08032786885245902,61000,65900,4900,6159941
8962,720,2018-05-03,0.05132192846034215,64300,61000,-3300,5111377
8963,720,2018-04-30,0.2619047619047619,50400,63600,13200,12951733
8964,720,2018-04-19,0.12203389830508475,44250,49650,5400,5783159
8965,720,2018-04-18,0.09124537607891492,40550,44250,3700,2155198
8966,720,2018-04-02,0.04462242562929062,43700,41750,-1950,679599
8967,720,2018-03-28,0.040194884287454324,41050,42700,1650,1889448
8968,720,2018-03-23,0.04584882280049566,40350,38500,-1850,1088300
8969,720,2018-03-13,0.046964490263459335,43650,41600,-2050,1166353
8970,720,2018-03-09,0.08198757763975155,40250,43550,3300,2324322
8971,720,2018-02-19,0.05089058524173028,39300,41300,2000,708801
8972,720,2018-02-07,0.05202312138728324,43250,41000,-2250,669259
8973,720,2018-01-29,0.06862745098039216,40800,43600,2800,2549812
8974,720,2018-01-19,0.051248357424441525,38050,40000,1950,923212
8975,720,2018-01-10,0.053385416666666664,38400,40450,2050,2027187
8976,720,2018-01-04,0.045454545454545456,36300,37950,1650,1459930
8977,720,2017-12-14,0.0506155950752394,36550,34700,-1850,872312
8978,720,2017-12-13,0.05028735632183908,34800,36550,1750,927689
8979,720,2017-11-15,0.043882978723404256,37600,35950,-1650,1542754
8980,720,2017-11-07,0.07732634338138926,38150,41100,2950,1881153
8981,720,2017-10-30,0.04534005037783375,39700,37900,-1800,729378
8982,720,2017-10-12,0.06542056074766354,37450,39900,2450,1101121
8983,720,2017-08-03,0.06688963210702341,44850,41850,-3000,1039225
8984,720,2017-07-28,0.050411522633744855,48600,46150,-2450,802449
8985,720,2017-03-23,0.05122950819672131,48800,51300,2500,623680
8986,720,2017-02-01,0.06377858002406739,41550,44200,2650,970881
8987,720,2017-01-09,0.044548651817116064,42650,40750,-1900,853928
8988,720,2016-12-12,0.06503067484662577,40750,43400,2650,605038
8989,720,2016-12-01,0.04193138500635324,39350,41000,1650,885772
8990,720,2016-11-30,0.04141291108404385,41050,39350,-1700,752250
8991,720,2016-11-10,0.06715506715506715,40950,43700,2750,833803
8992,720,2016-10-26,0.04842342342342342,44400,42250,-2150,756670
8993,720,2016-10-11,0.0425273390036452,41150,42900,1750,1079128
8994,720,2016-09-12,0.05384615384615385,39000,36900,-2100,576657
8995,720,2016-08-05,0.042134831460674156,35600,37100,1500,750357
8996,210,2021-05-13,0.053714285714285714,87500,82800,-4700,795569
8997,210,2021-05-12,0.13366336633663367,101000,87500,-13500,1815244
8998,210,2021-05-06,0.05379746835443038,94800,99900,5100,350593
8999,210,2021-04-28,0.05402843601895735,105500,99800,-5700,363799
9000,210,2021-04-27,0.06030150753768844,99500,105500,6000,338801
9001,210,2021-04-26,0.04407135362014691,95300,99500,4200,245148
9002,210,2021-04-22,0.05064655172413793,92800,97500,4700,412194
9003,210,2021-04-14,0.051643192488262914,85200,89600,4400,484546
9004,210,2021-03-25,0.09234507897934387,82300,89900,7600,822376
9005,210,2021-03-19,0.045121951219512194,82000,85700,3700,649238
9006,210,2021-03-18,0.05128205128205128,78000,82000,4000,423729
9007,210,2021-03-10,0.046153846153846156,78000,74400,-3600,321320
9008,210,2021-03-02,0.04393063583815029,86500,82700,-3800,473172
9009,210,2021-02-25,0.041666666666666664,84000,87500,3500,337803
9010,210,2021-02-24,0.08196721311475409,91500,84000,-7500,633359
9011,210,2021-02-19,0.09688581314878893,86700,95100,8400,814206
9012,210,2021-02-05,0.05158264947245018,85300,89700,4400,761503
9013,210,2021-02-04,0.08939974457215837,78300,85300,7000,1543565
9014,210,2021-02-03,0.07554945054945054,72800,78300,5500,1272508
9015,210,2021-02-02,0.12345679012345678,64800,72800,8000,1246356
9016,210,2021-02-01,0.06229508196721312,61000,64800,3800,450046
9017,210,2021-01-29,0.04538341158059468,63900,61000,-2900,599000
9018,210,2021-01-27,0.052781740370898715,70100,66400,-3700,721475
9019,210,2021-01-26,0.06032171581769437,74600,70100,-4500,921840
9020,210,2020-12-28,0.06108597285067873,88400,83000,-5400,3832744
9021,210,2020-12-21,0.042363433667781496,89700,93500,3800,752190
9022,210,2020-12-18,0.05653710247349823,84900,89700,4800,851731
9023,210,2020-12-11,0.04910179640718563,83500,87600,4100,1473994
9024,210,2020-12-04,0.04668304668304668,81400,85200,3800,956510
9025,210,2020-11-30,0.0498812351543943,84200,80000,-4200,1051932
9026,210,2020-10-30,0.06474820143884892,83400,78000,-5400,773767
9027,210,2020-10-28,0.06396063960639606,81300,86500,5200,831170
9028,210,2020-10-15,0.06657963446475196,76600,81700,5100,511303
9029,210,2020-10-05,0.04392764857881137,77400,80800,3400,342808
9030,210,2020-09-11,0.0603448275862069,92800,87200,-5600,1487256
9031,210,2020-09-07,0.0638063806380638,90900,96700,5800,730832
9032,210,2020-09-01,0.08400460299194476,86900,94200,7300,790761
9033,210,2020-08-28,0.13486005089058525,78600,89200,10600,910007
9034,210,2020-08-20,0.041312272174969626,82300,78900,-3400,367866
9035,210,2020-08-18,0.051605504587155966,87200,82700,-4500,384080
9036,210,2020-08-04,0.042067307692307696,83200,86700,3500,807738
9037,210,2020-06-19,0.050119331742243436,83800,88000,4200,279486
9038,210,2020-06-16,0.05493133583021224,80100,84500,4400,193927
9039,210,2020-06-15,0.06425233644859812,85600,80100,-5500,308770
9040,210,2020-06-12,0.044642857142857144,89600,85600,-4000,311175
9041,210,2020-06-02,0.04843918191603875,92900,97400,4500,678204
9042,210,2020-05-29,0.07450523864959255,85900,92300,6400,1062582
9043,210,2020-05-26,0.04630788485607009,79900,83600,3700,623400
9044,210,2020-05-04,0.06129398410896708,88100,82700,-5400,515714
9045,210,2020-04-28,0.07239263803680981,81500,87400,5900,457174
9046,210,2020-04-22,0.04668304668304668,81400,85200,3800,524318
9047,210,2020-04-17,0.047936085219707054,75100,78700,3600,704930
9048,210,2020-04-02,0.15565345080763582,68100,78700,10600,2034731
9049,210,2020-04-01,0.07598371777476255,73700,68100,-5600,689291
9050,210,2020-03-31,0.10329341317365269,66800,73700,6900,958005
9051,210,2020-03-30,0.08972267536704731,61300,66800,5500,563525
9052,210,2020-03-25,0.05357142857142857,56000,59000,3000,451382
9053,210,2020-03-24,0.06666666666666667,52500,56000,3500,317211
9054,210,2020-03-23,0.07243816254416961,56600,52500,-4100,239989
9055,210,2020-03-20,0.15510204081632653,49000,56600,7600,305317
9056,210,2020-03-19,0.11070780399274047,55100,49000,-6100,559253
9057,210,2020-03-18,0.05811965811965812,58500,55100,-3400,322816
9058,210,2020-03-16,0.05063291139240506,63200,60000,-3200,237690
9059,210,2020-03-13,0.04387291981845688,66100,63200,-2900,453473
9060,210,2020-03-12,0.044797687861271675,69200,66100,-3100,388547
9061,210,2020-03-09,0.045205479452054796,73000,69700,-3300,287194
9062,210,2020-02-25,0.04526748971193416,72900,76200,3300,170857
9063,210,2020-02-24,0.04954367666232073,76700,72900,-3800,196480
9064,210,2020-01-06,0.04214123006833713,87800,84100,-3700,235620
9065,210,2019-11-21,0.04665959703075292,94300,89900,-4400,228862
9066,210,2019-10-23,0.042008196721311473,97600,93500,-4100,153037
9067,210,2019-10-10,0.041109969167523124,97300,93300,-4000,272190
9068,210,2019-08-22,0.04878048780487805,102500,97500,-5000,167469
9069,210,2019-08-21,0.042726347914547304,98300,102500,4200,239361
9070,210,2019-08-13,0.05331991951710262,99400,94100,-5300,141569
9071,210,2019-08-01,0.052132701421800945,105500,100000,-5500,264306
9072,210,2019-06-04,0.046296296296296294,108000,113000,5000,201268
9073,210,2019-06-03,0.043478260869565216,103500,108000,4500,143608
9074,210,2019-05-15,0.06471816283924843,95800,102000,6200,166373
9075,210,2019-01-30,0.04411764705882353,102000,106500,4500,227167
9076,210,2019-01-24,0.04477611940298507,100500,105000,4500,238453
9077,210,2019-01-02,0.05951219512195122,102500,96400,-6100,353937
9078,210,2018-12-13,0.04522613065326633,99500,104000,4500,334455
9079,210,2018-11-28,0.04535398230088496,90400,94500,4100,365752
9080,210,2018-11-02,0.050666666666666665,75000,78800,3800,274126
9081,210,2018-10-11,0.05798816568047337,84500,79600,-4900,258435
9082,210,2018-06-27,0.058240396530359353,80700,76000,-4700,424246
9083,210,2018-06-14,0.048693586698337295,84200,80100,-4100,386767
9084,210,2018-05-29,0.043478260869565216,89700,85800,-3900,313526
9085,210,2018-05-28,0.08202653799758745,82900,89700,6800,1047957
9086,210,2018-05-18,0.04642857142857143,84000,87900,3900,328564
9087,210,2018-05-16,0.05142857142857143,87500,83000,-4500,356063
9088,210,2018-05-14,0.05060240963855422,83000,87200,4200,657660
9089,210,2018-05-08,0.048752834467120185,88200,83900,-4300,461949
9090,210,2018-04-18,0.04342273307790549,78300,81700,3400,401387
9091,210,2018-04-12,0.05263157894736842,76000,80000,4000,820424
9092,210,2018-03-09,0.047954866008462625,70900,74300,3400,304109
9093,210,2018-01-26,0.09172259507829977,89400,81200,-8200,1701345
9094,210,2017-11-15,0.051222351571594875,85900,81500,-4400,448729
9095,210,2017-11-02,0.041916167664670656,83500,87000,3500,383103
9096,210,2017-05-25,0.05176470588235294,85000,89400,4400,608762
9097,210,2016-12-29,0.053204353083434096,82700,87100,4400,376919
9098,210,2016-11-09,0.06323185011709602,85400,80000,-5400,353359
9099,210,2016-10-26,0.04143337066069429,89300,85600,-3700,265602
9100,139480,2021-03-03,0.08504398826979472,170500,185000,14500,757744
9101,139480,2021-02-16,0.06179775280898876,178000,189000,11000,779943
9102,139480,2021-01-26,0.04904632152588556,183500,174500,-9000,644663
9103,139480,2021-01-25,0.05459770114942529,174000,183500,9500,438042
9104,139480,2021-01-12,0.05475504322766571,173500,183000,9500,1152248
9105,139480,2021-01-08,0.06231454005934718,168500,179000,10500,1152187
9106,139480,2021-01-07,0.08709677419354839,155000,168500,13500,1081746
9107,139480,2021-01-05,0.0429042904290429,151500,158000,6500,491848
9108,139480,2020-11-11,0.07641196013289037,150500,162000,11500,842419
9109,139480,2020-09-10,0.05434782608695652,138000,145500,7500,1288453
9110,139480,2020-09-07,0.04330708661417323,127000,132500,5500,552803
9111,139480,2020-09-01,0.05,120000,126000,6000,495842
9112,139480,2020-08-20,0.05179282868525897,125500,119000,-6500,431942
9113,139480,2020-08-18,0.05363984674329502,130500,123500,-7000,522691
9114,139480,2020-08-14,0.0653061224489796,122500,130500,8000,763902
9115,139480,2020-08-10,0.056768558951965066,114500,121000,6500,562619
9116,139480,2020-07-29,0.04054054054054054,111000,115500,4500,307984
9117,139480,2020-07-21,0.04424778761061947,113000,118000,5000,426375
9118,139480,2020-07-13,0.04128440366972477,109000,113500,4500,378812
9119,139480,2020-06-16,0.041666666666666664,108000,112500,4500,235594
9120,139480,2020-06-15,0.04424778761061947,113000,108000,-5000,296418
9121,139480,2020-04-27,0.10138248847926268,108500,119500,11000,675818
9122,139480,2020-04-06,0.07075471698113207,106000,113500,7500,336357
9123,139480,2020-04-02,0.04390243902439024,102500,107000,4500,173345
9124,139480,2020-03-24,0.05720122574055159,97900,103500,5600,207709
9125,139480,2020-03-23,0.06761904761904762,105000,97900,-7100,211971
9126,139480,2020-03-18,0.05069124423963134,108500,103000,-5500,233030
9127,139480,2020-03-13,0.05855855855855856,111000,104500,-6500,407709
9128,139480,2020-03-03,0.04205607476635514,107000,111500,4500,358858
9129,139480,2020-02-25,0.04229607250755287,99300,103500,4200,287811
9130,139480,2020-02-06,0.0410958904109589,109500,114000,4500,156863
9131,139480,2019-11-28,0.048582995951417005,123500,129500,6000,268323
9132,139480,2019-11-20,0.041666666666666664,132000,126500,-5500,261555
9133,139480,2019-11-14,0.05078125,128000,134500,6500,416170
9134,139480,2019-11-06,0.07296137339055794,116500,125000,8500,491170
9135,139480,2019-11-04,0.06167400881057269,113500,120500,7000,330153
9136,139480,2019-10-16,0.06521739130434782,115000,122500,7500,449999
9137,139480,2019-08-19,0.04245283018867924,106000,110500,4500,195369
9138,139480,2019-08-16,0.04504504504504504,111000,106000,-5000,278776
9139,139480,2019-08-13,0.06635071090047394,105500,112500,7000,750186
9140,139480,2019-07-18,0.04059040590405904,135500,130000,-5500,183786
9141,139480,2019-05-16,0.054838709677419356,155000,146500,-8500,388331
9142,139480,2019-04-08,0.052478134110787174,171500,180500,9000,335009
9143,139480,2019-02-01,0.0625,192000,180000,-12000,473212
9144,139480,2019-01-04,0.040214477211796246,186500,194000,7500,138010
9145,139480,2018-12-10,0.046753246753246755,192500,183500,-9000,167871
9146,139480,2018-11-12,0.04691358024691358,202500,193000,-9500,154063
9147,139480,2018-10-31,0.05141388174807198,194500,204500,10000,190614
9148,139480,2018-10-25,0.0405727923627685,209500,201000,-8500,93987
9149,139480,2018-10-05,0.04523809523809524,210000,219500,9500,200989
9150,139480,2018-09-28,0.0532994923857868,197000,207500,10500,313911
9151,139480,2018-08-28,0.04976303317535545,211000,221500,10500,206599
9152,139480,2018-07-12,0.07021276595744681,235000,218500,-16500,339363
9153,139480,2018-07-11,0.04081632653061224,245000,235000,-10000,108479
9154,139480,2018-05-18,0.046242774566473986,259500,271500,12000,140670
9155,139480,2018-05-10,0.05058365758754864,257000,270000,13000,147645
9156,139480,2018-03-12,0.060655737704918035,305000,286500,-18500,186601
9157,139480,2018-03-05,0.04326923076923077,312000,298500,-13500,108244
9158,139480,2018-02-23,0.04201680672268908,297500,310000,12500,111962
9159,139480,2018-02-19,0.045454545454545456,286000,299000,13000,116346
9160,139480,2018-01-26,0.150390625,256000,294500,38500,515536
9161,139480,2018-01-08,0.04826254826254826,259000,271500,12500,81519
9162,139480,2017-12-15,0.044444444444444446,270000,282000,12000,133110
9163,139480,2017-12-13,0.04798464491362764,260500,273000,12500,97798
9164,139480,2017-11-24,0.06288032454361055,246500,262000,15500,115686
9165,139480,2017-11-07,0.05191873589164785,221500,233000,11500,125750
9166,139480,2017-10-10,0.04316546762589928,208500,217500,9000,180355
9167,139480,2017-08-21,0.04310344827586207,232000,222000,-10000,150418
9168,139480,2017-06-27,0.04081632653061224,220500,229500,9000,162241
9169,139480,2017-05-08,0.05701754385964912,228000,241000,13000,77713
9170,139480,2017-04-12,0.04434589800443459,225500,235500,10000,142652
9171,139480,2017-04-07,0.05128205128205128,214500,225500,11000,215810
9172,139480,2017-03-24,0.04,200000,208000,8000,104742
9173,139480,2017-02-23,0.04116222760290557,206500,215000,8500,132289
9174,139480,2017-01-26,0.05,190000,199500,9500,244775
9175,139480,2017-01-05,0.04189944134078212,179000,186500,7500,90211
9176,139480,2016-11-08,0.07165109034267912,160500,172000,11500,377204
9177,6360,2021-05-12,0.05189189189189189,46250,43850,-2400,1404383
9178,6360,2021-04-30,0.056623931623931624,46800,44150,-2650,1429768
9179,6360,2021-04-08,0.06447831184056271,42650,45400,2750,4408925
9180,6360,2021-03-09,0.0453920220082531,36350,38000,1650,1279560
9181,6360,2021-02-04,0.047674418604651166,43000,40950,-2050,1980674
9182,6360,2021-02-01,0.09436435124508519,38150,41750,3600,1327909
9183,6360,2021-01-29,0.048628428927680795,40100,38150,-1950,1303011
9184,6360,2021-01-05,0.051248357424441525,38050,40000,1950,1920208
9185,6360,2020-12-30,0.057342657342657345,35750,37800,2050,1378490
9186,6360,2020-12-22,0.04183535762483131,37050,35500,-1550,917280
9187,6360,2020-12-10,0.08534850640113797,35150,38150,3000,2081867
9188,6360,2020-12-04,0.06677018633540373,32200,34350,2150,1718281
9189,6360,2020-11-11,0.04013377926421405,29900,31100,1200,968952
9190,6360,2020-11-09,0.0497335701598579,28150,29550,1400,916458
9191,6360,2020-11-02,0.04119850187265917,26700,27800,1100,472993
9192,6360,2020-10-29,0.043782837127845885,28550,27300,-1250,626704
9193,6360,2020-09-01,0.04251012145748988,24700,25750,1050,520847
9194,6360,2020-08-20,0.05343511450381679,26200,24800,-1400,801921
9195,6360,2020-08-18,0.05776173285198556,27700,26100,-1600,769250
9196,6360,2020-08-04,0.0660377358490566,26500,28250,1750,3501113
9197,6360,2020-07-15,0.040229885057471264,26100,27150,1050,869825
9198,6360,2020-06-25,0.04061895551257253,25850,24800,-1050,413373
9199,6360,2020-06-16,0.047337278106508875,25350,26550,1200,439340
9200,6360,2020-06-15,0.054104477611940295,26800,25350,-1450,522259
9201,6360,2020-05-26,0.12266112266112267,24050,27000,2950,2922611
9202,6360,2020-05-19,0.04612159329140461,23850,24950,1100,713762
9203,6360,2020-04-14,0.04415011037527594,22650,23650,1000,843169
9204,6360,2020-04-08,0.05811138014527845,20650,21850,1200,1069596
9205,6360,2020-04-06,0.04081632653061224,19600,20400,800,645128
9206,6360,2020-04-02,0.04699738903394256,19150,20050,900,833845
9207,6360,2020-04-01,0.06585365853658537,20500,19150,-1350,736565
9208,6360,2020-03-31,0.08179419525065963,18950,20500,1550,1394932
9209,6360,2020-03-25,0.07780979827089338,17350,18700,1350,890296
9210,6360,2020-03-24,0.09119496855345911,15900,17350,1450,781275
9211,6360,2020-03-23,0.1016949152542373,17700,15900,-1800,733315
9212,6360,2020-03-20,0.1760797342192691,15050,17700,2650,1108678
9213,6360,2020-03-19,0.14730878186968838,17650,15050,-2600,1851550
9214,6360,2020-03-18,0.10406091370558376,19700,17650,-2050,755478
9215,6360,2020-03-13,0.06320541760722348,22150,20750,-1400,1525797
9216,6360,2020-03-12,0.08091286307053942,24100,22150,-1950,1149867
9217,6360,2020-03-09,0.0762081784386617,26900,24850,-2050,914767
9218,6360,2020-02-24,0.044722719141323794,27950,26700,-1250,706434
9219,6360,2020-02-06,0.05025996533795494,28850,30300,1450,530131
9220,6360,2020-01-28,0.041254125412541254,30300,29050,-1250,371547
9221,6360,2020-01-08,0.0547008547008547,29250,27650,-1600,913844
9222,6360,2019-11-15,0.0464,31250,32700,1450,440805
9223,6360,2019-08-13,0.05421686746987952,33200,31400,-1800,591828
9224,6360,2019-08-08,0.043548387096774194,31000,32350,1350,490484
9225,6360,2019-07-09,0.06068601583113457,37900,35600,-2300,1021937
9226,6360,2019-05-09,0.04714640198511166,40300,38400,-1900,470394
9227,6360,2019-03-29,0.040293040293040296,40950,42600,1650,537515
9228,6360,2019-03-15,0.05314009661835749,41400,43600,2200,929803
9229,6360,2018-12-27,0.049528301886792456,42400,44500,2100,707136
9230,6360,2018-12-13,0.06877113866967305,44350,47400,3050,925143
9231,6360,2018-11-22,0.04141291108404385,41050,39350,-1700,989048
9232,6360,2018-11-14,0.04470588235294118,42500,40600,-1900,929325
9233,6360,2018-11-02,0.06965174129353234,40200,43000,2800,895115
9234,6360,2018-10-24,0.07892004153686397,48150,44350,-3800,1931892
9235,6360,2018-10-11,0.0436046511627907,51600,49350,-2250,1186200
9236,6360,2018-10-01,0.04206500956022945,52300,54500,2200,1001216
9237,6360,2018-09-10,0.05263157894736842,49400,52000,2600,1299871
9238,6360,2018-08-23,0.04338394793926247,46100,48100,2000,969472
9239,6360,2018-07-26,0.09473684210526316,47500,43000,-4500,3169657
9240,6360,2018-07-24,0.05909090909090909,44000,46600,2600,833890
9241,6360,2018-07-18,0.05399568034557235,46300,43800,-2500,893032
9242,6360,2018-07-13,0.04793756967670011,44850,47000,2150,686671
9243,6360,2018-07-06,0.051991150442477874,45200,47550,2350,650845
9244,6360,2018-07-02,0.05,46000,43700,-2300,723279
9245,6360,2018-06-27,0.045501551189245086,48350,46150,-2200,919448
9246,6360,2018-06-22,0.04719101123595506,44500,46600,2100,1013222
9247,6360,2018-06-20,0.05509964830011723,42650,45000,2350,976968
9248,6360,2018-06-05,0.04741379310344827,46400,48600,2200,833973
9249,6360,2018-05-29,0.07073643410852713,51600,47950,-3650,1726808
9250,6360,2018-05-28,0.12418300653594772,45900,51600,5700,4391058
9251,6360,2018-05-16,0.05526036131774708,47050,44450,-2600,1533025
9252,6360,2018-05-14,0.07224770642201835,43600,46750,3150,2085396
9253,6360,2018-05-10,0.043795620437956206,41100,42900,1800,1086659
9254,6360,2018-05-04,0.05328376703841388,40350,42500,2150,1368509
9255,6360,2018-04-30,0.08222811671087533,37700,40800,3100,3417632
9256,6360,2018-04-19,0.0453257790368272,35300,36900,1600,1718011
9257,6360,2018-04-18,0.04283604135893648,33850,35300,1450,1201400
9258,6360,2018-04-09,0.14991482112436116,29350,33750,4400,5072323
9259,6360,2018-03-23,0.041379310344827586,29000,27800,-1200,516224
9260,6360,2018-02-07,0.046948356807511735,31950,30450,-1500,641802
9261,6360,2018-01-30,0.04126984126984127,31500,32800,1300,2113250
9262,6360,2018-01-19,0.05317324185248713,29150,30700,1550,927324
9263,6360,2018-01-04,0.05830388692579505,28300,29950,1650,1360644
9264,6360,2017-12-13,0.0450281425891182,26650,27850,1200,553102
9265,6360,2017-12-05,0.05128205128205128,27300,28700,1400,1361967
9266,6360,2017-11-07,0.048327137546468404,26900,28200,1300,1468416
9267,6360,2017-09-26,0.05714285714285714,26250,27750,1500,749380
9268,6360,2017-09-19,0.04744525547445255,27400,28700,1300,606413
9269,6360,2017-08-03,0.059654631083202514,31850,29950,-1900,1494518
9270,6360,2017-05-25,0.056910569105691054,30750,32500,1750,1590793
9271,6360,2017-05-04,0.040453074433656956,30900,29650,-1250,1960881
9272,6360,2017-04-05,0.053691275167785234,29800,31400,1600,630378
9273,6360,2017-03-07,0.0453781512605042,29750,31100,1350,969810
9274,6360,2017-01-26,0.0789980732177264,25950,28000,2050,1254846
9275,6360,2016-12-12,0.04627766599597585,24850,26000,1150,510796
9276,6360,2016-11-25,0.04483430799220273,25650,24500,-1150,1208447
9277,6360,2016-11-16,0.04182509505703422,26300,27400,1100,571227
9278,6360,2016-11-09,0.04419889502762431,27150,25950,-1200,861013
9279,6360,2016-10-26,0.049586776859504134,30250,28750,-1500,705403
9280,6360,2016-10-17,0.04,30000,28800,-1200,535742
9281,6360,2016-09-12,0.04513888888888889,28800,27500,-1300,462693
9282,6360,2016-08-19,0.047619047619047616,29400,30800,1400,1225223
9283,36570,2021-05-10,0.05783132530120482,830000,878000,48000,257577
9284,36570,2021-03-29,0.07126948775055679,898000,834000,-64000,343144
9285,36570,2021-02-25,0.04068522483940043,934000,972000,38000,95195
9286,36570,2021-02-22,0.06619859578736209,997000,931000,-66000,216700
9287,36570,2021-02-08,0.06352459016393443,976000,1038000,62000,239999
9288,36570,2021-02-04,0.04563492063492063,1008000,962000,-46000,138692
9289,36570,2021-01-26,0.04221105527638191,995000,953000,-42000,127191
9290,36570,2021-01-08,0.050686378035902854,947000,995000,48000,198693
9291,36570,2021-01-04,0.050483351235230935,931000,978000,47000,151790
9292,36570,2020-12-01,0.05185185185185185,810000,852000,42000,193153
9293,36570,2020-11-10,0.05568720379146919,844000,797000,-47000,172812
9294,36570,2020-11-04,0.07033248081841433,782000,837000,55000,197108
9295,36570,2020-10-30,0.04551045510455105,813000,776000,-37000,92285
9296,36570,2020-09-10,0.0493046776232617,791000,830000,39000,172103
9297,36570,2020-08-27,0.0550122249388753,818000,863000,45000,232351
9298,36570,2020-08-21,0.05108556832694764,783000,823000,40000,158623
9299,36570,2020-08-20,0.06896551724137931,841000,783000,-58000,271930
9300,36570,2020-08-18,0.04357798165137615,872000,834000,-38000,170816
9301,36570,2020-08-13,0.05529411764705883,850000,897000,47000,363276
9302,36570,2020-08-03,0.040690505548705305,811000,844000,33000,152000
9303,36570,2020-07-23,0.05807200929152149,861000,811000,-50000,339183
9304,36570,2020-07-16,0.052801724137931036,928000,879000,-49000,199187
9305,36570,2020-07-06,0.05402542372881356,944000,995000,51000,138049
9306,36570,2020-07-02,0.07950727883538634,893000,964000,71000,220292
9307,36570,2020-06-16,0.08024691358024691,810000,875000,65000,149986
9308,36570,2020-05-21,0.056,750000,792000,42000,208754
9309,36570,2020-05-14,0.044382801664355064,721000,753000,32000,214951
9310,36570,2020-05-12,0.06866952789699571,699000,747000,48000,344771
9311,36570,2020-05-08,0.05108359133126935,646000,679000,33000,194176
9312,36570,2020-04-22,0.05451713395638629,642000,677000,35000,139859
9313,36570,2020-04-06,0.04791344667697063,647000,678000,31000,97158
9314,36570,2020-04-02,0.061488673139158574,618000,656000,38000,148473
9315,36570,2020-04-01,0.05214723926380368,652000,618000,-34000,123474
9316,36570,2020-03-31,0.04487179487179487,624000,652000,28000,193212
9317,36570,2020-03-24,0.1346153846153846,572000,649000,77000,236136
9318,36570,2020-03-20,0.06981132075471698,530000,567000,37000,236382
9319,36570,2020-03-19,0.07017543859649122,570000,530000,-40000,400206
9320,36570,2020-03-16,0.0717628705148206,641000,595000,-46000,201806
9321,36570,2020-03-04,0.060382916053019146,679000,720000,41000,156369
9322,36570,2020-02-19,0.04885496183206107,655000,687000,32000,140128
9323,36570,2020-02-14,0.04451510333863275,629000,657000,28000,157977
9324,36570,2020-01-03,0.04436229205175601,541000,565000,24000,112404
9325,36570,2019-12-06,0.07370517928286853,502000,539000,37000,199337
9326,36570,2019-11-15,0.043726235741444866,526000,549000,23000,90461
9327,36570,2019-11-01,0.04263565891472868,516000,538000,22000,79749
9328,36570,2019-08-01,0.04257528556593977,481500,502000,20500,101832
9329,36570,2019-03-28,0.04075235109717868,478500,498000,19500,130105
9330,36570,2019-02-12,0.041988950276243095,452500,433500,-19000,313420
9331,36570,2018-12-17,0.04,500000,480000,-20000,99691
9332,36570,2018-11-28,0.041237113402061855,485000,505000,20000,204294
9333,36570,2018-11-26,0.04008438818565401,474000,493000,19000,137824
9334,36570,2018-10-30,0.04084158415841584,404000,420500,16500,134531
9335,36570,2018-10-02,0.06923076923076923,455000,423500,-31500,220739
9336,36570,2018-09-04,0.05317769130998703,385500,406000,20500,148337
9337,36570,2018-08-14,0.08146067415730338,356000,385000,29000,244138
9338,36570,2018-06-28,0.0488771466314399,378500,360000,-18500,119217
9339,36570,2018-05-15,0.05522388059701493,335000,353500,18500,240218
9340,36570,2018-05-11,0.04178674351585014,347000,332500,-14500,457226
9341,36570,2018-05-09,0.04824561403508772,342000,358500,16500,136092
9342,36570,2018-02-28,0.044585987261146494,392500,375000,-17500,260471
9343,36570,2018-02-09,0.05889570552147239,407500,383500,-24000,192589
9344,36570,2018-02-05,0.04104903078677309,438500,420500,-18000,147065
9345,36570,2018-01-26,0.0564042303172738,425500,449500,24000,331267
9346,36570,2017-12-27,0.04079254079254079,429000,446500,17500,124365
9347,36570,2017-12-20,0.056338028169014086,461500,435500,-26000,387985
9348,36570,2017-12-13,0.04721030042918455,466000,488000,22000,393983
9349,36570,2017-11-30,0.05621621621621622,462500,436500,-26000,309466
9350,36570,2017-11-21,0.05203619909502263,442000,465000,23000,458836
9351,36570,2017-11-16,0.05048076923076923,416000,437000,21000,377982
9352,36570,2017-11-09,0.06858407079646017,452000,421000,-31000,1059233
9353,36570,2017-10-31,0.05308641975308642,405000,426500,21500,296521
9354,36570,2017-10-30,0.04028436018957346,422000,405000,-17000,401475
9355,36570,2017-10-19,0.06497797356828194,454000,424500,-29500,325330
9356,36570,2017-10-10,0.0581270182992465,464500,437500,-27000,434789
9357,36570,2017-09-07,0.05694760820045558,439000,464000,25000,609603
9358,36570,2017-09-06,0.05783132530120482,415000,439000,24000,480874
9359,36570,2017-07-20,0.07212205270457697,360500,386500,26000,494831
9360,36570,2017-07-10,0.04298356510745891,395500,378500,-17000,504924
9361,36570,2017-07-06,0.04247104247104247,388500,405000,16500,749146
9362,36570,2017-06-29,0.04702627939142462,361500,378500,17000,622353
9363,36570,2017-06-28,0.06347150259067358,386000,361500,-24500,864760
9364,36570,2017-06-23,0.11781609195402298,348000,389000,41000,1569094
9365,36570,2017-06-22,0.04657534246575343,365000,348000,-17000,1853507
9366,36570,2017-06-20,0.11411042944785275,407500,361000,-46500,1104285
9367,36570,2017-05-17,0.044630404463040445,358500,374500,16000,381194
9368,36570,2017-05-12,0.04619565217391304,368000,351000,-17000,454470
9369,36570,2017-04-13,0.06222222222222222,337500,358500,21000,616917
9370,36570,2017-04-12,0.056338028169014086,319500,337500,18000,349162
9371,36570,2017-03-29,0.05181347150259067,289500,304500,15000,362242
9372,36570,2017-02-27,0.06666666666666667,300000,280000,-20000,331502
9373,36570,2017-02-07,0.04746835443037975,316000,301000,-15000,510053
9374,36570,2017-01-20,0.04666666666666667,300000,314000,14000,271677
9375,36570,2017-01-19,0.04712041884816754,286500,300000,13500,550008
9376,36570,2017-01-03,0.04435483870967742,248000,259000,11000,160386
9377,36570,2016-12-23,0.04770992366412214,262000,249500,-12500,205021
9378,36570,2016-12-09,0.11009174311926606,218000,242000,24000,503100
9379,36570,2016-12-08,0.09730848861283643,241500,218000,-23500,421158
9380,36570,2016-12-01,0.09926470588235294,272000,245000,-27000,443257
9381,36570,2016-11-25,0.04970178926441352,251500,264000,12500,145749
9382,36570,2016-11-11,0.06043956043956044,273000,256500,-16500,219777
9383,282330,2021-05-10,0.06626506024096386,166000,177000,11000,122935
9384,282330,2021-03-03,0.0660377358490566,159000,169500,10500,59126
9385,282330,2021-02-24,0.042042042042042045,166500,159500,-7000,45652
9386,282330,2021-02-17,0.045845272206303724,174500,166500,-8000,43092
9387,282330,2021-02-15,0.04105571847507331,170500,177500,7000,182653
9388,282330,2021-01-28,0.04430379746835443,158000,165000,7000,91596
9389,282330,2021-01-21,0.061224489795918366,147000,156000,9000,143118
9390,282330,2021-01-15,0.0429042904290429,151500,145000,-6500,75654
9391,282330,2021-01-13,0.0498220640569395,140500,147500,7000,135734
9392,282330,2020-11-11,0.06818181818181818,132000,141000,9000,132622
9393,282330,2020-10-19,0.04918032786885246,122000,128000,6000,123078
9394,282330,2020-08-31,0.04938271604938271,121500,127500,6000,101675
9395,282330,2020-07-10,0.04428044280442804,135500,129500,-6000,54173
9396,282330,2020-06-15,0.04878048780487805,143500,136500,-7000,48751
9397,282330,2020-06-12,0.04013377926421405,149500,143500,-6000,53698
9398,282330,2020-05-29,0.07395498392282958,155500,167000,11500,74107
9399,282330,2020-05-08,0.06230529595015576,160500,150500,-10000,162984
9400,282330,2020-04-27,0.06734006734006734,148500,158500,10000,137872
9401,282330,2020-04-14,0.0539568345323741,139000,146500,7500,33157
9402,282330,2020-04-13,0.060810810810810814,148000,139000,-9000,32134
9403,282330,2020-04-06,0.1111111111111111,130500,145000,14500,45854
9404,282330,2020-03-31,0.09090909090909091,121000,132000,11000,96353
9405,282330,2020-03-24,0.05172413793103448,116000,122000,6000,59289
9406,282330,2020-03-23,0.04526748971193416,121500,116000,-5500,37483
9407,282330,2020-03-20,0.11467889908256881,109000,121500,12500,45758
9408,282330,2020-03-19,0.09166666666666666,120000,109000,-11000,55754
9409,282330,2020-03-18,0.06976744186046512,129000,120000,-9000,48304
9410,282330,2020-03-13,0.04225352112676056,142000,136000,-6000,57520
9411,282330,2020-03-12,0.05016722408026756,149500,142000,-7500,49431
9412,282330,2019-11-04,0.04178272980501393,179500,187000,7500,35995
9413,282330,2019-08-09,0.04449648711943794,213500,204000,-9500,26166
9414,282330,2019-08-01,0.05378973105134474,204500,215500,11000,39856
9415,282330,2019-07-22,0.040865384615384616,208000,199500,-8500,21991
9416,282330,2019-06-27,0.06443298969072164,194000,206500,12500,39225
9417,282330,2019-06-14,0.046511627906976744,193500,202500,9000,41135
9418,282330,2019-06-10,0.04,187500,195000,7500,31441
9419,282330,2019-05-29,0.04987531172069826,200500,190500,-10000,27869
9420,282330,2019-02-25,0.04807692307692308,208000,218000,10000,24912
9421,282330,2019-02-20,0.05384615384615385,195000,205500,10500,37485
9422,282330,2019-02-13,0.05390835579514825,185500,195500,10000,67670
9423,282330,2019-01-10,0.09330143540669857,209000,189500,-19500,69556
9424,282330,2018-12-19,0.04455445544554455,202000,211000,9000,28040
9425,282330,2018-11-26,0.04918032786885246,183000,192000,9000,26642
9426,282330,2018-11-22,0.04120879120879121,182000,189500,7500,29132
9427,282330,2018-11-19,0.0471976401179941,169500,177500,8000,17531
9428,282330,2018-10-31,0.04261363636363636,176000,168500,-7500,87537
9429,282330,2018-10-26,0.04851752021563342,185500,176500,-9000,26371
9430,282330,2018-10-25,0.05597964376590331,196500,185500,-11000,27397
9431,282330,2018-10-10,0.04477611940298507,201000,210000,9000,41465
9432,282330,2018-10-01,0.051094890510948905,205500,195000,-10500,27749
9433,282330,2018-09-27,0.05721393034825871,201000,212500,11500,50760
9434,282330,2018-09-10,0.05234159779614325,181500,191000,9500,52077
9435,282330,2018-09-07,0.05217391304347826,172500,181500,9000,26900
9436,282330,2018-08-28,0.08108108108108109,166500,180000,13500,58210
9437,282330,2018-08-27,0.04716981132075472,159000,166500,7500,26875
9438,282330,2018-07-24,0.046511627906976744,150500,157500,7000,60120
9439,282330,2018-07-20,0.059748427672955975,159000,149500,-9500,119967
9440,282330,2018-07-18,0.041176470588235294,170000,163000,-7000,74839
9441,282330,2018-07-16,0.07799442896935933,179500,165500,-14000,223889
9442,282330,2018-07-03,0.04533333333333334,187500,179000,-8500,38610
9443,282330,2018-06-28,0.04509283819628647,188500,197000,8500,57752
9444,282330,2018-06-27,0.04314720812182741,197000,188500,-8500,36398
9445,282330,2018-06-20,0.06220095693779904,209000,196000,-13000,57442
9446,282330,2018-06-18,0.04415584415584416,192500,201000,8500,44563
9447,282330,2018-06-12,0.04092071611253197,195500,203500,8000,39578
9448,282330,2018-06-07,0.06027397260273973,182500,193500,11000,53852
9449,282330,2018-05-24,0.0446927374301676,179000,187000,8000,35877
9450,282330,2018-05-02,0.08115183246073299,191000,206500,15500,121961
9451,282330,2018-04-30,0.0670391061452514,179000,191000,12000,95325
9452,282330,2018-04-23,0.05367231638418079,177000,186500,9500,49545
9453,282330,2018-04-10,0.045576407506702415,186500,178000,-8500,39175
9454,282330,2018-04-09,0.06876790830945559,174500,186500,12000,42051
9455,282330,2018-04-03,0.05604719764011799,169500,179000,9500,106031
9456,282330,2018-03-30,0.10819672131147541,152500,169000,16500,64701
9457,282330,2018-02-22,0.0481283422459893,187000,178000,-9000,56556
9458,282330,2018-02-14,0.06030150753768844,199000,187000,-12000,143124
9459,282330,2018-02-13,0.05463182897862233,210500,199000,-11500,41843
9460,282330,2018-01-30,0.04185022026431718,227000,217500,-9500,32415
9461,282330,2017-12-19,0.046218487394957986,238000,227000,-11000,37388
9462,282330,2017-12-12,0.05432595573440644,248500,235000,-13500,286513
9463,282330,2017-12-11,0.2809278350515464,194000,248500,54500,684631
9464,282330,2017-12-08,0.1869747899159664,238000,194000,-44000,68343
9465,282330,2017-12-12,0.05432595573440644,248500,235000,-13500,286513
9466,282330,2017-12-11,0.2809278350515464,194000,248500,54500,684631
9467,282330,2017-12-08,0.1869747899159664,238000,194000,-44000,68343
9468,282330,2017-12-12,0.05432595573440644,248500,235000,-13500,286513
9469,282330,2017-12-11,0.2809278350515464,194000,248500,54500,684631
9470,282330,2017-12-08,0.1869747899159664,238000,194000,-44000,68343
9471,282330,2017-12-12,0.05432595573440644,248500,235000,-13500,286513
9472,282330,2017-12-11,0.2809278350515464,194000,248500,54500,684631
9473,282330,2017-12-08,0.1869747899159664,238000,194000,-44000,68343
9474,282330,2017-12-12,0.05432595573440644,248500,235000,-13500,286513
9475,282330,2017-12-11,0.2809278350515464,194000,248500,54500,684631
9476,282330,2017-12-08,0.1869747899159664,238000,194000,-44000,68343
9477,282330,2017-12-12,0.05432595573440644,248500,235000,-13500,286513
9478,282330,2017-12-11,0.2809278350515464,194000,248500,54500,684631
9479,282330,2017-12-08,0.1869747899159664,238000,194000,-44000,68343
9480,282330,2017-12-12,0.05432595573440644,248500,235000,-13500,286513
9481,282330,2017-12-11,0.2809278350515464,194000,248500,54500,684631
9482,282330,2017-12-08,0.1869747899159664,238000,194000,-44000,68343
9483,282330,2017-12-12,0.05432595573440644,248500,235000,-13500,286513
9484,282330,2017-12-11,0.2809278350515464,194000,248500,54500,684631
9485,282330,2017-12-08,0.1869747899159664,238000,194000,-44000,68343
9486,282330,2017-12-12,0.05432595573440644,248500,235000,-13500,286513
9487,282330,2017-12-11,0.2809278350515464,194000,248500,54500,684631
9488,282330,2017-12-08,0.1869747899159664,238000,194000,-44000,68343
9489,282330,2017-12-12,0.05432595573440644,248500,235000,-13500,286513
9490,282330,2017-12-11,0.2809278350515464,194000,248500,54500,684631
9491,282330,2017-12-08,0.1869747899159664,238000,194000,-44000,68343
9492,282330,2017-12-12,0.05432595573440644,248500,235000,-13500,286513
9493,282330,2017-12-11,0.2809278350515464,194000,248500,54500,684631
9494,282330,2017-12-08,0.1869747899159664,238000,194000,-44000,68343
9495,282330,2017-12-12,0.05432595573440644,248500,235000,-13500,286513
9496,282330,2017-12-11,0.2809278350515464,194000,248500,54500,684631
9497,282330,2017-12-08,0.1869747899159664,238000,194000,-44000,68343
9498,282330,2017-12-12,0.05432595573440644,248500,235000,-13500,286513
9499,282330,2017-12-11,0.2809278350515464,194000,248500,54500,684631
9500,282330,2017-12-08,0.1869747899159664,238000,194000,-44000,68343
9501,282330,2017-12-12,0.05432595573440644,248500,235000,-13500,286513
9502,282330,2017-12-11,0.2809278350515464,194000,248500,54500,684631
9503,282330,2017-12-08,0.1869747899159664,238000,194000,-44000,68343
9504,282330,2017-12-12,0.05432595573440644,248500,235000,-13500,286513
9505,282330,2017-12-11,0.2809278350515464,194000,248500,54500,684631
9506,282330,2017-12-08,0.1869747899159664,238000,194000,-44000,68343
9507,282330,2017-12-12,0.05432595573440644,248500,235000,-13500,286513
9508,282330,2017-12-11,0.2809278350515464,194000,248500,54500,684631
9509,282330,2017-12-08,0.1869747899159664,238000,194000,-44000,68343
9510,282330,2017-12-12,0.05432595573440644,248500,235000,-13500,286513
9511,282330,2017-12-11,0.2809278350515464,194000,248500,54500,684631
9512,282330,2017-12-08,0.1869747899159664,238000,194000,-44000,68343
9513,282330,2017-12-12,0.05432595573440644,248500,235000,-13500,286513
9514,282330,2017-12-11,0.2809278350515464,194000,248500,54500,684631
9515,282330,2017-12-08,0.1869747899159664,238000,194000,-44000,68343
9516,282330,2017-12-12,0.05432595573440644,248500,235000,-13500,286513
9517,282330,2017-12-11,0.2809278350515464,194000,248500,54500,684631
9518,282330,2017-12-08,0.1869747899159664,238000,194000,-44000,68343
9519,282330,2017-12-12,0.05432595573440644,248500,235000,-13500,286513
9520,282330,2017-12-11,0.2809278350515464,194000,248500,54500,684631
9521,282330,2017-12-08,0.1869747899159664,238000,194000,-44000,68343
9522,282330,2017-12-12,0.05432595573440644,248500,235000,-13500,286513
9523,282330,2017-12-11,0.2809278350515464,194000,248500,54500,684631
9524,282330,2017-12-08,0.1869747899159664,238000,194000,-44000,68343
9525,282330,2017-12-12,0.05432595573440644,248500,235000,-13500,286513
9526,282330,2017-12-11,0.2809278350515464,194000,248500,54500,684631
9527,282330,2017-12-08,0.1869747899159664,238000,194000,-44000,68343
9528,282330,2017-12-12,0.05432595573440644,248500,235000,-13500,286513
9529,282330,2017-12-11,0.2809278350515464,194000,248500,54500,684631
9530,282330,2017-12-08,0.1869747899159664,238000,194000,-44000,68343
9531,282330,2017-12-12,0.05432595573440644,248500,235000,-13500,286513
9532,282330,2017-12-11,0.2809278350515464,194000,248500,54500,684631
9533,282330,2017-12-08,0.1869747899159664,238000,194000,-44000,68343
9534,282330,2017-12-12,0.05432595573440644,248500,235000,-13500,286513
9535,282330,2017-12-11,0.2809278350515464,194000,248500,54500,684631
9536,282330,2017-12-08,0.1869747899159664,238000,194000,-44000,68343
9537,282330,2017-12-12,0.05432595573440644,248500,235000,-13500,286513
9538,282330,2017-12-11,0.2809278350515464,194000,248500,54500,684631
9539,282330,2017-12-08,0.1869747899159664,238000,194000,-44000,68343
9540,282330,2017-12-12,0.05432595573440644,248500,235000,-13500,286513
9541,282330,2017-12-11,0.2809278350515464,194000,248500,54500,684631
9542,282330,2017-12-08,0.1869747899159664,238000,194000,-44000,68343
9543,282330,2017-12-12,0.05432595573440644,248500,235000,-13500,286513
9544,282330,2017-12-11,0.2809278350515464,194000,248500,54500,684631
9545,282330,2017-12-08,0.1869747899159664,238000,194000,-44000,68343
9546,282330,2017-12-12,0.05432595573440644,248500,235000,-13500,286513
9547,282330,2017-12-11,0.2809278350515464,194000,248500,54500,684631
9548,282330,2017-12-08,0.1869747899159664,238000,194000,-44000,68343
9549,282330,2017-12-12,0.05432595573440644,248500,235000,-13500,286513
9550,282330,2017-12-11,0.2809278350515464,194000,248500,54500,684631
9551,282330,2017-12-08,0.1869747899159664,238000,194000,-44000,68343
9552,282330,2017-12-12,0.05432595573440644,248500,235000,-13500,286513
9553,282330,2017-12-11,0.2809278350515464,194000,248500,54500,684631
9554,282330,2017-12-08,0.1869747899159664,238000,194000,-44000,68343
9555,282330,2017-12-12,0.05432595573440644,248500,235000,-13500,286513
9556,282330,2017-12-11,0.2809278350515464,194000,248500,54500,684631
9557,282330,2017-12-08,0.1869747899159664,238000,194000,-44000,68343
9558,282330,2017-12-12,0.05432595573440644,248500,235000,-13500,286513
9559,282330,2017-12-11,0.2809278350515464,194000,248500,54500,684631
9560,282330,2017-12-08,0.1869747899159664,238000,194000,-44000,68343
9561,282330,2017-12-12,0.05432595573440644,248500,235000,-13500,286513
9562,282330,2017-12-11,0.2809278350515464,194000,248500,54500,684631
9563,5850,2021-05-31,0.0641025641025641,31200,33200,2000,888939
9564,5850,2021-05-26,0.049689440993788817,32200,30600,-1600,669915
9565,5850,2021-05-25,0.042071197411003236,30900,32200,1300,977739
9566,5850,2021-05-20,0.04713804713804714,29700,31100,1400,1532448
9567,5850,2021-05-18,0.127134724857685,26350,29700,3350,2401012
9568,5850,2021-05-13,0.05291005291005291,28350,26850,-1500,700085
9569,5850,2021-05-12,0.07590132827324478,26350,28350,2000,1641430
9570,5850,2021-05-10,0.04242424242424243,24750,25800,1050,524463
9571,5850,2021-04-27,0.044715447154471545,24600,23500,-1100,401089
9572,5850,2021-04-02,0.06053811659192825,22300,23650,1350,697236
9573,5850,2021-03-23,0.051440329218107,24300,23050,-1250,262483
9574,5850,2021-03-18,0.04525862068965517,23200,24250,1050,645662
9575,5850,2021-03-11,0.09324009324009325,21450,23450,2000,360624
9576,5850,2021-03-08,0.04086021505376344,23250,22300,-950,164357
9577,5850,2021-02-24,0.06611570247933884,24200,22600,-1600,324584
9578,5850,2021-02-23,0.056768558951965066,22900,24200,1300,443803
9579,5850,2021-02-16,0.048355899419729204,25850,24600,-1250,496783
9580,5850,2021-02-08,0.09314586994727592,28450,25800,-2650,818000
9581,5850,2021-02-01,0.15384615384615385,24700,28500,3800,1423004
9582,5850,2021-01-29,0.04448742746615087,25850,24700,-1150,568684
9583,5850,2021-01-21,0.18101545253863136,22650,26750,4100,6262225
9584,5850,2021-01-19,0.29014084507042254,17750,22900,5150,6408068
9585,5850,2021-01-08,0.15337423312883436,16300,18800,2500,3611122
9586,5850,2020-11-17,0.04516129032258064,15500,16200,700,656828
9587,5850,2020-10-06,0.057432432432432436,14800,15650,850,1601743
9588,5850,2020-10-05,0.045936395759717315,14150,14800,650,1910632
9589,5850,2020-09-29,0.09266409266409266,12950,14150,1200,2246104
9590,5850,2020-09-24,0.06569343065693431,13700,12800,-900,648582
9591,5850,2020-09-23,0.05791505791505792,12950,13700,750,1871453
9592,5850,2020-09-17,0.07692307692307693,12350,13300,950,2102697
9593,5850,2020-09-01,0.07468879668049792,12050,12950,900,660036
9594,5850,2020-07-22,0.04296875,12800,12250,-550,436999
9595,5850,2020-07-17,0.044534412955465584,12350,12900,550,262142
9596,5850,2020-07-13,0.07111111111111111,11250,12050,800,830502
9597,5850,2020-05-19,0.05166051660516605,13550,14250,700,354769
9598,5850,2020-05-11,0.041666666666666664,13200,13750,550,262309
9599,5850,2020-05-04,0.04905660377358491,13250,12600,-650,123196
9600,5850,2020-04-28,0.044,12500,13050,550,110800
9601,5850,2020-04-27,0.041666666666666664,12000,12500,500,78968
9602,5850,2020-04-07,0.04887218045112782,13300,13950,650,123143
9603,5850,2020-03-31,0.05179282868525897,12550,13200,650,226622
9604,5850,2020-03-30,0.0546218487394958,11900,12550,650,98162
9605,5850,2020-03-26,0.091324200913242,10950,11950,1000,284590
9606,5850,2020-03-25,0.1162079510703364,9810,10950,1140,143113
9607,5850,2020-03-24,0.06630434782608696,9200,9810,610,132194
9608,5850,2020-03-23,0.05154639175257732,9700,9200,-500,144556
9609,5850,2020-03-19,0.07128712871287128,10100,9380,-720,289615
9610,5850,2020-03-18,0.08597285067873303,11050,10100,-950,313441
9611,5850,2020-03-17,0.08677685950413223,12100,11050,-1050,207287
9612,5850,2020-03-13,0.05928853754940711,12650,11900,-750,308064
9613,5850,2020-03-12,0.052434456928838954,13350,12650,-700,165729
9614,5850,2020-03-06,0.0436241610738255,14900,14250,-650,196964
9615,5850,2020-02-24,0.0473186119873817,15850,15100,-750,149570
9616,5850,2020-01-28,0.04960835509138381,19150,18200,-950,177281
9617,5850,2020-01-23,0.058011049723756904,18100,19150,1050,356529
9618,5850,2020-01-08,0.049132947976878616,17300,16450,-850,99246
9619,5850,2019-11-18,0.08866995073891626,20300,18500,-1800,403413
9620,5850,2019-10-30,0.04279279279279279,22200,21250,-950,68284
9621,5850,2019-08-09,0.06040268456375839,22350,23700,1350,165951
9622,5850,2019-07-26,0.05011389521640091,21950,23050,1100,194154
9623,5850,2019-07-24,0.04245283018867924,21200,22100,900,104272
9624,5850,2019-06-10,0.06981981981981981,22200,23750,1550,233600
9625,5850,2019-05-29,0.045081967213114756,24400,23300,-1100,163987
9626,5850,2019-05-27,0.09619686800894854,22350,24500,2150,150903
9627,5850,2019-05-09,0.04184100418410042,23900,22900,-1000,116947
9628,5850,2019-04-18,0.07453416149068323,24150,25950,1800,212379
9629,5850,2019-04-10,0.041666666666666664,22800,23750,950,148014
9630,5850,2019-03-27,0.041474654377880185,21700,22600,900,81899
9631,5850,2019-03-13,0.057208237986270026,21850,23100,1250,185980
9632,5850,2019-02-27,0.10687022900763359,19650,21750,2100,227131
9633,5850,2019-01-22,0.04028436018957346,21100,20250,-850,54982
9634,5850,2018-12-17,0.04825737265415549,18650,19550,900,132663
9635,5850,2018-12-12,0.08405797101449275,17250,18700,1450,184614
9636,5850,2018-12-06,0.04242424242424243,16500,17200,700,150306
9637,5850,2018-11-22,0.043209876543209874,16200,15500,-700,93355
9638,5850,2018-11-15,0.08609271523178808,15100,16400,1300,402524
9639,5850,2018-11-07,0.10309278350515463,14550,13050,-1500,381822
9640,5850,2018-10-31,0.04318936877076412,15050,14400,-650,175110
9641,5850,2018-10-30,0.041401273885350316,15700,15050,-650,106908
9642,5850,2018-10-25,0.07225433526011561,17300,16050,-1250,153871
9643,5850,2018-10-18,0.044444444444444446,18000,17200,-800,94680
9644,5850,2018-07-31,0.04871794871794872,19500,20450,950,60672
9645,5850,2018-07-23,0.048,18750,19650,900,109436
9646,5850,2018-06-22,0.05912596401028278,19450,18300,-1150,97347
9647,5850,2018-06-15,0.07336956521739131,18400,19750,1350,90223
9648,5850,2018-06-14,0.04909560723514212,19350,18400,-950,89271
9649,5850,2018-06-08,0.040214477211796246,18650,19400,750,87799
9650,5850,2018-05-24,0.046228710462287104,20550,19600,-950,106624
9651,5850,2018-04-24,0.046875,22400,21350,-1050,171366
9652,5850,2018-04-12,0.06444906444906445,24050,22500,-1550,131187
9653,5850,2018-04-09,0.0467706013363029,22450,23500,1050,221504
9654,5850,2018-04-06,0.0589622641509434,21200,22450,1250,208950
9655,5850,2018-03-23,0.040268456375838924,22350,21450,-900,62110
9656,5850,2018-03-09,0.041379310344827586,21750,22650,900,82862
9657,5850,2018-02-13,0.05451127819548872,26600,25150,-1450,219714
9658,5850,2018-02-12,0.05338078291814947,28100,26600,-1500,97175
9659,5850,2018-02-09,0.06037735849056604,26500,28100,1600,224001
9660,5850,2018-02-08,0.04950495049504951,25250,26500,1250,105770
9661,5850,2018-02-07,0.06307977736549165,26950,25250,-1700,109850
9662,5850,2018-01-24,0.08317929759704251,27050,29300,2250,382055
9663,5850,2018-01-23,0.13417190775681342,23850,27050,3200,339132
9664,5850,2018-01-17,0.05161290322580645,23250,24450,1200,133927
9665,5850,2018-01-08,0.05752212389380531,22600,23900,1300,172854
9666,5850,2017-12-20,0.06564551422319474,22850,24350,1500,471189
9667,5850,2017-12-15,0.046620046620046623,21450,22450,1000,70626
9668,5850,2017-12-14,0.044543429844097995,22450,21450,-1000,239148
9669,5850,2017-11-16,0.06521739130434782,23000,21500,-1500,236530
9670,5850,2017-10-26,0.05609756097560976,20500,21650,1150,103021
9671,5850,2017-10-24,0.07341772151898734,19750,21200,1450,137802
9672,5850,2017-09-26,0.05142857142857143,17500,18400,900,72169
9673,5850,2017-08-16,0.049217002237136466,22350,21250,-1100,346797
9674,5850,2017-06-08,0.04866180048661801,20550,21550,1000,267698
9675,5850,2017-05-16,0.08421052631578947,19000,20600,1600,374569
9676,5850,2017-04-20,0.04225352112676056,17750,18500,750,193802
9677,5850,2017-04-19,0.04054054054054054,18500,17750,-750,171061
9678,5850,2017-03-27,0.04600484261501211,20650,19700,-950,179792
9679,5850,2017-03-16,0.04522613065326633,19900,20800,900,187210
9680,5850,2017-03-06,0.05240174672489083,22900,21700,-1200,228392
9681,5850,2017-03-02,0.06653225806451613,24800,23150,-1650,164974
9682,5850,2017-02-15,0.0967741935483871,23250,25500,2250,274213
9683,5850,2017-02-13,0.04861111111111111,21600,22650,1050,150315
9684,5850,2017-02-10,0.04,22500,21600,-900,139623
9685,5850,2017-02-08,0.04025423728813559,23600,22650,-950,94844
9686,5850,2017-02-07,0.05592841163310962,22350,23600,1250,127120
9687,5850,2017-02-02,0.0507399577167019,23650,22450,-1200,178114
9688,5850,2017-01-18,0.07051282051282051,23400,25050,1650,298836
9689,5850,2017-01-04,0.04946236559139785,23250,24400,1150,195775
9690,5850,2017-01-03,0.0763888888888889,21600,23250,1650,343580
9691,5850,2016-12-06,0.045454545454545456,19800,20700,900,201229
9692,5850,2016-12-01,0.04289544235924933,18650,19450,800,181803
9693,5850,2016-11-15,0.0756578947368421,15200,16350,1150,700527
9694,5850,2016-11-11,0.0410958904109589,14600,15200,600,44810
9695,5850,2016-11-04,0.061016949152542375,14750,15650,900,59248
9696,5850,2016-08-18,0.06872852233676977,14550,15550,1000,250730
9697,39130,2021-06-02,0.04751131221719457,88400,92600,4200,582070
9698,39130,2021-05-31,0.06921241050119331,83800,89600,5800,460268
9699,39130,2021-05-25,0.044386422976501305,76600,80000,3400,546287
9700,39130,2021-05-17,0.0804093567251462,68400,73900,5500,774795
9701,39130,2021-02-23,0.06312292358803986,60200,64000,3800,722205
9702,39130,2021-01-18,0.07087827426810478,64900,60300,-4600,432011
9703,39130,2021-01-14,0.07023411371237458,59800,64000,4200,1186765
9704,39130,2020-12-29,0.0745697896749522,52300,56200,3900,398040
9705,39130,2020-12-24,0.04330708661417323,50800,53000,2200,198077
9706,39130,2020-12-14,0.04931972789115646,58800,55900,-2900,408741
9707,39130,2020-12-02,0.08925318761384335,54900,59800,4900,923180
9708,39130,2020-11-25,0.056910569105691054,49200,52000,2800,897999
9709,39130,2020-11-24,0.04792332268370607,46950,49200,2250,651458
9710,39130,2020-11-11,0.05561861520998865,44050,46500,2450,1235763
9711,39130,2020-11-10,0.09169764560099132,40350,44050,3700,1511118
9712,39130,2020-10-12,0.04466501240694789,40300,42100,1800,745200
9713,39130,2020-08-18,0.08180708180708181,40950,37600,-3350,471776
9714,39130,2020-08-12,0.06274007682458387,39050,41500,2450,2248457
9715,39130,2020-07-21,0.042723631508678236,37450,39050,1600,151164
9716,39130,2020-07-15,0.05146036161335188,35950,37800,1850,175352
9717,39130,2020-06-30,0.05357142857142857,36400,38350,1950,139703
9718,39130,2020-05-26,0.04239401496259352,40100,41800,1700,192623
9719,39130,2020-05-19,0.07051282051282051,39000,41750,2750,609857
9720,39130,2020-05-18,0.06267029972752043,36700,39000,2300,278157
9721,12510,2021-05-18,0.045627376425855515,78900,82500,3600,279459
9722,12510,2021-04-07,0.05518763796909492,90600,85600,-5000,618984
9723,12510,2021-02-18,0.0410958904109589,109500,105000,-4500,145348
9724,12510,2021-02-02,0.04390243902439024,102500,107000,4500,212437
9725,12510,2021-01-21,0.055793991416309016,116500,110000,-6500,178107
9726,12510,2021-01-11,0.041666666666666664,108000,112500,4500,367347
9727,12510,2020-12-15,0.04,100000,104000,4000,153419
9728,12510,2020-11-10,0.04608294930875576,108500,103500,-5000,132034
9729,12510,2020-10-26,0.05188679245283019,106000,100500,-5500,100061
9730,12510,2020-10-13,0.04424778761061947,113000,108000,-5000,107947
9731,12510,2020-10-08,0.045871559633027525,109000,114000,5000,233871
9732,12510,2020-09-14,0.05357142857142857,112000,118000,6000,245936
9733,12510,2020-09-09,0.041666666666666664,120000,115000,-5000,352632
9734,12510,2020-09-04,0.18779342723004694,106500,126500,20000,2501985
9735,12510,2020-09-02,0.055,100000,105500,5500,403669
9736,12510,2020-06-24,0.04405286343612335,113500,108500,-5000,216662
9737,12510,2020-06-23,0.06074766355140187,107000,113500,6500,255660
9738,12510,2020-06-15,0.05263157894736842,114000,108000,-6000,287834
9739,12510,2020-06-10,0.06132075471698113,106000,112500,6500,305281
9740,12510,2020-06-05,0.04090909090909091,110000,105500,-4500,360028
9741,12510,2020-06-03,0.06557377049180328,122000,114000,-8000,506605
9742,12510,2020-05-29,0.048034934497816595,114500,120000,5500,1746783
9743,12510,2020-05-28,0.045662100456621,109500,114500,5000,410991
9744,12510,2020-05-25,0.06435643564356436,101000,107500,6500,311410
9745,12510,2020-05-13,0.04950495049504951,101000,106000,5000,807846
9746,12510,2020-05-08,0.043933054393305436,95600,99800,4200,414818
9747,12510,2020-05-07,0.06815642458100558,89500,95600,6100,577767
9748,12510,2020-04-16,0.14942528735632185,78300,90000,11700,660682
9749,12510,2020-04-13,0.04114713216957606,80200,76900,-3300,144562
9750,12510,2020-03-30,0.07142857142857142,77000,82500,5500,241426
9751,12510,2020-03-26,0.052132701421800945,84400,80000,-4400,169994
9752,12510,2020-03-25,0.061635220125786164,79500,84400,4900,321699
9753,12510,2020-03-24,0.16911764705882354,68000,79500,11500,324767
9754,12510,2020-03-20,0.22522522522522523,55500,68000,12500,318875
9755,12510,2020-03-19,0.15267175572519084,65500,55500,-10000,475184
9756,12510,2020-03-18,0.08134642356241234,71300,65500,-5800,258251
9757,12510,2020-03-16,0.07151979565772669,78300,72700,-5600,203830
9758,12510,2020-03-11,0.045819014891179836,87300,83300,-4000,164169
9759,12510,2020-02-28,0.0539053905390539,90900,86000,-4900,305016
9760,12510,2020-02-27,0.04416403785488959,95100,90900,-4200,173124
9761,12510,2020-02-11,0.04147982062780269,89200,92900,3700,122110
9762,12510,2019-11-07,0.062111801242236024,80500,75500,-5000,250086
9763,12510,2019-11-06,0.04409857328145266,77100,80500,3400,216824
9764,12510,2019-10-23,0.0967741935483871,62000,68000,6000,364584
9765,12510,2019-09-18,0.053833605220228384,61300,64600,3300,157481
9766,12510,2019-09-04,0.04786324786324787,58500,61300,2800,228715
9767,12510,2019-08-21,0.053763440860215055,55800,58800,3000,400317
9768,12510,2019-08-16,0.06924315619967794,62100,57800,-4300,824162
9769,12510,2019-08-14,0.16532258064516128,74400,62100,-12300,1820808
9770,12510,2019-07-26,0.04777070063694268,62800,65800,3000,149446
9771,12510,2019-07-10,0.0701468189233279,61300,65600,4300,230905
9772,12510,2019-06-12,0.054929577464788736,71000,67100,-3900,137321
9773,12510,2019-06-10,0.04229607250755287,66200,69000,2800,147145
9774,12510,2019-04-25,0.04477611940298507,53600,56000,2400,247943
9775,12510,2019-04-24,0.09164969450101833,49100,53600,4500,507418
9776,12510,2019-04-23,0.0593311758360302,46350,49100,2750,289318
9777,12510,2019-02-13,0.05732484076433121,39250,41500,2250,292910
9778,12510,2019-01-29,0.05056179775280899,44500,42250,-2250,454412
9779,12510,2018-12-17,0.04242424242424243,49500,47400,-2100,77663
9780,12510,2018-12-14,0.04807692307692308,52000,49500,-2500,47170
9781,12510,2018-11-29,0.07142857142857142,46200,49500,3300,195881
9782,12510,2018-11-27,0.04932735426008968,44600,46800,2200,86983
9783,12510,2018-11-12,0.04421052631578947,47500,45400,-2100,83899
9784,12510,2018-11-02,0.06567796610169492,47200,50300,3100,158390
9785,12510,2018-11-01,0.08881199538638986,43350,47200,3850,143087
9786,12510,2018-10-30,0.04835164835164835,45500,43300,-2200,221450
9787,12510,2018-10-26,0.045871559633027525,43600,45600,2000,210504
9788,12510,2018-10-25,0.06638115631691649,46700,43600,-3100,271015
9789,12510,2018-10-24,0.05846774193548387,49600,46700,-2900,141377
9790,12510,2018-10-23,0.04247104247104247,51800,49600,-2200,148715
9791,12510,2018-10-18,0.05065666041275797,53300,50600,-2700,103914
9792,12510,2018-10-11,0.07413793103448275,58000,53700,-4300,85792
9793,12510,2018-09-18,0.0421792618629174,56900,54500,-2400,129903
9794,12510,2018-08-08,0.04150943396226415,53000,55200,2200,120726
9795,12510,2018-07-23,0.05246422893481717,62900,59600,-3300,81347
9796,12510,2018-07-13,0.05564142194744977,64700,61100,-3600,170322
9797,12510,2018-07-12,0.06942148760330578,60500,64700,4200,191521
9798,12510,2018-07-06,0.0430622009569378,62700,60000,-2700,120385
9799,12510,2018-07-02,0.041935483870967745,62000,64600,2600,206879
9800,12510,2018-06-22,0.043795620437956206,54800,57200,2400,179631
9801,12510,2018-06-20,0.05263157894736842,53200,56000,2800,108742
9802,12510,2018-06-18,0.06563039723661486,57900,54100,-3800,99732
9803,12510,2018-06-15,0.07222222222222222,54000,57900,3900,191607
9804,12510,2018-06-07,0.05642023346303502,51400,54300,2900,168443
9805,12510,2018-06-04,0.18181818181818182,44000,52000,8000,653071
9806,12510,2018-05-16,0.052752293577981654,43600,45900,2300,185897
9807,12510,2018-05-15,0.04907306434023991,45850,43600,-2250,204400
9808,12510,2018-04-26,0.0626204238921002,51900,48650,-3250,384995
9809,12510,2018-04-20,0.04861111111111111,57600,54800,-2800,114451
9810,12510,2018-04-18,0.06476190476190476,52500,55900,3400,192961
9811,12510,2018-04-17,0.04891304347826087,55200,52500,-2700,244790
9812,12510,2018-03-23,0.045,60000,57300,-2700,107397
9813,12510,2018-03-09,0.04915254237288136,59000,61900,2900,125104
9814,12510,2018-02-26,0.07076350093109869,53700,57500,3800,245139
9815,12510,2018-02-14,0.04025423728813559,47200,49100,1900,132339
9816,12510,2018-02-13,0.10943396226415095,53000,47200,-5800,387324
9817,12510,2018-02-12,0.08163265306122448,49000,53000,4000,373786
9818,12510,2018-01-31,0.04017372421281216,46050,47900,1850,218187
9819,12510,2018-01-26,0.05782312925170068,44100,46650,2550,183274
9820,12510,2018-01-24,0.1125158027812895,39550,44000,4450,449495
9821,12510,2018-01-12,0.049707602339181284,34200,35900,1700,276966
9822,12510,2018-01-11,0.062111801242236024,32200,34200,2000,260806
9823,12510,2017-09-27,0.052901023890784986,29300,30850,1550,129871
9824,12510,2017-09-25,0.05238095238095238,31500,29850,-1650,156844
9825,12510,2017-07-20,0.04011887072808321,33650,35000,1350,216856
9826,12510,2017-07-19,0.0499219968798752,32050,33650,1600,220906
9827,12510,2017-06-29,0.04012841091492777,31150,29900,-1250,197169
9828,12510,2017-06-27,0.052805280528052806,30300,31900,1600,161215
9829,12510,2017-05-08,0.061837455830388695,28300,30050,1750,244671
9830,12510,2017-04-18,0.04085603112840467,25700,26750,1050,159280
9831,12510,2017-03-22,0.041237113402061855,24250,23250,-1000,151701
9832,12510,2017-02-02,0.040948275862068964,23200,22250,-950,162263
9833,12510,2016-11-16,0.04827586206896552,21750,22800,1050,122494
9834,12510,2016-11-02,0.04054054054054054,22200,21300,-900,195218
9835,12510,2016-09-13,0.044270833333333336,19200,20050,850,152300
9836,12510,2016-08-23,0.09137055837563451,19700,21500,1800,518239
9837,12510,2016-08-16,0.041379310344827586,21750,20850,-900,212795
9838,102110,2021-01-08,0.04478866474543708,41640,43505,1865,1804424
9839,102110,2020-06-16,0.05913173652694611,26720,28300,1580,2262732
9840,102110,2020-06-15,0.048771804912780346,28090,26720,-1370,3034165
9841,102110,2020-04-01,0.04842715231788079,24160,22990,-1170,3564858
9842,102110,2020-03-25,0.057251058142125194,22445,23730,1285,7160876
9843,102110,2020-03-24,0.09194843103867673,20555,22445,1890,7093950
9844,102110,2020-03-23,0.05581074873679375,21770,20555,-1215,7835339
9845,102110,2020-03-20,0.07426597582037997,20265,21770,1505,8407183
9846,102110,2020-03-19,0.06934557979334098,21775,20265,-1510,10104416
9847,102110,2020-03-18,0.056951061065396276,23090,21775,-1315,6252936
9848,102110,2020-03-09,0.04229390681003584,27900,26720,-1180,3631544
9849,102110,2018-10-11,0.04149377593360996,28920,27720,-1200,2500049
9850,8930,2021-05-27,0.04296296296296296,67500,70400,2900,237834
9851,8930,2021-05-24,0.04721030042918455,69900,66600,-3300,233219
9852,8930,2021-05-18,0.07600596125186289,67100,72200,5100,1069689
9853,8930,2021-05-14,0.10604026845637583,74500,66600,-7900,720625
9854,8930,2021-05-13,0.05673758865248227,70500,74500,4000,596471
9855,8930,2021-05-07,0.04940119760479042,66800,70100,3300,265781
9856,8930,2021-05-03,0.05346820809248555,69200,65500,-3700,294007
9857,8930,2021-04-22,0.04183535762483131,74100,71000,-3100,384974
9858,8930,2021-04-21,0.07391304347826087,69000,74100,5100,1070244
9859,8930,2021-04-19,0.07981220657276995,63900,69000,5100,949271
9860,8930,2021-04-15,0.07947019867549669,60400,65200,4800,1847822
9861,8930,2021-04-07,0.04262877442273535,56300,58700,2400,159851
9862,8930,2021-03-02,0.05271317829457364,64500,61100,-3400,384911
9863,8930,2021-02-25,0.05087440381558029,62900,66100,3200,172810
9864,8930,2021-02-17,0.05622489959839357,74700,70500,-4200,335397
9865,8930,2021-01-29,0.0539906103286385,85200,80600,-4600,311776
9866,8930,2021-01-25,0.05343511450381679,78600,82800,4200,487627
9867,8930,2021-01-20,0.05702917771883289,75400,79700,4300,780318
9868,8930,2021-01-18,0.05987261146496815,78500,73800,-4700,286046
9869,8930,2021-01-12,0.04395604395604396,81900,78300,-3600,447200
9870,8930,2021-01-08,0.06298342541436464,90500,84800,-5700,779077
9871,8930,2021-01-07,0.07100591715976332,84500,90500,6000,1937708
9872,8930,2021-01-06,0.09740259740259741,77000,84500,7500,3809822
9873,8930,2020-12-29,0.10882352941176471,68000,74100,6100,1252112
9874,8930,2020-12-22,0.0481283422459893,74800,71200,-3600,326958
9875,8930,2020-12-11,0.042582417582417584,72800,75900,3100,916991
9876,8930,2020-12-08,0.14022988505747128,87000,74800,-12200,2325917
9877,8930,2020-12-07,0.12694300518134716,77200,87000,9800,2809066
9878,8930,2020-12-04,0.09815078236130868,70300,77200,6900,2316057
9879,8930,2020-11-30,0.0700152207001522,65700,70300,4600,1975619
9880,8930,2020-11-27,0.1116751269035533,59100,65700,6600,1871463
9881,8930,2020-11-26,0.047872340425531915,56400,59100,2700,2733199
9882,8930,2020-11-18,0.06179775280898876,53400,56700,3300,458376
9883,8930,2020-10-30,0.04316546762589928,55600,53200,-2400,191848
9884,8930,2020-10-26,0.04538087520259319,61700,58900,-2800,270454
9885,8930,2020-10-23,0.05110732538330494,58700,61700,3000,449282
9886,8930,2020-10-16,0.06964285714285715,56000,59900,3900,314056
9887,8930,2020-09-29,0.06715063520871144,55100,58800,3700,540935
9888,8930,2020-09-24,0.060218978102189784,54800,51500,-3300,236407
9889,8930,2020-09-22,0.04421768707482993,58800,56200,-2600,218358
9890,8930,2020-08-27,0.055,60000,56700,-3300,391973
9891,8930,2020-08-25,0.07491289198606271,57400,61700,4300,907095
9892,8930,2020-08-18,0.09162717219589257,63300,57500,-5800,699055
9893,8930,2020-08-13,0.04451510333863275,62900,65700,2800,1069341
9894,8930,2020-08-10,0.0445468509984639,65100,62200,-2900,3286285
9895,8930,2020-08-06,0.11142454160789844,70900,63000,-7900,955942
9896,8930,2020-08-05,0.29853479853479853,54600,70900,16300,526200
9897,8930,2020-08-04,0.1075050709939148,49300,54600,5300,6240654
9898,8930,2020-08-03,0.16824644549763032,42200,49300,7100,5989647
9899,8930,2020-07-29,0.09415584415584416,46200,41850,-4350,2501803
9900,8930,2020-07-28,0.29957805907172996,35550,46200,10650,5604461
9901,8930,2020-06-29,0.0423728813559322,35400,33900,-1500,198495
9902,8930,2020-06-19,0.05236270753512133,39150,37100,-2050,470556
9903,8930,2020-06-17,0.06111111111111111,36000,38200,2200,980017
9904,8930,2020-06-16,0.0650887573964497,33800,36000,2200,873943
9905,8930,2020-06-12,0.05187319884726225,34700,32900,-1800,271214
9906,8930,2020-06-05,0.11655405405405406,29600,33050,3450,925171
9907,8930,2020-05-14,0.09421487603305785,30250,27400,-2850,575243
9908,8930,2020-04-23,0.046125461254612546,27100,28350,1250,124409
9909,8930,2020-04-07,0.04127579737335835,26650,27750,1100,208767
9910,8930,2020-04-01,0.05380333951762523,26950,25500,-1450,178348
9911,8930,2020-03-31,0.050682261208576995,25650,26950,1300,201080
9912,8930,2020-03-30,0.04693877551020408,24500,25650,1150,137820
9913,8930,2020-03-25,0.08685446009389672,21300,23150,1850,237168
9914,8930,2020-03-24,0.08951406649616368,19550,21300,1750,206427
9915,8930,2020-03-23,0.06235011990407674,20850,19550,-1300,193923
9916,8930,2020-03-19,0.1711340206185567,24250,20100,-4150,259625
9917,8930,2020-03-18,0.05458089668615984,25650,24250,-1400,148478
9918,8930,2020-03-13,0.06498194945848375,27700,25900,-1800,243601
9919,8930,2020-03-12,0.07666666666666666,30000,27700,-2300,279002
9920,8930,2020-03-05,0.08025682182985554,31150,33650,2500,165975
9921,8930,2020-02-28,0.041935483870967745,31000,29700,-1300,193529
9922,8930,2020-02-24,0.06191950464396285,32300,30300,-2000,185025
9923,8930,2020-02-06,0.05409582689335394,32350,34100,1750,124891
9924,8930,2020-01-28,0.043055555555555555,36000,34450,-1550,166895
9925,8930,2020-01-08,0.045576407506702415,37300,35600,-1700,210042
9926,8930,2019-12-30,0.042119565217391304,36800,38350,1550,95436
9927,8930,2019-12-10,0.045743329097839895,39350,37550,-1800,360958
9928,8930,2019-10-23,0.04814814814814815,40500,42450,1950,273819
9929,8930,2019-10-07,0.056818181818181816,39600,41850,2250,167748
9930,8930,2019-10-01,0.04671717171717172,39600,41450,1850,109361
9931,8930,2019-09-17,0.07526881720430108,41850,45000,3150,223866
9932,8930,2019-08-09,0.04116222760290557,41300,43000,1700,102309
9933,8930,2019-08-05,0.07452725250278086,44950,41600,-3350,137600
9934,8930,2019-07-04,0.27695716395864106,67700,48950,-18750,906389
9935,8930,2019-05-09,0.04495912806539509,73400,70100,-3300,67867
9936,8930,2018-11-13,0.043478260869565216,66700,69600,2900,71659
9937,8930,2018-11-02,0.04047976011994003,66700,69400,2700,72246
9938,8930,2018-10-26,0.051893408134642355,71300,67600,-3700,86247
9939,8930,2018-10-23,0.06631299734748011,75400,70400,-5000,133323
9940,8930,2018-10-11,0.041719342604298354,79100,75800,-3300,98556
9941,8930,2018-10-01,0.05466970387243736,87800,83000,-4800,140484
9942,8930,2018-09-27,0.050493962678375415,91100,86500,-4600,247744
9943,8930,2018-08-13,0.04145077720207254,77200,74000,-3200,144316
9944,8930,2018-08-06,0.04329608938547486,71600,74700,3100,184317
9945,8930,2018-07-25,0.041666666666666664,69600,66700,-2900,109625
9946,8930,2018-07-11,0.04,70000,67200,-2800,107382
9947,8930,2018-07-04,0.058823529411764705,62900,66600,3700,137026
9948,8930,2018-06-19,0.04833836858006042,66200,63000,-3200,144249
9949,8930,2018-05-09,0.0636237897648686,72300,76900,4600,107534
9950,8930,2018-04-23,0.04892601431980907,83800,79700,-4100,163268
9951,8930,2018-04-12,0.04145077720207254,96500,92500,-4000,142608
9952,8930,2018-04-10,0.04520990312163617,92900,97100,4200,229155
9953,8930,2018-03-12,0.06342015855039637,88300,93900,5600,217362
9954,8930,2018-02-28,0.04869762174405436,88300,84000,-4300,171785
9955,8930,2018-02-19,0.08677248677248678,94500,86300,-8200,555431
9956,8930,2018-02-05,0.06470588235294118,102000,95400,-6600,185920
9957,8930,2018-01-04,0.043668122270742356,114500,109500,-5000,146833
9958,8930,2017-12-22,0.0430622009569378,104500,109000,4500,133451
9959,8930,2017-12-11,0.05714285714285714,105000,111000,6000,121575
9960,8930,2017-11-30,0.04602510460251046,119500,114000,-5500,272905
9961,8930,2017-11-22,0.05508474576271186,118000,111500,-6500,394975
9962,8930,2017-11-17,0.049586776859504134,121000,115000,-6000,491976
9963,8930,2017-11-15,0.21413934426229508,97600,118500,20900,2251419
9964,8930,2017-10-19,0.05870020964360587,95400,101000,5600,739923
9965,8930,2017-10-12,0.04480874316939891,91500,95600,4100,416800
9966,8930,2017-09-19,0.053469852104664393,87900,92600,4700,426833
9967,8930,2017-08-28,0.043132803632236094,88100,91900,3800,541069
9968,8930,2017-08-18,0.07818411097099622,79300,85500,6200,302712
9969,8930,2017-08-07,0.05064935064935065,77000,80900,3900,159692
9970,8930,2017-08-03,0.056580565805658053,81300,76700,-4600,324896
9971,8930,2017-07-28,0.046275395033860044,88600,84500,-4100,244508
9972,8930,2017-06-30,0.04090909090909091,88000,84400,-3600,431408
9973,8930,2017-06-28,0.05680600214362272,93300,88000,-5300,522058
9974,8930,2017-06-20,0.05251875669882101,93300,88400,-4900,669999
9975,8930,2017-06-16,0.0925553319919517,99400,90200,-9200,1133894
9976,8930,2017-06-13,0.09710982658959537,86500,94900,8400,787830
9977,8930,2017-06-09,0.05454545454545454,82500,87000,4500,693653
9978,8930,2017-06-08,0.059050064184852376,77900,82500,4600,559241
9979,8930,2017-05-31,0.058655221745350504,69900,74000,4100,553801
9980,8930,2017-05-11,0.057663125948406675,65900,69700,3800,693539
9981,8930,2017-05-08,0.07413509060955518,60700,65200,4500,878564
9982,8930,2017-02-27,0.040880503144654086,63600,66200,2600,339302
9983,8930,2017-02-07,0.0451505016722408,59800,62500,2700,254833
9984,8930,2017-01-20,0.04844290657439446,57800,60600,2800,324318
9985,8930,2017-01-13,0.04121863799283154,55800,58100,2300,347925
9986,8930,2017-01-02,0.07201309328968904,61100,56700,-4400,353721
9987,8930,2016-12-29,0.11320754716981132,68900,61100,-7800,747580
9988,8930,2016-12-26,0.04672897196261682,64200,67200,3000,234835
9989,8930,2016-12-23,0.04560260586319218,61400,64200,2800,202421
9990,8930,2016-12-07,0.1483050847457627,70800,60300,-10500,1809192
9991,8930,2016-11-25,0.056657223796033995,70600,74600,4000,233737
9992,8930,2016-11-23,0.045020463847203276,73300,70000,-3300,214121
9993,8930,2016-11-10,0.1725067385444744,74200,87000,12800,654708
9994,8930,2016-11-09,0.04871794871794872,78000,74200,-3800,311369
9995,8930,2016-11-03,0.055162659123055166,70700,74600,3900,223943
9996,8930,2016-11-02,0.04973118279569892,74400,70700,-3700,208936
9997,8930,2016-10-31,0.041561712846347604,79400,76100,-3300,304775
9998,8930,2016-10-28,0.06916764361078546,85300,79400,-5900,236129
9999,8930,2016-10-25,0.04561003420752566,87700,83700,-4000,205757
10000,8930,2016-10-10,0.04787812840043525,91900,96300,4400,299448
10001,8930,2016-10-07,0.06889564336372847,98700,91900,-6800,644455
10002,8930,2016-10-04,0.08333333333333333,114000,104500,-9500,1266560
10003,8930,2016-09-30,0.1827956989247312,139500,114000,-25500,1862415
10004,8930,2016-09-20,0.04247104247104247,129500,135000,5500,194723
10005,8930,2016-08-23,0.04477611940298507,134000,140000,6000,141576
10006,19170,2021-05-20,0.05057803468208093,69200,65700,-3500,1443701
10007,19170,2021-05-12,0.04107648725212465,70600,67700,-2900,2606220
10008,19170,2021-05-11,0.05992010652463382,75100,70600,-4500,3563256
10009,19170,2021-05-10,0.16796267496111975,64300,75100,10800,8286373
10010,19170,2021-05-06,0.046511627906976744,60200,63000,2800,2363933
10011,19170,2021-05-03,0.12177650429799428,69800,61300,-8500,3508651
10012,19170,2021-04-30,0.05929919137466307,74200,69800,-4400,3267387
10013,19170,2021-04-29,0.0725,80000,74200,-5800,2654793
10014,19170,2021-04-27,0.1472457627118644,94400,80500,-13900,7166189
10015,19170,2021-04-26,0.055055055055055056,99900,94400,-5500,1575125
10016,19170,2021-04-19,0.12472160356347439,89800,101000,11200,4817452
10017,19170,2021-04-05,0.04920049200492005,81300,85300,4000,1006960
10018,19170,2021-03-31,0.06994535519125683,91500,85100,-6400,2573586
10019,19170,2021-03-25,0.056716417910447764,100500,94800,-5700,1999576
10020,19170,2021-03-23,0.08333333333333333,114000,104500,-9500,2953578
10021,19170,2021-03-19,0.052132701421800945,105500,111000,5500,3816352
10022,19170,2021-03-17,0.05909090909090909,110000,103500,-6500,2162121
10023,19170,2021-03-16,0.15789473684210525,95000,110000,15000,2955453
10024,19170,2021-03-05,0.04888888888888889,90000,94400,4400,2573876
10025,19170,2021-03-04,0.0425531914893617,94000,90000,-4000,878351
10026,19170,2021-03-02,0.08472553699284009,83800,90900,7100,3331367
10027,19170,2021-02-25,0.06826801517067003,79100,84500,5400,1116319
10028,19170,2021-02-24,0.04353083434099154,82700,79100,-3600,1231354
10029,19170,2021-02-22,0.053164556962025315,79000,83200,4200,3901049
10030,19170,2021-02-19,0.046357615894039736,75500,79000,3500,1377883
10031,19170,2021-02-15,0.0421455938697318,78300,81600,3300,1413783
10032,19170,2021-02-04,0.083986562150056,89300,81800,-7500,1795234
10033,19170,2021-02-03,0.04079254079254079,85800,89300,3500,1342443
10034,19170,2021-02-01,0.050617283950617285,81000,85100,4100,2689053
10035,19170,2021-01-29,0.06789413118527042,86900,81000,-5900,3615085
10036,19170,2021-01-26,0.07314629258517034,99800,92500,-7300,1881531
10037,19170,2021-01-21,0.04081632653061224,98000,102000,4000,2475707
10038,19170,2021-01-19,0.041584158415841586,101000,96800,-4200,5384870
10039,19170,2021-01-18,0.13304721030042918,116500,101000,-15500,2863343
10040,19170,2021-01-11,0.08745247148288973,131500,120000,-11500,2001170
10041,19170,2021-01-07,0.0823045267489712,121500,131500,10000,5279009
10042,19170,2020-12-29,0.07111111111111111,112500,120500,8000,3562985
10043,19170,2020-12-28,0.0546218487394958,119000,112500,-6500,5033466
10044,19170,2020-12-24,0.048458149779735685,113500,119000,5500,10565072
10045,19170,2020-12-23,0.058091286307053944,120500,113500,-7000,3154452
10046,19170,2020-12-21,0.1806020066889632,149500,122500,-27000,8958344
10047,19170,2020-12-15,0.07547169811320754,159000,147000,-12000,3487935
10048,19170,2020-12-11,0.17585301837270342,190500,157000,-33500,7420883
10049,19170,2020-12-04,0.05307262569832402,179000,188500,9500,3616479
10050,19170,2020-12-02,0.2326388888888889,144000,177500,33500,10464643
10051,19170,2020-12-01,0.09090909090909091,132000,144000,12000,3395342
10052,19170,2020-11-26,0.07983193277310924,119000,128500,9500,3357638
10053,19170,2020-11-18,0.04365079365079365,126000,120500,-5500,1246035
10054,19170,2020-11-13,0.2,105000,126000,21000,10987113
10055,19170,2020-11-12,0.14979757085020243,123500,105000,-18500,3541236
10056,19170,2020-11-10,0.041044776119402986,134000,128500,-5500,979177
10057,19170,2020-11-03,0.06746031746031746,126000,134500,8500,1452688
10058,19170,2020-10-27,0.0695970695970696,136500,127000,-9500,2104948
10059,19170,2020-10-21,0.0796812749003984,125500,135500,10000,3452509
10060,19170,2020-10-19,0.07983193277310924,119000,128500,9500,3029185
10061,19170,2020-10-16,0.048,125000,119000,-6000,1106753
10062,19170,2020-10-13,0.08239700374531835,133500,122500,-11000,2159439
10063,19170,2020-10-12,0.04642857142857143,140000,133500,-6500,1235415
10064,19170,2020-10-06,0.05511811023622047,127000,134000,7000,2832451
10065,19170,2020-09-29,0.052434456928838954,133500,126500,-7000,3151057
10066,19170,2020-09-25,0.09333333333333334,150000,136000,-14000,3873628
10067,19170,2020-09-24,0.09090909090909091,165000,150000,-15000,3130738
10068,19170,2020-09-22,0.1421188630490956,193500,166000,-27500,13709460
10069,19170,2020-09-18,0.2983606557377049,152500,198000,45500,11151883
10070,19170,2020-09-16,0.051194539249146756,146500,154000,7500,1613973
10071,19170,2020-09-14,0.04560260586319218,153500,146500,-7000,1454336
10072,19170,2020-09-11,0.08865248226950355,141000,153500,12500,4196887
10073,19170,2020-09-08,0.05723905723905724,148500,140000,-8500,1896434
10074,19170,2020-09-04,0.0670926517571885,156500,146000,-10500,3207785
10075,19170,2020-09-02,0.07482993197278912,147000,158000,11000,5227173
10076,19170,2020-09-01,0.07692307692307693,136500,147000,10500,8457244
10077,19170,2020-08-31,0.22972972972972974,111000,136500,25500,8923037
10078,19170,2020-08-25,0.13432835820895522,100500,114000,13500,8298145
10079,19170,2020-08-24,0.1043956043956044,91000,100500,9500,6447748
10080,19170,2020-08-20,0.11616766467065869,83500,93200,9700,7406541
10081,19170,2020-08-18,0.1118508655126498,75100,83500,8400,8167164
10082,19170,2020-08-13,0.04596100278551532,71800,75100,3300,2849271
10083,19170,2020-08-12,0.06631989596879063,76900,71800,-5100,2147793
10084,19170,2020-08-05,0.04933333333333333,75000,78700,3700,4779936
10085,19170,2020-08-03,0.06521739130434782,69000,73500,4500,5853424
10086,19170,2020-07-31,0.19767441860465115,86000,69000,-17000,9550127
10087,19170,2020-07-30,0.14666666666666667,75000,86000,11000,16135343
10088,19170,2020-07-29,0.04748603351955307,71600,75000,3400,13369199
10089,19170,2020-07-27,0.3,105000,73500,-31500,17014592
10090,19170,2020-07-24,0.14634146341463414,123000,105000,-18000,7202366
10091,19170,2020-07-22,0.29610115911485774,94900,123000,28100,8513185
10092,19170,2020-07-20,0.3,73000,94900,21900,8684128
10093,19170,2020-07-17,0.15689381933438987,63100,73000,9900,10346334
10094,19170,2020-07-13,0.2394655704008222,48650,60300,11650,13164176
10095,19170,2020-07-10,0.1822600243013366,41150,48650,7500,21832615
10096,19170,2020-07-09,0.044416243654822336,39400,41150,1750,8047240
10097,19170,2020-07-07,0.2222222222222222,31050,37950,6900,28716072
10098,19170,2020-07-06,0.050761421319796954,29550,31050,1500,5148966
10099,19170,2020-06-30,0.05226480836236934,28700,30200,1500,12042952
10100,19170,2020-06-18,0.05128205128205128,29250,30750,1500,11117553
10101,19170,2020-06-17,0.07728706624605679,31700,29250,-2450,6505157
10102,19170,2020-06-16,0.07580174927113703,34300,31700,-2600,12590696
10103,19170,2020-06-15,0.12459016393442623,30500,34300,3800,28085389
10104,19170,2020-06-11,0.05432937181663837,29450,31050,1600,15894953
10105,19170,2020-06-10,0.08272058823529412,27200,29450,2250,33420484
10106,19170,2020-06-09,0.29832935560859186,20950,27200,6250,25754237
10107,19170,2020-05-29,0.061124694376528114,20450,21700,1250,8590829
10108,19170,2020-05-15,0.08968609865470852,22300,20300,-2000,4715851
10109,19170,2020-05-14,0.10945273631840796,20100,22300,2200,12918593
10110,19170,2020-05-04,0.15269461077844312,16700,19250,2550,17744790
10111,19170,2020-04-28,0.055401662049861494,18050,17050,-1000,4185905
10112,19170,2020-04-20,0.16615384615384615,16250,18950,2700,35260557
10113,19170,2020-04-16,0.17708333333333334,19200,15800,-3400,11720117
10114,19170,2020-04-14,0.12727272727272726,22000,19200,-2800,14978862
10115,19170,2020-04-13,0.07368421052631578,23750,22000,-1750,12886870
10116,19170,2020-04-10,0.16136919315403422,20450,23750,3300,23427263
10117,19170,2020-04-06,0.2987012987012987,15400,20000,4600,3994971
10118,19170,2020-04-03,0.29957805907172996,11850,15400,3550,21410786
10119,19170,2020-04-01,0.15625,14400,12150,-2250,9571806
10120,19170,2020-03-30,0.1346153846153846,13000,14750,1750,28078381
10121,19170,2020-03-27,0.04417670682730924,12450,13000,550,60560513
10122,19170,2020-03-26,0.29552549427679503,9610,12450,2840,45953613
10123,19170,2020-03-25,0.1239766081871345,8550,9610,1060,30547156
10124,19170,2020-03-23,0.0583756345177665,7880,8340,460,29900733
10125,19170,2020-03-20,0.19213313161875945,6610,7880,1270,23789010
10126,19170,2020-03-19,0.15256410256410258,7800,6610,-1190,6210653
10127,19170,2020-03-13,0.054696789536266346,8410,7950,-460,43159438
10128,19170,2020-03-12,0.043424317617866005,8060,8410,350,12175871
10129,19170,2020-03-10,0.043795620437956206,8220,7860,-360,7649332
10130,19170,2020-03-04,0.07381776239907728,8670,8030,-640,13231425
10131,19170,2020-03-03,0.1991701244813278,7230,8670,1440,36558831
10132,19170,2020-02-27,0.05056890012642225,7910,7510,-400,9295152
10133,19170,2020-02-25,0.11299435028248588,8850,7850,-1000,12061702
10134,19170,2020-02-21,0.10565110565110565,8140,9000,860,39241653
10135,19170,2020-02-20,0.11135371179039301,9160,8140,-1020,25453076
10136,19170,2020-02-19,0.11300121506682867,8230,9160,930,53340093
10137,19170,2020-02-18,0.1494413407821229,7160,8230,1070,53332630
10138,19170,2020-02-12,0.0758988015978695,7510,6940,-570,6817712
10139,19170,2020-02-11,0.046954314720812185,7880,7510,-370,15066138
10140,19170,2020-02-10,0.10454545454545454,8800,7880,-920,11438334
10141,19170,2020-02-07,0.11735205616850551,9970,8800,-1170,36655616
10142,19170,2020-02-06,0.16608187134502925,8550,9970,1420,48735427
10143,19170,2020-02-05,0.2993920972644377,6580,8550,1970,27487133
10144,19170,2020-01-31,0.05420827389443652,7010,6630,-380,1289446
10145,19170,2020-01-29,0.07522697795071336,7710,7130,-580,2197885
10146,19170,2020-01-08,0.06482758620689655,7250,6780,-470,831279
10147,19170,2020-01-07,0.04316546762589928,6950,7250,300,3214624
10148,19170,2019-12-06,0.04661654135338346,6650,6960,310,1261923
10149,19170,2019-11-19,0.04011461318051576,6980,6700,-280,706489
10150,19170,2019-11-08,0.040927694406548434,7330,7030,-300,1200843
10151,19170,2019-11-06,0.0546583850931677,8050,7610,-440,5316376
10152,19170,2019-11-05,0.12273361227336123,7170,8050,880,6533414
10153,19170,2019-11-04,0.060650887573964495,6760,7170,410,6669599
10154,19170,2019-10-28,0.04723127035830619,6140,6430,290,932363
10155,19170,2019-10-24,0.044753086419753084,6480,6190,-290,613984
10156,19170,2019-10-23,0.06578947368421052,6080,6480,400,3154438
10157,19170,2019-08-26,0.05114638447971781,5670,5380,-290,132853
10158,19170,2019-08-07,0.043824701195219126,5020,5240,220,352614
10159,19170,2019-08-06,0.07380073800738007,5420,5020,-400,683949
10160,19170,2019-08-05,0.11437908496732026,6120,5420,-700,596476
10161,19170,2019-07-29,0.06396255850234009,6410,6000,-410,368507
10162,19170,2019-07-08,0.04451038575667656,6740,6440,-300,223145
10163,19170,2019-05-28,0.043154761904761904,6720,7010,290,324009
10164,19170,2019-05-13,0.0431266846361186,7420,7100,-320,584999
10165,19170,2019-04-30,0.05643044619422572,7620,8050,430,4787042
10166,19170,2019-04-10,0.048051948051948054,7700,8070,370,1599160
10167,19170,2019-04-01,0.05593451568894952,7330,7740,410,4925023
10168,19170,2019-03-04,0.08964646464646464,7920,8630,710,1909844
10169,19170,2019-02-11,0.04161248374512354,7690,8010,320,4784465
10170,19170,2019-02-07,0.05027932960893855,7160,7520,360,1423624
10171,19170,2019-01-18,0.04451038575667656,6740,7040,300,648865
10172,19170,2019-01-07,0.08333333333333333,6840,7410,570,2745330
10173,19170,2019-01-04,0.1085899513776337,6170,6840,670,1526914
10174,19170,2018-12-10,0.05714285714285714,7000,6600,-400,833339
10175,19170,2018-11-27,0.04415954415954416,7020,7330,310,736433
10176,19170,2018-11-05,0.05278592375366569,6820,7180,360,1267878
10177,19170,2018-11-02,0.04281345565749235,6540,6820,280,280496
10178,19170,2018-10-30,0.047540983606557376,6100,6390,290,608259
10179,19170,2018-10-29,0.08132530120481928,6640,6100,-540,593283
10180,19170,2018-10-26,0.052781740370898715,7010,6640,-370,501619
10181,19170,2018-10-23,0.054474708171206226,7710,7290,-420,446768
10182,19170,2018-10-16,0.0446685878962536,6940,7250,310,623264
10183,19170,2018-10-11,0.06521739130434782,7360,6880,-480,1131355
10184,19170,2018-10-08,0.04198473282442748,7860,7530,-330,934794
10185,19170,2018-10-05,0.043795620437956206,8220,7860,-360,1770981
10186,19170,2018-10-04,0.047508690614136734,8630,8220,-410,2297480
10187,19170,2018-10-02,0.05683060109289618,9150,8630,-520,4871591
10188,19170,2018-10-01,0.07142857142857142,8540,9150,610,24116130
10189,19170,2018-08-17,0.05891238670694864,6620,7010,390,568877
10190,19170,2018-08-13,0.05084745762711865,7080,6720,-360,407039
10191,19170,2018-07-26,0.0448,6250,6530,280,173757
10192,19170,2018-07-25,0.042879019908116385,6530,6250,-280,256124
10193,19170,2018-07-23,0.055964653902798235,6790,6410,-380,318384
10194,19170,2018-07-03,0.05341246290801187,6740,7100,360,698392
10195,19170,2018-07-02,0.04936530324400564,7090,6740,-350,381402
10196,19170,2018-06-28,0.059602649006622516,7550,7100,-450,329513
10197,19170,2018-06-19,0.06641604010025062,7980,7450,-530,627467
10198,19170,2018-06-07,0.05070754716981132,8480,8910,430,1219139
10199,19170,2018-06-01,0.04628501827040195,8210,8590,380,522111
10200,19170,2018-05-24,0.05011389521640091,8780,8340,-440,1494535
10201,19170,2018-05-23,0.07383966244725738,9480,8780,-700,1426735
10202,19170,2018-05-21,0.061386138613861385,10100,9480,-620,1458161
10203,19170,2018-05-18,0.07339449541284404,10900,10100,-800,3718064
10204,19170,2018-05-15,0.04932735426008968,11150,10600,-550,841688
10205,19170,2018-05-04,0.08850457782299084,9830,10700,870,1863145
10206,19170,2018-04-30,0.05612244897959184,9800,10350,550,877743
10207,19170,2018-04-19,0.05069124423963134,10850,10300,-550,1359521
10208,19170,2018-04-18,0.07659574468085106,11750,10850,-900,1630860
10209,19170,2018-04-13,0.04424778761061947,11300,11800,500,2884073
10210,19170,2018-04-11,0.17834394904458598,9420,11100,1680,7739495
10211,19170,2018-04-09,0.05808656036446469,8780,9290,510,830990
10212,19170,2018-03-23,0.08013544018058691,8860,8150,-710,1469892
10213,19170,2018-03-19,0.052525252525252523,9900,9380,-520,1147604
10214,19170,2018-03-15,0.07675675675675675,9250,9960,710,2934240
10215,19170,2018-03-12,0.05460750853242321,8790,9270,480,1887643
10216,19170,2018-02-22,0.04397905759162304,9550,9130,-420,1103728
10217,19170,2018-02-20,0.06704545454545455,8800,9390,590,5188066
10218,19170,2018-02-14,0.040380047505938245,8420,8760,340,779625
10219,19170,2018-02-13,0.04858757062146893,8850,8420,-430,3634690
10220,19170,2018-02-12,0.07926829268292683,8200,8850,650,2929934
10221,19170,2018-02-06,0.040236686390532544,8450,8110,-340,1191030
10222,19170,2018-02-05,0.04842342342342342,8880,8450,-430,5357089
10223,19170,2018-02-02,0.04964539007092199,8460,8880,420,764237
10224,19170,2018-01-26,0.05057471264367816,8700,9140,440,891678
10225,19170,2018-01-18,0.06302021403091558,8410,8940,530,512695
10226,19170,2018-01-11,0.06698002350176263,8510,9080,570,672258
10227,19170,2018-01-09,0.05,8800,8360,-440,586124
10228,19170,2018-01-05,0.05924170616113744,8440,8940,500,647279
10229,19170,2018-01-03,0.07421383647798742,7950,8540,590,2617845
10230,19170,2017-12-11,0.04184100418410042,7170,7470,300,214007
10231,19170,2017-12-07,0.0426098535286285,7510,7190,-320,541086
10232,19170,2017-11-20,0.06415620641562064,7170,7630,460,3120891
10233,19170,2017-11-10,0.0607661822985469,7570,7110,-460,2706796
10234,19170,2017-11-09,0.15572519083969466,6550,7570,1020,8236195
10235,19170,2017-11-01,0.042483660130718956,6120,6380,260,218365
10236,19170,2017-08-28,0.05201342281879195,5960,6270,310,172149
10237,19170,2017-04-27,0.072992700729927,6850,6350,-500,824411
10238,19170,2017-04-24,0.11147540983606558,6100,6780,680,5601021
10239,19170,2017-04-07,0.04568527918781726,5910,6180,270,197365
10240,19170,2017-03-27,0.05927342256214149,5230,5540,310,675698
10241,19170,2017-03-03,0.04247787610619469,5650,5410,-240,138689
10242,19170,2016-12-28,0.04601769911504425,5650,5910,260,155125
10243,19170,2016-12-15,0.06284658040665435,5410,5750,340,235601
10244,19170,2016-12-12,0.048355899419729204,5170,5420,250,127021
10245,19170,2016-11-23,0.04063604240282685,5660,5430,-230,137231
10246,19170,2016-11-10,0.10285714285714286,5250,5790,540,294685
10247,19170,2016-11-09,0.08216783216783216,5720,5250,-470,466283
10248,19170,2016-11-02,0.08085808580858085,6060,5570,-490,342874
10249,19170,2016-09-30,0.06935687263556116,7930,7380,-550,851543
10250,19170,2016-09-28,0.07470511140235911,7630,8200,570,2791232
10251,19170,2016-09-27,0.05096418732782369,7260,7630,370,762025
10252,19170,2016-09-08,0.045714285714285714,7000,7320,320,1029481
10253,19170,2016-08-31,0.04484304932735426,6690,6990,300,476429
10254,19170,2016-08-29,0.07044198895027624,7240,6730,-510,776181
10255,19170,2016-08-23,0.10875706214689265,7080,7850,770,1896442
10256,34020,2021-06-02,0.11645569620253164,19750,22050,2300,65569886
10257,34020,2021-05-31,0.11484593837535013,17850,19900,2050,40307576
10258,34020,2021-05-28,0.0625,16800,17850,1050,22969402
10259,34020,2021-05-27,0.043478260869565216,16100,16800,700,22653777
10260,34020,2021-05-26,0.09523809523809523,14700,16100,1400,25778709
10261,34020,2021-05-24,0.046762589928057555,13900,14550,650,14284697
10262,34020,2021-05-20,0.09523809523809523,12600,13800,1200,10551893
10263,34020,2021-05-03,0.08243727598566308,13950,12800,-1150,6583366
10264,34020,2021-04-14,0.06691449814126393,13450,14350,900,9803404
10265,34020,2021-03-29,0.04330708661417323,12700,13250,550,7978246
10266,34020,2021-03-12,0.07075471698113207,10600,11350,750,4854988
10267,34020,2021-03-03,0.056074766355140186,10700,11300,600,3121554
10268,34020,2021-02-26,0.04504504504504504,11100,10600,-500,3778708
10269,34020,2021-02-25,0.08292682926829269,10250,11100,850,3366323
10270,34020,2021-02-24,0.06818181818181818,11000,10250,-750,4156906
10271,34020,2021-01-29,0.07114624505928854,12650,11750,-900,6873260
10272,34020,2021-01-14,0.045112781954887216,13300,13900,600,7981165
10273,34020,2021-01-11,0.0528169014084507,14200,13450,-750,6981930
10274,34020,2021-01-05,0.05755395683453238,13900,14700,800,7228208
10275,34020,2020-12-01,0.07462686567164178,16750,15500,-1250,9105455
10276,34020,2020-11-27,0.06542056074766354,16050,17100,1050,16536985
10277,34020,2020-11-26,0.04220779220779221,15400,16050,650,7391253
10278,34020,2020-11-18,0.05993690851735016,15850,14900,-950,7600712
10279,34020,2020-11-16,0.0425531914893617,16450,15750,-700,5797926
10280,34020,2020-11-09,0.06462585034013606,14700,15650,950,16870984
10281,34020,2020-11-05,0.05054151624548736,13850,14550,700,5530543
10282,34020,2020-10-26,0.0539568345323741,13900,13150,-750,3274617
10283,34020,2020-10-19,0.1078838174273859,12050,13350,1300,8173802
10284,34020,2020-10-05,0.05263157894736842,13300,14000,700,3595091
10285,34020,2020-09-28,0.05058365758754864,12850,13500,650,5477811
10286,34020,2020-09-23,0.04285714285714286,14000,13400,-600,5174096
10287,34020,2020-09-21,0.04,15000,14400,-600,5982061
10288,34020,2020-09-16,0.04666666666666667,15000,15700,700,8133286
10289,34020,2020-09-10,0.0425531914893617,14100,14700,600,24374578
10290,34020,2020-09-09,0.07540983606557378,15250,14100,-1150,11886727
10291,34020,2020-09-08,0.052795031055900624,16100,15250,-850,14535692
10292,34020,2020-09-02,0.050156739811912224,15950,16750,800,44917768
10293,34020,2020-08-31,0.23846153846153847,13000,16100,3100,72792099
10294,34020,2020-08-28,0.2621359223300971,10300,13000,2700,72620662
10295,34020,2020-08-14,0.07436182019977802,9010,9680,670,29948472
10296,34020,2020-08-03,0.11714285714285715,10500,9270,-1230,14335122
10297,34020,2020-07-29,0.09045226130653267,9950,10850,900,22574519
10298,34020,2020-07-28,0.1423650975889782,8710,9950,1240,7321406
10299,34020,2020-07-27,0.06609547123623011,8170,8710,540,4790529
10300,34020,2020-07-24,0.05110336817653891,8610,8170,-440,3983059
10301,34020,2020-07-22,0.2,7150,8580,1430,81915574
10302,34020,2020-07-21,0.3,5500,7150,1650,33938081
10303,34020,2020-07-20,0.1190233977619532,4915,5500,585,14522226
10304,34020,2020-06-30,0.04202586206896552,4640,4835,195,4391289
10305,34020,2020-06-16,0.10396570203644159,4665,5150,485,7651105
10306,34020,2020-06-15,0.059475806451612906,4960,4665,-295,2380851
10307,34020,2020-06-02,0.0945945945945946,4440,4860,420,12206389
10308,34020,2020-05-27,0.14285714285714285,3990,4560,570,18027176
10309,34020,2020-05-22,0.040097205346294046,4115,3950,-165,2473381
10310,34020,2020-05-19,0.04639175257731959,3880,4060,180,3387190
10311,34020,2020-04-24,0.04092071611253197,3910,3750,-160,1752023
10312,34020,2020-04-20,0.07068062827225131,3820,4090,270,6061652
10313,34020,2020-04-16,0.08455882352941177,4080,3735,-345,4869416
10314,34020,2020-04-03,0.04055944055944056,3575,3720,145,4658939
10315,34020,2020-04-01,0.04978038067349927,3415,3585,170,11071823
10316,34020,2020-03-30,0.04874651810584958,3590,3415,-175,4475555
10317,34020,2020-03-27,0.10122699386503067,3260,3590,330,12592104
10318,34020,2020-03-26,0.06535947712418301,3060,3260,200,6259963
10319,34020,2020-03-25,0.09090909090909091,2805,3060,255,4245711
10320,34020,2020-03-24,0.13562753036437247,2470,2805,335,2832196
10321,34020,2020-03-23,0.07142857142857142,2660,2470,-190,2689734
10322,34020,2020-03-19,0.08635578583765112,2895,2645,-250,3790942
10323,34020,2020-03-18,0.06913183279742766,3110,2895,-215,3309600
10324,34020,2020-03-17,0.0779896013864818,2885,3110,225,5123524
10325,34020,2020-03-16,0.07085346215780998,3105,2885,-220,4159318
10326,34020,2020-03-13,0.051908396946564885,3275,3105,-170,6606806
10327,34020,2020-03-12,0.08774373259052924,3590,3275,-315,9676133
10328,34020,2020-03-11,0.21444201312910285,4570,3590,-980,18831495
10329,34020,2020-03-09,0.05421686746987952,4980,4710,-270,2004801
10330,34020,2020-02-24,0.04275092936802974,5380,5150,-230,1933589
10331,34020,2020-02-17,0.05799648506151142,5690,6020,330,4456082
10332,34020,2020-02-14,0.04981549815498155,5420,5690,270,2734795
10333,34020,2020-01-30,0.05714285714285714,5950,5610,-340,2112366
10334,34020,2020-01-29,0.04340836012861737,6220,5950,-270,1843903
10335,34020,2020-01-23,0.05862068965517241,5800,6140,340,3923005
10336,34020,2020-01-22,0.05263157894736842,5510,5800,290,2030554
10337,34020,2019-12-12,0.0449438202247191,5340,5580,240,1789927
10338,34020,2019-11-01,0.06026058631921824,6140,5770,-370,3360057
10339,34020,2019-09-19,0.0413589364844904,6770,7050,280,2802848
10340,34020,2019-09-17,0.04783258594917788,6690,7010,320,6977102
10341,34020,2019-09-16,0.060221870047543584,6310,6690,380,2180028
10342,34020,2019-08-19,0.05225225225225225,5550,5840,290,1256394
10343,34020,2019-08-05,0.10499139414802065,5810,5200,-610,3513614
10344,34020,2019-07-29,0.040625,6400,6140,-260,1900235
10345,34020,2019-07-26,0.04746317512274959,6110,6400,290,4164548
10346,34020,2019-06-28,0.06060606060606061,6600,6200,-400,2601348
10347,34020,2019-05-30,0.046822742474916385,5980,6260,280,1822254
10348,34020,2019-05-29,0.041666666666666664,6240,5980,-260,2044631
10349,34020,2019-05-13,0.05246913580246913,6480,6140,-340,1774059
10350,34020,2019-05-03,0.05779569892473118,7440,7010,-430,2470841
10351,34020,2019-05-02,0.06437768240343347,6990,7440,450,4654884
10352,34020,2019-04-18,0.0403899721448468,7180,6890,-290,1424647
10353,34020,2019-04-01,0.059790732436472344,6690,7090,400,1656328
10354,34020,2019-02-22,0.08842794759825327,9160,8350,-810,5643940
10355,34020,2019-02-14,0.09856459330143541,10450,9420,-1030,5235166
10356,34020,2019-02-13,0.045662100456621,10950,10450,-500,1487102
10357,34020,2019-02-07,0.04035874439461883,11150,11600,450,795714
10358,34020,2018-12-26,0.0986046511627907,10750,9690,-1060,2279461
10359,34020,2018-11-26,0.055299539170506916,10850,11450,600,1629886
10360,34020,2018-11-14,0.06756756756756757,11100,10350,-750,2558000
10361,34020,2018-11-02,0.0547945205479452,10950,11550,600,800678
10362,34020,2018-10-11,0.05970149253731343,13400,12600,-800,1034277
10363,34020,2018-10-10,0.06293706293706294,14300,13400,-900,1121651
10364,34020,2018-08-01,0.04983388704318937,15050,14300,-750,1471602
10365,34020,2018-07-06,0.04195804195804196,14300,14900,600,634266
10366,34020,2018-07-02,0.07348242811501597,15650,14500,-1150,1669731
10367,34020,2018-06-21,0.046153846153846156,16250,15500,-750,869543
10368,34020,2018-06-19,0.06451612903225806,17050,15950,-1100,2405351
10369,34020,2018-06-14,0.058823529411764705,18700,17600,-1100,1273870
10370,34020,2018-05-29,0.05555555555555555,19800,18700,-1100,1292202
10371,34020,2018-05-28,0.06451612903225806,18600,19800,1200,1916388
10372,34020,2018-05-25,0.041237113402061855,19400,18600,-800,1403864
10373,34020,2018-05-14,0.05670103092783505,19400,20500,1100,1855015
10374,34020,2018-05-10,0.05945945945945946,18500,19600,1100,1781460
10375,34020,2018-05-04,0.04065040650406504,18450,19200,750,1682285
10376,34020,2018-04-18,0.0594059405940594,15150,16050,900,1840724
10377,34020,2018-03-27,0.08169934640522876,15300,16550,1250,2240849
10378,34020,2018-01-29,0.04643962848297214,16150,16900,750,1830016
10379,34020,2018-01-10,0.04242424242424243,16500,17200,700,2060863
10380,34020,2017-12-08,0.05389221556886228,16700,15800,-900,1391743
10381,34020,2017-12-05,0.09006211180124224,16100,17550,1450,3019559
10382,34020,2017-11-15,0.04,17500,16800,-700,878226
10383,34020,2017-10-23,0.05154639175257732,19400,18400,-1000,2046507
10384,34020,2017-10-19,0.05929919137466307,18550,19650,1100,2013938
10385,34020,2017-08-03,0.08759124087591241,20550,18750,-1800,2151421
10386,34020,2017-07-14,0.04728132387706856,21150,20150,-1000,1379999
10387,34020,2017-06-28,0.04398148148148148,21600,20650,-950,1369069
10388,34020,2017-06-19,0.10995850622406639,24100,21450,-2650,3351941
10389,34020,2017-05-29,0.04680851063829787,23500,22400,-1100,1883429
10390,34020,2017-04-05,0.04612159329140461,23850,24950,1100,1552075
10391,34020,2017-03-23,0.04285714285714286,24500,25550,1050,1216026
10392,34020,2017-03-07,0.04801670146137787,23950,25100,1150,1225705
10393,34020,2017-02-28,0.07706766917293233,26600,24550,-2050,3256278
10394,34020,2017-02-01,0.04007285974499089,27450,28550,1100,421770
10395,34020,2016-12-20,0.05927342256214149,26150,27700,1550,1233580
10396,34020,2016-12-07,0.05204460966542751,26900,25500,-1400,663612
10397,34020,2016-11-18,0.04609929078014184,28200,26900,-1300,1067127
10398,34020,2016-11-11,0.05273069679849341,26550,27950,1400,1266798
10399,34020,2016-11-10,0.09937888198757763,24150,26550,2400,1160017
10400,34020,2016-11-09,0.056640625,25600,24150,-1450,1452446
10401,34020,2016-10-12,0.045275590551181105,25400,26550,1150,801632
10402,34020,2016-10-06,0.07214428857715431,24950,26750,1800,1291773
10403,34020,2016-09-12,0.04067796610169491,29500,28300,-1200,536770
10404,34020,2016-08-05,0.060903732809430254,25450,27000,1550,1206287
10405,175330,2021-05-21,0.04066073697585769,7870,7550,-320,878565
10406,175330,2021-04-27,0.0413589364844904,6770,7050,280,1182728
10407,175330,2021-01-29,0.040740740740740744,5400,5180,-220,502828
10408,175330,2020-12-29,0.044142614601018676,5890,5630,-260,625995
10409,175330,2020-12-17,0.0528,6250,5920,-330,707647
10410,175330,2020-11-11,0.053763440860215055,5580,5880,300,1271307
10411,175330,2020-11-02,0.043137254901960784,5100,5320,220,751655
10412,175330,2020-06-15,0.06126482213438735,5060,4750,-310,446666
10413,175330,2020-05-19,0.06270996640537514,4465,4745,280,661645
10414,175330,2020-04-27,0.054982817869415807,4365,4605,240,776746
10415,175330,2020-03-26,0.048284625158831,3935,4125,190,854056
10416,175330,2020-03-25,0.08701657458563536,3620,3935,315,625522
10417,175330,2020-03-24,0.040229885057471264,3480,3620,140,521168
10418,175330,2020-03-23,0.08900523560209424,3820,3480,-340,627780
10419,175330,2020-03-20,0.13185185185185186,3375,3820,445,1052187
10420,175330,2020-03-19,0.09759358288770054,3740,3375,-365,1322175
10421,175330,2020-03-17,0.06318347509113001,4115,3855,-260,867784
10422,175330,2020-03-13,0.05915813424345848,4395,4135,-260,1187241
10423,175330,2020-03-09,0.047520661157024795,4840,4610,-230,763653
10424,175330,2018-10-11,0.046232876712328765,5840,5570,-270,447059
10425,175330,2018-07-13,0.06890459363957598,5660,6050,390,960454
10426,175330,2018-02-07,0.04599406528189911,6740,6430,-310,599624
10427,175330,2017-07-31,0.04524886877828054,6630,6930,300,1408344
10428,175330,2016-11-02,0.0472972972972973,5920,5640,-280,628772
10429,2790,2021-04-28,0.10151515151515152,66000,72700,6700,1287584
10430,2790,2021-01-29,0.04383116883116883,61600,58900,-2700,293208
10431,2790,2021-01-26,0.04066265060240964,66400,63700,-2700,229952
10432,2790,2021-01-18,0.0416,62500,59900,-2600,230649
10433,2790,2021-01-13,0.041237113402061855,58200,60600,2400,405259
10434,2790,2020-12-09,0.055350553505535055,54200,57200,3000,464140
10435,2790,2020-11-20,0.05905511811023622,50800,53800,3000,544612
10436,2790,2020-10-30,0.041804180418041806,45450,43550,-1900,204079
10437,2790,2020-08-20,0.049557522123893805,56500,53700,-2800,163356
10438,2790,2020-08-18,0.05527638190954774,59700,56400,-3300,266151
10439,2790,2020-07-02,0.04944500504540868,49550,52000,2450,301438
10440,2790,2020-06-30,0.09554140127388536,47100,51600,4500,1747806
10441,2790,2020-06-25,0.04513540621865597,49850,47600,-2250,223557
10442,2790,2020-06-15,0.07208872458410351,54100,50200,-3900,228903
10443,2790,2020-05-29,0.05474452554744526,54800,57800,3000,246501
10444,2790,2020-05-19,0.056672760511883,54700,57800,3100,257532
10445,2790,2020-04-08,0.09426987060998152,54100,59200,5100,485599
10446,2790,2020-04-02,0.045454545454545456,50600,52900,2300,114545
10447,2790,2020-04-01,0.08664259927797834,55400,50600,-4800,162390
10448,2790,2020-03-25,0.1033013844515442,46950,51800,4850,263173
10449,2790,2020-03-24,0.07069555302166476,43850,46950,3100,179382
10450,2790,2020-03-23,0.10783316378433368,49150,43850,-5300,177304
10451,2790,2020-03-19,0.06432748538011696,51300,48000,-3300,281988
10452,2790,2020-03-16,0.05038022813688213,52600,49950,-2650,203610
10453,2790,2020-03-13,0.045372050816696916,55100,52600,-2500,328339
10454,2790,2020-03-12,0.045060658578856154,57700,55100,-2600,312917
10455,2790,2020-03-11,0.05718954248366013,61200,57700,-3500,249719
10456,2790,2020-02-28,0.047619047619047616,65100,62000,-3100,193127
10457,2790,2020-02-24,0.04154302670623145,67400,64600,-2800,179160
10458,2790,2020-02-05,0.07432432432432433,74000,68500,-5500,419078
10459,2790,2020-01-30,0.04392764857881137,77400,74000,-3400,101839
10460,2790,2020-01-28,0.07692307692307693,83200,76800,-6400,251693
10461,2790,2020-01-20,0.0537280701754386,91200,86300,-4900,198397
10462,2790,2020-01-13,0.041666666666666664,86400,90000,3600,209911
10463,2790,2020-01-07,0.06064356435643564,80800,85700,4900,197173
10464,2790,2019-12-20,0.040892193308550186,80700,84000,3300,219287
10465,2790,2019-12-05,0.05308641975308642,81000,76700,-4300,175164
10466,2790,2019-10-30,0.17852161785216178,71700,84500,12800,493349
10467,2790,2019-10-14,0.06761006289308176,63600,67900,4300,224112
10468,2790,2019-10-11,0.11173184357541899,71600,63600,-8000,451526
10469,2790,2019-10-08,0.04454022988505747,69600,72700,3100,159911
10470,2790,2019-09-03,0.04584040747028863,58900,61600,2700,156874
10471,2790,2019-08-30,0.08256880733944955,54500,59000,4500,196939
10472,2790,2019-08-26,0.05615942028985507,55200,52100,-3100,72436
10473,2790,2019-08-06,0.044444444444444446,54000,51600,-2400,195074
10474,2790,2019-08-05,0.0425531914893617,56400,54000,-2400,212960
10475,2790,2019-07-17,0.08661417322834646,63500,58000,-5500,419090
10476,2790,2019-07-08,0.04954954954954955,66600,63300,-3300,100731
10477,2790,2019-07-05,0.06050955414012739,62800,66600,3800,234947
10478,2790,2019-06-14,0.043478260869565216,64400,61600,-2800,165039
10479,2790,2019-05-13,0.047683923705722074,73400,69900,-3500,130012
10480,2790,2019-05-09,0.051047120418848166,76400,72500,-3900,163003
10481,2790,2019-04-30,0.06583850931677018,80500,75200,-5300,409452
10482,2790,2019-04-15,0.06919060052219321,76600,81900,5300,409712
10483,2790,2019-04-12,0.07584269662921349,71200,76600,5400,492069
10484,2790,2019-03-15,0.049786628733997154,70300,73800,3500,278865
10485,2790,2019-02-20,0.10708898944193061,66300,73400,7100,654272
10486,2790,2019-02-08,0.04704097116843703,65900,62800,-3100,235811
10487,2790,2019-01-02,0.06602475928473177,72700,67900,-4800,199818
10488,2790,2018-12-27,0.049490538573508006,68700,72100,3400,142865
10489,2790,2018-12-18,0.05105105105105105,66600,70000,3400,299201
10490,2790,2018-12-12,0.05434782608695652,64400,67900,3500,363191
10491,2790,2018-11-23,0.0423861852433281,63700,61000,-2700,165815
10492,2790,2018-11-21,0.045454545454545456,59400,62100,2700,437613
10493,2790,2018-11-15,0.048109965635738834,58200,61000,2800,434466
10494,2790,2018-11-01,0.04186795491143317,62100,64700,2600,162600
10495,2790,2018-10-29,0.14738292011019283,72600,61900,-10700,582796
10496,2790,2018-10-23,0.04285714285714286,77000,73700,-3300,202177
10497,2790,2018-10-22,0.0504774897680764,73300,77000,3700,165852
10498,2790,2018-10-18,0.044213263979193757,76900,73500,-3400,247594
10499,2790,2018-10-11,0.043137254901960784,76500,73200,-3300,335022
10500,2790,2018-10-04,0.14594594594594595,92500,79000,-13500,609410
10501,2790,2018-08-23,0.0446985446985447,96200,100500,4300,193374
10502,2790,2018-08-01,0.054279749478079335,95800,101000,5200,259450
10503,2790,2018-07-27,0.04,102500,98400,-4100,252114
10504,2790,2018-07-17,0.0410958904109589,109500,105000,-4500,131319
10505,2790,2018-07-04,0.04700854700854701,117000,111500,-5500,100924
10506,2790,2018-05-14,0.048327137546468404,134500,128000,-6500,261395
10507,2790,2018-05-03,0.045774647887323945,142000,135500,-6500,88167
10508,2790,2018-04-13,0.05,140000,147000,7000,107349
10509,2790,2018-04-02,0.0528169014084507,142000,149500,7500,253192
10510,2790,2018-03-15,0.04059040590405904,135500,141000,5500,100126
10511,2790,2018-03-09,0.060836501901140684,131500,139500,8000,165080
10512,2790,2018-02-28,0.04182509505703422,131500,126000,-5500,81931
10513,2790,2018-02-21,0.048,125000,131000,6000,121393
10514,2790,2018-02-07,0.05514705882352941,136000,128500,-7500,168729
10515,2790,2018-01-24,0.06070287539936102,156500,147000,-9500,199486
10516,2790,2018-01-04,0.04195804195804196,143000,137000,-6000,98856
10517,2790,2017-12-12,0.046357615894039736,151000,144000,-7000,165174
10518,2790,2017-12-04,0.06375838926174497,149000,158500,9500,221321
10519,2790,2017-11-03,0.041379310344827586,145000,151000,6000,171075
10520,2790,2017-10-31,0.06514657980456026,153500,143500,-10000,541556
10521,2790,2017-10-30,0.04778156996587031,146500,153500,7000,324379
10522,2790,2017-10-26,0.10545454545454545,137500,152000,14500,358167
10523,2790,2017-10-24,0.058365758754863814,128500,136000,7500,140834
10524,2790,2017-10-13,0.06451612903225806,124000,132000,8000,238735
10525,2790,2017-09-29,0.046610169491525424,118000,123500,5500,148876
10526,2790,2017-09-25,0.05371900826446281,121000,114500,-6500,119621
10527,2790,2017-09-08,0.043478260869565216,126500,121000,-5500,124597
10528,2790,2017-08-24,0.046875,128000,134000,6000,198194
10529,2790,2017-07-07,0.04633204633204633,129500,123500,-6000,247823
10530,2790,2017-06-26,0.04744525547445255,137000,130500,-6500,115461
10531,2790,2017-06-19,0.042105263157894736,142500,136500,-6000,121348
10532,2790,2017-05-12,0.04472843450479233,156500,149500,-7000,202565
10533,2790,2017-05-08,0.06810035842293907,139500,149000,9500,327643
10534,2790,2017-05-04,0.04887218045112782,133000,139500,6500,236086
10535,2790,2017-04-21,0.040892193308550186,134500,140000,5500,254886
10536,2790,2017-04-19,0.05555555555555555,126000,133000,7000,208744
10537,2790,2017-04-17,0.04583333333333333,120000,125500,5500,294995
10538,2790,2017-03-03,0.10975609756097561,123000,109500,-13500,543308
10539,2790,2017-03-02,0.05384615384615385,130000,123000,-7000,174354
10540,2790,2017-02-24,0.07053941908713693,120500,129000,8500,313373
10541,2790,2017-02-15,0.04081632653061224,122500,127500,5000,203515
10542,2790,2017-02-02,0.08365019011406843,131500,120500,-11000,535787
10543,2790,2017-01-16,0.04633204633204633,129500,135500,6000,201949
10544,2790,2017-01-09,0.04,125000,120000,-5000,203532
10545,2790,2017-01-02,0.07894736842105263,133000,122500,-10500,195498
10546,2790,2016-12-08,0.052845528455284556,123000,129500,6500,215964
10547,2790,2016-12-02,0.043137254901960784,127500,122000,-5500,127946
10548,2790,2016-11-30,0.04797047970479705,135500,129000,-6500,203432
10549,2790,2016-11-29,0.07114624505928854,126500,135500,9000,277768
10550,2790,2016-11-21,0.06181818181818182,137500,129000,-8500,314197
10551,2790,2016-10-25,0.09034267912772585,160500,146000,-14500,682883
10552,2790,2016-08-23,0.04946996466431095,141500,148500,7000,165548
10553,2790,2016-08-08,0.046263345195729534,140500,147000,6500,354248
10554,2790,2016-08-05,0.05704697986577181,149000,140500,-8500,288657
10555,2790,2016-08-02,0.0410958904109589,146000,152000,6000,253493
10556,316140,2021-05-06,0.04285714285714286,10500,10950,450,4710798
10557,316140,2021-04-07,0.054455445544554455,10100,10650,550,6075671
10558,316140,2020-12-29,0.04532019704433497,10150,9690,-460,4206637
10559,316140,2020-06-16,0.06306306306306306,8880,9440,560,2269007
10560,316140,2020-06-15,0.05026737967914439,9350,8880,-470,2780928
10561,316140,2020-06-03,0.06701030927835051,9700,10350,650,4612618
10562,316140,2020-06-02,0.06359649122807018,9120,9700,580,4494389
10563,316140,2020-05-29,0.04462242562929062,8740,9130,390,6520075
10564,316140,2020-05-28,0.045454545454545456,8360,8740,380,7434397
10565,316140,2020-05-04,0.052132701421800945,8440,8000,-440,3931182
10566,316140,2020-04-27,0.061146496815286625,7850,8330,480,4592760
10567,316140,2020-04-10,0.04319371727748691,7640,7970,330,4688039
10568,316140,2020-04-06,0.043835616438356165,7300,7620,320,2366158
10569,316140,2020-04-01,0.04967320261437908,7650,7270,-380,2763532
10570,316140,2020-03-27,0.0410958904109589,7300,7600,300,4177831
10571,316140,2020-03-25,0.06618705035971223,6950,7410,460,5753690
10572,316140,2020-03-24,0.05945121951219512,6560,6950,390,3259220
10573,316140,2020-03-23,0.11827956989247312,7440,6560,-880,3892290
10574,316140,2020-03-20,0.13414634146341464,6560,7440,880,4574529
10575,316140,2020-03-19,0.06285714285714286,7000,6560,-440,3761628
10576,316140,2020-03-18,0.04240766073871409,7310,7000,-310,3167429
10577,316140,2020-03-17,0.04193971166448231,7630,7310,-320,3269796
10578,316140,2020-03-13,0.05474452554744526,8220,7770,-450,4111531
10579,316140,2020-03-12,0.040840140023337225,8570,8220,-350,4539764
10580,316140,2020-03-09,0.06521739130434782,9200,8600,-600,3813212
10581,316140,2020-02-25,0.04148936170212766,9400,9790,390,2806191
10582,316140,2020-02-24,0.0417940876656473,9810,9400,-410,2931508
10583,316140,2020-01-28,0.041666666666666664,10800,10350,-450,2165380
10584,316140,2020-01-08,0.04054054054054054,11100,10650,-450,2640130
10585,316140,2019-12-27,0.04897959183673469,12250,11650,-600,2953576
10586,316140,2019-10-10,0.04680851063829787,11750,11200,-550,3462956
10587,316140,2019-08-30,0.057777777777777775,11250,11900,650,1603022
10588,316140,2019-08-02,0.04198473282442748,13100,12550,-550,1241170
10589,316140,2019-03-25,0.046263345195729534,14050,13400,-650,3167652
10590,316140,2019-03-22,0.040955631399317405,14650,14050,-600,23513784
10591,316140,2019-02-14,0.0457516339869281,15300,16000,700,2626606
10592,316140,2019-02-14,0.0457516339869281,15300,16000,700,2626606
10593,316140,2019-02-14,0.0457516339869281,15300,16000,700,2626606
10594,316140,2019-02-14,0.0457516339869281,15300,16000,700,2626606
10595,316140,2019-02-14,0.0457516339869281,15300,16000,700,2626606
10596,316140,2019-02-14,0.0457516339869281,15300,16000,700,2626606
10597,316140,2019-02-14,0.0457516339869281,15300,16000,700,2626606
10598,316140,2019-02-14,0.0457516339869281,15300,16000,700,2626606
10599,316140,2019-02-14,0.0457516339869281,15300,16000,700,2626606
10600,316140,2019-02-14,0.0457516339869281,15300,16000,700,2626606
10601,316140,2019-02-14,0.0457516339869281,15300,16000,700,2626606
10602,316140,2019-02-14,0.0457516339869281,15300,16000,700,2626606
10603,316140,2019-02-14,0.0457516339869281,15300,16000,700,2626606
10604,316140,2019-02-14,0.0457516339869281,15300,16000,700,2626606
10605,316140,2019-02-14,0.0457516339869281,15300,16000,700,2626606
10606,316140,2019-02-14,0.0457516339869281,15300,16000,700,2626606
10607,316140,2019-02-14,0.0457516339869281,15300,16000,700,2626606
10608,316140,2019-02-14,0.0457516339869281,15300,16000,700,2626606
10609,316140,2019-02-14,0.0457516339869281,15300,16000,700,2626606
10610,316140,2019-02-14,0.0457516339869281,15300,16000,700,2626606
10611,316140,2019-02-14,0.0457516339869281,15300,16000,700,2626606
10612,316140,2019-02-14,0.0457516339869281,15300,16000,700,2626606
10613,316140,2019-02-14,0.0457516339869281,15300,16000,700,2626606
10614,316140,2019-02-14,0.0457516339869281,15300,16000,700,2626606
10615,316140,2019-02-14,0.0457516339869281,15300,16000,700,2626606
10616,316140,2019-02-14,0.0457516339869281,15300,16000,700,2626606
10617,316140,2019-02-14,0.0457516339869281,15300,16000,700,2626606
10618,316140,2019-02-14,0.0457516339869281,15300,16000,700,2626606
10619,316140,2019-02-14,0.0457516339869281,15300,16000,700,2626606
10620,316140,2019-02-14,0.0457516339869281,15300,16000,700,2626606
10621,316140,2019-02-14,0.0457516339869281,15300,16000,700,2626606
10622,316140,2019-02-14,0.0457516339869281,15300,16000,700,2626606
10623,316140,2019-02-14,0.0457516339869281,15300,16000,700,2626606
10624,316140,2019-02-14,0.0457516339869281,15300,16000,700,2626606
10625,316140,2019-02-14,0.0457516339869281,15300,16000,700,2626606
10626,316140,2019-02-14,0.0457516339869281,15300,16000,700,2626606
10627,316140,2019-02-14,0.0457516339869281,15300,16000,700,2626606
10628,316140,2019-02-14,0.0457516339869281,15300,16000,700,2626606
10629,316140,2019-02-14,0.0457516339869281,15300,16000,700,2626606
10630,316140,2019-02-14,0.0457516339869281,15300,16000,700,2626606
10631,316140,2019-02-14,0.0457516339869281,15300,16000,700,2626606
10632,316140,2019-02-14,0.0457516339869281,15300,16000,700,2626606
10633,316140,2019-02-14,0.0457516339869281,15300,16000,700,2626606
10634,316140,2019-02-14,0.0457516339869281,15300,16000,700,2626606
10635,316140,2019-02-14,0.0457516339869281,15300,16000,700,2626606
10636,316140,2019-02-14,0.0457516339869281,15300,16000,700,2626606
10637,316140,2019-02-14,0.0457516339869281,15300,16000,700,2626606
10638,316140,2019-02-14,0.0457516339869281,15300,16000,700,2626606
10639,316140,2019-02-14,0.0457516339869281,15300,16000,700,2626606
10640,316140,2019-02-14,0.0457516339869281,15300,16000,700,2626606
10641,316140,2019-02-14,0.0457516339869281,15300,16000,700,2626606
10642,316140,2019-02-14,0.0457516339869281,15300,16000,700,2626606
10643,316140,2019-02-14,0.0457516339869281,15300,16000,700,2626606
10644,316140,2019-02-14,0.0457516339869281,15300,16000,700,2626606
10645,316140,2019-02-14,0.0457516339869281,15300,16000,700,2626606
10646,316140,2019-02-14,0.0457516339869281,15300,16000,700,2626606
10647,316140,2019-02-14,0.0457516339869281,15300,16000,700,2626606
10648,316140,2019-02-14,0.0457516339869281,15300,16000,700,2626606
10649,316140,2019-02-14,0.0457516339869281,15300,16000,700,2626606
10650,316140,2019-02-14,0.0457516339869281,15300,16000,700,2626606
10651,316140,2019-02-14,0.0457516339869281,15300,16000,700,2626606
10652,316140,2019-02-14,0.0457516339869281,15300,16000,700,2626606
10653,307950,2021-05-27,0.056338028169014086,106500,112500,6000,91867
10654,307950,2021-05-10,0.05116279069767442,107500,113000,5500,147417
10655,307950,2021-04-02,0.08189655172413793,116000,125500,9500,429644
10656,307950,2021-03-11,0.04054054054054054,111000,115500,4500,53957
10657,307950,2021-03-08,0.05714285714285714,122500,115500,-7000,132104
10658,307950,2021-02-24,0.055762081784386616,134500,127000,-7500,135260
10659,307950,2021-02-19,0.04263565891472868,129000,134500,5500,142687
10660,307950,2021-02-18,0.04797047970479705,135500,129000,-6500,95302
10661,307950,2021-02-16,0.0421455938697318,130500,136000,5500,190169
10662,307950,2021-02-09,0.06557377049180328,122000,130000,8000,221390
10663,307950,2021-02-01,0.05714285714285714,122500,129500,7000,132633
10664,307950,2021-01-29,0.0648854961832061,131000,122500,-8500,182496
10665,307950,2021-01-20,0.10887096774193548,124000,137500,13500,356867
10666,307950,2021-01-11,0.04240282685512368,141500,135500,-6000,545565
10667,307950,2021-01-04,0.1214574898785425,123500,138500,15000,634892
10668,307950,2020-12-30,0.060085836909871244,116500,123500,7000,396484
10669,307950,2020-12-23,0.04888888888888889,112500,118000,5500,532046
10670,307950,2020-12-21,0.04938271604938271,121500,115500,-6000,370650
10671,307950,2020-12-15,0.14349775784753363,111500,127500,16000,1581998
10672,307950,2020-12-14,0.09313725490196079,102000,111500,9500,1118606
10673,307950,2020-12-10,0.06486486486486487,92500,98500,6000,313772
10674,307950,2020-12-03,0.07727797001153403,86700,93400,6700,375682
10675,307950,2020-12-01,0.043532338308457715,80400,83900,3500,202281
10676,307950,2020-11-17,0.07496823379923762,78700,84600,5900,345277
10677,307950,2020-11-13,0.06860158311345646,75800,81000,5200,520838
10678,307950,2020-11-12,0.06311360448807854,71300,75800,4500,342747
10679,307950,2020-11-11,0.04852941176470588,68000,71300,3300,366220
10680,307950,2020-11-09,0.043343653250773995,64600,67400,2800,159183
10681,307950,2020-10-30,0.044444444444444446,67500,64500,-3000,149379
10682,307950,2020-10-28,0.053712480252764615,63300,66700,3400,138348
10683,307950,2020-10-22,0.05970149253731343,67000,63000,-4000,181143
10684,307950,2020-10-20,0.08744038155802862,62900,68400,5500,854068
10685,307950,2020-10-19,0.075,68000,62900,-5100,327283
10686,307950,2020-10-15,0.06466165413533835,66500,70800,4300,418711
10687,307950,2020-10-05,0.08562197092084006,61900,67200,5300,355104
10688,307950,2020-09-28,0.10229276895943562,56700,62500,5800,485511
10689,307950,2020-09-23,0.05714285714285714,56000,59200,3200,301667
10690,307950,2020-09-22,0.05245346869712352,59100,56000,-3100,252091
10691,307950,2020-09-17,0.044905008635578586,57900,60500,2600,337657
10692,307950,2020-09-14,0.11753371868978806,51900,58000,6100,873821
10693,307950,2020-09-10,0.06431535269709543,48200,51300,3100,613665
10694,307950,2020-09-09,0.08680947012401354,44350,48200,3850,506493
10695,307950,2020-08-28,0.07178217821782178,40400,43300,2900,296910
10696,307950,2020-08-25,0.04846938775510204,39200,41100,1900,73596
10697,307950,2020-08-18,0.04205607476635514,42800,41000,-1800,118290
10698,307950,2020-08-12,0.059665871121718374,41900,44400,2500,108811
10699,307950,2020-08-06,0.04591836734693878,39200,41000,1800,113075
10700,307950,2020-06-15,0.043532338308457715,40200,38450,-1750,46975
10701,307950,2020-06-12,0.04513064133016627,42100,40200,-1900,62099
10702,307950,2020-05-25,0.06707317073170732,41000,43750,2750,134131
10703,307950,2020-05-11,0.04327485380116959,42750,44600,1850,91691
10704,307950,2020-04-14,0.04252400548696845,36450,38000,1550,39708
10705,307950,2020-04-13,0.06177606177606178,38850,36450,-2400,58870
10706,307950,2020-04-09,0.07810320781032078,35850,38650,2800,74720
10707,307950,2020-04-08,0.040638606676342524,34450,35850,1400,48003
10708,307950,2020-03-27,0.06357388316151202,29100,30950,1850,103747
10709,307950,2020-03-25,0.14989733059548255,24350,28000,3650,117102
10710,307950,2020-03-24,0.07743362831858407,22600,24350,1750,37164
10711,307950,2020-03-23,0.07186858316221766,24350,22600,-1750,41596
10712,307950,2020-03-20,0.11697247706422019,21800,24350,2550,66240
10713,307950,2020-03-19,0.1383399209486166,25300,21800,-3500,99529
10714,307950,2020-03-18,0.11072056239015818,28450,25300,-3150,74083
10715,307950,2020-03-17,0.051666666666666666,30000,28450,-1550,98806
10716,307950,2020-03-16,0.06976744186046512,32250,30000,-2250,58836
10717,307950,2020-03-13,0.06521739130434782,34500,32250,-2250,124362
10718,307950,2020-03-12,0.07506702412868632,37300,34500,-2800,74904
10719,307950,2020-02-25,0.046052631578947366,38000,39750,1750,81786
10720,307950,2020-02-24,0.05472636815920398,40200,38000,-2200,90258
10721,307950,2020-01-28,0.04897959183673469,49000,46600,-2400,45058
10722,307950,2020-01-10,0.05061867266591676,44450,46700,2250,47685
10723,307950,2020-01-08,0.05638297872340425,47000,44350,-2650,72261
10724,307950,2019-08-26,0.050522648083623695,57400,54500,-2900,490999
10725,307950,2019-08-19,0.041121495327102804,53500,55700,2200,45924
10726,307950,2019-08-07,0.11702127659574468,47000,52500,5500,117671
10727,307950,2019-08-05,0.06057692307692308,52000,48850,-3150,51705
10728,307950,2019-07-29,0.04081632653061224,53900,51700,-2200,25489
10729,307950,2019-07-19,0.04296875,51200,53400,2200,49236
10730,307950,2019-07-09,0.041015625,51200,53300,2100,84566
10731,307950,2019-07-08,0.07913669064748201,55600,51200,-4400,109598
10732,307950,2019-06-11,0.05666156202143951,65300,69000,3700,103764
10733,307950,2019-06-10,0.060064935064935064,61600,65300,3700,47809
10734,307950,2019-05-30,0.06040268456375839,59600,63200,3600,52816
10735,307950,2019-05-28,0.0627177700348432,57400,61000,3600,41565
10736,307950,2019-05-27,0.04809286898839138,60300,57400,-2900,67040
10737,307950,2019-05-14,0.06774668630338733,67900,63300,-4600,173465
10738,307950,2019-05-13,0.07240437158469945,73200,67900,-5300,99364
10739,307950,2019-05-08,0.0504774897680764,73300,77000,3700,83513
10740,307950,2019-04-18,0.048863636363636366,88000,83700,-4300,93744
10741,307950,2019-04-11,0.059453032104637336,84100,89100,5000,290864
10742,307950,2019-04-10,0.047322540473225407,80300,84100,3800,398111
10743,307950,2019-04-09,0.0469361147327249,76700,80300,3600,241415
10744,307950,2019-03-29,0.07440811724915446,88700,82100,-6600,1131418
10745,307950,2019-03-28,0.1607795371498173,82100,88700,6600,4171304
10746,307950,2019-03-29,0.07440811724915446,88700,82100,-6600,1131418
10747,307950,2019-03-28,0.1607795371498173,82100,88700,6600,4171304
10748,307950,2019-03-29,0.07440811724915446,88700,82100,-6600,1131418
10749,307950,2019-03-28,0.1607795371498173,82100,88700,6600,4171304
10750,307950,2019-03-29,0.07440811724915446,88700,82100,-6600,1131418
10751,307950,2019-03-28,0.1607795371498173,82100,88700,6600,4171304
10752,307950,2019-03-29,0.07440811724915446,88700,82100,-6600,1131418
10753,307950,2019-03-28,0.1607795371498173,82100,88700,6600,4171304
10754,307950,2019-03-29,0.07440811724915446,88700,82100,-6600,1131418
10755,307950,2019-03-28,0.1607795371498173,82100,88700,6600,4171304
10756,307950,2019-03-29,0.07440811724915446,88700,82100,-6600,1131418
10757,307950,2019-03-28,0.1607795371498173,82100,88700,6600,4171304
10758,307950,2019-03-29,0.07440811724915446,88700,82100,-6600,1131418
10759,307950,2019-03-28,0.1607795371498173,82100,88700,6600,4171304
10760,307950,2019-03-29,0.07440811724915446,88700,82100,-6600,1131418
10761,307950,2019-03-28,0.1607795371498173,82100,88700,6600,4171304
10762,307950,2019-03-29,0.07440811724915446,88700,82100,-6600,1131418
10763,307950,2019-03-28,0.1607795371498173,82100,88700,6600,4171304
10764,307950,2019-03-29,0.07440811724915446,88700,82100,-6600,1131418
10765,307950,2019-03-28,0.1607795371498173,82100,88700,6600,4171304
10766,307950,2019-03-29,0.07440811724915446,88700,82100,-6600,1131418
10767,307950,2019-03-28,0.1607795371498173,82100,88700,6600,4171304
10768,307950,2019-03-29,0.07440811724915446,88700,82100,-6600,1131418
10769,307950,2019-03-28,0.1607795371498173,82100,88700,6600,4171304
10770,307950,2019-03-29,0.07440811724915446,88700,82100,-6600,1131418
10771,307950,2019-03-28,0.1607795371498173,82100,88700,6600,4171304
10772,307950,2019-03-29,0.07440811724915446,88700,82100,-6600,1131418
10773,307950,2019-03-28,0.1607795371498173,82100,88700,6600,4171304
10774,307950,2019-03-29,0.07440811724915446,88700,82100,-6600,1131418
10775,307950,2019-03-28,0.1607795371498173,82100,88700,6600,4171304
10776,307950,2019-03-29,0.07440811724915446,88700,82100,-6600,1131418
10777,307950,2019-03-28,0.1607795371498173,82100,88700,6600,4171304
10778,307950,2019-03-29,0.07440811724915446,88700,82100,-6600,1131418
10779,307950,2019-03-28,0.1607795371498173,82100,88700,6600,4171304
10780,307950,2019-03-29,0.07440811724915446,88700,82100,-6600,1131418
10781,307950,2019-03-28,0.1607795371498173,82100,88700,6600,4171304
10782,307950,2019-03-29,0.07440811724915446,88700,82100,-6600,1131418
10783,307950,2019-03-28,0.1607795371498173,82100,88700,6600,4171304
10784,307950,2019-03-29,0.07440811724915446,88700,82100,-6600,1131418
10785,307950,2019-03-28,0.1607795371498173,82100,88700,6600,4171304
10786,307950,2019-03-29,0.07440811724915446,88700,82100,-6600,1131418
10787,307950,2019-03-28,0.1607795371498173,82100,88700,6600,4171304
10788,307950,2019-03-29,0.07440811724915446,88700,82100,-6600,1131418
10789,307950,2019-03-28,0.1607795371498173,82100,88700,6600,4171304
10790,307950,2019-03-29,0.07440811724915446,88700,82100,-6600,1131418
10791,307950,2019-03-28,0.1607795371498173,82100,88700,6600,4171304
10792,307950,2019-03-29,0.07440811724915446,88700,82100,-6600,1131418
10793,307950,2019-03-28,0.1607795371498173,82100,88700,6600,4171304
10794,307950,2019-03-29,0.07440811724915446,88700,82100,-6600,1131418
10795,307950,2019-03-28,0.1607795371498173,82100,88700,6600,4171304
10796,307950,2019-03-29,0.07440811724915446,88700,82100,-6600,1131418
10797,307950,2019-03-28,0.1607795371498173,82100,88700,6600,4171304
10798,307950,2019-03-29,0.07440811724915446,88700,82100,-6600,1131418
10799,307950,2019-03-28,0.1607795371498173,82100,88700,6600,4171304
10800,307950,2019-03-29,0.07440811724915446,88700,82100,-6600,1131418
10801,307950,2019-03-28,0.1607795371498173,82100,88700,6600,4171304
10802,307950,2019-03-29,0.07440811724915446,88700,82100,-6600,1131418
10803,307950,2019-03-28,0.1607795371498173,82100,88700,6600,4171304
10804,307950,2019-03-29,0.07440811724915446,88700,82100,-6600,1131418
10805,307950,2019-03-28,0.1607795371498173,82100,88700,6600,4171304
10806,307950,2019-03-29,0.07440811724915446,88700,82100,-6600,1131418
10807,307950,2019-03-28,0.1607795371498173,82100,88700,6600,4171304
10808,307950,2019-03-29,0.07440811724915446,88700,82100,-6600,1131418
10809,307950,2019-03-28,0.1607795371498173,82100,88700,6600,4171304
10810,307950,2019-03-29,0.07440811724915446,88700,82100,-6600,1131418
10811,307950,2019-03-28,0.1607795371498173,82100,88700,6600,4171304
10812,307950,2019-03-29,0.07440811724915446,88700,82100,-6600,1131418
10813,307950,2019-03-28,0.1607795371498173,82100,88700,6600,4171304
10814,307950,2019-03-29,0.07440811724915446,88700,82100,-6600,1131418
10815,307950,2019-03-28,0.1607795371498173,82100,88700,6600,4171304
10816,307950,2019-03-29,0.07440811724915446,88700,82100,-6600,1131418
10817,307950,2019-03-28,0.1607795371498173,82100,88700,6600,4171304
10818,307950,2019-03-29,0.07440811724915446,88700,82100,-6600,1131418
10819,307950,2019-03-28,0.1607795371498173,82100,88700,6600,4171304
10820,307950,2019-03-29,0.07440811724915446,88700,82100,-6600,1131418
10821,307950,2019-03-28,0.1607795371498173,82100,88700,6600,4171304
10822,307950,2019-03-29,0.07440811724915446,88700,82100,-6600,1131418
10823,307950,2019-03-28,0.1607795371498173,82100,88700,6600,4171304
10824,307950,2019-03-29,0.07440811724915446,88700,82100,-6600,1131418
10825,307950,2019-03-28,0.1607795371498173,82100,88700,6600,4171304
10826,307950,2019-03-29,0.07440811724915446,88700,82100,-6600,1131418
10827,307950,2019-03-28,0.1607795371498173,82100,88700,6600,4171304
10828,307950,2019-03-29,0.07440811724915446,88700,82100,-6600,1131418
10829,307950,2019-03-28,0.1607795371498173,82100,88700,6600,4171304
10830,307950,2019-03-29,0.07440811724915446,88700,82100,-6600,1131418
10831,307950,2019-03-28,0.1607795371498173,82100,88700,6600,4171304
10832,307950,2019-03-29,0.07440811724915446,88700,82100,-6600,1131418
10833,307950,2019-03-28,0.1607795371498173,82100,88700,6600,4171304
10834,307950,2019-03-29,0.07440811724915446,88700,82100,-6600,1131418
10835,307950,2019-03-28,0.1607795371498173,82100,88700,6600,4171304
10836,307950,2019-03-29,0.07440811724915446,88700,82100,-6600,1131418
10837,307950,2019-03-28,0.1607795371498173,82100,88700,6600,4171304
10838,307950,2019-03-29,0.07440811724915446,88700,82100,-6600,1131418
10839,307950,2019-03-28,0.1607795371498173,82100,88700,6600,4171304
10840,307950,2019-03-29,0.07440811724915446,88700,82100,-6600,1131418
10841,307950,2019-03-28,0.1607795371498173,82100,88700,6600,4171304
10842,307950,2019-03-29,0.07440811724915446,88700,82100,-6600,1131418
10843,307950,2019-03-28,0.1607795371498173,82100,88700,6600,4171304
10844,307950,2019-03-29,0.07440811724915446,88700,82100,-6600,1131418
10845,307950,2019-03-28,0.1607795371498173,82100,88700,6600,4171304
10846,307950,2019-03-29,0.07440811724915446,88700,82100,-6600,1131418
10847,307950,2019-03-28,0.1607795371498173,82100,88700,6600,4171304
10848,307950,2019-03-29,0.07440811724915446,88700,82100,-6600,1131418
10849,307950,2019-03-28,0.1607795371498173,82100,88700,6600,4171304
10850,307950,2019-03-29,0.07440811724915446,88700,82100,-6600,1131418
10851,307950,2019-03-28,0.1607795371498173,82100,88700,6600,4171304
10852,307950,2019-03-29,0.07440811724915446,88700,82100,-6600,1131418
10853,307950,2019-03-28,0.1607795371498173,82100,88700,6600,4171304
10854,307950,2019-03-29,0.07440811724915446,88700,82100,-6600,1131418
10855,307950,2019-03-28,0.1607795371498173,82100,88700,6600,4171304
10856,307950,2019-03-29,0.07440811724915446,88700,82100,-6600,1131418
10857,307950,2019-03-28,0.1607795371498173,82100,88700,6600,4171304
10858,307950,2019-03-29,0.07440811724915446,88700,82100,-6600,1131418
10859,307950,2019-03-28,0.1607795371498173,82100,88700,6600,4171304
10860,307950,2019-03-29,0.07440811724915446,88700,82100,-6600,1131418
10861,307950,2019-03-28,0.1607795371498173,82100,88700,6600,4171304
10862,307950,2019-03-29,0.07440811724915446,88700,82100,-6600,1131418
10863,307950,2019-03-28,0.1607795371498173,82100,88700,6600,4171304
10864,307950,2019-03-29,0.07440811724915446,88700,82100,-6600,1131418
10865,307950,2019-03-28,0.1607795371498173,82100,88700,6600,4171304
10866,307950,2019-03-29,0.07440811724915446,88700,82100,-6600,1131418
10867,307950,2019-03-28,0.1607795371498173,82100,88700,6600,4171304
10868,307950,2019-03-29,0.07440811724915446,88700,82100,-6600,1131418
10869,307950,2019-03-28,0.1607795371498173,82100,88700,6600,4171304
10870,307950,2019-03-29,0.07440811724915446,88700,82100,-6600,1131418
10871,307950,2019-03-28,0.1607795371498173,82100,88700,6600,4171304
10872,307950,2019-03-29,0.07440811724915446,88700,82100,-6600,1131418
10873,240,2021-04-27,0.05945945945945946,18500,19600,1100,3345401
10874,240,2021-03-26,0.04456824512534819,17950,18750,800,428553
10875,240,2021-03-19,0.058823529411764705,17000,18000,1000,2459874
10876,240,2021-02-26,0.041666666666666664,18000,17250,-750,1320514
10877,240,2021-02-24,0.19196428571428573,22400,18100,-4300,2891315
10878,240,2021-02-15,0.04954954954954955,22200,21100,-1100,990430
10879,240,2021-02-10,0.0962962962962963,20250,22200,1950,1184623
10880,240,2021-02-09,0.055944055944055944,21450,20250,-1200,902609
10881,240,2021-02-03,0.13186813186813187,18200,20600,2400,3852988
10882,240,2021-02-02,0.09969788519637462,16550,18200,1650,3554617
10883,240,2021-02-01,0.04416403785488959,15850,16550,700,386245
10884,240,2021-01-28,0.041176470588235294,17000,16300,-700,592418
10885,240,2021-01-27,0.04294478527607362,16300,17000,700,741550
10886,240,2021-01-25,0.052795031055900624,16100,16950,850,813148
10887,240,2021-01-21,0.08143322475570032,15350,16600,1250,1248618
10888,240,2021-01-19,0.04040404040404041,14850,15450,600,421735
10889,240,2020-12-22,0.04040404040404041,14850,14250,-600,431559
10890,240,2020-11-27,0.04416403785488959,15850,16550,700,1789306
10891,240,2020-10-30,0.04180064308681672,15550,14900,-650,388101
10892,240,2020-10-26,0.05970149253731343,16750,15750,-1000,634487
10893,240,2020-09-28,0.060897435897435896,15600,16550,950,2209295
10894,240,2020-09-24,0.07507507507507508,16650,15400,-1250,1220233
10895,240,2020-09-23,0.09510869565217392,18400,16650,-1750,2505621
10896,240,2020-09-22,0.1393188854489164,16150,18400,2250,4753505
10897,240,2020-09-14,0.045307443365695796,15450,16150,700,944907
10898,240,2020-09-11,0.043343653250773995,16150,15450,-700,791461
10899,240,2020-09-08,0.060897435897435896,15600,16550,950,6159246
10900,240,2020-08-26,0.07102272727272728,17600,16350,-1250,12566006
10901,240,2020-08-25,0.2988929889298893,13550,17600,4050,16022141
10902,240,2020-08-20,0.0539568345323741,13900,13150,-750,528773
10903,240,2020-07-30,0.29955947136563876,11350,14750,3400,8100058
10904,240,2020-07-09,0.06521739130434782,13800,12900,-900,938084
10905,240,2020-07-06,0.0984251968503937,12700,13950,1250,2421577
10906,240,2020-06-30,0.05714285714285714,12250,12950,700,13742119
10907,240,2020-06-29,0.09865470852017937,11150,12250,1100,3217689
10908,240,2020-06-19,0.04602510460251046,11950,11400,-550,214073
10909,240,2020-06-18,0.07657657657657657,11100,11950,850,184543
10910,240,2020-06-16,0.1,10000,11000,1000,123670
10911,240,2020-06-15,0.05660377358490566,10600,10000,-600,96722
10912,240,2020-05-19,0.04912998976458546,9770,10250,480,215074
10913,240,2020-05-12,0.05242718446601942,10300,9760,-540,150464
10914,240,2020-04-13,0.04739336492890995,10550,10050,-500,88632
10915,240,2020-04-10,0.07763023493360573,9790,10550,760,220960
10916,240,2020-03-25,0.10513141426783479,7990,8830,840,153595
10917,240,2020-03-24,0.06675567423230974,7490,7990,500,157346
10918,240,2020-03-23,0.1351039260969977,8660,7490,-1170,136101
10919,240,2020-03-20,0.0825,8000,8660,660,117672
10920,240,2020-03-19,0.12087912087912088,9100,8000,-1100,183967
10921,240,2020-03-18,0.08726178535606821,9970,9100,-870,86713
10922,240,2020-03-12,0.06018518518518518,10800,10150,-650,114961
10923,240,2020-03-09,0.05217391304347826,11500,10900,-600,142983
10924,240,2020-03-06,0.053497942386831275,12150,11500,-650,175030
10925,240,2019-08-16,0.04844290657439446,14450,13750,-700,45906
10926,240,2019-07-09,0.06382978723404255,16450,15400,-1050,122410
10927,240,2018-11-07,0.06097560975609756,16400,15400,-1000,148118
10928,240,2018-10-24,0.04154302670623145,16850,17550,700,50803
10929,240,2017-07-31,0.04719101123595506,22250,21200,-1050,177432
10930,240,2017-01-10,0.04316546762589928,20850,21750,900,235745
10931,240,2016-08-31,0.054187192118226604,20300,21400,1100,183709
10932,240,2016-08-17,0.09620253164556962,19750,21650,1900,761724
10933,383220,2021-06-01,0.09566184649610679,449500,492500,43000,137800
10934,383220,2021-05-24,0.07878787878787878,412500,445000,32500,175980
10935,383220,2021-05-21,0.12727272727272726,412500,412500,0,554836
10936,383220,2021-05-21,0.12727272727272726,412500,412500,0,554836
10937,383220,2021-05-21,0.12727272727272726,412500,412500,0,554836
10938,383220,2021-05-21,0.12727272727272726,412500,412500,0,554836
10939,383220,2021-05-21,0.12727272727272726,412500,412500,0,554836
10940,383220,2021-05-21,0.12727272727272726,412500,412500,0,554836
10941,383220,2021-05-21,0.12727272727272726,412500,412500,0,554836
10942,383220,2021-05-21,0.12727272727272726,412500,412500,0,554836
10943,383220,2021-05-21,0.12727272727272726,412500,412500,0,554836
10944,383220,2021-05-21,0.12727272727272726,412500,412500,0,554836
10945,383220,2021-05-21,0.12727272727272726,412500,412500,0,554836
10946,383220,2021-05-21,0.12727272727272726,412500,412500,0,554836
10947,383220,2021-05-21,0.12727272727272726,412500,412500,0,554836
10948,383220,2021-05-21,0.12727272727272726,412500,412500,0,554836
10949,383220,2021-05-21,0.12727272727272726,412500,412500,0,554836
10950,383220,2021-05-21,0.12727272727272726,412500,412500,0,554836
10951,383220,2021-05-21,0.12727272727272726,412500,412500,0,554836
10952,383220,2021-05-21,0.12727272727272726,412500,412500,0,554836
10953,383220,2021-05-21,0.12727272727272726,412500,412500,0,554836
10954,383220,2021-05-21,0.12727272727272726,412500,412500,0,554836
10955,383220,2021-05-21,0.12727272727272726,412500,412500,0,554836
10956,383220,2021-05-21,0.12727272727272726,412500,412500,0,554836
10957,383220,2021-05-21,0.12727272727272726,412500,412500,0,554836
10958,383220,2021-05-21,0.12727272727272726,412500,412500,0,554836
10959,383220,2021-05-21,0.12727272727272726,412500,412500,0,554836
10960,383220,2021-05-21,0.12727272727272726,412500,412500,0,554836
10961,383220,2021-05-21,0.12727272727272726,412500,412500,0,554836
10962,383220,2021-05-21,0.12727272727272726,412500,412500,0,554836
10963,383220,2021-05-21,0.12727272727272726,412500,412500,0,554836
10964,383220,2021-05-21,0.12727272727272726,412500,412500,0,554836
10965,383220,2021-05-21,0.12727272727272726,412500,412500,0,554836
10966,383220,2021-05-21,0.12727272727272726,412500,412500,0,554836
10967,383220,2021-05-21,0.12727272727272726,412500,412500,0,554836
10968,383220,2021-05-21,0.12727272727272726,412500,412500,0,554836
10969,383220,2021-05-21,0.12727272727272726,412500,412500,0,554836
10970,383220,2021-05-21,0.12727272727272726,412500,412500,0,554836
10971,383220,2021-05-21,0.12727272727272726,412500,412500,0,554836
10972,383220,2021-05-21,0.12727272727272726,412500,412500,0,554836
10973,383220,2021-05-21,0.12727272727272726,412500,412500,0,554836
10974,383220,2021-05-21,0.12727272727272726,412500,412500,0,554836
10975,383220,2021-05-21,0.12727272727272726,412500,412500,0,554836
10976,383220,2021-05-21,0.12727272727272726,412500,412500,0,554836
10977,383220,2021-05-21,0.12727272727272726,412500,412500,0,554836
10978,383220,2021-05-21,0.12727272727272726,412500,412500,0,554836
10979,383220,2021-05-21,0.12727272727272726,412500,412500,0,554836
10980,383220,2021-05-21,0.12727272727272726,412500,412500,0,554836
10981,383220,2021-05-21,0.12727272727272726,412500,412500,0,554836
10982,383220,2021-05-21,0.12727272727272726,412500,412500,0,554836
10983,383220,2021-05-21,0.12727272727272726,412500,412500,0,554836
10984,383220,2021-05-21,0.12727272727272726,412500,412500,0,554836
10985,383220,2021-05-21,0.12727272727272726,412500,412500,0,554836
10986,383220,2021-05-21,0.12727272727272726,412500,412500,0,554836
10987,383220,2021-05-21,0.12727272727272726,412500,412500,0,554836
10988,383220,2021-05-21,0.12727272727272726,412500,412500,0,554836
10989,383220,2021-05-21,0.12727272727272726,412500,412500,0,554836
10990,383220,2021-05-21,0.12727272727272726,412500,412500,0,554836
10991,383220,2021-05-21,0.12727272727272726,412500,412500,0,554836
10992,383220,2021-05-21,0.12727272727272726,412500,412500,0,554836
10993,383220,2021-05-21,0.12727272727272726,412500,412500,0,554836
10994,383220,2021-05-21,0.12727272727272726,412500,412500,0,554836
10995,383220,2021-05-21,0.12727272727272726,412500,412500,0,554836
10996,383220,2021-05-21,0.12727272727272726,412500,412500,0,554836
10997,383220,2021-05-21,0.12727272727272726,412500,412500,0,554836
10998,383220,2021-05-21,0.12727272727272726,412500,412500,0,554836
10999,383220,2021-05-21,0.12727272727272726,412500,412500,0,554836
11000,383220,2021-05-21,0.12727272727272726,412500,412500,0,554836
11001,383220,2021-05-21,0.12727272727272726,412500,412500,0,554836
11002,383220,2021-05-21,0.12727272727272726,412500,412500,0,554836
11003,383220,2021-05-21,0.12727272727272726,412500,412500,0,554836
11004,383220,2021-05-21,0.12727272727272726,412500,412500,0,554836
11005,383220,2021-05-21,0.12727272727272726,412500,412500,0,554836
11006,383220,2021-05-21,0.12727272727272726,412500,412500,0,554836
11007,383220,2021-05-21,0.12727272727272726,412500,412500,0,554836
11008,383220,2021-05-21,0.12727272727272726,412500,412500,0,554836
11009,383220,2021-05-21,0.12727272727272726,412500,412500,0,554836
11010,383220,2021-05-21,0.12727272727272726,412500,412500,0,554836
11011,383220,2021-05-21,0.12727272727272726,412500,412500,0,554836
11012,383220,2021-05-21,0.12727272727272726,412500,412500,0,554836
11013,383220,2021-05-21,0.12727272727272726,412500,412500,0,554836
11014,383220,2021-05-21,0.12727272727272726,412500,412500,0,554836
11015,383220,2021-05-21,0.12727272727272726,412500,412500,0,554836
11016,383220,2021-05-21,0.12727272727272726,412500,412500,0,554836
11017,383220,2021-05-21,0.12727272727272726,412500,412500,0,554836
11018,383220,2021-05-21,0.12727272727272726,412500,412500,0,554836
11019,383220,2021-05-21,0.12727272727272726,412500,412500,0,554836
11020,383220,2021-05-21,0.12727272727272726,412500,412500,0,554836
11021,383220,2021-05-21,0.12727272727272726,412500,412500,0,554836
11022,383220,2021-05-21,0.12727272727272726,412500,412500,0,554836
11023,383220,2021-05-21,0.12727272727272726,412500,412500,0,554836
11024,383220,2021-05-21,0.12727272727272726,412500,412500,0,554836
11025,383220,2021-05-21,0.12727272727272726,412500,412500,0,554836
11026,383220,2021-05-21,0.12727272727272726,412500,412500,0,554836
11027,383220,2021-05-21,0.12727272727272726,412500,412500,0,554836
11028,383220,2021-05-21,0.12727272727272726,412500,412500,0,554836
11029,383220,2021-05-21,0.12727272727272726,412500,412500,0,554836
11030,383220,2021-05-21,0.12727272727272726,412500,412500,0,554836
11031,383220,2021-05-21,0.12727272727272726,412500,412500,0,554836
11032,383220,2021-05-21,0.12727272727272726,412500,412500,0,554836
11033,383220,2021-05-21,0.12727272727272726,412500,412500,0,554836
11034,383220,2021-05-21,0.12727272727272726,412500,412500,0,554836
11035,383220,2021-05-21,0.12727272727272726,412500,412500,0,554836
11036,383220,2021-05-21,0.12727272727272726,412500,412500,0,554836
11037,383220,2021-05-21,0.12727272727272726,412500,412500,0,554836
11038,383220,2021-05-21,0.12727272727272726,412500,412500,0,554836
11039,383220,2021-05-21,0.12727272727272726,412500,412500,0,554836
11040,383220,2021-05-21,0.12727272727272726,412500,412500,0,554836
11041,383220,2021-05-21,0.12727272727272726,412500,412500,0,554836
11042,383220,2021-05-21,0.12727272727272726,412500,412500,0,554836
11043,383220,2021-05-21,0.12727272727272726,412500,412500,0,554836
11044,383220,2021-05-21,0.12727272727272726,412500,412500,0,554836
11045,383220,2021-05-21,0.12727272727272726,412500,412500,0,554836
11046,383220,2021-05-21,0.12727272727272726,412500,412500,0,554836
11047,383220,2021-05-21,0.12727272727272726,412500,412500,0,554836
11048,383220,2021-05-21,0.12727272727272726,412500,412500,0,554836
11049,383220,2021-05-21,0.12727272727272726,412500,412500,0,554836
11050,383220,2021-05-21,0.12727272727272726,412500,412500,0,554836
11051,383220,2021-05-21,0.12727272727272726,412500,412500,0,554836
11052,21240,2021-05-18,0.04774193548387097,77500,81200,3700,575384
11053,21240,2021-05-13,0.09585121602288985,69900,76600,6700,1755822
11054,21240,2021-02-01,0.04160688665710186,69700,72600,2900,284341
11055,21240,2020-11-05,0.06125356125356125,70200,74500,4300,390774
11056,21240,2020-10-12,0.052303860523038606,80300,84500,4200,344566
11057,21240,2020-09-24,0.04247104247104247,77700,74400,-3300,187041
11058,21240,2020-08-20,0.04524886877828054,88400,84400,-4000,230565
11059,21240,2020-08-19,0.06634499396863691,82900,88400,5500,346343
11060,21240,2020-08-11,0.10552763819095477,79600,88000,8400,738135
11061,21240,2020-08-06,0.07142857142857142,74200,79500,5300,523107
11062,21240,2020-07-20,0.04842931937172775,76400,80100,3700,409778
11063,21240,2020-07-16,0.04372355430183357,70900,74000,3100,261003
11064,21240,2020-06-19,0.04183006535947712,76500,73300,-3200,376655
11065,21240,2020-06-16,0.05507246376811594,69000,72800,3800,274916
11066,21240,2020-06-15,0.06756756756756757,74000,69000,-5000,251930
11067,21240,2020-06-10,0.042582417582417584,72800,75900,3100,337950
11068,21240,2020-06-04,0.04755244755244755,71500,74900,3400,363201
11069,21240,2020-05-28,0.045714285714285714,70000,66800,-3200,422884
11070,21240,2020-05-26,0.11198738170347003,63400,70500,7100,720117
11071,21240,2020-05-21,0.046251993620414676,62700,65600,2900,432406
11072,21240,2020-05-12,0.05434782608695652,64400,60900,-3500,421301
11073,21240,2020-05-11,0.042071197411003236,61800,64400,2600,545127
11074,21240,2020-04-07,0.04376012965964344,61700,64400,2700,270638
11075,21240,2020-04-06,0.09786476868327403,56200,61700,5500,210629
11076,21240,2020-04-02,0.043478260869565216,55200,57600,2400,235015
11077,21240,2020-04-01,0.04498269896193772,57800,55200,-2600,260432
11078,21240,2020-03-25,0.11,50000,55500,5500,483541
11079,21240,2020-03-23,0.1163003663003663,54600,48250,-6350,376051
11080,21240,2020-03-18,0.06862745098039216,61200,57000,-4200,469298
11081,21240,2020-03-13,0.0723589001447178,69100,64100,-5000,476301
11082,21240,2020-02-17,0.18141592920353983,90400,74000,-16400,1357393
11083,21240,2019-11-25,0.040992448759439054,92700,96500,3800,310251
11084,21240,2019-11-13,0.04520990312163617,92900,88700,-4200,164677
11085,21240,2019-10-08,0.04946996466431095,84900,80700,-4200,282392
11086,21240,2019-08-07,0.041176470588235294,85000,81500,-3500,180374
11087,21240,2019-08-01,0.06197854588796186,83900,89100,5200,345188
11088,21240,2019-07-16,0.04322429906542056,85600,81900,-3700,234690
11089,21240,2019-07-15,0.055487053020961775,81100,85600,4500,265333
11090,21240,2019-06-28,0.07747318235995232,83900,77400,-6500,478310
11091,21240,2019-05-14,0.04342273307790549,78300,74900,-3400,294415
11092,21240,2019-05-09,0.05289052890528905,81300,77000,-4300,294257
11093,21240,2019-05-02,0.07289293849658314,87800,81400,-6400,515135
11094,21240,2018-11-14,0.04585798816568047,67600,70700,3100,257951
11095,21240,2018-11-01,0.05547652916073969,70300,66400,-3900,361478
11096,21240,2018-10-30,0.07936507936507936,63000,68000,5000,1471273
11097,21240,2018-10-29,0.24910607866507747,83900,63000,-20900,1429342
11098,21240,2018-10-11,0.04604486422668241,84700,80800,-3900,302068
11099,21240,2018-09-19,0.08149779735682819,90800,83400,-7400,4809464
11100,21240,2018-07-09,0.047018348623853214,87200,91300,4100,182186
11101,21240,2018-07-06,0.05186972255729795,82900,87200,4300,281392
11102,21240,2018-05-02,0.064,87500,93100,5600,312840
11103,21240,2018-03-23,0.04875406283856988,92300,87800,-4500,174919
11104,21240,2018-03-22,0.05606407322654462,87400,92300,4900,280389
11105,21240,2018-02-21,0.04524361948955916,86200,90100,3900,245783
11106,21240,2018-02-13,0.05941704035874439,89200,83900,-5300,431512
11107,21240,2017-12-20,0.06124401913875598,104500,98100,-6400,382925
11108,21240,2017-12-19,0.04128440366972477,109000,104500,-4500,307326
11109,21240,2017-12-11,0.07281553398058252,103000,110500,7500,197726
11110,21240,2017-12-01,0.047966631908237745,95900,100500,4600,150699
11111,21240,2017-11-30,0.041,100000,95900,-4100,360535
11112,21240,2017-07-19,0.059803921568627454,102000,95900,-6100,431608
11113,21240,2017-07-17,0.05128205128205128,97500,102500,5000,225209
11114,21240,2017-05-16,0.05619047619047619,105000,99100,-5900,4689306
11115,21240,2017-05-12,0.04072398190045249,110500,106000,-4500,225125
11116,21240,2017-05-10,0.04054054054054054,111000,106500,-4500,397810
11117,21240,2017-05-08,0.04716981132075472,106000,111000,5000,398277
11118,21240,2017-05-04,0.06747230614300101,99300,106000,6700,330340
11119,21240,2017-03-24,0.0429042904290429,90900,94800,3900,223537
11120,21240,2016-11-15,0.04065934065934066,91000,87300,-3700,228250
11121,21240,2016-09-19,0.05144694533762058,93300,98100,4800,490852
11122,21240,2016-09-12,0.06534422403733955,85700,91300,5600,347982
11123,21240,2016-09-07,0.047505938242280284,84200,88200,4000,292993
11124,21240,2016-08-25,0.04059040590405904,81300,84600,3300,302682
11125,21240,2016-08-16,0.05385427666314678,94700,89600,-5100,556256
11126,81660,2021-06-01,0.06422018348623854,54500,58000,3500,888400
11127,81660,2021-05-21,0.05087719298245614,57000,54100,-2900,939389
11128,81660,2021-05-10,0.13245702730030334,49450,56000,6550,2832732
11129,81660,2021-05-07,0.075,46000,49450,3450,2887823
11130,81660,2021-04-16,0.0675990675990676,42900,45800,2900,1199897
11131,81660,2021-03-23,0.052878965922444184,42550,44800,2250,976296
11132,81660,2021-03-03,0.0475,40000,41900,1900,608403
11133,81660,2021-02-25,0.040100250626566414,39900,41500,1600,251314
11134,81660,2021-01-29,0.046875,44800,42700,-2100,1145558
11135,81660,2021-01-19,0.049944506104328525,45050,47300,2250,336839
11136,81660,2021-01-05,0.043173862310385065,42850,44700,1850,664596
11137,81660,2020-11-18,0.041935483870967745,46500,44550,-1950,573128
11138,81660,2020-11-17,0.0472972972972973,44400,46500,2100,689121
11139,81660,2020-11-12,0.042105263157894736,47500,45500,-2000,569478
11140,81660,2020-11-10,0.07424593967517401,43100,46300,3200,915615
11141,81660,2020-11-02,0.06005221932114883,38300,40600,2300,338849
11142,81660,2020-10-30,0.040100250626566414,39900,38300,-1600,322292
11143,81660,2020-10-28,0.05754475703324808,39100,41350,2250,405544
11144,81660,2020-10-23,0.046192259675405745,40050,41900,1850,1425556
11145,81660,2020-10-14,0.042682926829268296,41000,39250,-1750,535752
11146,81660,2020-10-13,0.04591836734693878,39200,41000,1800,782399
11147,81660,2020-10-12,0.043941411451398134,37550,39200,1650,448539
11148,81660,2020-09-24,0.04365620736698499,36650,35050,-1600,298061
11149,81660,2020-09-17,0.04221635883905013,37900,36300,-1600,304139
11150,81660,2020-09-03,0.06040268456375839,37250,39500,2250,1230204
11151,81660,2020-09-01,0.06628242074927954,34700,37000,2300,486193
11152,81660,2020-08-31,0.06342780026990553,37050,34700,-2350,607832
11153,81660,2020-08-24,0.05413533834586466,33250,35050,1800,824134
11154,81660,2020-08-21,0.09735973597359736,30300,33250,2950,916405
11155,81660,2020-08-18,0.05718475073313783,34100,32150,-1950,584434
11156,81660,2020-08-11,0.04930662557781202,32450,34050,1600,627559
11157,81660,2020-08-03,0.04341317365269461,33400,31950,-1450,453075
11158,81660,2020-07-10,0.05084745762711865,38350,36400,-1950,1038624
11159,81660,2020-07-07,0.061079545454545456,35200,37350,2150,810162
11160,81660,2020-06-22,0.0472972972972973,37000,35250,-1750,429270
11161,81660,2020-06-15,0.06684141546526867,38150,35600,-2550,943048
11162,81660,2020-06-12,0.06837606837606838,40950,38150,-2800,975775
11163,81660,2020-06-04,0.049019607843137254,40800,42800,2000,1144284
11164,81660,2020-05-28,0.059045226130653265,39800,37450,-2350,922656
11165,81660,2020-05-27,0.09641873278236915,36300,39800,3500,1625527
11166,81660,2020-05-20,0.07511045655375552,33950,36500,2550,1531949
11167,81660,2020-05-19,0.0898876404494382,31150,33950,2800,1520235
11168,81660,2020-05-12,0.04242424242424243,33000,31600,-1400,588971
11169,81660,2020-04-17,0.040625,32000,33300,1300,997356
11170,81660,2020-04-13,0.06020558002936858,34050,32000,-2050,561897
11171,81660,2020-04-06,0.08880994671403197,28150,30650,2500,909791
11172,81660,2020-03-26,0.10166358595194085,27050,29800,2750,2432110
11173,81660,2020-03-25,0.2973621103117506,20850,27050,6200,1790185
11174,81660,2020-03-24,0.06923076923076923,19500,20850,1350,1114439
11175,81660,2020-03-23,0.08235294117647059,21250,19500,-1750,677460
11176,81660,2020-03-19,0.11368421052631579,23750,21050,-2700,2363952
11177,81660,2020-03-18,0.1782006920415225,28900,23750,-5150,1473486
11178,81660,2020-03-13,0.07087827426810478,32450,30150,-2300,1174769
11179,81660,2020-03-12,0.06213872832369942,34600,32450,-2150,672054
11180,81660,2020-03-09,0.05255878284923928,36150,34250,-1900,645934
11181,81660,2020-03-06,0.06589147286821706,38700,36150,-2550,780457
11182,81660,2020-02-28,0.04119850187265917,40050,38400,-1650,618422
11183,81660,2020-02-24,0.04767580452920143,41950,39950,-2000,506391
11184,81660,2020-01-28,0.04565217391304348,46000,43900,-2100,757715
11185,81660,2020-01-09,0.04377431906614786,51400,49150,-2250,1723223
11186,81660,2019-11-21,0.04220183486238532,54500,52200,-2300,1082792
11187,81660,2019-11-20,0.05709342560553633,57800,54500,-3300,1082627
11188,81660,2019-11-13,0.040492957746478875,56800,59100,2300,906553
11189,81660,2019-11-12,0.0453781512605042,59500,56800,-2700,2383004
11190,81660,2019-11-11,0.04186795491143317,62100,59500,-2600,626322
11191,81660,2019-11-01,0.057291666666666664,57600,60900,3300,1104388
11192,81660,2019-10-15,0.059625212947189095,58700,55200,-3500,907538
11193,81660,2019-10-04,0.04482758620689655,58000,55400,-2600,1324639
11194,81660,2019-09-26,0.04926108374384237,60900,57900,-3000,928246
11195,81660,2019-09-20,0.04666666666666667,60000,62800,2800,723920
11196,81660,2019-09-16,0.05457746478873239,56800,59900,3100,962711
11197,81660,2019-08-27,0.0994263862332696,52300,57500,5200,1400285
11198,81660,2019-08-26,0.04909090909090909,55000,52300,-2700,856511
11199,81660,2019-08-21,0.041666666666666664,55200,52900,-2300,1562087
11200,81660,2019-08-19,0.07952622673434856,59100,54400,-4700,2049829
11201,81660,2019-08-14,0.07680491551459294,65100,60100,-5000,2705269
11202,81660,2019-07-15,0.04,72500,69600,-2900,500145
11203,81660,2019-06-14,0.044444444444444446,81000,84600,3600,662123
11204,81660,2019-06-07,0.050870147255689425,74700,78500,3800,588681
11205,81660,2019-05-17,0.05308641975308642,81000,85300,4300,784672
11206,81660,2019-05-16,0.04113110539845758,77800,81000,3200,768416
11207,81660,2019-04-17,0.05121951219512195,82000,77800,-4200,648141
11208,81660,2019-04-03,0.044854881266490766,75800,72400,-3400,1172424
11209,81660,2019-03-29,0.04697986577181208,74500,78000,3500,437524
11210,81660,2019-03-20,0.07339449541284404,65400,70200,4800,1035493
11211,81660,2019-03-07,0.04477611940298507,60300,63000,2700,828139
11212,81660,2019-03-06,0.04325259515570934,57800,60300,2500,1119552
11213,81660,2019-02-26,0.0497131931166348,52300,54900,2600,900786
11214,81660,2019-02-21,0.061224489795918366,49000,52000,3000,750851
11215,81660,2019-02-14,0.05888767720828789,45850,48550,2700,891263
11216,81660,2019-02-08,0.07975460122699386,48900,45000,-3900,1216176
11217,81660,2019-01-02,0.044859813084112146,53500,51100,-2400,317655
11218,81660,2018-12-28,0.049019607843137254,51000,53500,2500,511197
11219,81660,2018-12-27,0.04081632653061224,49000,51000,2000,754655
11220,81660,2018-12-20,0.07222222222222222,54000,50100,-3900,661207
11221,81660,2018-12-18,0.04790419161676647,50100,52500,2400,626768
11222,81660,2018-12-04,0.064,50000,53200,3200,1098228
11223,81660,2018-11-29,0.06521739130434782,55200,51600,-3600,1712890
11224,81660,2018-11-14,0.051330798479087454,52600,55300,2700,1697340
11225,81660,2018-11-12,0.11416490486257928,47300,52700,5400,1672676
11226,81660,2018-11-07,0.041666666666666664,46800,48750,1950,549905
11227,81660,2018-11-06,0.04932735426008968,44600,46800,2200,700751
11228,81660,2018-10-30,0.08229988726042842,44350,40700,-3650,1560869
11229,81660,2018-10-12,0.09987357774968394,39550,43500,3950,754418
11230,81660,2018-10-11,0.046987951807228916,41500,39550,-1950,600217
11231,81660,2018-09-27,0.08982035928143713,41750,45500,3750,837411
11232,81660,2018-09-07,0.049338146811071,41550,39500,-2050,921097
11233,81660,2018-09-06,0.04396984924623116,39800,41550,1750,661505
11234,81660,2018-09-03,0.0407185628742515,41750,40050,-1700,515454
11235,81660,2018-08-16,0.08882521489971347,34900,38000,3100,1459504
11236,81660,2018-08-14,0.08892355694227769,32050,34900,2850,1136999
11237,81660,2018-08-09,0.041050903119868636,30450,31700,1250,293190
11238,81660,2018-08-03,0.05098684210526316,30400,31950,1550,558546
11239,81660,2018-08-02,0.06027820710973725,32350,30400,-1950,474991
11240,81660,2018-07-24,0.07890499194847021,31050,33500,2450,849976
11241,81660,2018-07-23,0.04461538461538461,32500,31050,-1450,358507
11242,81660,2018-07-13,0.045112781954887216,33250,34750,1500,563944
11243,81660,2018-07-11,0.048034934497816595,34350,32700,-1650,480423
11244,81660,2018-07-03,0.048600883652430045,33950,35600,1650,501535
11245,81660,2018-06-26,0.06301369863013699,36500,34200,-2300,808481
11246,81660,2018-06-25,0.047345767575322814,34850,36500,1650,569540
11247,81660,2018-06-20,0.04821150855365474,32150,33700,1550,659044
11248,81660,2018-06-12,0.06732348111658457,30450,32500,2050,656053
11249,81660,2018-05-31,0.044802867383512544,27900,29150,1250,1021032
11250,81660,2018-05-30,0.0449438202247191,26700,27900,1200,521422
11251,81660,2018-05-21,0.04107142857142857,28000,26850,-1150,439938
11252,81660,2018-05-11,0.043137254901960784,25500,26600,1100,555223
11253,81660,2018-04-12,0.04184100418410042,119500,124500,5000,141950
11254,81660,2018-04-10,0.048672566371681415,113000,118500,5500,117372
11255,81660,2018-04-06,0.04072398190045249,110500,115000,4500,153500
11256,81660,2018-03-20,0.07881773399014778,101500,109500,8000,157294
11257,81660,2018-03-09,0.04245283018867924,106000,101500,-4500,77491
11258,81660,2018-03-08,0.06639839034205232,99400,106000,6600,108996
11259,81660,2018-02-26,0.0559662090813094,94700,100000,5300,301570
11260,81660,2018-02-23,0.06764374295377677,88700,94700,6000,296775
11261,81660,2018-01-03,0.05042016806722689,83300,87500,4200,78619
11262,81660,2017-11-09,0.07613469985358712,68300,73500,5200,261397
11263,81660,2017-08-16,0.044382801664355064,72100,68900,-3200,142247
11264,81660,2017-07-10,0.04187817258883249,78800,75500,-3300,73652
11265,81660,2017-07-04,0.04830917874396135,82800,78800,-4000,81551
11266,81660,2017-05-30,0.04897959183673469,73500,77100,3600,142239
11267,81660,2017-02-20,0.049204052098408106,69100,72500,3400,44153
11268,81660,2017-02-16,0.053973013493253376,66700,70300,3600,38653
11269,81660,2016-12-12,0.04739336492890995,63300,66300,3000,81813
11270,81660,2016-11-15,0.052763819095477386,79600,75400,-4200,94502
11271,55550,2021-05-12,0.04107981220657277,42600,40850,-1750,2328363
11272,55550,2021-05-06,0.044585987261146494,39250,41000,1750,2721258
11273,55550,2021-01-29,0.04813664596273292,32200,30650,-1550,3554121
11274,55550,2021-01-07,0.041666666666666664,32400,33750,1350,6546753
11275,55550,2020-12-29,0.04477611940298507,33500,32000,-1500,3583691
11276,55550,2020-11-30,0.05433186490455213,34050,32200,-1850,5779670
11277,55550,2020-11-02,0.04612850082372323,30350,31750,1400,3894347
11278,55550,2020-10-28,0.04304635761589404,30200,31500,1300,4419345
11279,55550,2020-08-11,0.06482982171799027,30850,32850,2000,5025552
11280,55550,2020-06-16,0.0847457627118644,29500,32000,2500,2692975
11281,55550,2020-06-15,0.052969502407704656,31150,29500,-1650,2915712
11282,55550,2020-06-12,0.04153846153846154,32500,31150,-1350,2612741
11283,55550,2020-06-03,0.1171875,32000,35750,3750,7122912
11284,55550,2020-06-02,0.04234527687296417,30700,32000,1300,3416978
11285,55550,2020-05-19,0.05181347150259067,28950,30450,1500,2602771
11286,55550,2020-04-27,0.10497237569060773,27150,30000,2850,5258451
11287,55550,2020-04-07,0.04204753199268738,27350,28500,1150,2830469
11288,55550,2020-04-01,0.06468531468531469,28600,26750,-1850,2216202
11289,55550,2020-03-31,0.04,27500,28600,1100,3312454
11290,55550,2020-03-25,0.1419624217118998,23950,27350,3400,3088695
11291,55550,2020-03-24,0.07882882882882883,22200,23950,1750,2261390
11292,55550,2020-03-23,0.08264462809917356,24200,22200,-2000,2185885
11293,55550,2020-03-20,0.0779510022271715,22450,24200,1750,3288066
11294,55550,2020-03-19,0.07991803278688525,24400,22450,-1950,3227344
11295,55550,2020-03-17,0.05970149253731343,26800,25200,-1600,3565928
11296,55550,2020-03-13,0.054982817869415807,29100,27500,-1600,4971131
11297,55550,2020-03-12,0.04118616144975288,30350,29100,-1250,3444605
11298,55550,2020-03-09,0.05799373040752351,31900,30050,-1850,2147355
11299,55550,2020-02-24,0.04628330995792426,35650,34000,-1650,2434887
11300,55550,2019-05-29,0.04791666666666667,48000,45700,-2300,2069839
11301,55550,2019-04-01,0.041666666666666664,42000,43750,1750,1184798
11302,55550,2018-10-30,0.04401805869074492,44300,42350,-1950,1547119
11303,55550,2018-10-22,0.04046242774566474,43250,45000,1750,823318
11304,55550,2018-10-11,0.04875406283856988,46150,43900,-2250,1533359
11305,55550,2017-08-11,0.04151624548736462,55400,53100,-2300,1227727
11306,55550,2017-01-05,0.04042553191489362,47000,45100,-1900,10173319
11307,55550,2016-12-08,0.05580357142857143,44800,47300,2500,2555332
11308,55550,2016-12-07,0.04186046511627907,43000,44800,1800,1575232
11309,55550,2016-11-10,0.04513064133016627,42100,44000,1900,1108320
11310,252670,2021-03-11,0.044543429844097995,2245,2145,-100,413670475
11311,252670,2021-02-26,0.055825242718446605,2060,2175,115,537602541
11312,252670,2021-02-25,0.07623318385650224,2230,2060,-170,526447366
11313,252670,2021-02-24,0.046948356807511735,2130,2230,100,736655197
11314,252670,2021-02-01,0.05274725274725275,2275,2155,-120,631911974
11315,252670,2021-01-29,0.050808314087759814,2165,2275,110,837063842
11316,252670,2021-01-26,0.05612244897959184,1960,2070,110,357656003
11317,252670,2021-01-25,0.046228710462287104,2055,1960,-95,336512000
11318,252670,2021-01-19,0.05580357142857143,2240,2115,-125,484379038
11319,252670,2021-01-18,0.04918032786885246,2135,2240,105,552680045
11320,252670,2021-01-15,0.044009779951100246,2045,2135,90,544112094
11321,252670,2021-01-08,0.09131403118040089,2245,2040,-205,464832002
11322,252670,2021-01-07,0.048728813559322036,2360,2245,-115,300683421
11323,252670,2021-01-04,0.05179282868525897,2510,2380,-130,178030291
11324,252670,2020-12-30,0.04924242424242424,2640,2510,-130,276345359
11325,252670,2020-12-24,0.041811846689895474,2870,2750,-120,252984898
11326,252670,2020-12-09,0.041736227045075125,2995,2870,-125,218925446
11327,252670,2020-11-23,0.046579330422125184,3435,3275,-160,188096897
11328,252670,2020-11-16,0.0458970792767733,3595,3430,-165,200373612
11329,252670,2020-11-05,0.04428044280442804,4065,3885,-180,240749482
11330,252670,2020-11-03,0.04079254079254079,4290,4115,-175,199801946
11331,252670,2020-10-30,0.05250596658711217,4190,4410,220,214675759
11332,252670,2020-09-24,0.045990566037735846,4240,4435,195,333011749
11333,252670,2020-09-22,0.04779411764705882,4080,4275,195,252446700
11334,252670,2020-08-20,0.07646356033452807,4185,4505,320,329691686
11335,252670,2020-08-18,0.042027194066749075,4045,4215,170,204873013
11336,252670,2020-07-28,0.04054054054054054,4810,4615,-195,194286530
11337,252670,2020-06-25,0.05258033106134372,5135,5405,270,242660764
11338,252670,2020-06-16,0.1174496644295302,5960,5260,-700,316290914
11339,252670,2020-06-15,0.0996309963099631,5420,5960,540,337746671
11340,252670,2020-06-11,0.040634291377601585,5045,5250,205,229822004
11341,252670,2020-06-03,0.07054673721340388,5670,5270,-400,230048100
11342,252670,2020-05-19,0.05101275318829707,6665,6325,-340,131947471
11343,252670,2020-05-04,0.06007604562737642,6575,6970,395,180130954
11344,252670,2020-04-27,0.04323175053153792,7055,6750,-305,156679490
11345,252670,2020-04-17,0.062326869806094184,7220,6770,-450,257739187
11346,252670,2020-04-06,0.08043217286914765,8330,7660,-670,246362127
11347,252670,2020-04-02,0.05719139297848245,8830,8325,-505,384091052
11348,252670,2020-04-01,0.09147095179233622,8090,8830,740,269351753
11349,252670,2020-03-27,0.04693760732684602,8735,8325,-410,422788093
11350,252670,2020-03-25,0.12195121951219512,9635,8460,-1175,375960417
11351,252670,2020-03-24,0.1764957264957265,11700,9635,-2065,266756217
11352,252670,2020-03-23,0.1111111111111111,10530,11700,1170,269458606
11353,252670,2020-03-20,0.14840274969672462,12365,10530,-1835,353530116
11354,252670,2020-03-19,0.13284470911589555,10915,12365,1450,493263934
11355,252670,2020-03-18,0.12063655030800821,9740,10915,1175,275017474
11356,252670,2020-03-16,0.08160919540229886,8700,9410,710,204351634
11357,252670,2020-03-13,0.04316546762589928,8340,8700,360,229000640
11358,252670,2020-03-12,0.07612903225806451,7750,8340,590,232154519
11359,252670,2020-03-11,0.06091718001368925,7305,7750,445,130760459
11360,252670,2020-03-09,0.08717948717948718,6825,7420,595,91256710
11361,252670,2020-03-04,0.045616535994297935,7015,6695,-320,88807232
11362,252670,2020-02-28,0.06425406203840472,6770,7205,435,101702582
11363,252670,2020-02-24,0.07346938775510205,6125,6575,450,94418563
11364,252670,2020-02-06,0.061488673139158574,6180,5800,-380,61550484
11365,252670,2020-01-28,0.06147186147186147,5775,6130,355,36279514
11366,252670,2019-10-02,0.041866849691146193,7285,7590,305,30207511
11367,252670,2019-08-05,0.04114713216957606,8020,8350,330,37915615
11368,252670,2019-07-08,0.04271186440677966,7375,7690,315,28401004
11369,252670,2019-05-09,0.058823529411764705,7140,7560,420,44997236
11370,252670,2019-04-29,0.04019746121297602,7090,6805,-285,20186379
11371,252670,2019-01-09,0.04308797127468582,8355,7995,-360,21883656
11372,252670,2018-11-02,0.07466196355085244,8505,7870,-635,28527832
11373,252670,2018-10-23,0.04847277556440903,7530,7895,365,18747738
11374,252670,2018-10-11,0.08350877192982456,7125,7720,595,22110467
11375,252670,2018-07-02,0.044977511244377814,6670,6970,300,20050900
11376,252670,2018-05-30,0.04398340248962656,6025,6290,265,16550381
11377,252670,2018-03-23,0.06976744186046512,5805,6210,405,22002991
11378,252670,2018-03-06,0.04271548436308162,6555,6275,-280,18004328
11379,252670,2018-02-09,0.05152979066022544,6210,6530,320,21883951
11380,252670,2018-02-07,0.051537822111388194,6015,6325,310,21369792
11381,252670,2018-02-02,0.040145985401459854,5480,5700,220,13692530
11382,252670,2017-05-08,0.05,7400,7030,-370,10544276
11383,252670,2016-11-10,0.04110898661567878,10460,10030,-430,17215972
11384,252670,2016-11-09,0.04339152119700748,10025,10460,435,36018301
11385,6400,2021-05-13,0.04897314375987362,633000,602000,-31000,588763
11386,6400,2021-04-13,0.05343511450381679,655000,690000,35000,908436
11387,6400,2021-03-17,0.060294117647058824,680000,639000,-41000,863521
11388,6400,2021-03-11,0.08018867924528301,636000,687000,51000,709286
11389,6400,2021-02-26,0.04261363636363636,704000,674000,-30000,579115
11390,6400,2021-02-22,0.04025974025974026,770000,739000,-31000,504042
11391,6400,2021-01-29,0.04302477183833116,767000,734000,-33000,764317
11392,6400,2021-01-22,0.06308724832214765,745000,792000,47000,973969
11393,6400,2021-01-18,0.04206241519674356,737000,706000,-31000,644139
11394,6400,2021-01-08,0.05873925501432665,698000,739000,41000,890113
11395,6400,2021-01-04,0.06847133757961783,628000,671000,43000,694737
11396,6400,2020-12-30,0.04492512479201331,601000,628000,27000,503572
11397,6400,2020-12-29,0.07513416815742398,559000,601000,42000,827634
11398,6400,2020-11-24,0.049429657794676805,526000,552000,26000,610630
11399,6400,2020-11-09,0.06813627254509018,499000,533000,34000,824167
11400,6400,2020-11-05,0.05331882480957562,459500,484000,24500,727072
11401,6400,2020-11-03,0.04431818181818182,440000,459500,19500,712258
11402,6400,2020-10-20,0.04721549636803874,413000,432500,19500,317386
11403,6400,2020-09-24,0.06071019473081329,436500,410000,-26500,722856
11404,6400,2020-08-20,0.04602991944764097,434500,414500,-20000,726581
11405,6400,2020-08-14,0.05732484076433121,471000,444000,-27000,1061360
11406,6400,2020-08-05,0.125,416000,468000,52000,1319206
11407,6400,2020-08-03,0.042767295597484274,397500,414500,17000,1058971
11408,6400,2020-06-16,0.07890961262553801,348500,376000,27500,846115
11409,6400,2020-06-15,0.08168642951251646,379500,348500,-31000,1182814
11410,6400,2020-05-27,0.059278350515463915,388000,365000,-23000,1676145
11411,6400,2020-05-26,0.11494252873563218,348000,388000,40000,1454090
11412,6400,2020-05-20,0.04251968503937008,317500,331000,13500,614805
11413,6400,2020-05-13,0.0897887323943662,284000,309500,25500,1659104
11414,6400,2020-04-17,0.05719557195571956,271000,286500,15500,2107737
11415,6400,2020-04-16,0.0775347912524851,251500,271000,19500,1230799
11416,6400,2020-04-14,0.041407867494824016,241500,251500,10000,640598
11417,6400,2020-03-25,0.04462474645030426,246500,257500,11000,1368513
11418,6400,2020-03-24,0.12814645308924486,218500,246500,28000,1668595
11419,6400,2020-03-20,0.1830601092896175,183000,216500,33500,1818258
11420,6400,2020-03-19,0.17381489841986456,221500,183000,-38500,2233285
11421,6400,2020-03-18,0.09959349593495935,246000,221500,-24500,1105362
11422,6400,2020-03-16,0.08828828828828829,277500,253000,-24500,994249
11423,6400,2020-03-09,0.0679304897314376,316500,295000,-21500,728826
11424,6400,2020-02-28,0.046849757673667204,309500,295000,-14500,919096
11425,6400,2020-02-24,0.04606240713224369,336500,321000,-15500,704622
11426,6400,2020-02-11,0.06687402799377916,321500,343000,21500,874870
11427,6400,2020-02-04,0.08450704225352113,284000,308000,24000,939164
11428,6400,2020-01-13,0.040160642570281124,249000,259000,10000,641733
11429,6400,2020-01-10,0.07096774193548387,232500,249000,16500,819751
11430,6400,2019-12-27,0.04719101123595506,222500,233000,10500,411543
11431,6400,2019-12-04,0.05485232067510549,237000,224000,-13000,555044
11432,6400,2019-09-25,0.0649895178197065,238500,223000,-15500,641510
11433,6400,2019-08-14,0.04073319755600815,245500,255500,10000,349485
11434,6400,2019-08-09,0.048728813559322036,236000,247500,11500,277745
11435,6400,2019-07-31,0.05063291139240506,237000,249000,12000,617734
11436,6400,2019-05-30,0.04914004914004914,203500,213500,10000,452930
11437,6400,2019-05-09,0.07112970711297072,239000,222000,-17000,725606
11438,6400,2019-03-21,0.04807692307692308,208000,218000,10000,1179042
11439,6400,2019-02-07,0.05726872246696035,227000,240000,13000,692664
11440,6400,2019-01-07,0.07960199004975124,201000,217000,16000,549913
11441,6400,2018-12-21,0.05238095238095238,210000,221000,11000,706872
11442,6400,2018-12-19,0.04197530864197531,202500,211000,8500,336919
11443,6400,2018-12-14,0.04861111111111111,216000,205500,-10500,459055
11444,6400,2018-12-03,0.07021791767554479,206500,221000,14500,511045
11445,6400,2018-11-20,0.060674157303370786,222500,209000,-13500,594077
11446,6400,2018-11-09,0.05458515283842795,229000,216500,-12500,698588
11447,6400,2018-10-24,0.0709812108559499,239500,222500,-17000,811416
11448,6400,2018-10-23,0.045816733067729085,251000,239500,-11500,514080
11449,6400,2018-10-12,0.07488986784140969,227000,244000,17000,516051
11450,6400,2018-10-11,0.04821802935010482,238500,227000,-11500,419946
11451,6400,2018-08-27,0.04017857142857143,224000,233000,9000,394144
11452,6400,2018-08-21,0.04326923076923077,208000,217000,9000,318915
11453,6400,2018-08-10,0.06564551422319474,228500,213500,-15000,625069
11454,6400,2018-07-23,0.04956896551724138,232000,220500,-11500,440882
11455,6400,2018-07-06,0.07441860465116279,215000,231000,16000,853958
11456,6400,2018-06-20,0.06018518518518518,216000,229000,13000,454949
11457,6400,2018-06-18,0.05307855626326964,235500,223000,-12500,646476
11458,6400,2018-06-04,0.04784688995215311,209000,219000,10000,610620
11459,6400,2018-06-01,0.04239401496259352,200500,209000,8500,357994
11460,6400,2018-05-14,0.04712041884816754,191000,200000,9000,456025
11461,6400,2018-04-04,0.04050632911392405,197500,189500,-8000,363317
11462,6400,2018-03-23,0.040865384615384616,208000,199500,-8500,453539
11463,6400,2018-03-19,0.04408352668213457,215500,206000,-9500,635991
11464,6400,2018-03-09,0.07967032967032966,182000,196500,14500,1178221
11465,6400,2018-03-06,0.05588235294117647,170000,179500,9500,378661
11466,6400,2018-02-14,0.0463768115942029,172500,180500,8000,386259
11467,6400,2018-02-02,0.04533333333333334,187500,179000,-8500,1541960
11468,6400,2018-02-01,0.048223350253807105,197000,187500,-9500,1296858
11469,6400,2018-01-19,0.06422018348623854,218000,204000,-14000,969072
11470,6400,2018-01-05,0.05755395683453238,208500,220500,12000,631052
11471,6400,2017-12-21,0.04265402843601896,211000,202000,-9000,281320
11472,6400,2017-12-05,0.04672897196261682,214000,204000,-10000,514290
11473,6400,2017-11-27,0.043010752688172046,232500,222500,-10000,462103
11474,6400,2017-11-22,0.041189931350114416,218500,227500,9000,554363
11475,6400,2017-11-01,0.08980582524271845,206000,224500,18500,1325337
11476,6400,2017-10-16,0.05787037037037037,216000,203500,-12500,771109
11477,6400,2017-10-10,0.07556675062972293,198500,213500,15000,632311
11478,6400,2017-09-28,0.045346062052505964,209500,200000,-9500,677664
11479,6400,2017-09-13,0.0425,200000,208500,8500,554660
11480,6400,2017-09-11,0.05194805194805195,192500,202500,10000,618610
11481,6400,2017-08-14,0.04437869822485207,169000,176500,7500,218942
11482,6400,2017-08-02,0.0436046511627907,172000,179500,7500,364917
11483,6400,2017-07-28,0.04046242774566474,173000,166000,-7000,781325
11484,6400,2017-07-26,0.057692307692307696,182000,171500,-10500,482123
11485,6400,2017-07-19,0.0582010582010582,189000,178000,-11000,644301
11486,6400,2017-07-13,0.04927536231884058,172500,181000,8500,557722
11487,6400,2017-07-05,0.050445103857566766,168500,177000,8500,516326
11488,6400,2017-06-26,0.0486322188449848,164500,172500,8000,607350
11489,6400,2017-06-19,0.05084745762711865,147500,155000,7500,375439
11490,6400,2017-06-12,0.04823151125401929,155500,148000,-7500,599554
11491,6400,2017-06-01,0.04229607250755287,165500,158500,-7000,400254
11492,6400,2017-05-11,0.06007067137809187,141500,150000,8500,664511
11493,6400,2017-03-08,0.04,125000,130000,5000,653779
11494,6400,2017-01-19,0.06222222222222222,112500,105500,-7000,694866
11495,6400,2016-12-15,0.044012282497441144,97700,102000,4300,508417
11496,6400,2016-12-08,0.04189636163175303,90700,94500,3800,413025
11497,6400,2016-09-12,0.05853658536585366,102500,96500,-6000,626466
11498,6400,2016-09-01,0.06060606060606061,115500,108500,-7000,920876
11499,6400,2016-08-22,0.046413502109704644,118500,124000,5500,422550
11500,6400,2016-08-03,0.04672897196261682,107000,112000,5000,468199
11501,5380,2021-05-28,0.05215419501133787,220500,232000,11500,2394356
11502,5380,2021-04-02,0.06621004566210045,219000,233500,14500,3648528
11503,5380,2021-02-25,0.0425531914893617,235000,245000,10000,1562697
11504,5380,2021-02-08,0.06212424849699399,249500,234000,-15500,3212977
11505,5380,2021-02-01,0.04148471615720524,229000,238500,9500,1798912
11506,5380,2021-01-19,0.08506224066390042,241000,261500,20500,4976690
11507,5380,2021-01-15,0.041916167664670656,250500,240000,-10500,3915078
11508,5380,2021-01-11,0.08739837398373984,246000,267500,21500,14433887
11509,5380,2021-01-08,0.1941747572815534,206000,246000,40000,19933702
11510,5380,2021-01-04,0.08072916666666667,192000,207500,15500,5651695
11511,5380,2020-12-03,0.07671232876712329,182500,196500,14000,6053809
11512,5380,2020-10-05,0.047619047619047616,178500,187000,8500,2732820
11513,5380,2020-09-24,0.04456824512534819,179500,171500,-8000,2841908
11514,5380,2020-09-14,0.04956268221574344,171500,180000,8500,3145262
11515,5380,2020-08-28,0.05198776758409786,163500,172000,8500,5571784
11516,5380,2020-08-20,0.057750759878419454,164500,155000,-9500,3630223
11517,5380,2020-08-19,0.04113924050632911,158000,164500,6500,3298626
11518,5380,2020-08-18,0.05389221556886228,167000,158000,-9000,4328953
11519,5380,2020-08-11,0.052941176470588235,170000,179000,9000,6776406
11520,5380,2020-08-10,0.1564625850340136,147000,170000,23000,8460795
11521,5380,2020-08-06,0.07835820895522388,134000,144500,10500,4040334
11522,5380,2020-08-04,0.04330708661417323,127000,132500,5500,2492506
11523,5380,2020-07-23,0.05063291139240506,118500,124500,6000,4505464
11524,5380,2020-07-17,0.06818181818181818,110000,117500,7500,4265529
11525,5380,2020-07-15,0.07389162561576355,101500,109000,7500,4494730
11526,5380,2020-06-24,0.04356636271529889,98700,103000,4300,1813817
11527,5380,2020-06-16,0.04639175257731959,97000,101500,4500,1389765
11528,5380,2020-06-15,0.06280193236714976,103500,97000,-6500,2022775
11529,5380,2020-06-12,0.04608294930875576,108500,103500,-5000,1977558
11530,5380,2020-06-03,0.05853658536585366,102500,108500,6000,3118795
11531,5380,2020-05-19,0.07834602829162132,91900,99100,7200,4564370
11532,5380,2020-04-21,0.042008196721311473,97600,93500,-4100,3634142
11533,5380,2020-04-09,0.07888888888888888,90000,97100,7100,3787201
11534,5380,2020-03-25,0.12967914438502673,74800,84500,9700,4604452
11535,5380,2020-03-24,0.08563134978229318,68900,74800,5900,2856282
11536,5380,2020-03-20,0.07890743550834597,65900,71100,5200,3349914
11537,5380,2020-03-19,0.10340136054421768,73500,65900,-7600,3138004
11538,5380,2020-03-18,0.08239700374531835,80100,73500,-6600,2679420
11539,5380,2020-03-16,0.04931192660550459,87200,82900,-4300,2674557
11540,5380,2020-03-13,0.08210526315789474,95000,87200,-7800,4835445
11541,5380,2020-03-12,0.05,100000,95000,-5000,2312355
11542,5380,2020-03-09,0.058823529411764705,110500,104000,-6500,1658544
11543,5380,2020-02-28,0.049586776859504134,121000,115000,-6000,1777353
11544,5380,2020-02-24,0.04296875,128000,122500,-5500,911932
11545,5380,2020-02-06,0.06451612903225806,124000,132000,8000,1659774
11546,5380,2020-01-22,0.08547008547008547,117000,127000,10000,2773421
11547,5380,2019-04-03,0.04201680672268908,119000,124000,5000,651778
11548,5380,2019-03-08,0.043824701195219126,125500,120000,-5500,467762
11549,5380,2019-02-27,0.053061224489795916,122500,129000,6500,1233285
11550,5380,2019-01-15,0.04938271604938271,121500,127500,6000,828015
11551,5380,2018-12-19,0.0423728813559322,118000,123000,5000,841175
11552,5380,2018-12-12,0.06278026905829596,111500,118500,7000,1558536
11553,5380,2018-11-30,0.07,100000,107000,7000,3017114
11554,5380,2018-11-27,0.06203995793901157,95100,101000,5900,1436195
11555,5380,2018-11-22,0.05112474437627812,97800,92800,-5000,1527106
11556,5380,2018-11-05,0.05454545454545454,110000,104000,-6000,921610
11557,5380,2018-10-25,0.05982905982905983,117000,110000,-7000,1633392
11558,5380,2018-04-26,0.04573170731707317,164000,156500,-7500,861668
11559,5380,2018-03-29,0.052805280528052806,151500,143500,-8000,1532300
11560,5380,2018-02-21,0.04234527687296417,153500,160000,6500,537567
11561,5380,2018-01-19,0.04516129032258064,155000,162000,7000,637243
11562,5380,2018-01-02,0.041666666666666664,156000,149500,-6500,731763
11563,5380,2017-12-11,0.05362776025236593,158500,150000,-8500,1235495
11564,5380,2017-10-26,0.07407407407407407,148500,159500,11000,1550507
11565,5380,2017-09-26,0.04609929078014184,141000,147500,6500,841918
11566,5380,2017-05-18,0.04100946372239748,158500,165000,6500,1274106
11567,5380,2017-05-02,0.04861111111111111,144000,151000,7000,883476
11568,5380,2017-04-26,0.04498269896193772,144500,151000,6500,1288277
11569,5380,2017-03-21,0.08626198083067092,156500,170000,13500,2100147
11570,5380,2017-03-03,0.04377104377104377,148500,142000,-6500,774281
11571,5380,2016-12-08,0.040293040293040296,136500,142000,5500,889649
11572,17670,2021-04-13,0.06007067137809187,283000,300000,17000,640853
11573,17670,2021-03-26,0.08086785009861933,253500,274000,20500,1101946
11574,17670,2021-02-05,0.0465587044534413,247000,258500,11500,744401
11575,17670,2021-01-07,0.07784431137724551,250500,270000,19500,1358231
11576,17670,2020-10-14,0.049484536082474224,242500,230500,-12000,860420
11577,17670,2020-07-01,0.052132701421800945,211000,222000,11000,872553
11578,17670,2020-04-06,0.040983606557377046,183000,190500,7500,417491
11579,17670,2020-04-02,0.04,175000,182000,7000,458271
11580,17670,2020-03-23,0.054285714285714284,175000,165500,-9500,341417
11581,17670,2020-03-18,0.04,187500,180000,-7500,278157
11582,17670,2020-03-13,0.06855791962174941,211500,197000,-14500,670552
11583,17670,2020-03-04,0.06038647342995169,207000,219500,12500,353005
11584,17670,2018-11-16,0.0449438202247191,267000,279000,12000,175679
11585,17670,2018-10-11,0.05263157894736842,285000,270000,-15000,234179
11586,17670,2018-06-11,0.04782608695652174,230000,241000,11000,493788
11587,17670,2018-01-18,0.043151969981238276,266500,278000,11500,289341
11588,17670,2017-10-10,0.049019607843137254,255000,267500,12500,385055
11589,17670,2017-09-15,0.045454545454545456,242000,253000,11000,262637
11590,17670,2017-03-15,0.048879837067209775,245500,257500,12000,436849
11591,17670,2017-03-08,0.04329004329004329,231000,241000,10000,565790
11592,86790,2021-05-06,0.05942857142857143,43750,46350,2600,1569158
11593,86790,2021-02-18,0.04084321475625823,37950,36400,-1550,1528640
11594,86790,2021-02-05,0.06480117820324006,33950,36150,2200,2786900
11595,86790,2021-02-01,0.07656967840735068,32650,35150,2500,2949278
11596,86790,2021-01-29,0.0536231884057971,34500,32650,-1850,3128632
11597,86790,2021-01-07,0.058992805755395686,34750,36800,2050,4379391
11598,86790,2020-12-29,0.04881450488145049,35850,34100,-1750,2294951
11599,86790,2020-11-30,0.04915730337078652,35600,33850,-1750,3275948
11600,86790,2020-11-16,0.05339105339105339,34650,36500,1850,2553852
11601,86790,2020-11-10,0.05757575757575758,33000,34900,1900,3233993
11602,86790,2020-11-02,0.06085526315789474,30400,32250,1850,2057204
11603,86790,2020-10-27,0.04747320061255743,32650,31100,-1550,3144245
11604,86790,2020-10-05,0.042704626334519574,28100,29300,1200,2961211
11605,86790,2020-08-20,0.043029259896729774,29050,27800,-1250,2282005
11606,86790,2020-08-18,0.056818181818181816,30800,29050,-1750,2370890
11607,86790,2020-07-20,0.055357142857142855,28000,29550,1550,2844468
11608,86790,2020-07-13,0.05631067961165048,25750,27200,1450,1447994
11609,86790,2020-06-16,0.08662900188323917,26550,28850,2300,2368001
11610,86790,2020-06-15,0.044964028776978415,27800,26550,-1250,2631725
11611,86790,2020-06-12,0.041379310344827586,29000,27800,-1200,2502641
11612,86790,2020-06-10,0.040453074433656956,30900,29650,-1250,3333691
11613,86790,2020-06-02,0.04983388704318937,30100,31600,1500,2627730
11614,86790,2020-05-29,0.04569420035149385,28450,29750,1300,3900266
11615,86790,2020-05-28,0.04595588235294118,27200,28450,1250,5036049
11616,86790,2020-05-26,0.044921875,25600,26750,1150,2522700
11617,86790,2020-05-19,0.04819277108433735,24900,26100,1200,3506962
11618,86790,2020-05-04,0.04528985507246377,27600,26350,-1250,2747849
11619,86790,2020-04-27,0.16846652267818574,23150,27050,3900,6692821
11620,86790,2020-04-10,0.05636743215031315,23950,25300,1350,2977354
11621,86790,2020-04-06,0.0625,22400,23800,1400,1971860
11622,86790,2020-04-01,0.05411255411255411,23100,21850,-1250,2390120
11623,86790,2020-03-27,0.08447488584474885,21900,23750,1850,3537522
11624,86790,2020-03-25,0.10416666666666667,19200,21200,2000,4994511
11625,86790,2020-03-24,0.04065040650406504,18450,19200,750,3296990
11626,86790,2020-03-23,0.10653753026634383,20650,18450,-2200,2660270
11627,86790,2020-03-20,0.11320754716981132,18550,20650,2100,3413303
11628,86790,2020-03-19,0.125,21200,18550,-2650,2790246
11629,86790,2020-03-17,0.09401709401709402,23400,21200,-2200,3142301
11630,86790,2020-03-12,0.08775137111517367,27350,24950,-2400,3230934
11631,86790,2020-03-09,0.06532663316582915,29850,27900,-1950,1581464
11632,86790,2019-10-28,0.042432814710042434,35350,33850,-1500,2077624
11633,86790,2019-10-14,0.04011887072808321,33650,35000,1350,1461750
11634,86790,2019-09-20,0.04090267983074753,35450,36900,1450,1769383
11635,86790,2019-01-15,0.04843304843304843,35100,36800,1700,1276452
11636,86790,2018-12-27,0.04289544235924933,37300,35700,-1600,1074830
11637,86790,2018-10-30,0.04814814814814815,40500,38550,-1950,1520453
11638,86790,2018-10-25,0.05092592592592592,43200,41000,-2200,5334364
11639,86790,2018-10-11,0.05779716466739367,45850,43200,-2650,1823297
11640,86790,2018-06-21,0.04152637485970819,44550,42700,-1850,1188473
11641,86790,2018-06-04,0.057279236276849645,41900,44300,2400,1402129
11642,86790,2018-04-23,0.07272727272727272,44000,47200,3200,2206684
11643,86790,2018-04-03,0.05561735261401557,44950,42450,-2500,2251301
11644,86790,2018-03-13,0.044579533941236066,49350,47150,-2200,1300496
11645,86790,2018-03-12,0.04777070063694268,47100,49350,2250,928569
11646,86790,2018-02-12,0.05056759545923633,48450,50900,2450,915286
11647,86790,2018-02-06,0.05451127819548872,53200,50300,-2900,1339682
11648,86790,2017-10-10,0.0454065469904963,47350,49500,2150,1575860
11649,86790,2017-09-05,0.055613850996852045,47650,45000,-2650,2791230
11650,86790,2017-06-28,0.058333333333333334,42000,44450,2450,2519854
11651,86790,2017-05-11,0.04495747266099635,41150,43000,1850,1917586
11652,86790,2017-04-24,0.07258064516129033,37200,39900,2700,2735622
11653,86790,2017-03-13,0.050870147255689425,37350,39250,1900,1710796
11654,86790,2017-03-02,0.04113475177304964,35250,36700,1450,1799642
11655,86790,2017-02-27,0.04558011049723757,36200,34550,-1650,1311347
11656,86790,2016-11-10,0.06811145510835913,32300,34500,2200,2801451
11657,86280,2021-04-26,0.040106951871657755,187000,194500,7500,447871
11658,86280,2021-02-24,0.06082725060827251,205500,193000,-12500,583894
11659,86280,2021-02-19,0.04176904176904177,203500,212000,8500,648547
11660,86280,2021-02-08,0.09502262443438914,221000,200000,-21000,908032
11661,86280,2021-02-04,0.05411764705882353,212500,224000,11500,1000325
11662,86280,2021-02-03,0.05459057071960298,201500,212500,11000,1308961
11663,86280,2021-02-01,0.04473684210526316,190000,198500,8500,439416
11664,86280,2021-01-29,0.05,200000,190000,-10000,610106
11665,86280,2021-01-28,0.054373522458628844,211500,200000,-11500,539157
11666,86280,2021-01-26,0.04395604395604396,227500,217500,-10000,619574
11667,86280,2021-01-25,0.07819905213270142,211000,227500,16500,1443664
11668,86280,2021-01-22,0.04524886877828054,221000,211000,-10000,827471
11669,86280,2021-01-21,0.17553191489361702,188000,221000,33000,2481191
11670,86280,2021-01-19,0.04132231404958678,181500,189000,7500,323187
11671,86280,2021-01-07,0.07547169811320754,185500,199500,14000,1593352
11672,86280,2020-12-08,0.041343669250646,193500,185500,-8000,358624
11673,86280,2020-12-07,0.04032258064516129,186000,193500,7500,436758
11674,86280,2020-11-10,0.05434782608695652,184000,194000,10000,680423
11675,86280,2020-11-05,0.05263157894736842,171000,180000,9000,381711
11676,86280,2020-10-30,0.056338028169014086,177500,167500,-10000,378881
11677,86280,2020-10-26,0.05305039787798409,188500,178500,-10000,765536
11678,86280,2020-10-22,0.04488778054862843,200500,191500,-9000,658556
11679,86280,2020-10-20,0.14326647564469913,174500,199500,25000,3238647
11680,86280,2020-10-19,0.05420054200542006,184500,174500,-10000,776935
11681,86280,2020-10-15,0.06528189910979229,168500,179500,11000,942734
11682,86280,2020-10-13,0.1,150000,165000,15000,718644
11683,86280,2020-09-22,0.04421768707482993,147000,140500,-6500,160291
11684,86280,2020-09-14,0.05673758865248227,141000,149000,8000,207148
11685,86280,2020-09-04,0.0425531914893617,141000,135000,-6000,237503
11686,86280,2020-08-28,0.11153846153846154,130000,144500,14500,736070
11687,86280,2020-08-20,0.05511811023622047,127000,120000,-7000,167390
11688,86280,2020-08-19,0.049586776859504134,121000,127000,6000,182671
11689,86280,2020-08-18,0.08333333333333333,132000,121000,-11000,300421
11690,86280,2020-08-14,0.07317073170731707,123000,132000,9000,362789
11691,86280,2020-08-10,0.05327868852459016,122000,128500,6500,431886
11692,86280,2020-08-06,0.044444444444444446,112500,117500,5000,292493
11693,86280,2020-07-22,0.040983606557377046,122000,117000,-5000,230536
11694,86280,2020-07-20,0.10087719298245613,114000,125500,11500,366083
11695,86280,2020-07-13,0.043478260869565216,103500,108000,4500,87606
11696,86280,2020-06-25,0.04954954954954955,111000,105500,-5500,77342
11697,86280,2020-06-24,0.05714285714285714,105000,111000,6000,138719
11698,86280,2020-06-17,0.044642857142857144,112000,107000,-5000,129708
11699,86280,2020-06-16,0.07692307692307693,104000,112000,8000,131995
11700,86280,2020-06-15,0.05454545454545454,110000,104000,-6000,168887
11701,86280,2020-06-12,0.047619047619047616,115500,110000,-5500,212929
11702,86280,2020-06-05,0.06329113924050633,118500,126000,7500,190843
11703,86280,2020-05-19,0.11168562564632885,96700,107500,10800,355264
11704,86280,2020-04-13,0.047619047619047616,105000,100000,-5000,110742
11705,86280,2020-04-09,0.07106598984771574,98500,105500,7000,209037
11706,86280,2020-04-06,0.11508379888268157,89500,99800,10300,175936
11707,86280,2020-04-01,0.04856512141280353,90600,86200,-4400,120861
11708,86280,2020-03-31,0.041379310344827586,87000,90600,3600,159249
11709,86280,2020-03-25,0.1095890410958904,80300,89100,8800,253558
11710,86280,2020-03-24,0.09549795361527967,73300,80300,7000,146516
11711,86280,2020-03-23,0.09506172839506173,81000,73300,-7700,231152
11712,86280,2020-03-19,0.0871559633027523,87200,79600,-7600,207059
11713,86280,2020-03-18,0.044906900328587074,91300,87200,-4100,187253
11714,86280,2020-03-17,0.07591093117408906,98800,91300,-7500,206253
11715,86280,2020-03-13,0.06481481481481481,108000,101000,-7000,210940
11716,86280,2020-03-09,0.058091286307053944,120500,113500,-7000,141332
11717,86280,2020-02-24,0.04797047970479705,135500,129000,-6500,87117
11718,86280,2020-01-23,0.0684931506849315,146000,156000,10000,251701
11719,86280,2019-07-19,0.04234527687296417,153500,160000,6500,66165
11720,86280,2019-06-14,0.041666666666666664,168000,161000,-7000,133848
11721,86280,2019-04-29,0.07142857142857142,147000,157500,10500,307584
11722,86280,2019-04-16,0.04044117647058824,136000,141500,5500,102145
11723,86280,2019-02-27,0.0627062706270627,151500,142000,-9500,354023
11724,86280,2019-01-25,0.05460750853242321,146500,138500,-8000,251637
11725,86280,2019-01-03,0.05976095617529881,125500,133000,7500,122377
11726,86280,2018-12-12,0.09623430962343096,119500,131000,11500,231083
11727,86280,2018-11-26,0.04017857142857143,112000,116500,4500,81449
11728,86280,2018-11-22,0.0425531914893617,117500,112500,-5000,161507
11729,86280,2018-11-06,0.04,112500,117000,4500,129436
11730,86280,2018-10-31,0.06542056074766354,107000,114000,7000,168399
11731,86280,2018-10-23,0.04054054054054054,111000,106500,-4500,95331
11732,86280,2018-10-18,0.057777777777777775,112500,106000,-6500,180053
11733,86280,2018-10-11,0.04741379310344827,116000,110500,-5500,140469
11734,86280,2018-09-07,0.050980392156862744,127500,134000,6500,293505
11735,86280,2018-09-06,0.0625,120000,127500,7500,204616
11736,86280,2018-08-08,0.04044117647058824,136000,130500,-5500,471336
11737,86280,2018-08-02,0.05434782608695652,138000,130500,-7500,131498
11738,86280,2018-07-16,0.05327868852459016,122000,128500,6500,189013
11739,86280,2018-07-12,0.061946902654867256,113000,120000,7000,207545
11740,86280,2018-06-27,0.0411522633744856,121500,116500,-5000,174713
11741,86280,2018-05-30,0.040293040293040296,136500,131000,-5500,374984
11742,86280,2018-05-23,0.04983388704318937,150500,143000,-7500,638682
11743,86280,2018-05-04,0.047058823529411764,170000,162000,-8000,213393
11744,86280,2018-04-18,0.0425531914893617,188000,180000,-8000,260868
11745,86280,2018-04-17,0.06515580736543909,176500,188000,11500,366618
11746,86280,2018-03-30,0.07142857142857142,182000,169000,-13000,1048094
11747,86280,2018-03-29,0.04899135446685879,173500,182000,8500,1716544
11748,86280,2018-03-28,0.10158730158730159,157500,173500,16000,1335794
11749,86280,2018-03-22,0.04643962848297214,161500,154000,-7500,279717
11750,86280,2018-03-14,0.09285714285714286,140000,153000,13000,537347
11751,86280,2018-02-26,0.051094890510948905,137000,144000,7000,370812
11752,86280,2017-08-09,0.04126984126984127,157500,164000,6500,134047
11753,86280,2017-08-04,0.058823529411764705,153000,162000,9000,235249
11754,86280,2017-03-21,0.0436241610738255,149000,155500,6500,381844
11755,86280,2017-01-31,0.04892966360856269,163500,155500,-8000,164291
11756,86280,2017-01-12,0.054313099041533544,156500,165000,8500,224605
11757,86280,2017-01-02,0.045307443365695796,154500,161500,7000,177177
11758,86280,2016-12-01,0.05660377358490566,159000,150000,-9000,242619
11759,86280,2016-11-10,0.05341246290801187,168500,159500,-9000,432456
11760,86280,2016-11-09,0.0453257790368272,176500,168500,-8000,154539
11761,86280,2016-08-24,0.07462686567164178,167500,180000,12500,353531
11762,5385,2021-05-28,0.04265402843601896,105500,110000,4500,129676
11763,5385,2021-04-02,0.059113300492610835,101500,107500,6000,151389
11764,5385,2021-03-19,0.0502283105022831,109500,104000,-5500,294876
11765,5385,2021-03-18,0.04784688995215311,104500,109500,5000,114712
11766,5385,2021-02-24,0.045454545454545456,110000,105000,-5000,127588
11767,5385,2021-02-03,0.04741379310344827,116000,121500,5500,245461
11768,5385,2021-01-29,0.05042016806722689,119000,113000,-6000,311928
11769,5385,2021-01-21,0.05603448275862069,116000,122500,6500,421610
11770,5385,2021-01-19,0.05829596412556054,111500,118000,6500,459736
11771,5385,2021-01-18,0.04700854700854701,117000,111500,-5500,662236
11772,5385,2021-01-11,0.15789473684210525,104500,121000,16500,1653451
11773,5385,2021-01-08,0.16111111111111112,90000,104500,14500,1613820
11774,5385,2020-12-03,0.042352941176470586,85000,88600,3600,346208
11775,5385,2020-09-14,0.047044632086851626,82900,86800,3900,152529
11776,5385,2020-08-20,0.05103280680437424,82300,78100,-4200,297954
11777,5385,2020-08-18,0.06805074971164937,86700,80800,-5900,336178
11778,5385,2020-08-10,0.12658227848101267,79000,89000,10000,966852
11779,5385,2020-08-06,0.0521978021978022,72800,76600,3800,253244
11780,5385,2020-07-17,0.07993197278911565,58800,63500,4700,415950
11781,5385,2020-07-15,0.04316546762589928,55600,58000,2400,268321
11782,5385,2020-06-15,0.047697368421052634,60800,57900,-2900,276494
11783,5385,2020-05-19,0.07076350093109869,53700,57500,3800,222549
11784,5385,2020-04-09,0.0890909090909091,55000,59900,4900,195596
11785,5385,2020-03-31,0.04559270516717325,49350,51600,2250,214284
11786,5385,2020-03-25,0.1085972850678733,44200,49000,4800,407188
11787,5385,2020-03-24,0.046153846153846156,42250,44200,1950,249395
11788,5385,2020-03-20,0.0853960396039604,40400,43850,3450,170162
11789,5385,2020-03-19,0.09417040358744394,44600,40400,-4200,228340
11790,5385,2020-03-18,0.06006322444678609,47450,44600,-2850,126626
11791,5385,2020-03-17,0.04527162977867203,49700,47450,-2250,125357
11792,5385,2020-03-16,0.05333333333333334,52500,49700,-2800,148700
11793,5385,2020-03-13,0.06417112299465241,56100,52500,-3600,223092
11794,5385,2020-03-12,0.04915254237288136,59000,56100,-2900,115983
11795,5385,2020-03-09,0.05092592592592592,64800,61500,-3300,102333
11796,5385,2020-02-06,0.045205479452054796,73000,76300,3300,74177
11797,5385,2020-01-22,0.04728789986091794,71900,75300,3400,69332
11798,5385,2019-02-27,0.0458970792767733,71900,75200,3300,66072
11799,5385,2019-01-15,0.047345767575322814,69700,73000,3300,64676
11800,5385,2018-12-13,0.041604754829123326,67300,70100,2800,109026
11801,5385,2018-11-30,0.049441786283891544,62700,65800,3100,149869
11802,5385,2018-11-22,0.04145936981757877,60300,57800,-2500,81269
11803,5385,2018-11-20,0.04588607594936709,63200,60300,-2900,63874
11804,5385,2018-10-25,0.05053598774885146,65300,62000,-3300,68458
11805,5385,2018-04-24,0.047311827956989246,93000,97400,4400,307217
11806,5385,2018-04-17,0.040183696900114814,87100,90600,3500,229636
11807,5385,2018-04-04,0.04225352112676056,85200,88800,3600,104435
11808,5385,2018-03-19,0.04092920353982301,90400,86700,-3700,47154
11809,5385,2017-10-26,0.05714285714285714,94500,99900,5400,94255
11810,5385,2017-03-21,0.075,100000,107500,7500,111577
11811,5385,2016-12-01,0.04175365344467641,95800,91800,-4000,30438
11812,5385,2016-11-10,0.04090419806243272,92900,89100,-3800,60886
11813,122630,2021-03-11,0.04229304469833634,24945,26000,1055,37068944
11814,122630,2021-02-26,0.05305525064032199,27330,25880,-1450,48357169
11815,122630,2021-02-25,0.07134457075656606,25510,27330,1820,39211065
11816,122630,2021-02-24,0.04169797145003756,26620,25510,-1110,49977421
11817,122630,2021-02-01,0.04913180741910024,25340,26585,1245,53778379
11818,122630,2021-01-29,0.04772641863960917,26610,25340,-1270,57505130
11819,122630,2021-01-26,0.05333786308816035,29435,27865,-1570,42364091
11820,122630,2021-01-25,0.04713625044468161,28110,29435,1325,32979184
11821,122630,2021-01-19,0.05387723686742352,25985,27385,1400,50743899
11822,122630,2021-01-18,0.048691195313930076,27315,25985,-1330,51188340
11823,122630,2021-01-15,0.04174706191896158,28505,27315,-1190,60344002
11824,122630,2021-01-08,0.09118598895869028,26265,28660,2395,82580037
11825,122630,2021-01-07,0.04871231782790976,25045,26265,1220,64213048
11826,122630,2021-01-04,0.05412863510931862,23555,24830,1275,47006539
11827,122630,2020-12-30,0.049220489977728286,22450,23555,1105,82665235
11828,122630,2020-12-09,0.04302151075537769,19990,20850,860,69067841
11829,122630,2020-11-23,0.04469114716766297,17565,18350,785,66558284
11830,122630,2020-11-16,0.04334916864608076,16840,17570,730,70135877
11831,122630,2020-11-05,0.04466666666666667,15000,15670,670,68150084
11832,122630,2020-11-03,0.04073033707865169,14240,14820,580,49844786
11833,122630,2020-10-30,0.052307692307692305,14625,13860,-765,69968858
11834,122630,2020-09-24,0.04462753175420529,14565,13915,-650,93336355
11835,122630,2020-09-22,0.04707044107965767,15190,14475,-715,87031205
11836,122630,2020-08-20,0.07671957671957672,15120,13960,-1160,88667816
11837,122630,2020-08-18,0.04028132992327366,15640,15010,-630,50533337
11838,122630,2020-07-28,0.04072398190045249,13260,13800,540,58274268
11839,122630,2020-06-25,0.05344418052256532,12630,11955,-675,101259290
11840,122630,2020-06-16,0.11852861035422343,11010,12315,1305,108269670
11841,122630,2020-06-15,0.10012259910093993,12235,11010,-1225,108611045
11842,122630,2020-06-03,0.07139839459231094,11835,12680,845,120807314
11843,122630,2020-05-19,0.050664043285784555,10165,10680,515,83759982
11844,122630,2020-05-04,0.05831325301204819,10375,9770,-605,109536575
11845,122630,2020-04-27,0.041173443129181676,9715,10115,400,100714810
11846,122630,2020-04-17,0.06341719077568134,9540,10145,605,151077291
11847,122630,2020-04-06,0.08233890214797136,8380,9070,690,175582249
11848,122630,2020-04-02,0.05726872246696035,7945,8400,455,237250899
11849,122630,2020-04-01,0.08887614678899082,8720,7945,-775,140887045
11850,122630,2020-03-27,0.04621072088724584,8115,8490,375,258365393
11851,122630,2020-03-25,0.09647979139504563,7670,8410,740,359958109
11852,122630,2020-03-24,0.18181818181818182,6490,7670,1180,321288874
11853,122630,2020-03-23,0.11700680272108843,7350,6490,-860,254018216
11854,122630,2020-03-20,0.13953488372093023,6450,7350,900,317997413
11855,122630,2020-03-19,0.14399469143994692,7535,6450,-1085,348129036
11856,122630,2020-03-18,0.11196228638774308,8485,7535,-950,207660013
11857,122630,2020-03-16,0.07708442579968537,9535,8800,-735,139803278
11858,122630,2020-03-13,0.045067601402103155,9985,9535,-450,217764791
11859,122630,2020-03-12,0.08141674333026679,10870,9985,-885,149276466
11860,122630,2020-03-11,0.06050129645635264,11570,10870,-700,85614537
11861,122630,2020-03-09,0.07516077170418006,12440,11505,-935,81658729
11862,122630,2020-03-06,0.040123456790123455,12960,12440,-520,53915669
11863,122630,2020-03-04,0.04642563681183237,12170,12735,565,56395689
11864,122630,2020-02-28,0.062302839116719244,12680,11890,-790,77195789
11865,122630,2020-02-24,0.07261778250088559,14115,13090,-1025,54223745
11866,122630,2020-02-06,0.05986539142755933,14115,14960,845,33957205
11867,122630,2020-01-28,0.0576036866359447,15190,14315,-875,19627071
11868,122630,2019-10-02,0.04331983805668016,12350,11815,-535,18828245
11869,122630,2019-08-05,0.043076923076923075,11375,10885,-490,32773134
11870,122630,2019-07-08,0.042724707779121324,12405,11875,-530,26500612
11871,122630,2019-05-09,0.05714285714285714,12950,12210,-740,35934867
11872,122630,2019-03-25,0.040392600981502456,13245,12710,-535,15855015
11873,122630,2019-01-09,0.041259982253771074,11270,11735,465,23324011
11874,122630,2018-11-02,0.07259849490925188,11295,12115,820,27541346
11875,122630,2018-10-23,0.047674872997264556,12795,12185,-610,23408737
11876,122630,2018-10-11,0.08193123628383321,13670,12550,-1120,32570741
11877,122630,2018-07-02,0.043199460006749915,14815,14175,-640,17360237
11878,122630,2018-05-30,0.04293921983671001,16535,15825,-710,40059396
11879,122630,2018-03-23,0.0683588116527257,17335,16150,-1185,30572550
11880,122630,2018-03-06,0.04019448946515397,15425,16045,620,14334983
11881,122630,2018-02-09,0.05070250458155162,16370,15540,-830,30251675
11882,122630,2018-02-07,0.048686928297432874,16945,16120,-825,32122967
11883,122630,2017-05-08,0.05127310777816533,14335,15070,735,19000858
11884,122630,2016-11-09,0.041879944160074456,10745,10295,-450,92379630
11885,122630,2016-09-12,0.0502283105022831,10950,10400,-550,25078756
11886,5387,2021-05-27,0.04524886877828054,110500,105500,-5000,224459
11887,5387,2021-04-02,0.07106598984771574,98500,105500,7000,212281
11888,5387,2021-02-26,0.04672897196261682,107000,102000,-5000,232077
11889,5387,2021-02-24,0.04608294930875576,108500,103500,-5000,169394
11890,5387,2021-02-10,0.046296296296296294,108000,113000,5000,94318
11891,5387,2021-02-08,0.06140350877192982,114000,107000,-7000,190124
11892,5387,2021-02-01,0.04854368932038835,103000,108000,5000,127937
11893,5387,2021-01-29,0.0593607305936073,109500,103000,-6500,250714
11894,5387,2021-01-26,0.041666666666666664,120000,115000,-5000,180599
11895,5387,2021-01-21,0.06550218340611354,114500,122000,7500,319389
11896,5387,2021-01-19,0.09813084112149532,107000,117500,10500,287452
11897,5387,2021-01-11,0.11650485436893204,103000,115000,12000,859727
11898,5387,2021-01-08,0.13561190738699008,90700,103000,12300,1253389
11899,5387,2020-12-03,0.04431818181818182,88000,91900,3900,215355
11900,5387,2020-09-14,0.05174488567990373,83100,87400,4300,102119
11901,5387,2020-08-25,0.04390243902439024,82000,85600,3600,108829
11902,5387,2020-08-20,0.0430622009569378,83600,80000,-3600,163389
11903,5387,2020-08-18,0.04994192799070848,86100,81800,-4300,225496
11904,5387,2020-08-10,0.11389236545682102,79900,89000,9100,650756
11905,5387,2020-08-06,0.05810810810810811,74000,78300,4300,176804
11906,5387,2020-07-22,0.0436046511627907,68800,65800,-3000,261898
11907,5387,2020-07-17,0.0840064620355412,61900,67100,5200,230788
11908,5387,2020-07-15,0.04513888888888889,57600,60200,2600,277129
11909,5387,2020-06-15,0.07938931297709924,65500,60300,-5200,179840
11910,5387,2020-06-12,0.050724637681159424,69000,65500,-3500,151113
11911,5387,2020-06-08,0.045655375552282766,67900,71000,3100,202992
11912,5387,2020-06-05,0.04461538461538461,65000,67900,2900,157515
11913,5387,2020-05-19,0.09747292418772563,55400,60800,5400,262857
11914,5387,2020-04-09,0.047619047619047616,60900,63800,2900,74567
11915,5387,2020-03-26,0.0497131931166348,52300,54900,2600,118551
11916,5387,2020-03-25,0.06408952187182096,49150,52300,3150,434850
11917,5387,2020-03-24,0.04797441364605544,46900,49150,2250,107314
11918,5387,2020-03-19,0.09295499021526418,51100,46350,-4750,136132
11919,5387,2020-03-18,0.062385321100917435,54500,51100,-3400,185432
11920,5387,2020-03-17,0.0421792618629174,56900,54500,-2400,120859
11921,5387,2020-03-16,0.051666666666666666,60000,56900,-3100,122600
11922,5387,2020-03-13,0.058084772370486655,63700,60000,-3700,262859
11923,5387,2020-03-09,0.04986149584487535,72200,68600,-3600,179610
11924,5387,2020-02-06,0.05714285714285714,80500,85100,4600,103138
11925,5387,2020-01-22,0.04905660377358491,79500,83400,3900,118558
11926,5387,2019-03-14,0.04198473282442748,78600,75300,-3300,68813
11927,5387,2019-02-27,0.046094750320102434,78100,81700,3600,299052
11928,5387,2019-02-13,0.04794520547945205,87600,83400,-4200,78585
11929,5387,2019-01-02,0.04415584415584416,77000,73600,-3400,71224
11930,5387,2018-12-13,0.05128205128205128,74100,77900,3800,68503
11931,5387,2018-12-12,0.05106382978723404,70500,74100,3600,170048
11932,5387,2018-11-30,0.04491017964071856,66800,69800,3000,232797
11933,5387,2018-11-27,0.04120443740095087,63100,65700,2600,71223
11934,5387,2018-11-22,0.05997001499250375,66700,62700,-4000,127186
11935,5387,2018-11-20,0.048104956268221574,68600,65300,-3300,68372
11936,5387,2018-10-25,0.06837606837606838,70200,65400,-4800,225072
11937,5387,2018-06-15,0.04883227176220807,94200,89600,-4600,226349
11938,5387,2018-06-04,0.040372670807453416,96600,100500,3900,40049
11939,5387,2018-05-02,0.043478260869565216,115000,110000,-5000,334590
11940,5387,2018-03-29,0.04016477857878476,97100,93200,-3900,92158
11941,5387,2018-02-09,0.04097560975609756,102500,98300,-4200,60807
11942,5387,2017-11-07,0.048034934497816595,114500,109000,-5500,74831
11943,5387,2017-10-26,0.06796116504854369,103000,110000,7000,188960
11944,5387,2017-06-14,0.047619047619047616,115500,121000,5500,181209
11945,5387,2017-04-26,0.050505050505050504,99000,104000,5000,153116
11946,5387,2017-03-21,0.06763285024154589,103500,110500,7000,333548
11947,248070,2021-04-28,0.047619047619047616,26250,25000,-1250,1181074
11948,248070,2021-04-16,0.040776699029126215,25750,26800,1050,1995750
11949,248070,2021-04-08,0.049079754601226995,24450,25650,1200,1212862
11950,248070,2021-03-31,0.05947955390334572,26900,25300,-1600,2376189
11951,248070,2021-03-24,0.1358574610244989,22450,25500,3050,6219517
11952,248070,2021-03-03,0.06320541760722348,22150,23550,1400,1013646
11953,248070,2021-02-26,0.06170212765957447,23500,22050,-1450,1148307
11954,248070,2021-02-23,0.043912175648702596,25050,23950,-1100,1243470
11955,248070,2021-02-17,0.09246575342465753,29200,26500,-2700,3834364
11956,248070,2021-02-16,0.050359712230215826,27800,29200,1400,8039412
11957,248070,2021-02-09,0.04642166344294004,25850,27050,1200,11146486
11958,248070,2021-02-08,0.04024144869215292,24850,25850,1000,6428840
11959,248070,2021-02-05,0.046065259117082535,26050,24850,-1200,6899845
11960,248070,2021-02-04,0.0843585237258348,28450,26050,-2400,3681410
11961,248070,2021-02-02,0.19517102615694165,24850,29150,4300,19866445
11962,248070,2021-02-05,0.046065259117082535,26050,24850,-1200,6899845
11963,248070,2021-02-04,0.0843585237258348,28450,26050,-2400,3681410
11964,248070,2021-02-02,0.19517102615694165,24850,29150,4300,19866445
11965,248070,2021-02-05,0.046065259117082535,26050,24850,-1200,6899845
11966,248070,2021-02-04,0.0843585237258348,28450,26050,-2400,3681410
11967,248070,2021-02-02,0.19517102615694165,24850,29150,4300,19866445
11968,248070,2021-02-05,0.046065259117082535,26050,24850,-1200,6899845
11969,248070,2021-02-04,0.0843585237258348,28450,26050,-2400,3681410
11970,248070,2021-02-02,0.19517102615694165,24850,29150,4300,19866445
11971,248070,2021-02-05,0.046065259117082535,26050,24850,-1200,6899845
11972,248070,2021-02-04,0.0843585237258348,28450,26050,-2400,3681410
11973,248070,2021-02-02,0.19517102615694165,24850,29150,4300,19866445
11974,248070,2021-02-05,0.046065259117082535,26050,24850,-1200,6899845
11975,248070,2021-02-04,0.0843585237258348,28450,26050,-2400,3681410
11976,248070,2021-02-02,0.19517102615694165,24850,29150,4300,19866445
11977,248070,2021-02-05,0.046065259117082535,26050,24850,-1200,6899845
11978,248070,2021-02-04,0.0843585237258348,28450,26050,-2400,3681410
11979,248070,2021-02-02,0.19517102615694165,24850,29150,4300,19866445
11980,248070,2021-02-05,0.046065259117082535,26050,24850,-1200,6899845
11981,248070,2021-02-04,0.0843585237258348,28450,26050,-2400,3681410
11982,248070,2021-02-02,0.19517102615694165,24850,29150,4300,19866445
11983,248070,2021-02-05,0.046065259117082535,26050,24850,-1200,6899845
11984,248070,2021-02-04,0.0843585237258348,28450,26050,-2400,3681410
11985,248070,2021-02-02,0.19517102615694165,24850,29150,4300,19866445
11986,248070,2021-02-05,0.046065259117082535,26050,24850,-1200,6899845
11987,248070,2021-02-04,0.0843585237258348,28450,26050,-2400,3681410
11988,248070,2021-02-02,0.19517102615694165,24850,29150,4300,19866445
11989,248070,2021-02-05,0.046065259117082535,26050,24850,-1200,6899845
11990,248070,2021-02-04,0.0843585237258348,28450,26050,-2400,3681410
11991,248070,2021-02-02,0.19517102615694165,24850,29150,4300,19866445
11992,248070,2021-02-05,0.046065259117082535,26050,24850,-1200,6899845
11993,248070,2021-02-04,0.0843585237258348,28450,26050,-2400,3681410
11994,248070,2021-02-02,0.19517102615694165,24850,29150,4300,19866445
11995,248070,2021-02-05,0.046065259117082535,26050,24850,-1200,6899845
11996,248070,2021-02-04,0.0843585237258348,28450,26050,-2400,3681410
11997,248070,2021-02-02,0.19517102615694165,24850,29150,4300,19866445
11998,248070,2021-02-05,0.046065259117082535,26050,24850,-1200,6899845
11999,248070,2021-02-04,0.0843585237258348,28450,26050,-2400,3681410
12000,248070,2021-02-02,0.19517102615694165,24850,29150,4300,19866445
12001,248070,2021-02-05,0.046065259117082535,26050,24850,-1200,6899845
12002,248070,2021-02-04,0.0843585237258348,28450,26050,-2400,3681410
12003,248070,2021-02-02,0.19517102615694165,24850,29150,4300,19866445
12004,248070,2021-02-05,0.046065259117082535,26050,24850,-1200,6899845
12005,248070,2021-02-04,0.0843585237258348,28450,26050,-2400,3681410
12006,248070,2021-02-02,0.19517102615694165,24850,29150,4300,19866445
12007,248070,2021-02-05,0.046065259117082535,26050,24850,-1200,6899845
12008,248070,2021-02-04,0.0843585237258348,28450,26050,-2400,3681410
12009,248070,2021-02-02,0.19517102615694165,24850,29150,4300,19866445
12010,248070,2021-02-05,0.046065259117082535,26050,24850,-1200,6899845
12011,248070,2021-02-04,0.0843585237258348,28450,26050,-2400,3681410
12012,248070,2021-02-02,0.19517102615694165,24850,29150,4300,19866445
12013,248070,2021-02-05,0.046065259117082535,26050,24850,-1200,6899845
12014,248070,2021-02-04,0.0843585237258348,28450,26050,-2400,3681410
12015,248070,2021-02-02,0.19517102615694165,24850,29150,4300,19866445
12016,248070,2021-02-05,0.046065259117082535,26050,24850,-1200,6899845
12017,248070,2021-02-04,0.0843585237258348,28450,26050,-2400,3681410
12018,248070,2021-02-02,0.19517102615694165,24850,29150,4300,19866445
12019,248070,2021-02-05,0.046065259117082535,26050,24850,-1200,6899845
12020,248070,2021-02-04,0.0843585237258348,28450,26050,-2400,3681410
12021,248070,2021-02-02,0.19517102615694165,24850,29150,4300,19866445
12022,248070,2021-02-05,0.046065259117082535,26050,24850,-1200,6899845
12023,248070,2021-02-04,0.0843585237258348,28450,26050,-2400,3681410
12024,248070,2021-02-02,0.19517102615694165,24850,29150,4300,19866445
12025,248070,2021-02-05,0.046065259117082535,26050,24850,-1200,6899845
12026,248070,2021-02-04,0.0843585237258348,28450,26050,-2400,3681410
12027,248070,2021-02-02,0.19517102615694165,24850,29150,4300,19866445
12028,248070,2021-02-05,0.046065259117082535,26050,24850,-1200,6899845
12029,248070,2021-02-04,0.0843585237258348,28450,26050,-2400,3681410
12030,248070,2021-02-02,0.19517102615694165,24850,29150,4300,19866445
12031,248070,2021-02-05,0.046065259117082535,26050,24850,-1200,6899845
12032,248070,2021-02-04,0.0843585237258348,28450,26050,-2400,3681410
12033,248070,2021-02-02,0.19517102615694165,24850,29150,4300,19866445
12034,248070,2021-02-05,0.046065259117082535,26050,24850,-1200,6899845
12035,248070,2021-02-04,0.0843585237258348,28450,26050,-2400,3681410
12036,248070,2021-02-02,0.19517102615694165,24850,29150,4300,19866445
12037,248070,2021-02-05,0.046065259117082535,26050,24850,-1200,6899845
12038,248070,2021-02-04,0.0843585237258348,28450,26050,-2400,3681410
12039,248070,2021-02-02,0.19517102615694165,24850,29150,4300,19866445
12040,248070,2021-02-05,0.046065259117082535,26050,24850,-1200,6899845
12041,248070,2021-02-04,0.0843585237258348,28450,26050,-2400,3681410
12042,248070,2021-02-02,0.19517102615694165,24850,29150,4300,19866445
12043,248070,2021-02-05,0.046065259117082535,26050,24850,-1200,6899845
12044,248070,2021-02-04,0.0843585237258348,28450,26050,-2400,3681410
12045,248070,2021-02-02,0.19517102615694165,24850,29150,4300,19866445
12046,248070,2021-02-05,0.046065259117082535,26050,24850,-1200,6899845
12047,248070,2021-02-04,0.0843585237258348,28450,26050,-2400,3681410
12048,248070,2021-02-02,0.19517102615694165,24850,29150,4300,19866445
12049,248070,2021-02-05,0.046065259117082535,26050,24850,-1200,6899845
12050,248070,2021-02-04,0.0843585237258348,28450,26050,-2400,3681410
12051,248070,2021-02-02,0.19517102615694165,24850,29150,4300,19866445
12052,248070,2021-02-05,0.046065259117082535,26050,24850,-1200,6899845
12053,248070,2021-02-04,0.0843585237258348,28450,26050,-2400,3681410
12054,248070,2021-02-02,0.19517102615694165,24850,29150,4300,19866445
12055,248070,2021-02-05,0.046065259117082535,26050,24850,-1200,6899845
12056,248070,2021-02-04,0.0843585237258348,28450,26050,-2400,3681410
12057,248070,2021-02-02,0.19517102615694165,24850,29150,4300,19866445
12058,248070,2021-02-05,0.046065259117082535,26050,24850,-1200,6899845
12059,248070,2021-02-04,0.0843585237258348,28450,26050,-2400,3681410
12060,248070,2021-02-02,0.19517102615694165,24850,29150,4300,19866445
12061,248070,2021-02-05,0.046065259117082535,26050,24850,-1200,6899845
12062,248070,2021-02-04,0.0843585237258348,28450,26050,-2400,3681410
12063,248070,2021-02-02,0.19517102615694165,24850,29150,4300,19866445
12064,248070,2021-02-05,0.046065259117082535,26050,24850,-1200,6899845
12065,248070,2021-02-04,0.0843585237258348,28450,26050,-2400,3681410
12066,248070,2021-02-02,0.19517102615694165,24850,29150,4300,19866445
12067,248070,2021-02-05,0.046065259117082535,26050,24850,-1200,6899845
12068,248070,2021-02-04,0.0843585237258348,28450,26050,-2400,3681410
12069,248070,2021-02-02,0.19517102615694165,24850,29150,4300,19866445
12070,248070,2021-02-05,0.046065259117082535,26050,24850,-1200,6899845
12071,248070,2021-02-04,0.0843585237258348,28450,26050,-2400,3681410
12072,248070,2021-02-02,0.19517102615694165,24850,29150,4300,19866445
12073,248070,2021-02-05,0.046065259117082535,26050,24850,-1200,6899845
12074,248070,2021-02-04,0.0843585237258348,28450,26050,-2400,3681410
12075,248070,2021-02-02,0.19517102615694165,24850,29150,4300,19866445
12076,248070,2021-02-05,0.046065259117082535,26050,24850,-1200,6899845
12077,248070,2021-02-04,0.0843585237258348,28450,26050,-2400,3681410
12078,248070,2021-02-02,0.19517102615694165,24850,29150,4300,19866445
12079,248070,2021-02-05,0.046065259117082535,26050,24850,-1200,6899845
12080,248070,2021-02-04,0.0843585237258348,28450,26050,-2400,3681410
12081,248070,2021-02-02,0.19517102615694165,24850,29150,4300,19866445
12082,248070,2021-02-05,0.046065259117082535,26050,24850,-1200,6899845
12083,248070,2021-02-04,0.0843585237258348,28450,26050,-2400,3681410
12084,248070,2021-02-02,0.19517102615694165,24850,29150,4300,19866445
12085,248070,2021-02-05,0.046065259117082535,26050,24850,-1200,6899845
12086,248070,2021-02-04,0.0843585237258348,28450,26050,-2400,3681410
12087,248070,2021-02-02,0.19517102615694165,24850,29150,4300,19866445
12088,248070,2021-02-05,0.046065259117082535,26050,24850,-1200,6899845
12089,248070,2021-02-04,0.0843585237258348,28450,26050,-2400,3681410
12090,248070,2021-02-02,0.19517102615694165,24850,29150,4300,19866445
12091,248070,2021-02-05,0.046065259117082535,26050,24850,-1200,6899845
12092,248070,2021-02-04,0.0843585237258348,28450,26050,-2400,3681410
12093,248070,2021-02-02,0.19517102615694165,24850,29150,4300,19866445
12094,248070,2021-02-05,0.046065259117082535,26050,24850,-1200,6899845
12095,248070,2021-02-04,0.0843585237258348,28450,26050,-2400,3681410
12096,248070,2021-02-02,0.19517102615694165,24850,29150,4300,19866445
12097,248070,2021-02-05,0.046065259117082535,26050,24850,-1200,6899845
12098,248070,2021-02-04,0.0843585237258348,28450,26050,-2400,3681410
12099,248070,2021-02-02,0.19517102615694165,24850,29150,4300,19866445
12100,248070,2021-02-05,0.046065259117082535,26050,24850,-1200,6899845
12101,248070,2021-02-04,0.0843585237258348,28450,26050,-2400,3681410
12102,248070,2021-02-02,0.19517102615694165,24850,29150,4300,19866445
12103,248070,2021-02-05,0.046065259117082535,26050,24850,-1200,6899845
12104,248070,2021-02-04,0.0843585237258348,28450,26050,-2400,3681410
12105,248070,2021-02-02,0.19517102615694165,24850,29150,4300,19866445
12106,248070,2021-02-05,0.046065259117082535,26050,24850,-1200,6899845
12107,248070,2021-02-04,0.0843585237258348,28450,26050,-2400,3681410
12108,248070,2021-02-02,0.19517102615694165,24850,29150,4300,19866445
12109,248070,2021-02-05,0.046065259117082535,26050,24850,-1200,6899845
12110,248070,2021-02-04,0.0843585237258348,28450,26050,-2400,3681410
12111,248070,2021-02-02,0.19517102615694165,24850,29150,4300,19866445
12112,248070,2021-02-05,0.046065259117082535,26050,24850,-1200,6899845
12113,248070,2021-02-04,0.0843585237258348,28450,26050,-2400,3681410
12114,248070,2021-02-02,0.19517102615694165,24850,29150,4300,19866445
12115,248070,2021-02-05,0.046065259117082535,26050,24850,-1200,6899845
12116,248070,2021-02-04,0.0843585237258348,28450,26050,-2400,3681410
12117,248070,2021-02-02,0.19517102615694165,24850,29150,4300,19866445
12118,248070,2021-02-05,0.046065259117082535,26050,24850,-1200,6899845
12119,248070,2021-02-04,0.0843585237258348,28450,26050,-2400,3681410
12120,248070,2021-02-02,0.19517102615694165,24850,29150,4300,19866445
12121,248070,2021-02-05,0.046065259117082535,26050,24850,-1200,6899845
12122,248070,2021-02-04,0.0843585237258348,28450,26050,-2400,3681410
12123,248070,2021-02-02,0.19517102615694165,24850,29150,4300,19866445
12124,248070,2021-02-05,0.046065259117082535,26050,24850,-1200,6899845
12125,248070,2021-02-04,0.0843585237258348,28450,26050,-2400,3681410
12126,248070,2021-02-02,0.19517102615694165,24850,29150,4300,19866445
12127,248070,2021-02-05,0.046065259117082535,26050,24850,-1200,6899845
12128,248070,2021-02-04,0.0843585237258348,28450,26050,-2400,3681410
12129,248070,2021-02-02,0.19517102615694165,24850,29150,4300,19866445
12130,248070,2021-02-05,0.046065259117082535,26050,24850,-1200,6899845
12131,248070,2021-02-04,0.0843585237258348,28450,26050,-2400,3681410
12132,248070,2021-02-02,0.19517102615694165,24850,29150,4300,19866445
12133,248070,2021-02-05,0.046065259117082535,26050,24850,-1200,6899845
12134,248070,2021-02-04,0.0843585237258348,28450,26050,-2400,3681410
12135,248070,2021-02-02,0.19517102615694165,24850,29150,4300,19866445
12136,248070,2021-02-05,0.046065259117082535,26050,24850,-1200,6899845
12137,248070,2021-02-04,0.0843585237258348,28450,26050,-2400,3681410
12138,248070,2021-02-02,0.19517102615694165,24850,29150,4300,19866445
12139,248070,2021-02-05,0.046065259117082535,26050,24850,-1200,6899845
12140,248070,2021-02-04,0.0843585237258348,28450,26050,-2400,3681410
12141,248070,2021-02-02,0.19517102615694165,24850,29150,4300,19866445
12142,248070,2021-02-05,0.046065259117082535,26050,24850,-1200,6899845
12143,248070,2021-02-04,0.0843585237258348,28450,26050,-2400,3681410
12144,248070,2021-02-02,0.19517102615694165,24850,29150,4300,19866445
12145,248070,2021-02-05,0.046065259117082535,26050,24850,-1200,6899845
12146,248070,2021-02-04,0.0843585237258348,28450,26050,-2400,3681410
12147,248070,2021-02-02,0.19517102615694165,24850,29150,4300,19866445
12148,248070,2021-02-05,0.046065259117082535,26050,24850,-1200,6899845
12149,248070,2021-02-04,0.0843585237258348,28450,26050,-2400,3681410
12150,248070,2021-02-02,0.19517102615694165,24850,29150,4300,19866445
12151,248070,2021-02-05,0.046065259117082535,26050,24850,-1200,6899845
12152,248070,2021-02-04,0.0843585237258348,28450,26050,-2400,3681410
12153,248070,2021-02-02,0.19517102615694165,24850,29150,4300,19866445
12154,248070,2021-02-05,0.046065259117082535,26050,24850,-1200,6899845
12155,248070,2021-02-04,0.0843585237258348,28450,26050,-2400,3681410
12156,248070,2021-02-02,0.19517102615694165,24850,29150,4300,19866445
12157,248070,2021-02-05,0.046065259117082535,26050,24850,-1200,6899845
12158,248070,2021-02-04,0.0843585237258348,28450,26050,-2400,3681410
12159,248070,2021-02-02,0.19517102615694165,24850,29150,4300,19866445
12160,248070,2021-02-05,0.046065259117082535,26050,24850,-1200,6899845
12161,248070,2021-02-04,0.0843585237258348,28450,26050,-2400,3681410
12162,248070,2021-02-02,0.19517102615694165,24850,29150,4300,19866445
12163,248070,2021-02-05,0.046065259117082535,26050,24850,-1200,6899845
12164,248070,2021-02-04,0.0843585237258348,28450,26050,-2400,3681410
12165,248070,2021-02-02,0.19517102615694165,24850,29150,4300,19866445
12166,248070,2021-02-05,0.046065259117082535,26050,24850,-1200,6899845
12167,248070,2021-02-04,0.0843585237258348,28450,26050,-2400,3681410
12168,248070,2021-02-02,0.19517102615694165,24850,29150,4300,19866445
12169,248070,2021-02-05,0.046065259117082535,26050,24850,-1200,6899845
12170,248070,2021-02-04,0.0843585237258348,28450,26050,-2400,3681410
12171,248070,2021-02-02,0.19517102615694165,24850,29150,4300,19866445
12172,248070,2021-02-05,0.046065259117082535,26050,24850,-1200,6899845
12173,248070,2021-02-04,0.0843585237258348,28450,26050,-2400,3681410
12174,248070,2021-02-02,0.19517102615694165,24850,29150,4300,19866445
12175,248070,2021-02-05,0.046065259117082535,26050,24850,-1200,6899845
12176,248070,2021-02-04,0.0843585237258348,28450,26050,-2400,3681410
12177,248070,2021-02-02,0.19517102615694165,24850,29150,4300,19866445
12178,248070,2021-02-05,0.046065259117082535,26050,24850,-1200,6899845
12179,248070,2021-02-04,0.0843585237258348,28450,26050,-2400,3681410
12180,248070,2021-02-02,0.19517102615694165,24850,29150,4300,19866445
12181,248070,2021-02-05,0.046065259117082535,26050,24850,-1200,6899845
12182,248070,2021-02-04,0.0843585237258348,28450,26050,-2400,3681410
12183,248070,2021-02-02,0.19517102615694165,24850,29150,4300,19866445
12184,248070,2021-02-05,0.046065259117082535,26050,24850,-1200,6899845
12185,248070,2021-02-04,0.0843585237258348,28450,26050,-2400,3681410
12186,248070,2021-02-02,0.19517102615694165,24850,29150,4300,19866445
12187,248070,2021-02-05,0.046065259117082535,26050,24850,-1200,6899845
12188,248070,2021-02-04,0.0843585237258348,28450,26050,-2400,3681410
12189,248070,2021-02-02,0.19517102615694165,24850,29150,4300,19866445
12190,248070,2021-02-05,0.046065259117082535,26050,24850,-1200,6899845
12191,248070,2021-02-04,0.0843585237258348,28450,26050,-2400,3681410
12192,248070,2021-02-02,0.19517102615694165,24850,29150,4300,19866445
12193,248070,2021-02-05,0.046065259117082535,26050,24850,-1200,6899845
12194,248070,2021-02-04,0.0843585237258348,28450,26050,-2400,3681410
12195,248070,2021-02-02,0.19517102615694165,24850,29150,4300,19866445
12196,248070,2021-02-05,0.046065259117082535,26050,24850,-1200,6899845
12197,248070,2021-02-04,0.0843585237258348,28450,26050,-2400,3681410
12198,248070,2021-02-02,0.19517102615694165,24850,29150,4300,19866445
12199,248070,2021-02-05,0.046065259117082535,26050,24850,-1200,6899845
12200,248070,2021-02-04,0.0843585237258348,28450,26050,-2400,3681410
12201,248070,2021-02-02,0.19517102615694165,24850,29150,4300,19866445
12202,248070,2021-02-05,0.046065259117082535,26050,24850,-1200,6899845
12203,248070,2021-02-04,0.0843585237258348,28450,26050,-2400,3681410
12204,248070,2021-02-02,0.19517102615694165,24850,29150,4300,19866445
12205,248070,2021-02-05,0.046065259117082535,26050,24850,-1200,6899845
12206,248070,2021-02-04,0.0843585237258348,28450,26050,-2400,3681410
12207,248070,2021-02-02,0.19517102615694165,24850,29150,4300,19866445
12208,248070,2021-02-05,0.046065259117082535,26050,24850,-1200,6899845
12209,248070,2021-02-04,0.0843585237258348,28450,26050,-2400,3681410
12210,248070,2021-02-02,0.19517102615694165,24850,29150,4300,19866445
12211,248070,2021-02-05,0.046065259117082535,26050,24850,-1200,6899845
12212,248070,2021-02-04,0.0843585237258348,28450,26050,-2400,3681410
12213,248070,2021-02-02,0.19517102615694165,24850,29150,4300,19866445
12214,248070,2021-02-05,0.046065259117082535,26050,24850,-1200,6899845
12215,248070,2021-02-04,0.0843585237258348,28450,26050,-2400,3681410
12216,248070,2021-02-02,0.19517102615694165,24850,29150,4300,19866445
12217,248070,2021-02-05,0.046065259117082535,26050,24850,-1200,6899845
12218,248070,2021-02-04,0.0843585237258348,28450,26050,-2400,3681410
12219,248070,2021-02-02,0.19517102615694165,24850,29150,4300,19866445
12220,248070,2021-02-05,0.046065259117082535,26050,24850,-1200,6899845
12221,248070,2021-02-04,0.0843585237258348,28450,26050,-2400,3681410
12222,248070,2021-02-02,0.19517102615694165,24850,29150,4300,19866445
12223,248070,2021-02-05,0.046065259117082535,26050,24850,-1200,6899845
12224,248070,2021-02-04,0.0843585237258348,28450,26050,-2400,3681410
12225,248070,2021-02-02,0.19517102615694165,24850,29150,4300,19866445
12226,248070,2021-02-05,0.046065259117082535,26050,24850,-1200,6899845
12227,248070,2021-02-04,0.0843585237258348,28450,26050,-2400,3681410
12228,248070,2021-02-02,0.19517102615694165,24850,29150,4300,19866445
12229,248070,2021-02-05,0.046065259117082535,26050,24850,-1200,6899845
12230,248070,2021-02-04,0.0843585237258348,28450,26050,-2400,3681410
12231,248070,2021-02-02,0.19517102615694165,24850,29150,4300,19866445
12232,248070,2021-02-05,0.046065259117082535,26050,24850,-1200,6899845
12233,248070,2021-02-04,0.0843585237258348,28450,26050,-2400,3681410
12234,248070,2021-02-02,0.19517102615694165,24850,29150,4300,19866445
12235,248070,2021-02-05,0.046065259117082535,26050,24850,-1200,6899845
12236,248070,2021-02-04,0.0843585237258348,28450,26050,-2400,3681410
12237,248070,2021-02-02,0.19517102615694165,24850,29150,4300,19866445
12238,248070,2021-02-05,0.046065259117082535,26050,24850,-1200,6899845
12239,248070,2021-02-04,0.0843585237258348,28450,26050,-2400,3681410
12240,248070,2021-02-02,0.19517102615694165,24850,29150,4300,19866445
12241,248070,2021-02-05,0.046065259117082535,26050,24850,-1200,6899845
12242,248070,2021-02-04,0.0843585237258348,28450,26050,-2400,3681410
12243,248070,2021-02-02,0.19517102615694165,24850,29150,4300,19866445
12244,248070,2021-02-05,0.046065259117082535,26050,24850,-1200,6899845
12245,248070,2021-02-04,0.0843585237258348,28450,26050,-2400,3681410
12246,248070,2021-02-02,0.19517102615694165,24850,29150,4300,19866445
12247,248070,2021-02-05,0.046065259117082535,26050,24850,-1200,6899845
12248,248070,2021-02-04,0.0843585237258348,28450,26050,-2400,3681410
12249,248070,2021-02-02,0.19517102615694165,24850,29150,4300,19866445
12250,248070,2021-02-05,0.046065259117082535,26050,24850,-1200,6899845
12251,248070,2021-02-04,0.0843585237258348,28450,26050,-2400,3681410
12252,248070,2021-02-02,0.19517102615694165,24850,29150,4300,19866445
12253,248070,2021-02-05,0.046065259117082535,26050,24850,-1200,6899845
12254,248070,2021-02-04,0.0843585237258348,28450,26050,-2400,3681410
12255,248070,2021-02-02,0.19517102615694165,24850,29150,4300,19866445
12256,248070,2021-02-05,0.046065259117082535,26050,24850,-1200,6899845
12257,248070,2021-02-04,0.0843585237258348,28450,26050,-2400,3681410
12258,248070,2021-02-02,0.19517102615694165,24850,29150,4300,19866445
12259,248070,2021-02-05,0.046065259117082535,26050,24850,-1200,6899845
12260,248070,2021-02-04,0.0843585237258348,28450,26050,-2400,3681410
12261,248070,2021-02-02,0.19517102615694165,24850,29150,4300,19866445
12262,248070,2021-02-05,0.046065259117082535,26050,24850,-1200,6899845
12263,248070,2021-02-04,0.0843585237258348,28450,26050,-2400,3681410
12264,248070,2021-02-02,0.19517102615694165,24850,29150,4300,19866445
12265,248070,2021-02-05,0.046065259117082535,26050,24850,-1200,6899845
12266,248070,2021-02-04,0.0843585237258348,28450,26050,-2400,3681410
12267,248070,2021-02-02,0.19517102615694165,24850,29150,4300,19866445
12268,248070,2021-02-05,0.046065259117082535,26050,24850,-1200,6899845
12269,248070,2021-02-04,0.0843585237258348,28450,26050,-2400,3681410
12270,248070,2021-02-02,0.19517102615694165,24850,29150,4300,19866445
12271,248070,2021-02-05,0.046065259117082535,26050,24850,-1200,6899845
12272,248070,2021-02-04,0.0843585237258348,28450,26050,-2400,3681410
12273,248070,2021-02-02,0.19517102615694165,24850,29150,4300,19866445
12274,248070,2021-02-05,0.046065259117082535,26050,24850,-1200,6899845
12275,248070,2021-02-04,0.0843585237258348,28450,26050,-2400,3681410
12276,248070,2021-02-02,0.19517102615694165,24850,29150,4300,19866445
12277,248070,2021-02-05,0.046065259117082535,26050,24850,-1200,6899845
12278,248070,2021-02-04,0.0843585237258348,28450,26050,-2400,3681410
12279,248070,2021-02-02,0.19517102615694165,24850,29150,4300,19866445
12280,248070,2021-02-05,0.046065259117082535,26050,24850,-1200,6899845
12281,248070,2021-02-04,0.0843585237258348,28450,26050,-2400,3681410
12282,248070,2021-02-02,0.19517102615694165,24850,29150,4300,19866445
12283,248070,2021-02-05,0.046065259117082535,26050,24850,-1200,6899845
12284,248070,2021-02-04,0.0843585237258348,28450,26050,-2400,3681410
12285,248070,2021-02-02,0.19517102615694165,24850,29150,4300,19866445
12286,248070,2021-02-05,0.046065259117082535,26050,24850,-1200,6899845
12287,248070,2021-02-04,0.0843585237258348,28450,26050,-2400,3681410
12288,248070,2021-02-02,0.19517102615694165,24850,29150,4300,19866445
12289,248070,2021-02-05,0.046065259117082535,26050,24850,-1200,6899845
12290,248070,2021-02-04,0.0843585237258348,28450,26050,-2400,3681410
12291,270,2021-05-28,0.04826732673267327,80800,84700,3900,6187345
12292,270,2021-05-03,0.04025974025974026,77000,80100,3100,3400379
12293,270,2021-03-30,0.040740740740740744,81000,84300,3300,4249176
12294,270,2021-02-24,0.04701397712833545,78700,75000,-3700,4740627
12295,270,2021-02-08,0.1497536945812808,101500,86300,-15200,25297437
12296,270,2021-02-03,0.09652076318742986,89100,97700,8600,31478502
12297,270,2021-02-01,0.09090909090909091,82500,90000,7500,7948901
12298,270,2021-01-29,0.06462585034013606,88200,82500,-5700,9432805
12299,270,2021-01-25,0.06264236902050115,87800,93300,5500,9905812
12300,270,2021-01-20,0.050359712230215826,83400,87600,4200,26518838
12301,270,2021-01-19,0.16643356643356644,71500,83400,11900,13378821
12302,270,2021-01-08,0.08412698412698413,63000,68300,5300,25357804
12303,270,2020-12-03,0.06414473684210527,60800,64700,3900,4152306
12304,270,2020-11-11,0.06605504587155964,54500,58100,3600,4438993
12305,270,2020-11-10,0.04206500956022945,52300,54500,2200,3155193
12306,270,2020-10-30,0.04716981132075472,53000,50500,-2500,2559004
12307,270,2020-10-27,0.1032325338894682,47950,52900,4950,9347585
12308,270,2020-10-05,0.0767590618336887,46900,50500,3600,4185612
12309,270,2020-09-22,0.04437564499484004,48450,46300,-2150,2512697
12310,270,2020-09-16,0.04703247480403135,44650,46750,2100,4289868
12311,270,2020-09-14,0.04964539007092199,42300,44400,2100,2473674
12312,270,2020-08-20,0.04846335697399527,42300,40250,-2050,2611942
12313,270,2020-08-12,0.0413135593220339,47200,45250,-1950,2734266
12314,270,2020-08-10,0.0970414201183432,42250,46350,4100,6774254
12315,270,2020-07-29,0.05172413793103448,37700,39650,1950,3410420
12316,270,2020-07-17,0.042492917847025496,35300,36800,1500,2720640
12317,270,2020-07-13,0.054602184087363496,32050,33800,1750,1924926
12318,270,2020-06-24,0.046511627906976744,32250,33750,1500,2345625
12319,270,2020-06-16,0.06366459627329192,32200,34250,2050,1866950
12320,270,2020-06-15,0.08,35000,32200,-2800,2407518
12321,270,2020-06-02,0.05491329479768786,34600,36500,1900,3154171
12322,270,2020-05-29,0.06697819314641744,32100,34250,2150,5053078
12323,270,2020-05-19,0.08006814310051108,29350,31700,2350,5443583
12324,270,2020-05-08,0.05172413793103448,29000,30500,1500,2777232
12325,270,2020-04-13,0.04838709677419355,31000,29500,-1500,2007475
12326,270,2020-04-09,0.06725663716814159,28250,30150,1900,3167177
12327,270,2020-04-07,0.054104477611940295,26800,28250,1450,2680220
12328,270,2020-04-06,0.05511811023622047,25400,26800,1400,1721874
12329,270,2020-03-31,0.04208416833667335,24950,26000,1050,2219339
12330,270,2020-03-25,0.08874458874458875,23100,25150,2050,5010440
12331,270,2020-03-24,0.07441860465116279,21500,23100,1600,2947942
12332,270,2020-03-23,0.10973084886128365,24150,21500,-2650,2365341
12333,270,2020-03-20,0.07095343680709534,22550,24150,1600,3015123
12334,270,2020-03-19,0.10869565217391304,25300,22550,-2750,2305074
12335,270,2020-03-17,0.06457564575645756,27100,25350,-1750,2682844
12336,270,2020-03-16,0.060658578856152515,28850,27100,-1750,1862674
12337,270,2020-03-13,0.054098360655737705,30500,28850,-1650,2777060
12338,270,2020-03-12,0.040880503144654086,31800,30500,-1300,1872682
12339,270,2020-03-09,0.047619047619047616,34650,33000,-1650,1316550
12340,270,2020-03-02,0.04827586206896552,36250,34500,-1750,2981038
12341,270,2020-02-06,0.048223350253807105,39400,41300,1900,1405887
12342,270,2020-01-02,0.040632054176072234,44300,42500,-1800,1355029
12343,270,2019-09-23,0.05454545454545454,44000,46400,2400,2951967
12344,270,2019-06-10,0.04495747266099635,41150,43000,1850,1357541
12345,270,2019-05-31,0.044902912621359224,41200,39350,-1850,2666239
12346,270,2019-04-29,0.05355064027939464,42950,45250,2300,2828522
12347,270,2019-01-04,0.060882800608828,32850,34850,2000,1573507
12348,270,2018-11-22,0.05008635578583765,28950,27500,-1450,1219813
12349,270,2018-11-20,0.04713804713804714,29700,28300,-1400,1109399
12350,270,2018-11-05,0.04230118443316413,29550,28300,-1250,1176599
12351,270,2018-10-25,0.059233449477351915,28700,27000,-1700,2557751
12352,270,2018-10-15,0.06466165413533835,33250,31100,-2150,2038170
12353,270,2018-09-06,0.04503105590062112,32200,33650,1450,2459792
12354,270,2018-07-06,0.045454545454545456,29700,31050,1350,1366055
12355,270,2018-07-04,0.045234248788368334,30950,29550,-1400,1614173
12356,270,2018-06-04,0.05799373040752351,31900,33750,1850,2204733
12357,270,2018-01-19,0.04128440366972477,32700,34050,1350,1814883
12358,270,2017-10-18,0.046031746031746035,31500,32950,1450,1667694
12359,270,2017-08-08,0.044534412955465584,37050,35400,-1650,1904223
12360,270,2016-11-10,0.043914680050188205,39850,38100,-1750,3223287
12361,3850,2021-05-12,0.04318181818181818,22000,22950,950,1419429
12362,3850,2021-05-04,0.07494646680942184,23350,21600,-1750,2133685
12363,3850,2021-05-03,0.1254681647940075,26700,23350,-3350,3039290
12364,3850,2021-04-30,0.0942622950819672,24400,26700,2300,15290897
12365,3850,2021-04-28,0.06209850107066381,23350,24800,1450,13967351
12366,3850,2021-04-23,0.05228758169934641,22950,24150,1200,2119627
12367,3850,2021-04-20,0.04700854700854701,23400,22300,-1100,1488370
12368,3850,2021-04-13,0.06976744186046512,21500,23000,1500,3104372
12369,3850,2021-03-19,0.08353221957040573,20950,22700,1750,2558446
12370,3850,2021-03-10,0.05236907730673317,20050,21100,1050,943229
12371,3850,2021-02-04,0.045023696682464455,21100,20150,-950,1035580
12372,3850,2021-01-29,0.062034739454094295,20150,21400,1250,19251583
12373,3850,2021-01-22,0.05411255411255411,23100,21850,-1250,1030978
12374,3850,2021-01-20,0.07476635514018691,21400,23000,1600,6507534
12375,3850,2021-01-18,0.04878048780487805,22550,21450,-1100,1102270
12376,3850,2021-01-14,0.04139433551198257,22950,22000,-950,1974954
12377,3850,2021-01-12,0.08333333333333333,25800,23650,-2150,17709382
12378,3850,2021-01-11,0.29974811083123426,19850,25800,5950,12639281
12379,3850,2021-01-05,0.08108108108108109,18500,20000,1500,1713680
12380,3850,2020-12-18,0.04627249357326478,19450,20350,900,1978878
12381,3850,2020-12-08,0.053164556962025315,19750,18700,-1050,1013542
12382,3850,2020-12-03,0.10467706013363029,22450,20100,-2350,2814793
12383,3850,2020-12-01,0.07524271844660194,20600,22150,1550,4593954
12384,3850,2020-11-27,0.05357142857142857,19600,20650,1050,4211301
12385,3850,2020-11-26,0.05314009661835749,20700,19600,-1100,3842556
12386,3850,2020-11-25,0.23582089552238805,16750,20700,3950,17677293
12387,3850,2020-11-05,0.04406779661016949,14750,15400,650,289900
12388,3850,2020-10-30,0.0410958904109589,14600,14000,-600,196906
12389,3850,2020-10-26,0.043333333333333335,15000,14350,-650,248398
12390,3850,2020-09-22,0.04216867469879518,16600,15900,-700,397426
12391,3850,2020-09-17,0.045714285714285714,17500,16700,-800,569035
12392,3850,2020-09-16,0.041666666666666664,16800,17500,700,1157282
12393,3850,2020-09-11,0.05846153846153846,16250,17200,950,700860
12394,3850,2020-08-20,0.040372670807453416,16100,15450,-650,455293
12395,3850,2020-08-18,0.04878048780487805,16400,15600,-800,411004
12396,3850,2020-07-27,0.05,17000,16150,-850,895464
12397,3850,2020-07-23,0.05750798722044728,15650,16550,900,1233692
12398,3850,2020-06-16,0.08414239482200647,15450,16750,1300,1651082
12399,3850,2020-06-15,0.04923076923076923,16250,15450,-800,4280149
12400,3850,2020-05-28,0.05194805194805195,15400,14600,-800,1104368
12401,3850,2020-05-26,0.09722222222222222,14400,15800,1400,5529877
12402,3850,2020-05-14,0.06666666666666667,13500,14400,900,1938314
12403,3850,2020-05-06,0.043824701195219126,12550,13100,550,435608
12404,3850,2020-04-24,0.05223880597014925,13400,12700,-700,1147168
12405,3850,2020-04-23,0.09387755102040816,12250,13400,1150,1633341
12406,3850,2020-04-13,0.04878048780487805,12300,12900,600,1206288
12407,3850,2020-04-06,0.1608695652173913,11500,13350,1850,5856612
12408,3850,2020-04-01,0.06584362139917696,12150,11350,-800,966907
12409,3850,2020-03-30,0.04888888888888889,11250,11800,550,614661
12410,3850,2020-03-27,0.06635071090047394,10550,11250,700,2126795
12411,3850,2020-03-25,0.10526315789473684,9500,10500,1000,1524829
12412,3850,2020-03-24,0.1111111111111111,8550,9500,950,490646
12413,3850,2020-03-23,0.09042553191489362,9400,8550,-850,459287
12414,3850,2020-03-20,0.09302325581395349,8600,9400,800,407062
12415,3850,2020-03-19,0.13913913913913914,9990,8600,-1390,663641
12416,3850,2020-03-16,0.047619047619047616,10500,10000,-500,444231
12417,3850,2020-03-13,0.0625,11200,10500,-700,644802
12418,3850,2020-03-12,0.08196721311475409,12200,11200,-1000,491087
12419,3850,2020-02-24,0.04247104247104247,12950,12400,-550,294238
12420,3850,2020-02-06,0.04395604395604396,13650,14250,600,264159
12421,3850,2020-01-08,0.04113924050632911,15800,15150,-650,534034
12422,3850,2019-12-27,0.07516339869281045,15300,16450,1150,816964
12423,3850,2019-11-28,0.04180064308681672,15550,16200,650,786748
12424,3850,2019-11-15,0.04421768707482993,14700,15350,650,503885
12425,3850,2019-11-14,0.04854368932038835,15450,14700,-750,1119241
12426,3850,2019-11-04,0.07011070110701106,13550,14500,950,1088973
12427,3850,2019-10-30,0.058365758754863814,12850,13600,750,1365215
12428,3850,2019-08-27,0.068,12500,11650,-850,983791
12429,3850,2019-08-20,0.043859649122807015,11400,11900,500,335724
12430,3850,2019-08-05,0.08189655172413793,11600,10650,-950,426873
12431,3850,2019-07-29,0.04417670682730924,12450,11900,-550,424240
12432,3850,2019-07-19,0.07203389830508475,11800,12650,850,1546180
12433,3850,2019-07-11,0.042735042735042736,11700,12200,500,579109
12434,3850,2019-06-24,0.04329004329004329,11550,12050,500,347148
12435,3850,2019-05-29,0.04918032786885246,12200,11600,-600,277006
12436,3850,2019-04-25,0.053231939163498096,13150,13850,700,1148812
12437,3850,2019-04-16,0.05622489959839357,12450,13150,700,1400611
12438,3850,2019-03-28,0.043824701195219126,12550,12000,-550,629760
12439,3850,2019-03-25,0.047619047619047616,12600,12000,-600,1610933
12440,3850,2019-03-22,0.1506849315068493,10950,12600,1650,6486701
12441,3850,2018-12-18,0.050746268656716415,10050,9540,-510,515495
12442,3850,2018-11-26,0.04285714285714286,10500,10950,450,326969
12443,3850,2018-11-15,0.04854368932038835,10300,10800,500,389196
12444,3850,2018-10-23,0.04716981132075472,10600,10100,-500,138627
12445,3850,2018-10-15,0.04186046511627907,10750,10300,-450,204265
12446,3850,2018-10-10,0.043859649122807015,11400,10900,-500,193338
12447,3850,2018-07-13,0.056155507559395246,9260,9780,520,443584
12448,3850,2018-06-19,0.045454545454545456,9900,9450,-450,270939
12449,3850,2018-06-14,0.05472636815920398,10050,10600,550,311600
12450,3850,2018-05-23,0.046153846153846156,10400,9920,-480,373524
12451,3850,2018-05-08,0.04285714285714286,10500,10050,-450,334331
12452,3850,2018-05-04,0.049773755656108594,11050,10500,-550,335458
12453,3850,2018-05-03,0.05150214592274678,11650,11050,-600,412447
12454,3850,2018-04-23,0.07142857142857142,63000,58500,-4500,125762
12455,3850,2018-03-26,0.06415094339622641,53000,56400,3400,79551
12456,3850,2018-03-23,0.046762589928057555,55600,53000,-2600,89732
12457,3850,2018-03-22,0.044673539518900345,58200,55600,-2600,68860
12458,3850,2018-03-20,0.05698529411764706,54400,57500,3100,119845
12459,3850,2018-03-13,0.041015625,51200,53300,2100,83158
12460,3850,2018-02-07,0.045019157088122604,52200,49850,-2350,104651
12461,3850,2018-02-05,0.07308377896613191,56100,52000,-4100,126941
12462,3850,2018-01-26,0.0472027972027972,57200,59900,2700,284189
12463,3850,2018-01-24,0.05301645338208409,54700,57600,2900,204048
12464,3850,2018-01-18,0.07,50000,53500,3500,221733
12465,3850,2017-12-28,0.07142857142857142,44800,48000,3200,305601
12466,3850,2017-12-27,0.06413301662707839,42100,44800,2700,152358
12467,3850,2017-11-06,0.04049079754601227,40750,42400,1650,72690
12468,3850,2017-10-27,0.05535499398315283,41550,39250,-2300,175661
12469,3850,2017-07-31,0.0804851157662624,45350,41700,-3650,152035
12470,3850,2017-07-13,0.04396728016359918,48900,46750,-2150,114887
12471,3850,2017-06-05,0.04580152671755725,52400,54800,2400,161629
12472,3850,2017-05-31,0.054,50000,52700,2700,142661
12473,3850,2016-12-13,0.05008944543828265,55900,58700,2800,43927
12474,3850,2016-12-12,0.05075187969924812,53200,55900,2700,29272
12475,3850,2016-11-16,0.04187604690117253,59700,62200,2500,45755
12476,3850,2016-11-10,0.07495429616087751,54700,58800,4100,72333
12477,3850,2016-11-02,0.05025996533795494,57700,54800,-2900,57596
12478,4370,2020-08-27,0.04456824512534819,359000,375000,16000,51644
12479,4370,2020-06-17,0.05485232067510549,355500,375000,19500,83629
12480,4370,2020-06-12,0.058823529411764705,323000,342000,19000,116060
12481,4370,2020-05-21,0.04501607717041801,311000,325000,14000,63152
12482,4370,2020-05-19,0.04281345565749235,327000,313000,-14000,86901
12483,4370,2020-05-13,0.04213938411669368,308500,321500,13000,66568
12484,4370,2020-04-24,0.04452054794520548,292000,305000,13000,93184
12485,4370,2020-03-30,0.05639097744360902,266000,281000,15000,67063
12486,4370,2020-03-26,0.04339250493096647,253500,264500,11000,80215
12487,4370,2020-03-16,0.05737704918032787,244000,258000,14000,50067
12488,4370,2020-03-13,0.04873294346978557,256500,244000,-12500,58652
12489,4370,2020-03-04,0.06627680311890838,256500,273500,17000,74157
12490,4370,2020-02-19,0.04580152671755725,262000,274000,12000,73065
12491,4370,2020-02-12,0.04878048780487805,246000,258000,12000,127168
12492,4370,2020-02-11,0.044585987261146494,235500,246000,10500,59949
12493,4370,2019-09-04,0.041407867494824016,241500,251500,10000,25441
12494,4370,2019-08-30,0.043478260869565216,230000,240000,10000,15155
12495,4370,2019-05-16,0.04864864864864865,277500,264000,-13500,31531
12496,4370,2019-03-11,0.05913978494623656,279000,295500,16500,62748
12497,4370,2019-02-12,0.04912280701754386,285000,271000,-14000,28518
12498,4370,2019-01-22,0.04,275000,286000,11000,25831
12499,4370,2019-01-03,0.06772908366533864,251000,268000,17000,43424
12500,4370,2018-11-12,0.0472972972972973,222000,232500,10500,23033
12501,4370,2018-10-29,0.0467706013363029,224500,214000,-10500,19078
12502,4370,2018-08-16,0.07027027027027027,277500,258000,-19500,121040
12503,4370,2018-08-14,0.048027444253859346,291500,277500,-14000,38987
12504,4370,2018-07-02,0.04153846153846154,325000,311500,-13500,30964
12505,4370,2018-06-04,0.04185351270553064,334500,348500,14000,66310
12506,4370,2018-04-23,0.042789223454833596,315500,329000,13500,70688
12507,4370,2017-11-20,0.05693430656934306,342500,362000,19500,75814
12508,4370,2017-09-15,0.04896142433234421,337000,353500,16500,46914
12509,4370,2017-09-07,0.04704097116843703,329500,345000,15500,29948
12510,4370,2017-08-16,0.04381846635367762,319500,333500,14000,34203
12511,4370,2017-05-08,0.0405616224648986,320500,333500,13000,48888
12512,4370,2017-02-23,0.06784660766961652,339000,316000,-23000,177474
12513,4370,2017-02-06,0.048458149779735685,340500,357000,16500,46100
12514,4370,2017-02-02,0.0598159509202454,326000,345500,19500,61483
12515,4370,2016-11-29,0.07142857142857142,308000,330000,22000,44376
12516,4370,2016-11-15,0.10099337748344371,302000,332500,30500,123367
12517,4370,2016-11-03,0.05789473684210526,285000,301500,16500,28365
12518,4370,2016-10-31,0.04477611940298507,301500,288000,-13500,24132
12519,4370,2016-08-19,0.04327666151468315,323500,309500,-14000,73528
12520,4370,2016-08-17,0.06647807637906648,353500,330000,-23500,91386
12521,4370,2016-08-10,0.05433186490455213,340500,359000,18500,57183
12522,88350,2021-05-14,0.06287069988137604,4215,3950,-265,22731381
12523,88350,2021-05-13,0.09765625,3840,4215,375,95937402
12524,88350,2021-05-06,0.08132530120481928,3320,3590,270,16395863
12525,88350,2021-04-29,0.042876901798063624,3615,3460,-155,9109931
12526,88350,2021-04-23,0.04661654135338346,3325,3480,155,25581332
12527,88350,2021-03-30,0.0436241610738255,2980,3110,130,6043182
12528,88350,2021-03-05,0.04313099041533546,3130,3265,135,22716787
12529,88350,2021-02-24,0.05405405405405406,3330,3150,-180,14505095
12530,88350,2021-02-23,0.040345821325648415,3470,3330,-140,27584870
12531,88350,2021-02-22,0.07430340557275542,3230,3470,240,42329696
12532,88350,2021-02-19,0.045307443365695796,3090,3230,140,46338632
12533,88350,2021-02-18,0.06363636363636363,3300,3090,-210,14709721
12534,88350,2021-02-17,0.11298482293423272,2965,3300,335,54971193
12535,88350,2021-02-09,0.06713780918727916,2830,3020,190,17232609
12536,88350,2021-02-04,0.043706293706293704,2860,2735,-125,6066963
12537,88350,2021-02-02,0.04395604395604396,2730,2850,120,7919722
12538,88350,2021-01-13,0.04862236628849271,3085,3235,150,41230989
12539,88350,2021-01-12,0.04192546583850932,3220,3085,-135,16008777
12540,88350,2021-01-11,0.05014749262536873,3390,3220,-170,34141623
12541,88350,2021-01-07,0.2655367231638418,2655,3360,705,123286337
12542,88350,2021-01-06,0.06626506024096386,2490,2655,165,20494002
12543,88350,2021-01-05,0.0641025641025641,2340,2490,150,10319523
12544,88350,2021-01-04,0.040983606557377046,2440,2340,-100,8562131
12545,88350,2020-12-21,0.05827067669172932,2660,2505,-155,11353408
12546,88350,2020-12-16,0.0703125,2560,2740,180,15726769
12547,88350,2020-12-14,0.07051282051282051,2340,2505,165,28429052
12548,88350,2020-12-11,0.07834101382488479,2170,2340,170,17273889
12549,88350,2020-12-02,0.060240963855421686,2075,2200,125,14192346
12550,88350,2020-11-23,0.06666666666666667,2025,2160,135,14191499
12551,88350,2020-11-16,0.07651715039577836,1895,2040,145,25517146
12552,88350,2020-11-11,0.061452513966480445,1790,1900,110,33664086
12553,88350,2020-11-10,0.10835913312693499,1615,1790,175,33851921
12554,88350,2020-10-27,0.061946902654867256,1695,1590,-105,11722971
12555,88350,2020-10-23,0.07255520504731862,1585,1700,115,52760323
12556,88350,2020-09-01,0.042483660130718956,1530,1595,65,8784845
12557,88350,2020-08-25,0.07457627118644068,1475,1585,110,8991797
12558,88350,2020-08-20,0.04792332268370607,1565,1490,-75,6870834
12559,88350,2020-08-19,0.05387205387205387,1485,1565,80,6881325
12560,88350,2020-08-18,0.0804953560371517,1615,1485,-130,8910391
12561,88350,2020-08-10,0.04794520547945205,1460,1530,70,11132167
12562,88350,2020-07-23,0.041935483870967745,1550,1485,-65,6791906
12563,88350,2020-07-22,0.04377104377104377,1485,1550,65,12391461
12564,88350,2020-06-25,0.04240282685512368,1415,1355,-60,5394475
12565,88350,2020-06-16,0.05,1400,1470,70,7784651
12566,88350,2020-06-15,0.06976744186046512,1505,1400,-105,8520989
12567,88350,2020-06-12,0.04746835443037975,1580,1505,-75,11357121
12568,88350,2020-06-11,0.04242424242424243,1650,1580,-70,12032404
12569,88350,2020-06-05,0.040372670807453416,1610,1675,65,13484864
12570,88350,2020-05-29,0.0701219512195122,1640,1525,-115,40911723
12571,88350,2020-05-14,0.040123456790123455,1620,1685,65,14694317
12572,88350,2020-05-04,0.04722222222222222,1800,1715,-85,6242386
12573,88350,2020-04-17,0.1,1650,1815,165,82203632
12574,88350,2020-04-16,0.04899135446685879,1735,1650,-85,10398894
12575,88350,2020-04-10,0.21554770318021202,1415,1720,305,93431281
12576,88350,2020-04-01,0.050359712230215826,1390,1320,-70,6519043
12577,88350,2020-03-27,0.056291390728476824,1510,1425,-85,18146210
12578,88350,2020-03-26,0.1843137254901961,1275,1510,235,33525362
12579,88350,2020-03-25,0.2983706720977597,982,1275,293,19697553
12580,88350,2020-03-24,0.09720670391061452,895,982,87,9443067
12581,88350,2020-03-23,0.06576200417536535,958,895,-63,7377202
12582,88350,2020-03-20,0.04471101417666303,917,958,41,8514019
12583,88350,2020-03-19,0.05463917525773196,970,917,-53,7519295
12584,88350,2020-03-18,0.06280193236714976,1035,970,-65,6189787
12585,88350,2020-03-17,0.08,1125,1035,-90,8088146
12586,88350,2020-03-13,0.053061224489795916,1225,1160,-65,8116898
12587,88350,2020-03-12,0.04669260700389105,1285,1225,-60,6945957
12588,88350,2020-03-11,0.05860805860805861,1365,1285,-80,8216151
12589,88350,2020-03-09,0.09385113268608414,1545,1400,-145,7622905
12590,88350,2020-03-06,0.040372670807453416,1610,1545,-65,3832325
12591,88350,2020-02-24,0.06166219839142091,1865,1750,-115,3075294
12592,88350,2020-02-21,0.0532994923857868,1970,1865,-105,5096605
12593,88350,2020-01-28,0.04740406320541761,2215,2110,-105,2947261
12594,88350,2019-12-13,0.06153846153846154,2275,2415,140,3951468
12595,88350,2019-11-14,0.04781704781704782,2405,2290,-115,3374645
12596,88350,2019-11-07,0.04042553191489362,2350,2445,95,2653843
12597,88350,2019-10-02,0.06832298136645963,2415,2250,-165,4631897
12598,88350,2019-09-11,0.04819277108433735,2490,2610,120,4182341
12599,88350,2019-08-30,0.05394190871369295,2410,2540,130,2464881
12600,88350,2019-08-19,0.08158508158508158,2145,2320,175,2810295
12601,88350,2019-08-05,0.05060728744939271,2470,2345,-125,3419554
12602,88350,2019-08-01,0.0419047619047619,2625,2515,-110,1513987
12603,88350,2019-07-16,0.051666666666666666,3000,2845,-155,3811546
12604,88350,2019-03-15,0.046019900497512436,4020,4205,185,4568164
12605,88350,2018-10-11,0.04291417165668663,5010,4795,-215,1974208
12606,88350,2018-04-16,0.04047217537942664,5930,6170,240,2310861
12607,88350,2018-03-07,0.045941807044410414,6530,6230,-300,2527646
12608,88350,2018-02-09,0.04885057471264368,6960,6620,-340,2128024
12609,88350,2017-12-01,0.040214477211796246,7460,7160,-300,2188819
12610,88350,2017-10-25,0.07294429708222812,7540,8090,550,7450591
12611,88350,2017-10-20,0.06887052341597796,7260,7760,500,4881615
12612,88350,2017-10-11,0.0641399416909621,6860,7300,440,3230835
12613,88350,2017-07-10,0.04275862068965517,7250,7560,310,3234308
12614,88350,2017-07-07,0.0476878612716763,6920,7250,330,1322558
12615,88350,2016-11-17,0.056338028169014086,6390,6750,360,3761159
12616,88350,2016-11-11,0.06197654941373534,5970,6340,370,1998487
12617,88350,2016-11-03,0.04051863857374392,6170,5920,-250,1389552
12618,88350,2016-10-26,0.046511627906976744,6450,6150,-300,1281970
12619,5930,2021-02-25,0.04024390243902439,82000,85300,3300,34155986
12620,5930,2021-01-08,0.07117008443908324,82900,88800,5900,59013307
12621,5930,2020-12-24,0.05277401894451962,73900,77800,3900,32502870
12622,5930,2020-11-23,0.04327666151468315,64700,67500,2800,27134398
12623,5930,2020-11-16,0.0490506329113924,63200,66300,3100,36354334
12624,5930,2020-08-20,0.04152249134948097,57800,55400,-2400,30386029
12625,5930,2020-07-28,0.0539568345323741,55600,58600,3000,48431566
12626,5930,2020-06-16,0.04408817635270541,49900,52100,2200,21808375
12627,5930,2020-06-15,0.045889101338432124,52300,49900,-2400,28772921
12628,5930,2020-06-03,0.06031128404669261,51400,54500,3100,49257814
12629,5930,2020-04-17,0.04897959183673469,49000,51400,2400,32041675
12630,5930,2020-04-01,0.040837696335078534,47750,45800,-1950,27259532
12631,5930,2020-03-24,0.10470588235294118,42500,46950,4450,49801908
12632,5930,2020-03-23,0.06387665198237885,45400,42500,-2900,41701626
12633,5930,2020-03-20,0.0570430733410943,42950,45400,2450,49730008
12634,5930,2020-03-19,0.0581140350877193,45600,42950,-2650,56925513
12635,5930,2020-03-11,0.045787545787545784,54600,52100,-2500,45707281
12636,5930,2020-03-09,0.04070796460176991,56500,54200,-2300,30261485
12637,5930,2020-02-24,0.04054054054054054,59200,56800,-2400,25627537
12638,5930,2019-05-09,0.04067796610169491,44250,42450,-1800,23029718
12639,5930,2019-03-21,0.04086265607264472,44050,45850,1800,21138016
12640,5930,2018-11-02,0.04744958481613286,42150,44150,2000,16517112
12641,5930,2018-10-11,0.04856512141280353,45300,43100,-2200,19324537
12642,5930,2018-09-14,0.04086265607264472,44050,45850,1800,12446344
12643,5930,2018-03-06,0.04026548672566372,2260000,2351000,91000,308467
12644,5930,2018-02-02,0.0425531914893617,2491000,2385000,-106000,585207
12645,5930,2017-11-27,0.05084745762711865,2773000,2632000,-141000,362578
12646,5930,2017-09-18,0.04126984126984127,2520000,2624000,104000,230499
12647,5930,2017-07-28,0.04096385542168675,2490000,2388000,-102000,523366
12648,5930,2016-11-30,0.04114490161001789,1677000,1746000,69000,570704
12649,5930,2016-10-11,0.08035714285714286,1680000,1545000,-135000,768543
12650,5930,2016-10-06,0.044471896232242125,1619000,1691000,72000,591163
12651,5930,2016-09-13,0.042320819112627986,1465000,1527000,62000,494345
12652,5930,2016-09-12,0.06984126984126984,1575000,1465000,-110000,529987
12653,5930,2016-08-18,0.04725415070242656,1566000,1640000,74000,366541
12654,810,2021-03-02,0.046242774566473986,173000,181000,8000,403111
12655,810,2020-12-29,0.04081632653061224,196000,188000,-8000,252942
12656,810,2020-11-30,0.05289672544080604,198500,188000,-10500,688925
12657,810,2020-11-18,0.05194805194805195,192500,202500,10000,314019
12658,810,2020-11-10,0.056910569105691054,184500,195000,10500,276339
12659,810,2020-08-20,0.05333333333333334,187500,177500,-10000,177302
12660,810,2020-08-19,0.04456824512534819,179500,187500,8000,225856
12661,810,2020-08-18,0.05026455026455026,189000,179500,-9500,197936
12662,810,2020-08-13,0.047619047619047616,178500,187000,8500,563113
12663,810,2020-08-11,0.054380664652567974,165500,174500,9000,311788
12664,810,2020-07-10,0.04043126684636118,185500,178000,-7500,113945
12665,810,2020-06-25,0.045576407506702415,186500,178000,-8500,123282
12666,810,2020-06-16,0.05337078651685393,178000,187500,9500,126935
12667,810,2020-06-12,0.046632124352331605,193000,184000,-9000,171353
12668,810,2020-06-02,0.08847184986595175,186500,203000,16500,301777
12669,810,2020-05-14,0.042328042328042326,189000,197000,8000,195699
12670,810,2020-05-04,0.04199475065616798,190500,182500,-8000,170388
12671,810,2020-04-10,0.042735042735042736,175500,183000,7500,199766
12672,810,2020-04-02,0.15333333333333332,150000,173000,23000,365885
12673,810,2020-03-31,0.051194539249146756,146500,154000,7500,203980
12674,810,2020-03-27,0.041237113402061855,145500,151500,6000,189973
12675,810,2020-03-26,0.049019607843137254,153000,145500,-7500,192964
12676,810,2020-03-25,0.05517241379310345,145000,153000,8000,271935
12677,810,2020-03-24,0.05454545454545454,137500,145000,7500,168219
12678,810,2020-03-23,0.06177606177606178,129500,137500,8000,243535
12679,810,2020-03-19,0.08695652173913043,138000,126000,-12000,325928
12680,810,2020-03-18,0.07692307692307693,149500,138000,-11500,261880
12681,810,2020-03-17,0.056782334384858045,158500,149500,-9000,229767
12682,810,2020-03-16,0.05373134328358209,167500,158500,-9000,178133
12683,810,2020-03-13,0.04285714285714286,175000,167500,-7500,224625
12684,810,2019-12-12,0.04831932773109244,238000,249500,11500,321849
12685,810,2019-11-15,0.042316258351893093,224500,234000,9500,125167
12686,810,2019-08-12,0.06326530612244897,245000,229500,-15500,213954
12687,810,2019-08-07,0.052734375,256000,242500,-13500,199480
12688,810,2019-07-19,0.048638132295719845,257000,269500,12500,113610
12689,810,2019-04-02,0.040453074433656956,309000,296500,-12500,145264
12690,810,2019-02-01,0.040293040293040296,273000,284000,11000,135095
12691,810,2018-09-28,0.04220183486238532,272500,284000,11500,229368
12692,810,2018-02-19,0.04189435336976321,274500,286000,11500,76394
12693,810,2017-08-01,0.046232876712328765,292000,305500,13500,159583
12694,810,2017-02-16,0.051188299817184646,273500,259500,-14000,357146
12695,810,2016-12-21,0.06292517006802721,294000,275500,-18500,278032
12696,120110,2021-06-01,0.04012841091492777,62300,64800,2500,502601
12697,120110,2021-05-13,0.04038772213247173,61900,59400,-2500,396598
12698,120110,2021-04-13,0.04024767801857585,64600,62000,-2600,640241
12699,120110,2021-04-05,0.05546218487394958,59500,62800,3300,555009
12700,120110,2021-03-29,0.051036682615629984,62700,59500,-3200,548456
12701,120110,2021-03-24,0.05719237435008666,57700,61000,3300,776145
12702,120110,2021-03-11,0.0874751491053678,50300,54700,4400,584066
12703,120110,2021-03-09,0.051188299817184646,54700,51900,-2800,541542
12704,120110,2021-02-25,0.06118355065195587,49850,52900,3050,541197
12705,120110,2021-02-18,0.06690140845070422,56800,53000,-3800,783818
12706,120110,2021-02-03,0.0855397148676171,49100,53300,4200,3141662
12707,120110,2021-02-02,0.17044100119189512,41950,49100,7150,6136833
12708,120110,2021-01-25,0.0630841121495327,42800,45500,2700,506857
12709,120110,2021-01-08,0.04028436018957346,42200,43900,1700,763948
12710,120110,2020-11-19,0.06640625,38400,40950,2550,918366
12711,120110,2020-11-09,0.04613297150610583,36850,38550,1700,213757
12712,120110,2020-10-16,0.04632152588555858,36700,38400,1700,276691
12713,120110,2020-09-28,0.05070422535211268,35500,37300,1800,211838
12714,120110,2020-09-24,0.06258322237017311,37550,35200,-2350,335056
12715,120110,2020-09-22,0.06658595641646489,41300,38550,-2750,537944
12716,120110,2020-09-16,0.055782312925170066,36750,38800,2050,1031642
12717,120110,2020-09-14,0.05352112676056338,35500,37400,1900,704162
12718,120110,2020-09-07,0.09200603318250378,33150,36200,3050,962688
12719,120110,2020-09-01,0.04375,32000,33400,1400,230516
12720,120110,2020-08-20,0.05082212257100149,33450,31750,-1700,236031
12721,120110,2020-08-18,0.05397727272727273,35200,33300,-1900,361296
12722,120110,2020-08-10,0.04428571428571428,35000,36550,1550,469910
12723,120110,2020-07-14,0.0451527224435591,37650,35950,-1700,444733
12724,120110,2020-07-13,0.09766763848396501,34300,37650,3350,755494
12725,120110,2020-07-06,0.08602150537634409,32550,35350,2800,672479
12726,120110,2020-06-16,0.060556464811783964,30550,32400,1850,213714
12727,120110,2020-06-15,0.08395802098950525,33350,30550,-2800,325153
12728,120110,2020-06-12,0.052556818181818184,35200,33350,-1850,315375
12729,120110,2020-05-27,0.04776579352850539,32450,34000,1550,561958
12730,120110,2020-05-26,0.048465266558966075,30950,32450,1500,338051
12731,120110,2020-04-14,0.10101010101010101,34650,31150,-3500,3263859
12732,120110,2020-04-13,0.16275167785234898,29800,34650,4850,7029112
12733,120110,2020-04-01,0.06166666666666667,30000,28150,-1850,755017
12734,120110,2020-03-31,0.06761565836298933,28100,30000,1900,385771
12735,120110,2020-03-30,0.1217564870259481,25050,28100,3050,330261
12736,120110,2020-03-25,0.08315098468271334,22850,24750,1900,243015
12737,120110,2020-03-24,0.08293838862559241,21100,22850,1750,152115
12738,120110,2020-03-23,0.10021321961620469,23450,21100,-2350,188886
12739,120110,2020-03-20,0.11933174224343675,20950,23450,2500,265602
12740,120110,2020-03-19,0.12159329140461216,23850,20950,-2900,332133
12741,120110,2020-03-18,0.07915057915057915,25900,23850,-2050,187526
12742,120110,2020-03-13,0.10391822827938671,29350,26300,-3050,396165
12743,120110,2020-03-12,0.05016181229773463,30900,29350,-1550,249836
12744,120110,2020-02-28,0.0456490727532097,35050,33450,-1600,194762
12745,120110,2020-02-24,0.051075268817204304,37200,35300,-1900,231790
12746,120110,2020-02-21,0.04980842911877394,39150,37200,-1950,303606
12747,120110,2020-02-19,0.06432748538011696,42750,40000,-2750,406194
12748,120110,2020-01-28,0.046536796536796536,46200,44050,-2150,117097
12749,120110,2020-01-08,0.06256517205422316,47950,44950,-3000,202518
12750,120110,2019-11-06,0.060445387062566275,47150,50000,2850,464070
12751,120110,2019-10-14,0.042067307692307696,41600,43350,1750,153005
12752,120110,2019-08-05,0.0425531914893617,39950,38250,-1700,177663
12753,120110,2019-07-19,0.04878048780487805,41000,43000,2000,221769
12754,120110,2019-07-09,0.05829596412556054,44600,42000,-2600,210292
12755,120110,2019-05-30,0.041719342604298354,39550,41200,1650,198875
12756,120110,2019-05-29,0.05155875299760192,41700,39550,-2150,346212
12757,120110,2019-05-28,0.051194539249146756,43950,41700,-2250,450484
12758,120110,2019-05-14,0.05203619909502263,44200,46500,2300,211802
12759,120110,2019-03-05,0.04044117647058824,54400,52200,-2200,377481
12760,120110,2019-02-19,0.10114192495921696,61300,55100,-6200,1244391
12761,120110,2019-01-07,0.05454545454545454,55000,58000,3000,161578
12762,120110,2018-12-28,0.055248618784530384,54300,57300,3000,223728
12763,120110,2018-12-21,0.045889101338432124,52300,54700,2400,182421
12764,120110,2018-11-02,0.07976653696498054,51400,55500,4100,222788
12765,120110,2018-10-29,0.04642166344294004,51700,49300,-2400,244592
12766,120110,2018-10-11,0.043697478991596636,59500,56900,-2600,184614
12767,120110,2018-09-19,0.06921944035346098,67900,63200,-4700,487727
12768,120110,2018-08-09,0.0544,62500,65900,3400,439512
12769,120110,2018-07-03,0.10872894333843798,65300,58200,-7100,1267824
12770,120110,2018-06-15,0.041891891891891894,74000,70900,-3100,235849
12771,120110,2018-06-01,0.07250755287009064,66200,71000,4800,608784
12772,120110,2018-05-14,0.06051873198847262,69400,65200,-4200,340683
12773,120110,2018-03-23,0.041176470588235294,68000,65200,-2800,179795
12774,120110,2018-01-11,0.057919621749408984,84600,79700,-4900,983495
12775,120110,2017-12-27,0.04945717732207479,82900,87000,4100,433469
12776,120110,2017-09-21,0.05483028720626632,76600,72400,-4200,533507
12777,120110,2017-09-13,0.11511789181692095,72100,80400,8300,1463220
12778,120110,2017-09-12,0.05873715124816446,68100,72100,4000,378490
12779,120110,2017-08-14,0.04128440366972477,65400,68100,2700,175932
12780,120110,2017-06-19,0.05499276410998553,69100,72900,3800,568662
12781,120110,2017-05-17,0.048104956268221574,68600,65300,-3300,410206
12782,120110,2017-04-06,0.044630404463040445,71700,68500,-3200,513443
12783,120110,2017-01-02,0.07027027027027027,74000,79200,5200,330661
12784,120110,2016-12-08,0.058992805755395686,69500,73600,4100,233431
12785,120110,2016-11-11,0.05100671140939597,74500,70700,-3800,255919
12786,120110,2016-11-07,0.04195804195804196,71500,74500,3000,90632
12787,120110,2016-10-19,0.043478260869565216,75900,79200,3300,471804
12788,120110,2016-09-27,0.04804045512010114,79100,82900,3800,253764
12789,120110,2016-08-29,0.04789719626168224,85600,81500,-4100,193574
12790,5935,2021-01-11,0.04113110539845758,77800,81000,3200,12293635
12791,5935,2021-01-08,0.047106325706594884,74300,77800,3500,8225064
12792,5935,2020-12-24,0.04148783977110158,69900,72800,2900,5870143
12793,5935,2020-11-23,0.04631217838765009,58300,61000,2700,3411903
12794,5935,2020-07-28,0.042105263157894736,47500,49500,2000,6280763
12795,5935,2020-06-03,0.05,44000,46200,2200,4824403
12796,5935,2020-04-17,0.041371158392434985,42300,44050,1750,3207970
12797,5935,2020-03-25,0.05874840357598978,39150,41450,2300,4241958
12798,5935,2020-03-24,0.0875,36000,39150,3150,4179097
12799,5935,2020-03-23,0.05263157894736842,38000,36000,-2000,3367606
12800,5935,2020-03-20,0.07193229901269393,35450,38000,2550,4623584
12801,5935,2020-03-19,0.06710526315789474,38000,35450,-2550,5640126
12802,5935,2020-03-18,0.0416141235813367,39650,38000,-1650,3745813
12803,5935,2020-03-09,0.0410958904109589,47450,45500,-1950,3515886
12804,5935,2020-02-28,0.04206098843322818,47550,45550,-2000,3872934
12805,5935,2019-03-21,0.05807365439093484,35300,37350,2050,2064463
12806,5935,2019-01-09,0.05177993527508091,30900,32500,1600,1829977
12807,5935,2019-01-07,0.054187192118226604,30450,32100,1650,1500454
12808,5935,2018-11-20,0.040446304044630406,35850,34400,-1450,2476205
12809,5935,2018-10-11,0.04281767955801105,36200,34650,-1550,1976912
12810,5935,2018-09-14,0.04415954415954416,35100,36650,1550,704944
12811,5935,2018-04-05,0.04134762633996937,1959000,2040000,81000,24534
12812,5935,2018-02-13,0.05585106382978723,1880000,1985000,105000,48889
12813,5935,2018-02-02,0.04176784847013113,2059000,1973000,-86000,68655
12814,5935,2018-01-10,0.04403131115459882,2044000,1954000,-90000,66062
12815,5935,2017-12-28,0.04343484772840739,2003000,2090000,87000,35681
12816,5935,2017-11-27,0.051907719609582965,2254000,2137000,-117000,55388
12817,5935,2017-11-01,0.04241071428571429,2240000,2335000,95000,58951
12818,5935,2017-10-31,0.04918032786885246,2135000,2240000,105000,72304
12819,5935,2017-10-11,0.048931116389548696,2105000,2208000,103000,47010
12820,5935,2017-08-03,0.04185809086268504,1959000,1877000,-82000,72665
12821,5935,2017-04-27,0.04753199268738574,1641000,1719000,78000,105630
12822,5935,2017-03-02,0.047459893048128345,1496000,1567000,71000,39627
12823,5935,2017-01-11,0.040622884224779957,1477000,1537000,60000,52422
12824,5935,2016-11-30,0.04953560371517028,1292000,1356000,64000,102488
12825,5935,2016-10-11,0.06502242152466367,1338000,1251000,-87000,65540
12826,5935,2016-09-23,0.05387453874538745,1355000,1282000,-73000,57772
12827,5935,2016-09-13,0.06706281833616298,1178000,1257000,79000,59880
12828,5935,2016-09-12,0.07389937106918239,1272000,1178000,-94000,57393
12829,5935,2016-09-09,0.04790419161676647,1336000,1272000,-64000,44012
12830,30000,2021-05-31,0.07692307692307693,24050,25900,1850,1335610
12831,30000,2021-05-03,0.06605922551252848,21950,23400,1450,1640418
12832,30000,2021-03-08,0.04381443298969072,19400,20250,850,898405
12833,30000,2020-10-14,0.04186046511627907,21500,22400,900,645707
12834,30000,2020-09-16,0.05384615384615385,19500,20550,1050,1615365
12835,30000,2020-08-20,0.042134831460674156,17800,17050,-750,736928
12836,30000,2020-08-18,0.06631299734748011,18850,17600,-1250,896760
12837,30000,2020-07-31,0.04950495049504951,20200,19200,-1000,1074189
12838,30000,2020-07-28,0.08791208791208792,18200,19800,1600,2419211
12839,30000,2020-07-27,0.05202312138728324,17300,18200,900,723239
12840,30000,2020-06-16,0.08544303797468354,15800,17150,1350,798886
12841,30000,2020-06-15,0.07058823529411765,17000,15800,-1200,886191
12842,30000,2020-06-12,0.04225352112676056,17750,17000,-750,1020223
12843,30000,2020-06-02,0.07017543859649122,17100,18300,1200,1966142
12844,30000,2020-04-23,0.05688622754491018,16700,17650,950,1490803
12845,30000,2020-04-08,0.046242774566473986,17300,16500,-800,1329439
12846,30000,2020-04-06,0.062111801242236024,16100,17100,1000,804397
12847,30000,2020-04-02,0.049019607843137254,15300,16050,750,713238
12848,30000,2020-03-27,0.060810810810810814,14800,15700,900,1347478
12849,30000,2020-03-25,0.1927710843373494,12450,14850,2400,2293283
12850,30000,2020-03-23,0.09398496240601503,13300,12050,-1250,666144
12851,30000,2020-03-20,0.11764705882352941,11900,13300,1400,982485
12852,30000,2020-03-19,0.11851851851851852,13500,11900,-1600,1256746
12853,30000,2020-03-18,0.07534246575342465,14600,13500,-1100,919240
12854,30000,2020-03-17,0.06109324758842444,15550,14600,-950,919909
12855,30000,2020-03-16,0.046012269938650305,16300,15550,-750,717666
12856,30000,2020-03-13,0.0659025787965616,17450,16300,-1150,885620
12857,30000,2020-03-12,0.04120879120879121,18200,17450,-750,591468
12858,30000,2020-03-09,0.04092071611253197,19550,18750,-800,327564
12859,30000,2019-08-05,0.05232558139534884,25800,27150,1350,345158
12860,30000,2019-07-23,0.0429553264604811,29100,27850,-1250,762040
12861,30000,2019-03-15,0.05263157894736842,22800,24000,1200,526771
12862,30000,2019-01-31,0.044444444444444446,22500,23500,1000,370013
12863,30000,2019-01-11,0.05054945054945055,22750,21600,-1150,426491
12864,30000,2018-12-27,0.05473684210526316,23750,22450,-1300,454663
12865,30000,2018-11-01,0.046255506607929514,22700,21650,-1050,410506
12866,30000,2018-10-31,0.09134615384615384,20800,22700,1900,669902
12867,30000,2018-09-27,0.04773869346733668,19900,20850,950,393600
12868,30000,2018-06-28,0.05612244897959184,19600,20700,1100,365866
12869,30000,2018-06-27,0.04390243902439024,20500,19600,-900,380032
12870,30000,2018-06-15,0.0405727923627685,20950,20100,-850,794204
12871,30000,2018-05-11,0.059782608695652176,18400,19500,1100,634979
12872,30000,2018-04-02,0.06388888888888888,18000,19150,1150,669106
12873,30000,2018-02-12,0.05612244897959184,19600,18500,-1100,670792
12874,30000,2018-01-31,0.0759493670886076,19750,21250,1500,2452728
12875,30000,2017-10-31,0.09473684210526316,19000,20800,1800,2522659
12876,30000,2017-10-30,0.049723756906077346,18100,19000,900,759742
12877,30000,2017-07-31,0.04627249357326478,19450,20350,900,1432172
12878,30000,2017-01-31,0.09117647058823529,17000,18550,1550,2222868
12879,30000,2017-01-03,0.04075235109717868,15950,16600,650,445104
12880,30000,2016-12-27,0.0664451827242525,15050,16050,1000,629181
12881,30000,2016-10-27,0.057750759878419454,16450,17400,950,16012195
12882,30000,2016-09-28,0.046052631578947366,15200,15900,700,475290
12883,214320,2021-05-24,0.06375838926174497,59600,63400,3800,336600
12884,214320,2021-02-09,0.04612850082372323,60700,63500,2800,153703
12885,214320,2021-01-07,0.052969502407704656,62300,65600,3300,193882
12886,214320,2020-10-19,0.04915254237288136,59000,56100,-2900,103962
12887,214320,2020-10-14,0.06329113924050633,55300,58800,3500,254021
12888,214320,2020-09-29,0.04921259842519685,50800,53300,2500,100520
12889,214320,2020-09-04,0.0661764705882353,54400,50800,-3600,285035
12890,214320,2020-08-21,0.06827309236947791,49800,53200,3400,88784
12891,214320,2020-08-20,0.062146892655367235,53100,49800,-3300,125166
12892,214320,2020-08-18,0.07706093189964158,55800,51500,-4300,139933
12893,214320,2020-08-12,0.07142857142857142,51800,55500,3700,283515
12894,214320,2020-08-10,0.041289023162134945,49650,51700,2050,142292
12895,214320,2020-06-16,0.047261009667024706,46550,48750,2200,85155
12896,214320,2020-06-15,0.08366141732283465,50800,46550,-4250,137608
12897,214320,2020-06-12,0.054003724394785846,53700,50800,-2900,110242
12898,214320,2020-05-04,0.04974271012006861,58300,55400,-2900,51652
12899,214320,2020-04-21,0.05815831987075929,61900,58300,-3600,68373
12900,214320,2020-04-17,0.0782608695652174,57500,62000,4500,95792
12901,214320,2020-04-16,0.045454545454545456,55000,57500,2500,48041
12902,214320,2020-04-07,0.041121495327102804,53500,55700,2200,49833
12903,214320,2020-04-06,0.046966731898238745,51100,53500,2400,50665
12904,214320,2020-04-01,0.043726235741444866,52600,50300,-2300,57431
12905,214320,2020-03-26,0.04436229205175601,54100,51700,-2400,68260
12906,214320,2020-03-25,0.1572192513368984,46750,54100,7350,129667
12907,214320,2020-03-24,0.08092485549132948,43250,46750,3500,95099
12908,214320,2020-03-23,0.06080347448425624,46050,43250,-2800,82739
12909,214320,2020-03-20,0.05136986301369863,43800,46050,2250,88755
12910,214320,2020-03-19,0.0875,48000,43800,-4200,136203
12911,214320,2020-03-18,0.102803738317757,53500,48000,-5500,107852
12912,214320,2020-03-12,0.04738562091503268,61200,58300,-2900,84079
12913,214320,2019-12-10,0.043410852713178294,64500,67300,2800,52930
12914,214320,2019-11-04,0.04294478527607362,65200,68000,2800,81229
12915,214320,2019-08-01,0.08233532934131736,66800,72300,5500,133139
12916,214320,2019-06-19,0.05873925501432665,69800,73900,4100,83583
12917,214320,2019-05-10,0.047895500725689405,68900,72200,3300,244418
12918,214320,2019-03-22,0.04149377593360996,72300,69300,-3000,76134
12919,214320,2019-02-12,0.058577405857740586,71700,67500,-4200,802741
12920,214320,2019-01-08,0.0436817472698908,64100,66900,2800,51726
12921,214320,2018-12-03,0.05934718100890208,67400,63400,-4000,73451
12922,214320,2018-11-26,0.048986486486486486,59200,62100,2900,31326
12923,214320,2018-11-21,0.056239015817223195,56900,60100,3200,87256
12924,214320,2018-11-07,0.0663265306122449,58800,54900,-3900,86796
12925,214320,2018-11-06,0.0481283422459893,56100,58800,2700,39126
12926,214320,2018-10-30,0.08123791102514506,51700,55900,4200,56293
12927,214320,2018-10-23,0.04701627486437613,55300,52700,-2600,38815
12928,214320,2018-10-11,0.06976744186046512,55900,52000,-3900,55387
12929,214320,2018-10-08,0.048903878583473864,59300,56400,-2900,64982
12930,214320,2018-08-10,0.0425531914893617,56400,58800,2400,60611
12931,214320,2018-07-03,0.041666666666666664,57600,55200,-2400,38723
12932,214320,2018-06-25,0.05650684931506849,58400,61700,3300,55632
12933,214320,2018-06-19,0.05229793977812995,63100,59800,-3300,117433
12934,214320,2018-06-15,0.07205882352941176,68000,63100,-4900,78098
12935,214320,2018-05-09,0.04709576138147567,63700,66700,3000,29194
12936,214320,2018-03-02,0.05891472868217054,64500,60700,-3800,55225
12937,214320,2018-02-05,0.04538799414348463,68300,65200,-3100,49988
12938,214320,2018-01-03,0.051630434782608696,73600,69800,-3800,86023
12939,214320,2017-12-27,0.04954367666232073,76700,72900,-3800,38479
12940,214320,2017-10-18,0.04215116279069767,68800,71700,2900,56002
12941,214320,2017-09-25,0.04046242774566474,69200,66400,-2800,51978
12942,214320,2017-09-11,0.04178674351585014,69400,66500,-2900,129241
12943,214320,2017-03-28,0.047021943573667714,63800,60800,-3000,113338
12944,214320,2017-03-21,0.06105610561056106,60600,64300,3700,144383
12945,214320,2017-03-17,0.04778156996587031,58600,61400,2800,68006
12946,214320,2017-01-31,0.05073649754500818,61100,58000,-3100,72015
12947,214320,2017-01-18,0.05872193436960276,57900,61300,3400,94604
12948,214320,2016-11-16,0.056105610561056105,60600,64000,3400,85629
12949,214320,2016-11-11,0.04354587869362364,64300,61500,-2800,53999
12950,214320,2016-11-07,0.05377906976744186,68800,65100,-3700,60814
12951,5940,2021-05-06,0.05179282868525897,12550,13200,650,2504561
12952,5940,2021-04-30,0.04897959183673469,12250,12850,600,3183626
12953,5940,2021-02-01,0.06787330316742081,11050,11800,750,2125745
12954,5940,2020-12-29,0.04700854700854701,11700,11150,-550,1940064
12955,5940,2020-12-01,0.046511627906976744,10750,11250,500,1476918
12956,5940,2020-11-30,0.04017857142857143,11200,10750,-450,2065835
12957,5940,2020-11-16,0.04807692307692308,10400,10900,500,2596698
12958,5940,2020-10-28,0.04973544973544974,9450,9920,470,1825112
12959,5940,2020-10-23,0.06092436974789916,9520,10100,580,4073005
12960,5940,2020-08-25,0.045657015590200446,8980,9390,410,1480656
12961,5940,2020-08-20,0.0425531914893617,9400,9000,-400,2024141
12962,5940,2020-08-04,0.04827586206896552,8700,9120,420,3365017
12963,5940,2020-07-13,0.05128205128205128,8190,8610,420,2301339
12964,5940,2020-06-25,0.04308390022675737,8820,8440,-380,4200904
12965,5940,2020-06-23,0.04751847940865892,9470,9020,-450,3843624
12966,5940,2020-06-03,0.05314009661835749,10350,10900,550,4453576
12967,5940,2020-05-29,0.050731707317073174,10250,9730,-520,3744026
12968,5940,2020-05-21,0.041666666666666664,9600,10000,400,3320287
12969,5940,2020-05-19,0.048034934497816595,9160,9600,440,2202344
12970,5940,2020-04-29,0.0707182320441989,9050,9690,640,3947641
12971,5940,2020-04-17,0.0568445475638051,8620,9110,490,2879999
12972,5940,2020-04-01,0.06451612903225806,8990,8410,-580,1703845
12973,5940,2020-03-25,0.1856115107913669,6950,8240,1290,3801541
12974,5940,2020-03-24,0.10142630744849446,6310,6950,640,2467754
12975,5940,2020-03-23,0.1260387811634349,7220,6310,-910,2132665
12976,5940,2020-03-20,0.05401459854014599,6850,7220,370,2837378
12977,5940,2020-03-19,0.10807291666666667,7680,6850,-830,2800936
12978,5940,2020-03-18,0.061124694376528114,8180,7680,-500,1661276
12979,5940,2020-03-12,0.05463917525773196,9700,9170,-530,2097940
12980,5940,2020-03-09,0.04251207729468599,10350,9910,-440,1143387
12981,5940,2020-02-24,0.056074766355140186,10700,10100,-600,1459125
12982,5940,2020-01-28,0.05439330543933055,11950,11300,-650,1790625
12983,5940,2019-11-04,0.06198347107438017,12100,12850,750,2274495
12984,5940,2019-09-16,0.043824701195219126,12550,13100,550,1146901
12985,5940,2019-07-29,0.04,13750,13200,-550,1569050
12986,5940,2019-07-03,0.050335570469798654,14900,14150,-750,1127208
12987,5940,2019-04-03,0.04693140794223827,13850,14500,650,2293663
12988,5940,2019-03-29,0.04669260700389105,12850,13450,600,842731
12989,5940,2019-01-15,0.05533596837944664,12650,13350,700,1425182
12990,5940,2019-01-07,0.045081967213114756,12200,12750,550,1271676
12991,5940,2019-01-02,0.05363984674329502,13050,12350,-700,1139552
12992,5940,2018-11-02,0.09349593495934959,12300,13450,1150,2498229
12993,5940,2018-10-11,0.047244094488188976,12700,12100,-600,1393580
12994,5940,2018-10-10,0.05223880597014925,13400,12700,-700,1578872
12995,5940,2018-08-27,0.047058823529411764,12750,13350,600,1825292
12996,5940,2018-08-21,0.049586776859504134,12100,12700,600,1757662
12997,5940,2018-07-02,0.056856187290969896,14950,14100,-850,1415166
12998,5940,2018-06-14,0.05341246290801187,16850,15950,-900,2482614
12999,5940,2018-06-07,0.040123456790123455,16200,16850,650,1712093
13000,5940,2018-05-30,0.05917159763313609,16900,15900,-1000,2557922
13001,5940,2018-05-28,0.04281345565749235,16350,17050,700,1310407
13002,5940,2018-05-11,0.050955414012738856,15700,16500,800,2268239
13003,5940,2018-04-24,0.047619047619047616,14700,15400,700,2097059
13004,5940,2018-04-13,0.050359712230215826,13900,14600,700,2131534
13005,5940,2018-03-23,0.06506849315068493,14600,13650,-950,2589159
13006,5940,2018-03-09,0.045774647887323945,14200,14850,650,2670207
13007,5940,2018-02-02,0.044642857142857144,16800,16050,-750,1861404
13008,5940,2018-01-23,0.06309148264984227,15850,16850,1000,2486622
13009,5940,2018-01-12,0.06312292358803986,15050,16000,950,3133270
13010,5940,2018-01-08,0.059027777777777776,14400,15250,850,3137590
13011,5940,2017-10-12,0.061371841155234655,13850,14700,850,3259470
13012,5940,2017-09-18,0.043795620437956206,13700,14300,600,2189122
13013,5940,2017-09-07,0.05078125,12800,13450,650,1265094
13014,5940,2017-08-03,0.05536332179930796,14450,13650,-800,2711649
13015,5940,2017-07-28,0.06375838926174497,14900,13950,-950,2302683
13016,5940,2017-03-16,0.044715447154471545,12300,12850,550,3017574
13017,5940,2017-02-21,0.04932735426008968,11150,11700,550,2848214
13018,5940,2017-01-26,0.0502283105022831,10950,11500,550,3434371
13019,5940,2017-01-17,0.04608294930875576,10850,11350,500,4335561
13020,5940,2017-01-11,0.054455445544554455,10100,10650,550,3893652
13021,5940,2016-08-02,0.04225352112676056,10650,10200,-450,2097121
13022,192820,2021-06-02,0.04365079365079365,126000,131500,5500,153089
13023,192820,2021-05-26,0.05982905982905983,117000,124000,7000,166586
13024,192820,2021-05-03,0.0411522633744856,121500,116500,-5000,158798
13025,192820,2021-04-29,0.053811659192825115,111500,117500,6000,330953
13026,192820,2021-04-28,0.05907172995780591,118500,111500,-7000,504478
13027,192820,2021-04-27,0.11567164179104478,134000,118500,-15500,672458
13028,192820,2021-04-20,0.04150943396226415,132500,138000,5500,195752
13029,192820,2021-04-16,0.06938775510204082,122500,131000,8500,446529
13030,192820,2021-03-12,0.053811659192825115,111500,117500,6000,174233
13031,192820,2021-03-08,0.04700854700854701,117000,111500,-5500,161533
13032,192820,2021-03-03,0.0761904761904762,105000,113000,8000,506847
13033,192820,2021-02-24,0.046511627906976744,107500,102500,-5000,133431
13034,192820,2021-02-18,0.06103286384976526,106500,113000,6500,514945
13035,192820,2021-01-29,0.04186046511627907,107500,103000,-4500,203059
13036,192820,2021-01-22,0.08866995073891626,101500,110500,9000,711088
13037,192820,2021-01-14,0.04058272632674298,96100,100000,3900,246651
13038,192820,2020-12-09,0.0435244161358811,94200,98300,4100,226010
13039,192820,2020-11-16,0.0945945945945946,111000,100500,-10500,485574
13040,192820,2020-11-09,0.05092592592592592,108000,113500,5500,147872
13041,192820,2020-11-05,0.049019607843137254,102000,107000,5000,151385
13042,192820,2020-11-04,0.05116279069767442,107500,102000,-5500,467549
13043,192820,2020-10-30,0.06666666666666667,112500,105000,-7500,124155
13044,192820,2020-10-26,0.0502092050209205,119500,113500,-6000,88843
13045,192820,2020-10-12,0.08620689655172414,116000,126000,10000,299879
13046,192820,2020-09-29,0.049773755656108594,110500,116000,5500,182704
13047,192820,2020-09-25,0.054187192118226604,101500,107000,5500,114867
13048,192820,2020-09-22,0.0547945205479452,109500,103500,-6000,121943
13049,192820,2020-09-21,0.052884615384615384,104000,109500,5500,276614
13050,192820,2020-09-01,0.05392156862745098,102000,107500,5500,168564
13051,192820,2020-08-20,0.05429864253393665,110500,104500,-6000,284860
13052,192820,2020-08-14,0.13861386138613863,101000,115000,14000,993196
13053,192820,2020-08-12,0.05597416576964478,92900,98100,5200,319910
13054,192820,2020-07-15,0.08108108108108109,99900,91800,-8100,377829
13055,192820,2020-07-13,0.04607329842931937,95500,99900,4400,123416
13056,192820,2020-06-16,0.051008303677342826,84300,88600,4300,80554
13057,192820,2020-06-15,0.06541019955654102,90200,84300,-5900,112285
13058,192820,2020-05-25,0.04352678571428571,89600,93500,3900,186601
13059,192820,2020-05-22,0.04477611940298507,93800,89600,-4200,185578
13060,192820,2020-05-15,0.041758241758241756,91000,94800,3800,416061
13061,192820,2020-05-14,0.0950661853188929,83100,91000,7900,386807
13062,192820,2020-04-27,0.0481786133960047,85100,89200,4100,158679
13063,192820,2020-04-06,0.0468557336621455,81100,84900,3800,187348
13064,192820,2020-04-02,0.04907161803713528,75400,79100,3700,122271
13065,192820,2020-03-31,0.06377204884667571,73700,78400,4700,224099
13066,192820,2020-03-30,0.04096045197740113,70800,73700,2900,143485
13067,192820,2020-03-25,0.08527131782945736,64500,70000,5500,264320
13068,192820,2020-03-24,0.06260296540362438,60700,64500,3800,172103
13069,192820,2020-03-23,0.08446455505279035,66300,60700,-5600,141310
13070,192820,2020-03-19,0.048034934497816595,68700,65400,-3300,192323
13071,192820,2020-03-17,0.05757575757575758,66000,69800,3800,147778
13072,192820,2020-03-12,0.08119079837618404,73900,67900,-6000,260402
13073,192820,2020-03-11,0.060991105463786534,78700,73900,-4800,180581
13074,192820,2020-03-04,0.05,80000,84000,4000,195007
13075,192820,2020-03-02,0.07456724367509987,75100,80700,5600,154623
13076,192820,2020-02-28,0.04331210191082802,78500,75100,-3400,138215
13077,192820,2020-02-21,0.05089408528198074,72700,76400,3700,548397
13078,192820,2020-01-28,0.08679706601466992,81800,74700,-7100,289476
13079,192820,2020-01-23,0.04215456674473068,85400,81800,-3600,171328
13080,192820,2020-01-13,0.053268765133171914,82600,87000,4400,418187
13081,192820,2020-01-07,0.04961832061068702,78600,82500,3900,206729
13082,192820,2020-01-02,0.04881101376720901,79900,83800,3900,123691
13083,192820,2019-11-14,0.060075093867334166,79900,75100,-4800,383880
13084,192820,2019-11-06,0.055825242718446605,82400,87000,4600,347174
13085,192820,2019-10-31,0.06533333333333333,75000,79900,4900,547181
13086,192820,2019-10-30,0.04602510460251046,71700,75000,3300,188835
13087,192820,2019-10-04,0.04864864864864865,74000,70400,-3600,211312
13088,192820,2019-08-13,0.04161073825503356,74500,71400,-3100,674558
13089,192820,2019-08-12,0.19719827586206898,92800,74500,-18300,1104412
13090,192820,2019-08-08,0.0661345496009122,87700,93500,5800,122572
13091,192820,2019-08-05,0.061037639877924724,98300,92300,-6000,125779
13092,192820,2019-07-25,0.06167846309403438,98900,105000,6100,254577
13093,192820,2019-05-13,0.05078125,128000,121500,-6500,112261
13094,192820,2019-05-09,0.041666666666666664,132000,126500,-5500,65461
13095,192820,2019-03-18,0.05423728813559322,147500,155500,8000,110978
13096,192820,2019-02-15,0.08812260536398467,130500,142000,11500,301741
13097,192820,2018-12-27,0.04918032786885246,122000,128000,6000,71671
13098,192820,2018-12-12,0.046875,128000,134000,6000,71479
13099,192820,2018-11-29,0.042105263157894736,142500,136500,-6000,108957
13100,192820,2018-11-19,0.042801556420233464,128500,134000,5500,105887
13101,192820,2018-11-15,0.15151515151515152,115500,133000,17500,262811
13102,192820,2018-11-09,0.05533596837944664,126500,119500,-7000,174127
13103,192820,2018-11-08,0.04979253112033195,120500,126500,6000,210507
13104,192820,2018-10-30,0.06018518518518518,108000,114500,6500,150974
13105,192820,2018-10-29,0.07296137339055794,116500,108000,-8500,225948
13106,192820,2018-10-26,0.045081967213114756,122000,116500,-5500,178445
13107,192820,2018-10-25,0.05058365758754864,128500,122000,-6500,167608
13108,192820,2018-10-12,0.048327137546468404,134500,141000,6500,132255
13109,192820,2018-10-10,0.06688963210702341,149500,139500,-10000,170244
13110,192820,2018-10-04,0.07739938080495357,161500,149000,-12500,216204
13111,192820,2018-09-21,0.041935483870967745,155000,148500,-6500,107895
13112,192820,2018-08-21,0.04727272727272727,137500,144000,6500,108682
13113,192820,2018-08-13,0.045936395759717315,141500,148000,6500,145807
13114,192820,2018-08-01,0.07352941176470588,136000,146000,10000,161664
13115,192820,2018-07-17,0.04304635761589404,151000,144500,-6500,110497
13116,192820,2018-07-06,0.07191780821917808,146000,156500,10500,66029
13117,192820,2018-06-22,0.050445103857566766,168500,160000,-8500,107254
13118,192820,2018-06-05,0.0471976401179941,169500,177500,8000,87327
13119,192820,2018-05-11,0.09061488673139159,154500,168500,14000,363717
13120,192820,2018-05-03,0.04430379746835443,158000,151000,-7000,87965
13121,192820,2018-04-13,0.05821917808219178,146000,154500,8500,195350
13122,192820,2018-03-26,0.041666666666666664,132000,137500,5500,64596
13123,192820,2018-03-12,0.041666666666666664,132000,137500,5500,212114
13124,192820,2018-03-09,0.056,125000,132000,7000,186566
13125,192820,2018-03-02,0.04296875,128000,122500,-5500,106583
13126,192820,2018-02-19,0.04032258064516129,124000,129000,5000,98433
13127,192820,2018-02-14,0.046413502109704644,118500,124000,5500,266291
13128,192820,2018-02-07,0.05976095617529881,125500,118000,-7500,137429
13129,192820,2018-01-10,0.04132231404958678,121000,126000,5000,237304
13130,192820,2017-12-12,0.04330708661417323,127000,121500,-5500,130342
13131,192820,2017-11-29,0.04878048780487805,123000,129000,6000,232017
13132,192820,2017-11-15,0.045081967213114756,122000,116500,-5500,514031
13133,192820,2017-11-14,0.06153846153846154,130000,122000,-8000,526810
13134,192820,2017-10-13,0.07317073170731707,123000,132000,9000,441381
13135,192820,2017-09-29,0.06276150627615062,119500,127000,7500,358764
13136,192820,2017-09-21,0.04504504504504504,111000,116000,5000,167591
13137,192820,2017-09-14,0.052132701421800945,105500,111000,5500,103589
13138,192820,2017-09-08,0.04680851063829787,117500,112000,-5500,108514
13139,192820,2017-08-24,0.060085836909871244,116500,123500,7000,203263
13140,192820,2017-08-09,0.06698564593301436,104500,111500,7000,146078
13141,192820,2017-07-31,0.05045871559633028,109000,103500,-5500,116628
13142,192820,2017-07-10,0.0502283105022831,109500,104000,-5500,185555
13143,192820,2017-06-29,0.0625,120000,112500,-7500,201340
13144,192820,2017-06-23,0.05309734513274336,113000,119000,6000,142208
13145,192820,2017-05-12,0.17350157728706625,158500,131000,-27500,1112171
13146,192820,2017-05-04,0.04929577464788732,142000,149000,7000,102942
13147,192820,2017-04-13,0.04905660377358491,132500,139000,6500,156447
13148,192820,2017-03-24,0.05019305019305019,129500,136000,6500,138648
13149,192820,2017-03-02,0.041811846689895474,143500,137500,-6000,142028
13150,192820,2017-02-27,0.04040404040404041,148500,142500,-6000,105555
13151,192820,2017-02-24,0.0683453237410072,139000,148500,9500,185398
13152,192820,2017-02-14,0.07692307692307693,130000,140000,10000,263143
13153,192820,2017-01-24,0.043137254901960784,127500,133000,5500,105848
13154,192820,2017-01-13,0.04782608695652174,115000,120500,5500,109545
13155,192820,2017-01-09,0.05263157894736842,123500,117000,-6500,81389
13156,192820,2017-01-02,0.058577405857740586,119500,112500,-7000,68230
13157,192820,2016-12-27,0.04819277108433735,124500,118500,-6000,92588
13158,192820,2016-12-23,0.046610169491525424,118000,123500,5500,74983
13159,192820,2016-12-09,0.09004739336492891,105500,115000,9500,195222
13160,192820,2016-11-29,0.08163265306122448,98000,106000,8000,197254
13161,192820,2016-11-21,0.05726872246696035,113500,107000,-6500,137680
13162,192820,2016-11-18,0.04219409282700422,118500,113500,-5000,122660
13163,192820,2016-11-10,0.06224066390041494,120500,128000,7500,105151
13164,192820,2016-10-31,0.04149377593360996,120500,115500,-5000,88769
13165,192820,2016-10-25,0.08494208494208494,129500,118500,-11000,439024
13166,192820,2016-10-24,0.10689655172413794,145000,129500,-15500,453092
13167,192820,2016-10-04,0.06930693069306931,151500,162000,10500,210010
13168,192820,2016-09-01,0.040955631399317405,146500,152500,6000,72734
13169,192820,2016-08-23,0.06382978723404255,141000,150000,9000,113024
13170,192820,2016-08-08,0.08239700374531835,133500,144500,11000,177941
13171,192820,2016-08-05,0.04642857142857143,140000,133500,-6500,218042
13172,138040,2021-05-25,0.05675675675675676,18500,19550,1050,520139
13173,138040,2021-05-24,0.04519774011299435,17700,18500,800,712704
13174,138040,2021-05-17,0.1556122448979592,19600,16550,-3050,2800391
13175,138040,2021-05-14,0.04156479217603912,20450,19600,-850,418958
13176,138040,2021-05-06,0.043596730245231606,18350,19150,800,234799
13177,138040,2021-04-30,0.043731778425655975,17150,17900,750,239706
13178,138040,2021-04-02,0.0513595166163142,16550,15700,-850,378649
13179,138040,2021-03-31,0.05521472392638037,16300,17200,900,400848
13180,138040,2021-03-30,0.05161290322580645,15500,16300,800,188292
13181,138040,2021-03-08,0.048,12500,13100,600,415192
13182,138040,2021-02-22,0.04424778761061947,11300,11800,500,424870
13183,138040,2020-12-29,0.05238095238095238,10500,9950,-550,377199
13184,138040,2020-11-16,0.04455445544554455,10100,10550,450,245860
13185,138040,2020-10-22,0.04584221748400853,9380,9810,430,223342
13186,138040,2020-08-04,0.045507584597432905,8570,8960,390,193522
13187,138040,2020-06-15,0.04830917874396135,10350,9850,-500,65693
13188,138040,2020-06-09,0.041474654377880185,10850,10400,-450,123312
13189,138040,2020-05-22,0.0430622009569378,10450,10000,-450,96882
13190,138040,2020-03-31,0.11231101511879049,9260,10300,1040,161620
13191,138040,2020-03-30,0.06436781609195402,8700,9260,560,102520
13192,138040,2020-03-26,0.0475,8000,8380,380,142950
13193,138040,2020-03-25,0.15273775216138327,6940,8000,1060,145528
13194,138040,2020-03-24,0.051515151515151514,6600,6940,340,106915
13195,138040,2020-03-20,0.09,6000,6540,540,173142
13196,138040,2020-03-19,0.18699186991869918,7380,6000,-1380,281279
13197,138040,2020-03-18,0.08094645080946451,8030,7380,-650,149203
13198,138040,2020-03-17,0.08646188850967008,8790,8030,-760,106832
13199,138040,2020-03-13,0.11212121212121212,9900,8790,-1110,408661
13200,138040,2020-01-31,0.04390243902439024,10250,10700,450,159554
13201,138040,2019-12-11,0.043859649122807015,11400,11900,500,212475
13202,138040,2019-12-06,0.07916666666666666,12000,11050,-950,639046
13203,138040,2019-09-27,0.04961832061068702,13100,12450,-650,143964
13204,138040,2019-08-07,0.04411764705882353,13600,13000,-600,83778
13205,138040,2019-07-03,0.0410958904109589,14600,14000,-600,80444
13206,138040,2019-05-29,0.046357615894039736,15100,14400,-700,167850
13207,138040,2019-05-28,0.06338028169014084,14200,15100,900,183556
13208,138040,2019-04-25,0.043478260869565216,13800,13200,-600,49968
13209,138040,2018-11-30,0.05371900826446281,12100,11450,-650,120648
13210,138040,2018-10-11,0.04081632653061224,12250,11750,-500,101220
13211,138040,2017-12-15,0.04375,16000,15300,-700,115695
13212,138040,2017-10-11,0.0486322188449848,16450,15650,-800,81004
13213,138040,2017-09-19,0.046511627906976744,15050,15750,700,65041
13214,138040,2017-08-31,0.06687898089171974,15700,16750,1050,129721
13215,138040,2017-05-04,0.05078125,12800,13450,650,165069
13216,90430,2021-04-28,0.04448742746615087,258500,270000,11500,635279
13217,90430,2021-04-13,0.04892367906066536,255500,268000,12500,300061
13218,90430,2021-03-31,0.04963235294117647,272000,258500,-13500,264737
13219,90430,2021-03-17,0.046153846153846156,227500,238000,10500,263349
13220,90430,2021-01-29,0.04291845493562232,233000,223000,-10000,283625
13221,90430,2021-01-19,0.05938242280285035,210500,223000,12500,311506
13222,90430,2021-01-18,0.045351473922902494,220500,210500,-10000,366406
13223,90430,2021-01-13,0.04187192118226601,203000,211500,8500,553390
13224,90430,2020-12-09,0.10714285714285714,196000,217000,21000,909898
13225,90430,2020-12-01,0.04748603351955307,179000,187500,8500,340875
13226,90430,2020-11-20,0.047872340425531915,188000,197000,9000,894303
13227,90430,2020-11-17,0.06017191977077364,174500,185000,10500,1072147
13228,90430,2020-10-30,0.04242424242424243,165000,158000,-7000,362898
13229,90430,2020-08-20,0.0521978021978022,182000,172500,-9500,475380
13230,90430,2020-08-18,0.10178117048346055,196500,176500,-20000,867824
13231,90430,2020-08-14,0.048,187500,196500,9000,795049
13232,90430,2020-08-12,0.04597701149425287,174000,182000,8000,894705
13233,90430,2020-06-30,0.09477124183006536,153000,167500,14500,3896837
13234,90430,2020-06-26,0.05333333333333334,150000,158000,8000,374777
13235,90430,2020-06-16,0.04361370716510903,160500,167500,7000,193585
13236,90430,2020-06-15,0.044642857142857144,168000,160500,-7500,321454
13237,90430,2020-04-17,0.0463768115942029,172500,180500,8000,658064
13238,90430,2020-04-01,0.06231454005934718,168500,158000,-10500,422750
13239,90430,2020-03-24,0.07210031347962383,159500,171000,11500,433417
13240,90430,2020-03-17,0.05084745762711865,147500,155000,7500,412149
13241,90430,2020-03-11,0.04790419161676647,167000,159000,-8000,310982
13242,90430,2020-02-28,0.04451038575667656,168500,161000,-7500,597683
13243,90430,2020-02-24,0.04945054945054945,182000,173000,-9000,495760
13244,90430,2020-02-05,0.07614213197969544,197000,182000,-15000,1075027
13245,90430,2020-01-30,0.04197530864197531,202500,194000,-8500,501382
13246,90430,2020-01-29,0.04113110539845758,194500,202500,8000,639606
13247,90430,2020-01-28,0.08470588235294117,212500,194500,-18000,836404
13248,90430,2020-01-23,0.049217002237136466,223500,212500,-11000,467540
13249,90430,2020-01-20,0.048625792811839326,236500,225000,-11500,567605
13250,90430,2020-01-13,0.05215419501133787,220500,232000,11500,561971
13251,90430,2020-01-10,0.04009433962264151,212000,220500,8500,309458
13252,90430,2020-01-07,0.0748792270531401,207000,222500,15500,487251
13253,90430,2019-11-08,0.06356968215158924,204500,191500,-13000,731956
13254,90430,2019-10-31,0.043478260869565216,184000,192000,8000,1116590
13255,90430,2019-10-30,0.14285714285714285,161000,184000,23000,1310133
13256,90430,2019-09-27,0.050724637681159424,138000,145000,7000,547888
13257,90430,2019-09-03,0.07604562737642585,131500,141500,10000,838557
13258,90430,2019-08-30,0.04838709677419355,124000,130000,6000,517046
13259,90430,2019-08-05,0.04980842911877394,130500,124000,-6500,452317
13260,90430,2019-08-01,0.04642857142857143,140000,133500,-6500,710909
13261,90430,2019-07-31,0.06040268456375839,149000,140000,-9000,695519
13262,90430,2019-07-08,0.04142011834319527,169000,162000,-7000,237813
13263,90430,2019-07-05,0.04643962848297214,161500,169000,7500,421907
13264,90430,2019-05-24,0.040214477211796246,186500,179000,-7500,254547
13265,90430,2019-04-30,0.058823529411764705,221000,208000,-13000,536054
13266,90430,2019-04-15,0.07568807339449542,218000,234500,16500,827285
13267,90430,2019-04-12,0.06601466992665037,204500,218000,13500,506191
13268,90430,2019-03-18,0.04081632653061224,196000,204000,8000,355270
13269,90430,2019-03-15,0.05093833780160858,186500,196000,9500,280392
13270,90430,2019-03-11,0.04556962025316456,197500,188500,-9000,285609
13271,90430,2019-02-20,0.08602150537634409,186000,202000,16000,808568
13272,90430,2019-02-15,0.04057971014492753,172500,179500,7000,297262
13273,90430,2019-02-08,0.04225352112676056,177500,170000,-7500,352057
13274,90430,2019-01-17,0.04644808743169399,183000,174500,-8500,446966
13275,90430,2019-01-04,0.043701799485861184,194500,186000,-8500,553488
13276,90430,2019-01-02,0.07637231503579953,209500,193500,-16000,404377
13277,90430,2018-12-27,0.0475,200000,209500,9500,243557
13278,90430,2018-12-18,0.05526315789473684,190000,200500,10500,434394
13279,90430,2018-12-12,0.08022922636103152,174500,188500,14000,673079
13280,90430,2018-12-07,0.052795031055900624,161000,169500,8500,329600
13281,90430,2018-12-06,0.052941176470588235,170000,161000,-9000,315289
13282,90430,2018-11-28,0.04953560371517028,161500,169500,8000,664561
13283,90430,2018-11-27,0.041935483870967745,155000,161500,6500,735347
13284,90430,2018-11-20,0.05063291139240506,158000,150000,-8000,532991
13285,90430,2018-11-15,0.05555555555555555,153000,161500,8500,1820365
13286,90430,2018-11-02,0.06060606060606061,165000,175000,10000,474916
13287,90430,2018-11-01,0.0784313725490196,153000,165000,12000,474875
13288,90430,2018-10-29,0.12806539509536785,183500,160000,-23500,765730
13289,90430,2018-10-26,0.04177545691906005,191500,183500,-8000,272386
13290,90430,2018-10-15,0.04578313253012048,207500,198000,-9500,267688
13291,90430,2018-10-12,0.05063291139240506,197500,207500,10000,248467
13292,90430,2018-10-11,0.06839622641509434,212000,197500,-14500,464105
13293,90430,2018-10-10,0.04932735426008968,223000,212000,-11000,349662
13294,90430,2018-10-04,0.13988657844990549,264500,227500,-37000,994561
13295,90430,2018-08-23,0.054474708171206226,257000,271000,14000,320901
13296,90430,2018-07-26,0.04114490161001789,279500,268000,-11500,403475
13297,90430,2018-07-04,0.04038772213247173,309500,297000,-12500,155684
13298,90430,2018-06-15,0.040498442367601244,321000,308000,-13000,254526
13299,90430,2018-04-30,0.043348281016442454,334500,349000,14500,202938
13300,90430,2018-04-02,0.050473186119873815,317000,333000,16000,489376
13301,90430,2018-03-09,0.04152249134948097,289000,301000,12000,563866
13302,90430,2018-02-28,0.04088586030664395,293500,281500,-12000,191531
13303,90430,2018-02-21,0.06896551724137931,275500,294500,19000,273540
13304,90430,2018-02-07,0.048986486486486486,296000,281500,-14500,208904
13305,90430,2018-01-04,0.04012841091492777,311500,299000,-12500,199790
13306,90430,2017-12-12,0.040061633281972264,324500,311500,-13000,334464
13307,90430,2017-12-04,0.0784,312500,337000,24500,606655
13308,90430,2017-10-26,0.0723905723905724,297000,318500,21500,720822
13309,90430,2017-10-16,0.05166051660516605,271000,285000,14000,581424
13310,90430,2017-10-13,0.06483300589390963,254500,271000,16500,681271
13311,90430,2017-09-08,0.04634581105169341,280500,267500,-13000,446767
13312,90430,2017-08-24,0.05169340463458111,280500,295000,14500,305933
13313,90430,2017-05-12,0.0443213296398892,361000,345000,-16000,337452
13314,90430,2017-05-11,0.047895500725689405,344500,361000,16500,437736
13315,90430,2017-05-08,0.06389776357827476,313000,333000,20000,504682
13316,90430,2017-05-04,0.08117443868739206,289500,313000,23500,338626
13317,90430,2017-04-25,0.043973941368078175,307000,293500,-13500,305126
13318,90430,2017-04-17,0.05350553505535055,271000,285500,14500,309494
13319,90430,2017-03-03,0.1267361111111111,288000,251500,-36500,1060753
13320,90430,2017-03-02,0.04318936877076412,301000,288000,-13000,331092
13321,90430,2017-02-24,0.06401384083044982,289000,307500,18500,306334
13322,90430,2017-02-02,0.04595879556259905,315500,301000,-14500,488349
13323,90430,2017-01-13,0.041390728476821195,302000,314500,12500,192048
13324,90430,2017-01-02,0.049766718506998445,321500,305500,-16000,94147
13325,90430,2016-11-29,0.05564142194744977,323500,341500,18000,196781
13326,90430,2016-11-10,0.049723756906077346,362000,380000,18000,202326
13327,90430,2016-10-25,0.07123655913978495,372000,345500,-26500,762672
13328,90430,2016-10-07,0.05643044619422572,381000,359500,-21500,248561
13329,90430,2016-08-10,0.046419098143236075,377000,394500,17500,306998
13330,90430,2016-08-08,0.045454545454545456,363000,379500,16500,344886
13331,11070,2021-02-26,0.04326923076923077,208000,199000,-9000,413677
13332,11070,2021-02-24,0.07482993197278912,220500,204000,-16500,489849
13333,11070,2021-02-19,0.08490566037735849,212000,230000,18000,707031
13334,11070,2021-02-10,0.041666666666666664,204000,212500,8500,310647
13335,11070,2021-02-03,0.05925925925925926,202500,214500,12000,441969
13336,11070,2021-01-29,0.045346062052505964,209500,200000,-9500,542741
13337,11070,2021-01-28,0.04772727272727273,220000,209500,-10500,632490
13338,11070,2021-01-26,0.0665083135391924,210500,224500,14000,1625867
13339,11070,2021-01-25,0.0525,200000,210500,10500,461840
13340,11070,2021-01-20,0.08753315649867374,188500,205000,16500,1109736
13341,11070,2021-01-04,0.0547945205479452,182500,192500,10000,464216
13342,11070,2020-12-24,0.05945945945945946,185000,174000,-11000,688721
13343,11070,2020-12-23,0.12804878048780488,164000,185000,21000,3484070
13344,11070,2020-12-04,0.06230529595015576,160500,170500,10000,829883
13345,11070,2020-11-19,0.048859934853420196,153500,161000,7500,360149
13346,11070,2020-10-28,0.04516129032258064,155000,162000,7000,159522
13347,11070,2020-10-19,0.044585987261146494,157000,164000,7000,195739
13348,11070,2020-10-07,0.05732484076433121,157000,166000,9000,261275
13349,11070,2020-09-24,0.045307443365695796,154500,147500,-7000,175012
13350,11070,2020-09-02,0.10097719869706841,153500,169000,15500,818324
13351,11070,2020-09-01,0.05862068965517241,145000,153500,8500,322368
13352,11070,2020-08-24,0.05802047781569966,146500,155000,8500,228720
13353,11070,2020-08-20,0.061488673139158574,154500,145000,-9500,325065
13354,11070,2020-08-18,0.05504587155963303,163500,154500,-9000,418830
13355,11070,2020-07-21,0.062111801242236024,161000,171000,10000,440261
13356,11070,2020-06-26,0.055384615384615386,162500,171500,9000,296752
13357,11070,2020-06-16,0.059375,160000,169500,9500,217329
13358,11070,2020-06-15,0.07514450867052024,173000,160000,-13000,272176
13359,11070,2020-06-10,0.044444444444444446,157500,164500,7000,339108
13360,11070,2020-05-18,0.05136986301369863,146000,138500,-7500,444203
13361,11070,2020-05-12,0.04411764705882353,136000,142000,6000,379410
13362,11070,2020-04-27,0.07936507936507936,126000,136000,10000,462280
13363,11070,2020-04-17,0.051587301587301584,126000,132500,6500,526932
13364,11070,2020-04-14,0.04680851063829787,117500,123000,5500,253263
13365,11070,2020-04-13,0.05241935483870968,124000,117500,-6500,276368
13366,11070,2020-04-07,0.05327868852459016,122000,128500,6500,573155
13367,11070,2020-04-06,0.10909090909090909,110000,122000,12000,575285
13368,11070,2020-04-02,0.041474654377880185,108500,113000,4500,371857
13369,11070,2020-04-01,0.04824561403508772,114000,108500,-5500,421645
13370,11070,2020-03-30,0.05069124423963134,108500,114000,5500,433381
13371,11070,2020-03-26,0.05286343612334802,113500,107500,-6000,614784
13372,11070,2020-03-25,0.05581395348837209,107500,113500,6000,1082656
13373,11070,2020-03-24,0.1774370208105148,91300,107500,16200,1404434
13374,11070,2020-03-23,0.07870837537840565,99100,91300,-7800,656846
13375,11070,2020-03-20,0.29882044560943644,76300,99100,22800,847968
13376,11070,2020-03-19,0.0829326923076923,83200,76300,-6900,485245
13377,11070,2020-03-18,0.11205976520811099,93700,83200,-10500,579437
13378,11070,2020-03-16,0.08530805687203792,105500,96500,-9000,546732
13379,11070,2020-03-13,0.06637168141592921,113000,105500,-7500,783139
13380,11070,2020-03-12,0.06224066390041494,120500,113000,-7500,468120
13381,11070,2020-03-11,0.054901960784313725,127500,120500,-7000,314863
13382,11070,2020-03-09,0.07352941176470588,136000,126000,-10000,368951
13383,11070,2020-03-02,0.057692307692307696,130000,137500,7500,358597
13384,11070,2020-02-28,0.09407665505226481,143500,130000,-13500,551339
13385,11070,2020-02-18,0.04501607717041801,155500,148500,-7000,365652
13386,11070,2020-01-29,0.0429042904290429,151500,158000,6500,388880
13387,11070,2020-01-09,0.05818181818181818,137500,145500,8000,293629
13388,11070,2019-12-27,0.040892193308550186,134500,140000,5500,164555
13389,11070,2019-10-30,0.05138339920948617,126500,120000,-6500,464529
13390,11070,2019-10-16,0.04721030042918455,116500,122000,5500,283425
13391,11070,2019-10-01,0.04824561403508772,114000,119500,5500,284535
13392,11070,2019-09-24,0.05660377358490566,106000,112000,6000,259721
13393,11070,2019-09-04,0.04604604604604605,99900,104500,4600,188344
13394,11070,2019-08-26,0.06069651741293532,100500,94400,-6100,418067
13395,11070,2019-08-14,0.056622851365015166,98900,104500,5600,366381
13396,11070,2019-08-05,0.04,100000,96000,-4000,201836
13397,11070,2019-08-02,0.09502262443438914,110500,100000,-10500,445021
13398,11070,2019-07-29,0.04291845493562232,116500,111500,-5000,90797
13399,11070,2019-07-19,0.06018518518518518,108000,114500,6500,185406
13400,11070,2019-07-09,0.045662100456621,109500,104500,-5000,252965
13401,11070,2019-07-04,0.05,110000,115500,5500,164453
13402,11070,2019-07-01,0.045871559633027525,109000,114000,5000,262224
13403,11070,2019-06-27,0.04225352112676056,106500,111000,4500,253028
13404,11070,2019-06-19,0.04975124378109453,100500,105500,5000,443225
13405,11070,2019-05-30,0.04132231404958678,96800,92800,-4000,353303
13406,11070,2019-05-23,0.06666666666666667,103500,96600,-6900,364924
13407,11070,2019-05-16,0.04424778761061947,113000,108000,-5000,139802
13408,11070,2019-04-17,0.06584362139917696,121500,129500,8000,472931
13409,11070,2019-04-09,0.04700854700854701,117000,122500,5500,215647
13410,11070,2019-04-03,0.05652173913043478,115000,121500,6500,352158
13411,11070,2019-03-29,0.044444444444444446,112500,117500,5000,367818
13412,11070,2019-03-21,0.09547738693467336,99500,109000,9500,485145
13413,11070,2019-03-18,0.05660377358490566,106000,100000,-6000,319351
13414,11070,2019-02-07,0.05025125628140704,99500,104500,5000,363088
13415,11070,2019-01-15,0.04161849710982659,86500,90100,3600,232747
13416,11070,2019-01-07,0.05289052890528905,81300,85600,4300,226083
13417,11070,2018-12-27,0.04404761904761905,84000,87700,3700,291903
13418,11070,2018-11-26,0.05,94000,98700,4700,327018
13419,11070,2018-11-20,0.04455445544554455,101000,96500,-4500,545796
13420,11070,2018-11-13,0.0547945205479452,109500,103500,-6000,786528
13421,11070,2018-11-07,0.0423728813559322,118000,113000,-5000,477103
13422,11070,2018-11-06,0.06349206349206349,126000,118000,-8000,552490
13423,11070,2018-10-25,0.06995884773662552,121500,130000,8500,449403
13424,11070,2018-10-11,0.056,125000,118000,-7000,342587
13425,11070,2018-10-10,0.04580152671755725,131000,125000,-6000,275063
13426,11070,2018-09-13,0.04744525547445255,137000,130500,-6500,852161
13427,11070,2018-09-05,0.04180064308681672,155500,149000,-6500,229748
13428,11070,2018-09-04,0.0436241610738255,149000,155500,6500,377030
13429,11070,2018-08-10,0.04180064308681672,155500,149000,-6500,205557
13430,11070,2018-07-06,0.07216494845360824,145500,156000,10500,564528
13431,11070,2018-07-05,0.043010752688172046,139500,145500,6000,363258
13432,11070,2018-06-25,0.04316546762589928,139000,145000,6000,220431
13433,11070,2018-06-22,0.04794520547945205,146000,139000,-7000,439214
13434,11070,2018-06-19,0.04713804713804714,148500,141500,-7000,273473
13435,11070,2018-05-28,0.05474452554744526,137000,144500,7500,736884
13436,11070,2018-05-25,0.04580152671755725,131000,137000,6000,624640
13437,11070,2018-05-08,0.044,125000,130500,5500,352466
13438,11070,2018-05-03,0.04048582995951417,123500,128500,5000,448995
13439,11070,2018-05-02,0.060085836909871244,116500,123500,7000,498629
13440,11070,2018-04-25,0.06,125000,117500,-7500,626155
13441,11070,2018-04-24,0.0421455938697318,130500,125000,-5500,385075
13442,11070,2018-04-17,0.04198473282442748,131000,136500,5500,702301
13443,11070,2018-04-16,0.06504065040650407,123000,131000,8000,494828
13444,11070,2018-04-12,0.05416666666666667,120000,126500,6500,451634
13445,11070,2018-04-04,0.04897959183673469,122500,116500,-6000,345967
13446,11070,2018-03-27,0.05,120000,126000,6000,223476
13447,11070,2018-03-23,0.05138339920948617,126500,120000,-6500,503041
13448,11070,2018-03-09,0.042801556420233464,128500,134000,5500,299772
13449,11070,2018-03-07,0.04150943396226415,132500,127000,-5500,211607
13450,11070,2018-03-06,0.04330708661417323,127000,132500,5500,205295
13451,11070,2018-02-08,0.045454545454545456,121000,126500,5500,249516
13452,11070,2018-01-19,0.05357142857142857,140000,132500,-7500,1096410
13453,11070,2018-01-10,0.04792332268370607,156500,149000,-7500,603263
13454,11070,2018-01-09,0.10211267605633803,142000,156500,14500,1239506
13455,11070,2017-12-26,0.052083333333333336,144000,136500,-7500,504695
13456,11070,2017-12-21,0.060810810810810814,148000,139000,-9000,575472
13457,11070,2017-12-07,0.05102040816326531,147000,154500,7500,598789
13458,11070,2017-12-06,0.07547169811320754,159000,147000,-12000,772501
13459,11070,2017-12-04,0.05263157894736842,161500,153000,-8500,855780
13460,11070,2017-11-30,0.05014749262536873,169500,161000,-8500,499564
13461,11070,2017-11-13,0.05847953216374269,171000,161000,-10000,530564
13462,11070,2017-10-23,0.06666666666666667,157500,168000,10500,334260
13463,11070,2017-10-19,0.043076923076923075,162500,155500,-7000,303579
13464,11070,2017-10-11,0.07096774193548387,155000,166000,11000,475518
13465,11070,2017-09-28,0.04501607717041801,155500,148500,-7000,439301
13466,11070,2017-09-22,0.04180064308681672,155500,149000,-6500,546461
13467,11070,2017-09-21,0.04892966360856269,163500,155500,-8000,525518
13468,11070,2017-08-29,0.040697674418604654,172000,179000,7000,191035
13469,11070,2017-08-02,0.10367892976588629,149500,165000,15500,520279
13470,11070,2017-07-28,0.06811145510835913,161500,150500,-11000,362399
13471,11070,2017-07-12,0.04075235109717868,159500,153000,-6500,189951
13472,11070,2017-06-28,0.06376811594202898,172500,161500,-11000,459122
13473,11070,2017-06-26,0.07692307692307693,162500,175000,12500,356493
13474,11070,2017-06-19,0.041401273885350316,157000,163500,6500,208984
13475,11070,2017-06-12,0.05466237942122187,155500,147000,-8500,400911
13476,11070,2017-06-08,0.07446808510638298,141000,151500,10500,559166
13477,11070,2017-06-07,0.044444444444444446,135000,141000,6000,224086
13478,11070,2017-05-29,0.041353383458646614,133000,138500,5500,215983
13479,11070,2017-04-27,0.05090909090909091,137500,130500,-7000,358207
13480,11070,2017-04-21,0.06716417910447761,134000,143000,9000,344564
13481,11070,2017-04-10,0.040293040293040296,136500,131000,-5500,100811
13482,11070,2017-03-21,0.06130268199233716,130500,138500,8000,281795
13483,11070,2017-02-23,0.041666666666666664,120000,125000,5000,437588
13484,11070,2017-01-25,0.0806979280261723,91700,99100,7400,972100
13485,11070,2016-11-28,0.049738219895287955,76400,80200,3800,335834
13486,11070,2016-09-19,0.07051282051282051,78000,83500,5500,389751
13487,11070,2016-09-05,0.044902912621359224,82400,86100,3700,320500
13488,9540,2021-06-01,0.0456140350877193,142500,149000,6500,819339
13489,9540,2021-05-20,0.05194805194805195,154000,146000,-8000,567446
13490,9540,2021-05-12,0.04361370716510903,160500,153500,-7000,750161
13491,9540,2021-04-26,0.0673758865248227,141000,150500,9500,1065089
13492,9540,2021-03-26,0.11392405063291139,118500,132000,13500,1926320
13493,9540,2021-03-09,0.04054054054054054,111000,115500,4500,814808
13494,9540,2021-02-25,0.045871559633027525,109000,114000,5000,502114
13495,9540,2021-02-23,0.07692307692307693,104000,112000,8000,1164157
13496,9540,2021-02-15,0.0594059405940594,101000,107000,6000,494738
13497,9540,2021-02-01,0.0627659574468085,94000,99900,5900,449837
13498,9540,2021-01-29,0.04374364191251272,98300,94000,-4300,780382
13499,9540,2021-01-28,0.04097560975609756,102500,98300,-4200,674753
13500,9540,2021-01-05,0.06818181818181818,110000,117500,7500,1108466
13501,9540,2020-12-11,0.06829268292682927,102500,109500,7000,932001
13502,9540,2020-11-23,0.06471816283924843,95800,102000,6200,1141724
13503,9540,2020-11-19,0.04833836858006042,99300,94500,-4800,889242
13504,9540,2020-11-16,0.07150595882990249,92300,98900,6600,1026744
13505,9540,2020-11-09,0.08685162846803378,82900,90100,7200,1228520
13506,9540,2020-09-24,0.04310344827586207,81200,77700,-3500,368708
13507,9540,2020-08-20,0.04266958424507659,91400,87500,-3900,468677
13508,9540,2020-08-18,0.045881126173096975,95900,91500,-4400,1118237
13509,9540,2020-08-14,0.06201550387596899,90300,95900,5600,983827
13510,9540,2020-08-11,0.051605504587155966,87200,91700,4500,775258
13511,9540,2020-07-13,0.07168458781362007,83700,89700,6000,473931
13512,9540,2020-06-16,0.07184241019698726,86300,92500,6200,329689
13513,9540,2020-06-15,0.08773784355179703,94600,86300,-8300,558684
13514,9540,2020-06-12,0.044444444444444446,99000,94600,-4400,451334
13515,9540,2020-06-03,0.04994903160040775,98100,103000,4900,920385
13516,9540,2020-06-02,0.06399132321041215,92200,98100,5900,1921151
13517,9540,2020-05-27,0.08041958041958042,85800,92700,6900,1476514
13518,9540,2020-05-25,0.04881101376720901,79900,83800,3900,740036
13519,9540,2020-05-06,0.04040404040404041,79200,82400,3200,429041
13520,9540,2020-05-04,0.04232164449818621,82700,79200,-3500,453170
13521,9540,2020-04-29,0.06847545219638243,77400,82700,5300,1107897
13522,9540,2020-04-21,0.04938271604938271,81000,77000,-4000,758374
13523,9540,2020-04-13,0.053864168618266976,85400,80800,-4600,360328
13524,9540,2020-04-09,0.05157232704402516,79500,83600,4100,453140
13525,9540,2020-04-06,0.05352480417754569,76600,80700,4100,262082
13526,9540,2020-03-25,0.06901217861975643,73900,79000,5100,492705
13527,9540,2020-03-24,0.07725947521865889,68600,73900,5300,294642
13528,9540,2020-03-23,0.10909090909090909,77000,68600,-8400,324195
13529,9540,2020-03-20,0.16138763197586728,66300,77000,10700,517444
13530,9540,2020-03-19,0.07788595271210014,71900,66300,-5600,661951
13531,9540,2020-03-18,0.08524173027989822,78600,71900,-6700,404985
13532,9540,2020-03-16,0.05315203955500618,80900,76600,-4300,526279
13533,9540,2020-03-13,0.0920314253647587,89100,80900,-8200,969928
13534,9540,2020-03-12,0.06701570680628273,95500,89100,-6400,612408
13535,9540,2020-03-09,0.09014084507042254,106500,96900,-9600,812249
13536,9540,2020-03-05,0.04245283018867924,106000,110500,4500,298132
13537,9540,2020-02-24,0.05357142857142857,112000,106000,-6000,286441
13538,9540,2020-02-06,0.12272727272727273,110000,123500,13500,678051
13539,9540,2020-01-28,0.048,125000,119000,-6000,221836
13540,9540,2020-01-09,0.04435483870967742,124000,129500,5500,328602
13541,9540,2019-10-30,0.04296875,128000,122500,-5500,215726
13542,9540,2019-08-30,0.04265402843601896,105500,110000,4500,247446
13543,9540,2019-08-20,0.05339805825242718,103000,108500,5500,347794
13544,9540,2019-08-19,0.07628004179728318,95700,103000,7300,379578
13545,9540,2019-08-02,0.04672897196261682,107000,102000,-5000,333053
13546,9540,2019-07-25,0.055299539170506916,108500,102500,-6000,613245
13547,9540,2019-05-30,0.04054054054054054,111000,115500,4500,186414
13548,9540,2019-05-13,0.047619047619047616,115500,110000,-5500,366584
13549,9540,2019-05-09,0.04149377593360996,120500,115500,-5000,456761
13550,9540,2019-04-23,0.058333333333333334,120000,127000,7000,644267
13551,9540,2019-03-25,0.07539682539682539,126000,116500,-9500,743725
13552,9540,2019-02-01,0.07581227436823104,138500,128000,-10500,1709513
13553,9540,2019-01-31,0.04152249134948097,144500,138500,-6000,1538515
13554,9540,2019-01-04,0.053231939163498096,131500,138500,7000,369927
13555,9540,2019-01-03,0.04780876494023904,125500,131500,6000,334941
13556,9540,2018-12-27,0.040160642570281124,124500,129500,5000,324481
13557,9540,2018-12-12,0.05263157894736842,133000,140000,7000,329188
13558,9540,2018-11-16,0.05078125,128000,134500,6500,393648
13559,9540,2018-11-14,0.0599250936329588,133500,125500,-8000,488221
13560,9540,2018-11-06,0.053497942386831275,121500,128000,6500,415458
13561,9540,2018-11-01,0.06827309236947791,124500,116000,-8500,495843
13562,9540,2018-10-30,0.060085836909871244,116500,123500,7000,330059
13563,9540,2018-10-23,0.047619047619047616,126000,120000,-6000,392126
13564,9540,2018-10-18,0.052830188679245285,132500,125500,-7000,269037
13565,9540,2018-10-11,0.05904059040590406,135500,127500,-8000,425337
13566,9540,2018-10-08,0.0498220640569395,140500,133500,-7000,325392
13567,9540,2018-09-27,0.05078125,128000,134500,6500,338182
13568,9540,2018-08-22,0.04932735426008968,111500,117000,5500,3108253
13569,9540,2018-08-20,0.09223300970873786,103000,112500,9500,485114
13570,9540,2018-08-16,0.041666666666666664,108000,103500,-4500,236325
13571,9540,2018-08-03,0.06372549019607843,102000,108500,6500,261405
13572,9540,2018-08-02,0.04225352112676056,106500,102000,-4500,214657
13573,9540,2018-07-26,0.059837728194726165,98600,104500,5900,538714
13574,9540,2018-06-27,0.075,108000,99900,-8100,538434
13575,9540,2018-06-19,0.04524886877828054,110500,105500,-5000,285114
13576,9540,2018-06-14,0.0411522633744856,121500,116500,-5000,258444
13577,9540,2018-05-28,0.05327868852459016,122000,115500,-6500,975702
13578,9540,2018-05-04,0.04184100418410042,119500,124500,5000,727152
13579,9540,2018-04-26,0.057777777777777775,112500,119000,6500,448058
13580,9540,2018-04-25,0.0425531914893617,117500,112500,-5000,307780
13581,9540,2018-04-05,0.07024793388429752,121000,129500,8500,612806
13582,9540,2018-04-02,0.045454545454545456,132000,126000,-6000,545347
13583,9540,2018-03-30,0.04,137500,132000,-5500,762270
13584,9540,2018-03-29,0.041811846689895474,143500,137500,-6000,530692
13585,9540,2018-03-08,0.05474452554744526,137000,144500,7500,682091
13586,9540,2018-03-06,0.12550607287449392,123500,139000,15500,956555
13587,9540,2018-03-05,0.05725190839694656,131000,123500,-7500,403601
13588,9540,2018-02-23,0.04,125000,130000,5000,354833
13589,9540,2018-02-05,0.050359712230215826,139000,132000,-7000,176805
13590,9540,2018-01-04,0.0641025641025641,117000,124500,7500,555511
13591,9540,2018-01-03,0.08837209302325581,107500,117000,9500,556159
13592,9540,2018-01-02,0.06965174129353234,100500,107500,7000,451405
13593,9540,2017-12-27,0.2875,136000,96900,-39100,2122027
13594,9540,2017-12-08,0.07326007326007326,136500,126500,-10000,514973
13595,9540,2017-12-07,0.04878048780487805,143500,136500,-7000,322124
13596,9540,2017-12-06,0.06209150326797386,153000,143500,-9500,379419
13597,9540,2017-11-13,0.05396825396825397,157500,149000,-8500,392636
13598,9540,2017-11-07,0.04126984126984127,157500,164000,6500,383572
13599,9540,2017-10-31,0.043333333333333335,150000,156500,6500,365366
13600,9540,2017-09-26,0.05755395683453238,139000,147000,8000,307007
13601,9540,2017-09-19,0.07608695652173914,138000,148500,10500,478535
13602,9540,2017-08-21,0.04807692307692308,156000,148500,-7500,740324
13603,9540,2017-08-01,0.045845272206303724,174500,182500,8000,461779
13604,9540,2017-06-13,0.0423728813559322,177000,184500,7500,514888
13605,9540,2017-05-10,0.14242424242424243,165000,180500,15500,4003517
13606,9540,2017-03-16,0.06606606606606606,166500,177500,11000,727126
13607,9540,2017-02-28,0.051118210862619806,156500,164500,8000,668880
13608,9540,2017-02-21,0.04040404040404041,148500,154500,6000,398700
13609,9540,2017-02-01,0.052830188679245285,132500,139500,7000,233800
13610,9540,2017-01-04,0.04827586206896552,145000,138000,-7000,543478
13611,9540,2016-12-01,0.056338028169014086,142000,150000,8000,384857
13612,9540,2016-11-16,0.04778156996587031,146500,153500,7000,1265581
13613,9540,2016-11-10,0.057971014492753624,138000,146000,8000,302139
13614,9540,2016-11-09,0.04827586206896552,145000,138000,-7000,420397
13615,9540,2016-11-07,0.04744525547445255,137000,143500,6500,178557
13616,9540,2016-10-26,0.04823151125401929,155500,148000,-7500,351600
13617,9540,2016-10-06,0.04285714285714286,140000,146000,6000,373680
13618,9540,2016-09-12,0.05985915492957746,142000,133500,-8500,366884
13619,9540,2016-09-05,0.04411764705882353,136000,142000,6000,371542
13620,9540,2016-08-31,0.05363984674329502,130500,137500,7000,333691
13621,9540,2016-08-26,0.040740740740740744,135000,129500,-5500,305364
13622,9540,2016-08-05,0.05533596837944664,126500,133500,7000,547678
13623,69960,2021-03-03,0.06569343065693431,82200,87600,5400,1108512
13624,69960,2021-02-05,0.04469987228607918,78300,81800,3500,376046
13625,69960,2021-01-08,0.05756358768406961,74700,79000,4300,614195
13626,69960,2020-12-02,0.0546984572230014,71300,75200,3900,459696
13627,69960,2020-11-10,0.048818897637795275,63500,66600,3100,518723
13628,69960,2020-10-27,0.04961240310077519,64500,61300,-3200,344771
13629,69960,2020-10-19,0.07269789983844911,61900,66400,4500,959062
13630,69960,2020-10-16,0.047377326565143825,59100,61900,2800,339334
13631,69960,2020-08-18,0.055205047318611984,63400,59900,-3500,239499
13632,69960,2020-06-15,0.050488599348534204,61400,58300,-3100,155869
13633,69960,2020-05-19,0.04354354354354354,66600,69500,2900,127911
13634,69960,2020-04-28,0.06515580736543909,70600,75200,4600,169476
13635,69960,2020-04-27,0.045925925925925926,67500,70600,3100,144374
13636,69960,2020-04-06,0.06896551724137931,58000,62000,4000,85458
13637,69960,2020-04-01,0.04251700680272109,58800,56300,-2500,75960
13638,69960,2020-03-25,0.04512635379061372,55400,57900,2500,140043
13639,69960,2020-03-24,0.045283018867924525,53000,55400,2400,114552
13640,69960,2020-03-23,0.12828947368421054,60800,53000,-7800,120557
13641,69960,2020-03-19,0.06800618238021638,64700,60300,-4400,112405
13642,69960,2020-03-13,0.0713224368499257,67300,62500,-4800,158498
13643,69960,2020-02-24,0.05103448275862069,72500,68800,-3700,171429
13644,69960,2020-02-20,0.05216284987277354,78600,74500,-4100,137671
13645,69960,2020-02-06,0.04639175257731959,77600,81200,3600,70942
13646,69960,2020-01-28,0.10628571428571429,87500,78200,-9300,189520
13647,69960,2020-01-22,0.04728132387706856,84600,88600,4000,82944
13648,69960,2020-01-07,0.058333333333333334,84000,88900,4900,183531
13649,69960,2019-09-11,0.04068241469816273,76200,79300,3100,109207
13650,69960,2019-08-29,0.061971830985915494,71000,75400,4400,138765
13651,69960,2019-02-08,0.04275286757038582,95900,91800,-4100,129677
13652,69960,2018-11-15,0.06941176470588235,85000,90900,5900,147946
13653,69960,2018-10-11,0.056745182012847964,93400,88100,-5300,183703
13654,69960,2018-10-04,0.05040322580645161,99200,94200,-5000,185126
13655,69960,2018-07-03,0.04035874439461883,111500,107000,-4500,258049
13656,69960,2018-06-29,0.04054054054054054,111000,115500,4500,82375
13657,69960,2018-06-19,0.043859649122807015,114000,109000,-5000,213099
13658,69960,2018-05-31,0.056338028169014086,106500,112500,6000,349391
13659,69960,2018-05-11,0.06829268292682927,102500,109500,7000,296649
13660,69960,2018-05-08,0.052899287894201424,98300,103500,5200,341424
13661,69960,2018-04-25,0.06930693069306931,90900,97200,6300,362122
13662,69960,2018-02-09,0.0672782874617737,98100,91500,-6600,364482
13663,69960,2018-01-08,0.052884615384615384,104000,109500,5500,215093
13664,69960,2017-12-15,0.04950495049504951,101000,106000,5000,220359
13665,69960,2017-11-10,0.04021739130434782,92000,88300,-3700,333161
13666,69960,2017-10-26,0.040137614678899085,87200,90700,3500,248297
13667,69960,2017-08-10,0.04716981132075472,106000,101000,-5000,232790
13668,69960,2017-05-26,0.0514018691588785,107000,112500,5500,257177
13669,69960,2017-05-11,0.04504504504504504,111000,106000,-5000,344533
13670,69960,2017-03-24,0.05480868665977249,96700,102000,5300,475082
13671,10060,2021-06-02,0.05952380952380952,126000,133500,7500,1096338
13672,10060,2021-05-28,0.04905660377358491,132500,126000,-6500,568819
13673,10060,2021-05-27,0.07723577235772358,123000,132500,9500,900650
13674,10060,2021-05-24,0.047058823529411764,127500,121500,-6000,246770
13675,10060,2021-05-17,0.055793991416309016,116500,123000,6500,446093
13676,10060,2021-05-11,0.04897959183673469,122500,116500,-6000,445753
13677,10060,2021-04-29,0.06319702602230483,134500,126000,-8500,813959
13678,10060,2021-04-28,0.04946996466431095,141500,134500,-7000,926790
13679,10060,2021-04-22,0.10852713178294573,129000,143000,14000,1336224
13680,10060,2021-04-21,0.040892193308550186,134500,129000,-5500,389299
13681,10060,2021-04-16,0.04819277108433735,124500,130500,6000,574041
13682,10060,2021-04-07,0.04741379310344827,116000,121500,5500,545383
13683,10060,2021-03-29,0.07207207207207207,111000,119000,8000,700755
13684,10060,2021-03-18,0.04,125000,120000,-5000,465759
13685,10060,2021-03-08,0.09090909090909091,137500,125000,-12500,878024
13686,10060,2021-03-05,0.08267716535433071,127000,137500,10500,1004283
13687,10060,2021-02-25,0.12903225806451613,108500,122500,14000,920751
13688,10060,2021-02-24,0.07659574468085106,117500,108500,-9000,465723
13689,10060,2021-02-18,0.05982905982905983,117000,124000,7000,918553
13690,10060,2021-02-15,0.043859649122807015,114000,119000,5000,801995
13691,10060,2021-02-10,0.10144927536231885,103500,114000,10500,1234575
13692,10060,2021-02-04,0.04205607476635514,107000,102500,-4500,344848
13693,10060,2021-02-01,0.10264227642276423,98400,108500,10100,1325140
13694,10060,2021-01-29,0.04466019417475728,103000,98400,-4600,376029
13695,10060,2021-01-19,0.050761421319796954,98500,103500,5000,318521
13696,10060,2021-01-15,0.05092592592592592,108000,102500,-5500,415417
13697,10060,2021-01-13,0.04854368932038835,103000,108000,5000,721012
13698,10060,2021-01-11,0.07429718875502007,99600,107000,7400,1424904
13699,10060,2021-01-04,0.05913978494623656,93000,98500,5500,787830
13700,10060,2020-12-29,0.12087912087912088,81900,91800,9900,1174397
13701,10060,2020-12-28,0.05098493626882966,86300,81900,-4400,540817
13702,10060,2020-12-24,0.049878345498783457,82200,86300,4100,821613
13703,10060,2020-12-22,0.06050228310502283,87600,82300,-5300,861249
13704,10060,2020-12-21,0.140625,76800,87600,10800,1531675
13705,10060,2020-12-17,0.06853146853146853,71500,76400,4900,1300607
13706,10060,2020-12-16,0.04838709677419355,68200,71500,3300,722044
13707,10060,2020-12-02,0.04630969609261939,69100,72300,3200,613020
13708,10060,2020-11-09,0.06144393241167435,65100,69100,4000,873547
13709,10060,2020-11-05,0.08375209380234507,59700,64700,5000,1207534
13710,10060,2020-11-04,0.08294930875576037,65100,59700,-5400,1286912
13711,10060,2020-11-02,0.04854368932038835,61800,64800,3000,390840
13712,10060,2020-10-30,0.06646525679758308,66200,61800,-4400,632086
13713,10060,2020-10-28,0.08291873963515754,60300,65300,5000,1131502
13714,10060,2020-10-26,0.04146730462519936,62700,60100,-2600,251607
13715,10060,2020-10-21,0.0453781512605042,59500,62200,2700,277067
13716,10060,2020-10-08,0.08629441624365482,59100,64200,5100,1182112
13717,10060,2020-10-05,0.043859649122807015,57000,59500,2500,261552
13718,10060,2020-09-24,0.04770318021201413,56600,53900,-2700,570597
13719,10060,2020-09-21,0.044585987261146494,62800,60000,-2800,336753
13720,10060,2020-09-17,0.053516819571865444,65400,61900,-3500,677681
13721,10060,2020-09-11,0.055710306406685235,71800,67800,-4000,556004
13722,10060,2020-08-27,0.06986899563318777,68700,63900,-4800,831801
13723,10060,2020-08-24,0.11601307189542484,61200,68300,7100,1882621
13724,10060,2020-08-19,0.07446808510638298,56400,60600,4200,690872
13725,10060,2020-08-18,0.07389162561576355,60900,56400,-4500,502935
13726,10060,2020-08-10,0.05537459283387622,61400,64800,3400,1036574
13727,10060,2020-08-06,0.0452418096723869,64100,61200,-2900,840966
13728,10060,2020-08-05,0.12456140350877193,57000,64100,7100,2991692
13729,10060,2020-08-04,0.045871559633027525,54500,57000,2500,544493
13730,10060,2020-07-29,0.043478260869565216,52900,55200,2300,1251127
13731,10060,2020-07-24,0.05975395430579965,56900,53500,-3400,1241635
13732,10060,2020-07-23,0.054817275747508304,60200,56900,-3300,1503331
13733,10060,2020-07-21,0.29955947136563876,45400,59000,13600,4869651
13734,10060,2020-07-20,0.04247990815154994,43550,45400,1850,307058
13735,10060,2020-07-14,0.0650319829424307,46900,43850,-3050,508168
13736,10060,2020-07-10,0.04631578947368421,47500,45300,-2200,730005
13737,10060,2020-07-09,0.10722610722610723,42900,47500,4600,2547860
13738,10060,2020-07-06,0.0407911001236094,40450,42100,1650,386172
13739,10060,2020-07-02,0.07588075880758807,36900,39700,2800,761643
13740,10060,2020-06-16,0.07596685082872928,36200,38950,2750,231698
13741,10060,2020-06-15,0.06701030927835051,38800,36200,-2600,350742
13742,10060,2020-06-12,0.05018359853121175,40850,38800,-2050,377610
13743,10060,2020-06-03,0.045512010113780026,39550,41350,1800,677117
13744,10060,2020-05-29,0.09111880046136102,43350,39400,-3950,1911489
13745,10060,2020-05-26,0.07281553398058252,41200,44200,3000,510138
13746,10060,2020-05-22,0.050808314087759814,43300,41100,-2200,414590
13747,10060,2020-05-21,0.09205548549810845,39650,43300,3650,1666180
13748,10060,2020-05-11,0.04024390243902439,41000,39350,-1650,220940
13749,10060,2020-05-08,0.05670103092783505,38800,41000,2200,254570
13750,10060,2020-04-27,0.05291005291005291,37800,39800,2000,209235
13751,10060,2020-04-09,0.047619047619047616,36750,38500,1750,217027
13752,10060,2020-04-06,0.044733044733044736,34650,36200,1550,186350
13753,10060,2020-03-25,0.1077943615257048,30150,33400,3250,381662
13754,10060,2020-03-24,0.11254612546125461,27100,30150,3050,286104
13755,10060,2020-03-23,0.10561056105610561,30300,27100,-3200,265349
13756,10060,2020-03-20,0.13909774436090225,26600,30300,3700,441636
13757,10060,2020-03-19,0.21068249258160238,33700,26600,-7100,613687
13758,10060,2020-03-18,0.0703448275862069,36250,33700,-2550,268644
13759,10060,2020-03-13,0.09212121212121212,41250,37450,-3800,500873
13760,10060,2020-03-12,0.0963855421686747,45650,41250,-4400,541456
13761,10060,2020-03-09,0.064453125,51200,47900,-3300,250363
13762,10060,2020-02-28,0.060114503816793896,52400,49250,-3150,494824
13763,10060,2020-02-24,0.058823529411764705,56100,52800,-3300,252175
13764,10060,2020-02-11,0.11884550084889643,58900,65900,7000,1336793
13765,10060,2020-02-06,0.07481751824817519,54800,58900,4100,310638
13766,10060,2020-01-28,0.06031746031746032,63000,59200,-3800,234021
13767,10060,2020-01-08,0.048701298701298704,61600,58600,-3000,210974
13768,10060,2019-09-30,0.041979010494752625,66700,69500,2800,125369
13769,10060,2019-09-25,0.05241379310344828,72500,68700,-3800,207697
13770,10060,2019-09-11,0.05507246376811594,69000,72800,3800,331695
13771,10060,2019-08-16,0.042709867452135494,67900,65000,-2900,186775
13772,10060,2019-08-05,0.05364511691884457,72700,68800,-3900,201301
13773,10060,2019-07-29,0.0448318804483188,80300,76700,-3600,333390
13774,10060,2019-07-26,0.08646188850967008,87900,80300,-7600,416543
13775,10060,2019-07-15,0.05233219567690557,87900,92500,4600,170452
13776,10060,2019-07-10,0.045951859956236324,91400,87200,-4200,152255
13777,10060,2019-03-07,0.05,104000,98800,-5200,319596
13778,10060,2019-02-25,0.04926108374384237,101500,106500,5000,445512
13779,10060,2019-02-12,0.05533980582524272,103000,97300,-5700,458017
13780,10060,2019-01-03,0.13333333333333333,106500,92300,-14200,721402
13781,10060,2018-12-26,0.06756756756756757,111000,103500,-7500,206823
13782,10060,2018-12-12,0.05687203791469194,105500,111500,6000,281241
13783,10060,2018-12-10,0.041474654377880185,108500,104000,-4500,89715
13784,10060,2018-11-28,0.075,100000,107500,7500,252822
13785,10060,2018-11-05,0.09936575052854123,94600,104000,9400,626482
13786,10060,2018-11-02,0.08237986270022883,87400,94600,7200,314662
13787,10060,2018-10-26,0.07536557930258718,88900,82200,-6700,400277
13788,10060,2018-10-18,0.06161616161616162,99000,92900,-6100,329611
13789,10060,2018-10-12,0.04944500504540868,99100,104000,4900,202302
13790,10060,2018-10-11,0.07813953488372093,107500,99100,-8400,403154
13791,10060,2018-10-02,0.04054054054054054,111000,115500,4500,291393
13792,10060,2018-09-12,0.04888888888888889,112500,118000,5500,205571
13793,10060,2018-09-03,0.04329004329004329,115500,120500,5000,367169
13794,10060,2018-08-27,0.0502283105022831,109500,115000,5500,340238
13795,10060,2018-08-20,0.04090909090909091,110000,114500,4500,407815
13796,10060,2018-08-17,0.057692307692307696,104000,110000,6000,600563
13797,10060,2018-08-09,0.06862745098039216,102000,109000,7000,826514
13798,10060,2018-08-02,0.040776699029126215,103000,98800,-4200,286372
13799,10060,2018-08-01,0.04251012145748988,98800,103000,4200,354205
13800,10060,2018-07-27,0.08440170940170941,93600,101500,7900,663209
13801,10060,2018-06-29,0.04186046511627907,107500,103000,-4500,318887
13802,10060,2018-06-28,0.04878048780487805,102500,107500,5000,454962
13803,10060,2018-06-27,0.04205607476635514,107000,102500,-4500,302579
13804,10060,2018-06-04,0.08396946564885496,131000,120000,-11000,1042181
13805,10060,2018-05-30,0.06428571428571428,140000,131000,-9000,448549
13806,10060,2018-05-24,0.04560260586319218,153500,146500,-7000,313795
13807,10060,2018-05-10,0.07718120805369127,149000,160500,11500,285620
13808,10060,2018-05-04,0.04430379746835443,158000,151000,-7000,204733
13809,10060,2018-04-25,0.05389221556886228,167000,158000,-9000,1348677
13810,10060,2018-04-11,0.04643962848297214,161500,169000,7500,250032
13811,10060,2018-04-05,0.05,160000,168000,8000,413007
13812,10060,2018-03-28,0.05263157894736842,161500,153000,-8500,334475
13813,10060,2018-03-26,0.05362776025236593,158500,167000,8500,411665
13814,10060,2018-03-22,0.10139860139860139,143000,157500,14500,706620
13815,10060,2018-03-13,0.041666666666666664,156000,149500,-6500,391576
13816,10060,2018-03-05,0.07317073170731707,164000,152000,-12000,330441
13817,10060,2018-02-07,0.04416403785488959,158500,151500,-7000,489009
13818,10060,2018-02-06,0.0462046204620462,151500,158500,7000,841885
13819,10060,2018-02-01,0.07396449704142012,169000,156500,-12500,665963
13820,10060,2018-01-29,0.04126984126984127,157500,164000,6500,326453
13821,10060,2018-01-24,0.12290502793296089,179000,157000,-22000,934493
13822,10060,2018-01-23,0.05604719764011799,169500,179000,9500,467101
13823,10060,2018-01-11,0.06166219839142091,186500,175000,-11500,830070
13824,10060,2018-01-10,0.1303030303030303,165000,186500,21500,960766
13825,10060,2018-01-04,0.07612456747404844,144500,155500,11000,834460
13826,10060,2018-01-03,0.0625,136000,144500,8500,605301
13827,10060,2017-12-28,0.05426356589147287,129000,136000,7000,369226
13828,10060,2017-11-28,0.061068702290076333,131000,123000,-8000,459412
13829,10060,2017-11-15,0.04330708661417323,127000,121500,-5500,390768
13830,10060,2017-11-01,0.10619469026548672,113000,125000,12000,1151816
13831,10060,2017-10-18,0.045,100000,104500,4500,361108
13832,10060,2017-10-10,0.05268292682926829,102500,97100,-5400,592089
13833,10060,2017-09-14,0.054187192118226604,101500,107000,5500,700930
13834,10060,2017-09-06,0.04838709677419355,99200,104000,4800,665879
13835,10060,2017-07-27,0.04728950403690888,86700,90800,4100,679669
13836,10060,2017-07-12,0.04218928164196123,87700,84000,-3700,418011
13837,10060,2017-05-16,0.044524669073405534,83100,86800,3700,1242280
13838,10060,2017-03-07,0.045949214026602174,82700,86500,3800,221057
13839,10060,2017-02-08,0.07058823529411765,85000,91000,6000,674893
13840,10060,2017-02-01,0.045454545454545456,85800,89700,3900,213840
13841,10060,2017-01-17,0.08834355828220859,81500,88700,7200,904517
13842,10060,2016-12-16,0.06532663316582915,79600,74400,-5200,451290
13843,10060,2016-12-02,0.04404145077720207,77200,73800,-3400,168656
13844,10060,2016-12-01,0.04891304347826087,73600,77200,3600,298901
13845,10060,2016-11-24,0.07942238267148015,83100,76500,-6600,529831
13846,10060,2016-11-09,0.15960591133004925,101500,85300,-16200,1755232
13847,10060,2016-11-07,0.08766233766233766,92400,100500,8100,347076
13848,10060,2016-11-03,0.04932735426008968,89200,93600,4400,167280
13849,10060,2016-10-26,0.060784313725490195,102000,95800,-6200,438299
13850,10060,2016-10-14,0.055674518201284794,93400,98600,5200,340577
13851,10060,2016-10-13,0.059415911379657606,99300,93400,-5900,358161
13852,10060,2016-09-29,0.11551925320886815,85700,95600,9900,1238789
13853,10060,2016-09-26,0.05099502487562189,80400,84500,4100,362093
13854,2380,2021-05-26,0.0517503805175038,328500,311500,-17000,111731
13855,2380,2021-05-13,0.05091937765205092,353500,335500,-18000,97468
13856,2380,2021-05-12,0.0407055630936228,368500,353500,-15000,99693
13857,2380,2021-05-11,0.08064516129032258,341000,368500,27500,129920
13858,2380,2021-05-10,0.07401574803149606,317500,341000,23500,77202
13859,2380,2021-05-06,0.05921052631578947,304000,322000,18000,53900
13860,2380,2021-05-03,0.04952076677316294,313000,297500,-15500,82091
13861,2380,2021-04-22,0.08020477815699659,293000,316500,23500,99069
13862,2380,2021-04-08,0.04789272030651341,261000,273500,12500,141916
13863,2380,2021-04-07,0.044,250000,261000,11000,105274
13864,2380,2021-04-06,0.07526881720430108,232500,250000,17500,150240
13865,2380,2021-03-31,0.046255506607929514,227000,237500,10500,93931
13866,2380,2021-03-25,0.08801955990220049,204500,222500,18000,196692
13867,2380,2020-12-24,0.05555555555555555,189000,199500,10500,116419
13868,2380,2020-10-05,0.05136986301369863,146000,153500,7500,58733
13869,2380,2020-09-17,0.0711864406779661,147500,158000,10500,258718
13870,2380,2020-09-07,0.06338028169014084,142000,151000,9000,100901
13871,2380,2020-08-20,0.05802047781569966,146500,138000,-8500,163167
13872,2380,2020-08-18,0.09259259259259259,162000,147000,-15000,144133
13873,2380,2020-08-11,0.06315789473684211,142500,151500,9000,192996
13874,2380,2020-08-10,0.04779411764705882,136000,142500,6500,107305
13875,2380,2020-06-16,0.05204460966542751,134500,141500,7000,120208
13876,2380,2020-06-15,0.04609929078014184,141000,134500,-6500,136245
13877,2380,2020-06-11,0.04560260586319218,153500,146500,-7000,139909
13878,2380,2020-06-03,0.04745762711864407,147500,154500,7000,189359
13879,2380,2020-05-29,0.05901639344262295,152500,143500,-9000,480783
13880,2380,2020-05-21,0.05,150000,157500,7500,131734
13881,2380,2020-05-19,0.04195804195804196,143000,149000,6000,101794
13882,2380,2020-04-27,0.07766990291262135,154500,166500,12000,94332
13883,2380,2020-04-23,0.08650519031141868,144500,157000,12500,108947
13884,2380,2020-04-10,0.10507246376811594,138000,152500,14500,154431
13885,2380,2020-03-26,0.04918032786885246,122000,128000,6000,91248
13886,2380,2020-03-25,0.07017543859649122,114000,122000,8000,99241
13887,2380,2020-03-24,0.06542056074766354,107000,114000,7000,78792
13888,2380,2020-03-23,0.13709677419354838,124000,107000,-17000,73764
13889,2380,2020-03-20,0.08771929824561403,114000,124000,10000,57172
13890,2380,2020-03-19,0.13307984790874525,131500,114000,-17500,62561
13891,2380,2020-03-18,0.04363636363636364,137500,131500,-6000,39998
13892,2380,2020-03-17,0.05172413793103448,145000,137500,-7500,43209
13893,2380,2020-03-13,0.05537459283387622,153500,145000,-8500,64730
13894,2380,2020-03-12,0.06402439024390244,164000,153500,-10500,75552
13895,2380,2020-03-09,0.04057971014492753,172500,165500,-7000,37763
13896,2380,2020-03-05,0.041666666666666664,168000,175000,7000,47085
13897,2380,2020-02-28,0.059322033898305086,177000,166500,-10500,93350
13898,2380,2020-02-24,0.05822784810126582,197500,186000,-11500,46674
13899,2380,2020-02-21,0.06175771971496437,210500,197500,-13000,68511
13900,2380,2020-02-14,0.07929515418502203,227000,209000,-18000,109990
13901,2380,2020-02-11,0.04883720930232558,215000,225500,10500,52040
13902,2380,2020-02-06,0.04228855721393035,201000,209500,8500,45149
13903,2380,2020-01-28,0.07829977628635347,223500,206000,-17500,51805
13904,2380,2020-01-23,0.042826552462526764,233500,223500,-10000,70364
13905,2380,2020-01-21,0.14132762312633834,233500,238000,4500,313288
13906,2380,2019-12-13,0.04128440366972477,218000,227000,9000,36309
13907,2380,2019-11-04,0.05752212389380531,226000,239000,13000,31603
13908,2380,2019-07-18,0.04263565891472868,258000,247000,-11000,45339
13909,2380,2019-06-04,0.04296875,256000,267000,11000,33807
13910,2380,2019-05-13,0.04861111111111111,288000,274000,-14000,63581
13911,2380,2019-05-09,0.1724137931034483,348000,288000,-60000,200315
13912,2380,2019-04-10,0.0688,312500,334000,21500,72019
13913,2380,2019-03-15,0.04245283018867924,318000,331500,13500,35480
13914,2380,2018-11-01,0.048582995951417005,247000,259000,12000,37674
13915,2380,2018-05-09,0.04113110539845758,389000,373000,-16000,48466
13916,2380,2018-03-30,0.042232277526395176,331500,345500,14000,46076
13917,2380,2018-02-09,0.04062909567496723,381500,366000,-15500,52503
13918,2380,2017-12-15,0.19375,320000,382000,62000,48736
13919,2380,2017-12-14,0.17737789203084833,389000,320000,-69000,33022
13920,2380,2017-09-25,0.0488771466314399,378500,360000,-18500,29982
13921,2380,2017-08-07,0.04524361948955916,431000,411500,-19500,49134
13922,2380,2017-05-25,0.06258148631029987,383500,407500,24000,110079
13923,2380,2017-05-22,0.046218487394957986,357000,373500,16500,100363
13924,2380,2017-02-03,0.061224489795918366,343000,322000,-21000,107297
13925,2380,2016-11-08,0.040522875816993466,382500,398000,15500,44188
13926,2380,2016-10-06,0.07345360824742268,388000,416500,28500,79623
13927,2380,2016-08-04,0.05974025974025974,385000,408000,23000,68328
13928,26960,2021-05-03,0.04451510333863275,31450,30050,-1400,293999
13929,26960,2021-04-20,0.0453125,32000,33450,1450,288184
13930,26960,2021-03-29,0.0425531914893617,32900,31500,-1400,304956
13931,26960,2021-03-25,0.056657223796033995,35300,33300,-2000,427117
13932,26960,2021-03-18,0.09104938271604938,32400,35350,2950,431078
13933,26960,2021-03-12,0.07692307692307693,29250,31500,2250,600734
13934,26960,2021-03-08,0.07749627421758569,33550,30950,-2600,1192002
13935,26960,2021-03-05,0.17466174661746617,40650,33550,-7100,2281358
13936,26960,2021-02-19,0.061635220125786164,39750,42200,2450,495177
13937,26960,2021-02-15,0.06235294117647059,42500,39850,-2650,639048
13938,26960,2021-02-10,0.08974358974358974,39000,42500,3500,933572
13939,26960,2021-02-05,0.1273792093704246,34150,38500,4350,1620250
13940,26960,2021-02-04,0.042748091603053436,32750,34150,1400,428672
13941,26960,2021-01-26,0.057663125948406675,32950,31050,-1900,396943
13942,26960,2020-12-16,0.04065040650406504,30750,32000,1250,241265
13943,26960,2020-11-30,0.046153846153846156,32500,34000,1500,695527
13944,26960,2020-11-27,0.13043478260869565,28750,32500,3750,1044627
13945,26960,2020-10-06,0.06040268456375839,29800,28000,-1800,437285
13946,26960,2020-09-21,0.04712041884816754,28650,30000,1350,320271
13947,26960,2020-09-18,0.04181818181818182,27500,28650,1150,161745
13948,26960,2020-09-14,0.04259259259259259,27000,28150,1150,230229
13949,26960,2020-09-08,0.06387225548902195,25050,26650,1600,407389
13950,26960,2020-08-21,0.04883227176220807,23550,24700,1150,332931
13951,26960,2020-08-20,0.07465618860510806,25450,23550,-1900,498899
13952,26960,2020-08-19,0.06041666666666667,24000,25450,1450,377721
13953,26960,2020-08-14,0.04719101123595506,22250,23300,1050,278620
13954,26960,2020-07-27,0.08333333333333333,19200,20800,1600,476676
13955,26960,2020-07-16,0.08359133126934984,16150,17500,1350,583298
13956,26960,2020-06-01,0.041916167664670656,16700,17400,700,90773
13957,26960,2020-03-19,0.049019607843137254,15300,14550,-750,180011
13958,26960,2020-03-18,0.04075235109717868,15950,15300,-650,94104
13959,26960,2019-12-27,0.043596730245231606,18350,17550,-800,120262
13960,26960,2019-05-29,0.05378973105134474,20450,19350,-1100,215735
13961,26960,2019-05-10,0.0633245382585752,18950,20150,1200,209514
13962,26960,2019-03-14,0.05542168674698795,20750,21900,1150,482684
13963,26960,2019-02-28,0.05952380952380952,21000,19750,-1250,361975
13964,26960,2019-02-27,0.11702127659574468,18800,21000,2200,696154
13965,26960,2019-01-04,0.04011461318051576,17450,18150,700,142643
13966,26960,2018-11-20,0.061046511627906974,17200,18250,1050,310881
13967,26960,2018-11-14,0.06442577030812324,17850,16700,-1150,785522
13968,26960,2018-10-31,0.04189944134078212,17900,18650,750,147437
13969,26960,2018-09-20,0.06796116504854369,20600,22000,1400,308189
13970,26960,2017-12-15,0.04512635379061372,27700,28950,1250,188725
13971,26960,2017-11-20,0.0415944540727903,28850,30050,1200,217031
13972,26960,2017-05-24,0.05023547880690738,31850,33450,1600,292051
13973,26960,2017-04-05,0.043333333333333335,30000,31300,1300,180116
13974,26960,2017-03-21,0.05202312138728324,25950,27300,1350,268108
13975,3410,2021-05-03,0.041237113402061855,7760,7440,-320,2825900
13976,3410,2021-03-26,0.07857142857142857,7000,7550,550,19975688
13977,3410,2021-01-19,0.045871559633027525,6540,6840,300,5061676
13978,3410,2020-12-10,0.05856515373352855,6830,7230,400,8649599
13979,3410,2020-12-04,0.11171171171171171,5550,6700,1150,22171425
13980,3410,2020-09-18,0.04736842105263158,5700,5970,270,2184869
13981,3410,2020-09-02,0.06842105263157895,5700,6090,390,6013818
13982,3410,2020-08-06,0.06759443339960239,5030,5370,340,8643152
13983,3410,2020-04-23,0.04411764705882353,5440,5200,-240,3216036
13984,3410,2020-04-22,0.08582834331337326,5010,5440,430,12063898
13985,3410,2020-04-16,0.056133056133056136,4810,5080,270,2018492
13986,3410,2020-03-23,0.04487179487179487,4680,4470,-210,982500
13987,3410,2020-03-20,0.15413070283600494,4055,4680,625,1658698
13988,3410,2020-03-19,0.11269146608315099,4570,4055,-515,2669126
13989,3410,2020-03-18,0.07019328585961343,4915,4570,-345,1498036
13990,3410,2020-02-26,0.05219206680584551,4790,5040,250,2984825
13991,3410,2020-02-25,0.059734513274336286,4520,4790,270,1558792
13992,3410,2020-01-08,0.04291044776119403,5360,5130,-230,1603812
13993,3410,2019-12-27,0.04060913705583756,5910,5670,-240,2024909
13994,3410,2019-12-13,0.0423572744014733,5430,5660,230,1265855
13995,3410,2019-05-10,0.041666666666666664,6000,5750,-250,1727733
13996,3410,2019-03-28,0.061461794019933555,6020,6390,370,2877329
13997,3410,2019-02-28,0.05654761904761905,6720,6340,-380,2097382
13998,3410,2019-01-16,0.041050903119868636,6090,6340,250,2453523
13999,3410,2018-12-18,0.05281090289608177,5870,6180,310,3494383
14000,3410,2018-12-17,0.04552845528455285,6150,5870,-280,1458122
14001,3410,2018-12-13,0.05400696864111498,5740,6050,310,1536226
14002,3410,2018-12-03,0.04088586030664395,5870,6110,240,2650048
14003,3410,2018-11-21,0.05457746478873239,5680,5990,310,1753077
14004,3410,2018-11-19,0.04059040590405904,5420,5640,220,1990729
14005,3410,2018-11-08,0.06862745098039216,5100,5450,350,1819681
14006,3410,2018-11-02,0.05894519131334023,4835,5120,285,1973744
14007,3410,2018-10-29,0.04591836734693878,4900,4675,-225,1188330
14008,3410,2018-10-26,0.04854368932038835,5150,4900,-250,1521844
14009,3410,2018-10-23,0.04181818181818182,5500,5270,-230,965367
14010,3410,2018-10-10,0.09105431309904154,6260,5690,-570,3262006
14011,3410,2018-10-05,0.041666666666666664,6480,6210,-270,1881169
14012,3410,2018-09-21,0.06060606060606061,6270,6650,380,2609760
14013,3410,2018-09-10,0.07198748043818466,6390,6850,460,4711908
14014,3410,2018-08-28,0.07612456747404844,5780,6220,440,5393695
14015,3410,2018-08-27,0.04304635761589404,6040,5780,-260,2829552
14016,3410,2018-08-23,0.09724770642201835,5450,5980,530,6084708
14017,3410,2018-08-14,0.06261859582542695,5270,5600,330,2031029
14018,3410,2018-08-13,0.07381370826010544,5690,5270,-420,3462524
14019,3410,2018-08-10,0.09423076923076923,5200,5690,490,3598304
14020,3410,2018-07-25,0.059670781893004114,4860,5150,290,3045161
14021,3410,2018-07-24,0.05308775731310943,4615,4860,245,2598764
14022,3410,2018-07-18,0.06988188976377953,5080,4725,-355,2235070
14023,3410,2018-07-12,0.05789473684210526,5700,5370,-330,2075289
14024,3410,2018-07-02,0.05985915492957746,28400,26700,-1700,197359
14025,3410,2018-06-29,0.05185185185185185,27000,28400,1400,512834
14026,3410,2018-06-28,0.05263157894736842,28500,27000,-1500,389084
14027,3410,2018-06-27,0.051580698835274545,30050,28500,-1550,369337
14028,3410,2018-06-19,0.06932409012131716,28850,30850,2000,1094264
14029,3410,2018-06-14,0.0512396694214876,30250,28700,-1550,642276
14030,3410,2018-06-12,0.06055900621118013,32200,30250,-1950,899586
14031,3410,2018-06-11,0.045454545454545456,30800,32200,1400,567663
14032,3410,2018-06-07,0.045171339563862926,32100,30650,-1450,491749
14033,3410,2018-05-29,0.08290155440414508,38600,35400,-3200,1339442
14034,3410,2018-05-28,0.2996632996632997,29700,38600,8900,2297866
14035,3410,2018-05-25,0.08895705521472393,32600,29700,-2900,1250266
14036,3410,2018-05-16,0.09907529722589167,37850,34100,-3750,1516683
14037,3410,2018-05-14,0.13030746705710103,34150,38600,4450,1964124
14038,3410,2018-05-11,0.045941807044410414,32650,34150,1500,700909
14039,3410,2018-05-10,0.0448,31250,32650,1400,751701
14040,3410,2018-05-04,0.056105610561056105,30300,32000,1700,676279
14041,3410,2018-05-02,0.05695142378559464,29850,31550,1700,1810352
14042,3410,2018-04-30,0.19879518072289157,24900,29850,4950,2093454
14043,3410,2018-04-26,0.04979253112033195,24100,25300,1200,1151528
14044,3410,2018-04-19,0.08668076109936575,23650,25700,2050,2248527
14045,3410,2018-04-18,0.07013574660633484,22100,23650,1550,602820
14046,3410,2018-03-28,0.06,22500,23850,1350,435978
14047,3410,2018-03-16,0.0502283105022831,21900,20800,-1100,159700
14048,3410,2018-03-15,0.09226932668329177,20050,21900,1850,251945
14049,3410,2018-03-09,0.0525,20000,21050,1050,191710
14050,3410,2018-02-27,0.05037783375314862,19850,20850,1000,196831
14051,3410,2018-01-29,0.04608294930875576,21700,22700,1000,209901
14052,3410,2018-01-26,0.06633906633906633,20350,21700,1350,403567
14053,3410,2018-01-24,0.052770448548812667,18950,19950,1000,281904
14054,3410,2018-01-09,0.0425,20000,19150,-850,185590
14055,3410,2018-01-08,0.08991825613079019,18350,20000,1650,279475
14056,3410,2017-12-15,0.27009646302250806,15550,19750,4200,223263
14057,3410,2017-12-14,0.20051413881748073,19450,15550,-3900,336730
14058,3410,2017-12-08,0.044444444444444446,20250,19350,-900,151376
14059,3410,2017-11-23,0.04336734693877551,19600,20450,850,437672
14060,3410,2017-11-10,0.056,18750,19800,1050,942125
14061,3410,2017-11-09,0.056338028169014086,17750,18750,1000,563572
14062,3410,2017-11-02,0.08708708708708708,16650,18100,1450,1514987
14063,3410,2017-10-30,0.04126984126984127,15750,16400,650,739920
14064,3410,2017-10-26,0.06506849315068493,14600,15550,950,750310
14065,3410,2017-10-13,0.05747126436781609,13050,13800,750,570801
14066,3410,2017-10-12,0.0653061224489796,12250,13050,800,369559
14067,3410,2017-09-28,0.05555555555555555,12600,11900,-700,455851
14068,3410,2017-09-11,0.051094890510948905,13700,13000,-700,188076
14069,3410,2017-08-21,0.041666666666666664,13200,12650,-550,232803
14070,3410,2017-07-17,0.06859205776173286,13850,14800,950,365909
14071,3410,2017-06-26,0.041237113402061855,14550,15150,600,986836
14072,3410,2017-06-05,0.04823151125401929,15550,14800,-750,438517
14073,3410,2017-05-19,0.045454545454545456,14300,14950,650,256568
14074,3410,2017-03-28,0.04452054794520548,14600,15250,650,174064
14075,3410,2017-03-06,0.041237113402061855,14550,13950,-600,139560
14076,3410,2017-02-28,0.04983388704318937,15050,14300,-750,229410
14077,3410,2017-02-10,0.053691275167785234,14900,15700,800,180004
14078,3410,2017-01-25,0.04482758620689655,14500,13850,-650,116087
14079,3410,2017-01-10,0.050359712230215826,13900,14600,700,165140
14080,3410,2016-12-28,0.08518518518518518,13500,14650,1150,532805
14081,3410,2016-12-26,0.0726643598615917,14450,13400,-1050,611891
14082,3410,2016-12-09,0.041935483870967745,15500,14850,-650,130573
14083,3410,2016-11-11,0.04477611940298507,16750,17500,750,144119
14084,3410,2016-11-10,0.05345911949685535,15900,16750,850,109544
14085,3410,2016-11-04,0.05128205128205128,15600,16400,800,141062
14086,3410,2016-10-28,0.04093567251461988,17100,16400,-700,85681
14087,3410,2016-10-24,0.045871559633027525,16350,17100,750,95376
14088,3410,2016-10-17,0.0471976401179941,16950,16150,-800,135835
14089,3410,2016-10-13,0.042735042735042736,17550,16800,-750,103423
14090,3410,2016-09-21,0.061855670103092786,14550,15450,900,384204
14091,3410,2016-09-20,0.09345794392523364,16050,14550,-1500,664022
14092,3410,2016-09-13,0.06158357771260997,17050,16000,-1050,185893
14093,272210,2021-06-01,0.04046242774566474,17300,18000,700,1551849
14094,272210,2021-05-06,0.046511627906976744,17200,18000,800,1674487
14095,272210,2021-04-02,0.04072398190045249,22100,21200,-900,2709339
14096,272210,2021-03-31,0.09950248756218906,20100,22100,2000,12925310
14097,272210,2021-03-30,0.05789473684210526,19000,20100,1100,4325532
14098,272210,2021-03-29,0.0594059405940594,20200,19000,-1200,5615548
14099,272210,2021-03-26,0.05759162303664921,19100,20200,1100,2040897
14100,272210,2021-03-11,0.044444444444444446,18000,18800,800,1222357
14101,272210,2021-03-04,0.0475,20000,19050,-950,2295508
14102,272210,2021-02-25,0.08877284595300261,19150,20850,1700,4595933
14103,272210,2021-02-24,0.0425,20000,19150,-850,2444452
14104,272210,2021-02-23,0.045346062052505964,20950,20000,-950,2266506
14105,272210,2021-02-19,0.04318181818181818,22000,21050,-950,3606550
14106,272210,2021-02-18,0.08374384236453201,20300,22000,1700,7361577
14107,272210,2021-02-15,0.12295081967213115,18300,20550,2250,7497004
14108,272210,2021-02-09,0.04521276595744681,18800,17950,-850,1667295
14109,272210,2021-02-04,0.0653950953678474,18350,19550,1200,5391984
14110,272210,2021-02-02,0.061224489795918366,17150,18200,1050,2410765
14111,272210,2021-02-01,0.05214723926380368,16300,17150,850,1425853
14112,272210,2021-01-26,0.04054054054054054,18500,17750,-750,2317765
14113,272210,2021-01-22,0.05194805194805195,19250,18250,-1000,3402623
14114,272210,2021-01-21,0.04938271604938271,20250,19250,-1000,12776918
14115,272210,2021-01-20,0.06578947368421052,19000,20250,1250,2074762
14116,272210,2021-01-13,0.06442577030812324,17850,19000,1150,4908973
14117,272210,2020-12-28,0.11363636363636363,15400,17150,1750,6335366
14118,272210,2020-12-24,0.0657439446366782,14450,15400,950,3417379
14119,272210,2020-12-23,0.0462046204620462,15150,14450,-700,1782604
14120,272210,2020-12-21,0.08950617283950617,16200,14750,-1450,2915518
14121,272210,2020-12-16,0.060810810810810814,14800,15700,900,3937958
14122,272210,2020-12-15,0.08823529411764706,13600,14800,1200,3987479
14123,272210,2020-12-09,0.046875,12800,13400,600,2178771
14124,272210,2020-12-08,0.04065040650406504,12300,12800,500,1785608
14125,272210,2020-11-10,0.0502283105022831,10950,11500,550,1631008
14126,272210,2020-09-28,0.05188679245283019,10600,11150,550,633256
14127,272210,2020-09-22,0.05531914893617021,11750,11100,-650,1495155
14128,272210,2020-09-02,0.14601769911504425,11300,12950,1650,9743134
14129,272210,2020-08-31,0.09,10000,10900,900,2294693
14130,272210,2020-08-10,0.07729468599033816,10350,11150,800,4867467
14131,272210,2020-08-07,0.07476635514018691,9630,10350,720,2494185
14132,272210,2020-07-27,0.06086956521739131,9200,9760,560,1537385
14133,272210,2020-06-19,0.04904904904904905,9990,9500,-490,5470373
14134,272210,2020-06-17,0.0932475884244373,9330,10200,870,14239720
14135,272210,2020-06-09,0.0781078107810781,9090,9800,710,4759899
14136,272210,2020-05-29,0.05125148986889154,8390,8820,430,940440
14137,272210,2020-05-04,0.07568807339449542,8720,8060,-660,1145543
14138,272210,2020-04-24,0.06303030303030303,8250,8770,520,3395201
14139,272210,2020-04-20,0.058365758754863814,7710,8160,450,976840
14140,272210,2020-04-13,0.051047120418848166,7640,7250,-390,584264
14141,272210,2020-04-01,0.06073446327683616,7080,7510,430,1319626
14142,272210,2020-03-31,0.09428129829984544,6470,7080,610,1098021
14143,272210,2020-03-26,0.04047217537942664,5930,6170,240,1079774
14144,272210,2020-03-25,0.158203125,5120,5930,810,1103075
14145,272210,2020-03-24,0.0824524312896406,4730,5120,390,696857
14146,272210,2020-03-23,0.08155339805825243,5150,4730,-420,657949
14147,272210,2020-03-20,0.0629514963880289,4845,5150,305,603912
14148,272210,2020-03-19,0.1559233449477352,5740,4845,-895,1186417
14149,272210,2020-03-18,0.0636215334420881,6130,5740,-390,757701
14150,272210,2020-03-13,0.06451612903225806,6820,6380,-440,909665
14151,272210,2020-03-12,0.061898211829436035,7270,6820,-450,666520
14152,272210,2020-03-09,0.06699751861042183,8060,7520,-540,1006446
14153,272210,2020-02-24,0.06414300736067298,9510,8900,-610,728264
14154,272210,2020-01-09,0.06912442396313365,10850,10100,-750,2749832
14155,272210,2020-01-08,0.06896551724137931,10150,10850,700,8360503
14156,272210,2019-11-21,0.04,11250,10800,-450,1441331
14157,272210,2019-11-20,0.0546218487394958,11900,11250,-650,1859794
14158,272210,2019-11-15,0.04721030042918455,11650,12200,550,5304317
14159,272210,2019-11-14,0.04954954954954955,11100,11650,550,3649312
14160,272210,2019-11-13,0.044444444444444446,11250,11100,-150,15462185
14161,272210,2019-11-20,0.0546218487394958,11900,11250,-650,1859794
14162,272210,2019-11-15,0.04721030042918455,11650,12200,550,5304317
14163,272210,2019-11-14,0.04954954954954955,11100,11650,550,3649312
14164,272210,2019-11-13,0.044444444444444446,11250,11100,-150,15462185
14165,272210,2019-11-20,0.0546218487394958,11900,11250,-650,1859794
14166,272210,2019-11-15,0.04721030042918455,11650,12200,550,5304317
14167,272210,2019-11-14,0.04954954954954955,11100,11650,550,3649312
14168,272210,2019-11-13,0.044444444444444446,11250,11100,-150,15462185
14169,272210,2019-11-20,0.0546218487394958,11900,11250,-650,1859794
14170,272210,2019-11-15,0.04721030042918455,11650,12200,550,5304317
14171,272210,2019-11-14,0.04954954954954955,11100,11650,550,3649312
14172,272210,2019-11-13,0.044444444444444446,11250,11100,-150,15462185
14173,272210,2019-11-20,0.0546218487394958,11900,11250,-650,1859794
14174,272210,2019-11-15,0.04721030042918455,11650,12200,550,5304317
14175,272210,2019-11-14,0.04954954954954955,11100,11650,550,3649312
14176,272210,2019-11-13,0.044444444444444446,11250,11100,-150,15462185
14177,272210,2019-11-20,0.0546218487394958,11900,11250,-650,1859794
14178,272210,2019-11-15,0.04721030042918455,11650,12200,550,5304317
14179,272210,2019-11-14,0.04954954954954955,11100,11650,550,3649312
14180,272210,2019-11-13,0.044444444444444446,11250,11100,-150,15462185
14181,272210,2019-11-20,0.0546218487394958,11900,11250,-650,1859794
14182,272210,2019-11-15,0.04721030042918455,11650,12200,550,5304317
14183,272210,2019-11-14,0.04954954954954955,11100,11650,550,3649312
14184,272210,2019-11-13,0.044444444444444446,11250,11100,-150,15462185
14185,272210,2019-11-20,0.0546218487394958,11900,11250,-650,1859794
14186,272210,2019-11-15,0.04721030042918455,11650,12200,550,5304317
14187,272210,2019-11-14,0.04954954954954955,11100,11650,550,3649312
14188,272210,2019-11-13,0.044444444444444446,11250,11100,-150,15462185
14189,272210,2019-11-20,0.0546218487394958,11900,11250,-650,1859794
14190,272210,2019-11-15,0.04721030042918455,11650,12200,550,5304317
14191,272210,2019-11-14,0.04954954954954955,11100,11650,550,3649312
14192,272210,2019-11-13,0.044444444444444446,11250,11100,-150,15462185
14193,272210,2019-11-20,0.0546218487394958,11900,11250,-650,1859794
14194,272210,2019-11-15,0.04721030042918455,11650,12200,550,5304317
14195,272210,2019-11-14,0.04954954954954955,11100,11650,550,3649312
14196,272210,2019-11-13,0.044444444444444446,11250,11100,-150,15462185
14197,272210,2019-11-20,0.0546218487394958,11900,11250,-650,1859794
14198,272210,2019-11-15,0.04721030042918455,11650,12200,550,5304317
14199,272210,2019-11-14,0.04954954954954955,11100,11650,550,3649312
14200,272210,2019-11-13,0.044444444444444446,11250,11100,-150,15462185
14201,272210,2019-11-20,0.0546218487394958,11900,11250,-650,1859794
14202,272210,2019-11-15,0.04721030042918455,11650,12200,550,5304317
14203,272210,2019-11-14,0.04954954954954955,11100,11650,550,3649312
14204,272210,2019-11-13,0.044444444444444446,11250,11100,-150,15462185
14205,272210,2019-11-20,0.0546218487394958,11900,11250,-650,1859794
14206,272210,2019-11-15,0.04721030042918455,11650,12200,550,5304317
14207,272210,2019-11-14,0.04954954954954955,11100,11650,550,3649312
14208,272210,2019-11-13,0.044444444444444446,11250,11100,-150,15462185
14209,272210,2019-11-20,0.0546218487394958,11900,11250,-650,1859794
14210,272210,2019-11-15,0.04721030042918455,11650,12200,550,5304317
14211,272210,2019-11-14,0.04954954954954955,11100,11650,550,3649312
14212,272210,2019-11-13,0.044444444444444446,11250,11100,-150,15462185
14213,272210,2019-11-20,0.0546218487394958,11900,11250,-650,1859794
14214,272210,2019-11-15,0.04721030042918455,11650,12200,550,5304317
14215,272210,2019-11-14,0.04954954954954955,11100,11650,550,3649312
14216,272210,2019-11-13,0.044444444444444446,11250,11100,-150,15462185
14217,272210,2019-11-20,0.0546218487394958,11900,11250,-650,1859794
14218,272210,2019-11-15,0.04721030042918455,11650,12200,550,5304317
14219,272210,2019-11-14,0.04954954954954955,11100,11650,550,3649312
14220,272210,2019-11-13,0.044444444444444446,11250,11100,-150,15462185
14221,272210,2019-11-20,0.0546218487394958,11900,11250,-650,1859794
14222,272210,2019-11-15,0.04721030042918455,11650,12200,550,5304317
14223,272210,2019-11-14,0.04954954954954955,11100,11650,550,3649312
14224,272210,2019-11-13,0.044444444444444446,11250,11100,-150,15462185
14225,272210,2019-11-20,0.0546218487394958,11900,11250,-650,1859794
14226,272210,2019-11-15,0.04721030042918455,11650,12200,550,5304317
14227,272210,2019-11-14,0.04954954954954955,11100,11650,550,3649312
14228,272210,2019-11-13,0.044444444444444446,11250,11100,-150,15462185
14229,272210,2019-11-20,0.0546218487394958,11900,11250,-650,1859794
14230,272210,2019-11-15,0.04721030042918455,11650,12200,550,5304317
14231,272210,2019-11-14,0.04954954954954955,11100,11650,550,3649312
14232,272210,2019-11-13,0.044444444444444446,11250,11100,-150,15462185
14233,272210,2019-11-20,0.0546218487394958,11900,11250,-650,1859794
14234,272210,2019-11-15,0.04721030042918455,11650,12200,550,5304317
14235,272210,2019-11-14,0.04954954954954955,11100,11650,550,3649312
14236,272210,2019-11-13,0.044444444444444446,11250,11100,-150,15462185
14237,272210,2019-11-20,0.0546218487394958,11900,11250,-650,1859794
14238,272210,2019-11-15,0.04721030042918455,11650,12200,550,5304317
14239,272210,2019-11-14,0.04954954954954955,11100,11650,550,3649312
14240,272210,2019-11-13,0.044444444444444446,11250,11100,-150,15462185
14241,272210,2019-11-20,0.0546218487394958,11900,11250,-650,1859794
14242,272210,2019-11-15,0.04721030042918455,11650,12200,550,5304317
14243,272210,2019-11-14,0.04954954954954955,11100,11650,550,3649312
14244,272210,2019-11-13,0.044444444444444446,11250,11100,-150,15462185
14245,272210,2019-11-20,0.0546218487394958,11900,11250,-650,1859794
14246,272210,2019-11-15,0.04721030042918455,11650,12200,550,5304317
14247,272210,2019-11-14,0.04954954954954955,11100,11650,550,3649312
14248,272210,2019-11-13,0.044444444444444446,11250,11100,-150,15462185
14249,272210,2019-11-20,0.0546218487394958,11900,11250,-650,1859794
14250,272210,2019-11-15,0.04721030042918455,11650,12200,550,5304317
14251,272210,2019-11-14,0.04954954954954955,11100,11650,550,3649312
14252,272210,2019-11-13,0.044444444444444446,11250,11100,-150,15462185
14253,272210,2019-11-20,0.0546218487394958,11900,11250,-650,1859794
14254,272210,2019-11-15,0.04721030042918455,11650,12200,550,5304317
14255,272210,2019-11-14,0.04954954954954955,11100,11650,550,3649312
14256,272210,2019-11-13,0.044444444444444446,11250,11100,-150,15462185
14257,272210,2019-11-20,0.0546218487394958,11900,11250,-650,1859794
14258,272210,2019-11-15,0.04721030042918455,11650,12200,550,5304317
14259,272210,2019-11-14,0.04954954954954955,11100,11650,550,3649312
14260,272210,2019-11-13,0.044444444444444446,11250,11100,-150,15462185
14261,272210,2019-11-20,0.0546218487394958,11900,11250,-650,1859794
14262,272210,2019-11-15,0.04721030042918455,11650,12200,550,5304317
14263,272210,2019-11-14,0.04954954954954955,11100,11650,550,3649312
14264,272210,2019-11-13,0.044444444444444446,11250,11100,-150,15462185
14265,272210,2019-11-20,0.0546218487394958,11900,11250,-650,1859794
14266,272210,2019-11-15,0.04721030042918455,11650,12200,550,5304317
14267,272210,2019-11-14,0.04954954954954955,11100,11650,550,3649312
14268,272210,2019-11-13,0.044444444444444446,11250,11100,-150,15462185
14269,272210,2019-11-20,0.0546218487394958,11900,11250,-650,1859794
14270,272210,2019-11-15,0.04721030042918455,11650,12200,550,5304317
14271,272210,2019-11-14,0.04954954954954955,11100,11650,550,3649312
14272,272210,2019-11-13,0.044444444444444446,11250,11100,-150,15462185
14273,272210,2019-11-20,0.0546218487394958,11900,11250,-650,1859794
14274,272210,2019-11-15,0.04721030042918455,11650,12200,550,5304317
14275,272210,2019-11-14,0.04954954954954955,11100,11650,550,3649312
14276,272210,2019-11-13,0.044444444444444446,11250,11100,-150,15462185
14277,272210,2019-11-20,0.0546218487394958,11900,11250,-650,1859794
14278,272210,2019-11-15,0.04721030042918455,11650,12200,550,5304317
14279,272210,2019-11-14,0.04954954954954955,11100,11650,550,3649312
14280,272210,2019-11-13,0.044444444444444446,11250,11100,-150,15462185
14281,272210,2019-11-20,0.0546218487394958,11900,11250,-650,1859794
14282,272210,2019-11-15,0.04721030042918455,11650,12200,550,5304317
14283,272210,2019-11-14,0.04954954954954955,11100,11650,550,3649312
14284,272210,2019-11-13,0.044444444444444446,11250,11100,-150,15462185
14285,272210,2019-11-20,0.0546218487394958,11900,11250,-650,1859794
14286,272210,2019-11-15,0.04721030042918455,11650,12200,550,5304317
14287,272210,2019-11-14,0.04954954954954955,11100,11650,550,3649312
14288,272210,2019-11-13,0.044444444444444446,11250,11100,-150,15462185
14289,272210,2019-11-20,0.0546218487394958,11900,11250,-650,1859794
14290,272210,2019-11-15,0.04721030042918455,11650,12200,550,5304317
14291,272210,2019-11-14,0.04954954954954955,11100,11650,550,3649312
14292,272210,2019-11-13,0.044444444444444446,11250,11100,-150,15462185
14293,272210,2019-11-20,0.0546218487394958,11900,11250,-650,1859794
14294,272210,2019-11-15,0.04721030042918455,11650,12200,550,5304317
14295,272210,2019-11-14,0.04954954954954955,11100,11650,550,3649312
14296,272210,2019-11-13,0.044444444444444446,11250,11100,-150,15462185
14297,272210,2019-11-20,0.0546218487394958,11900,11250,-650,1859794
14298,272210,2019-11-15,0.04721030042918455,11650,12200,550,5304317
14299,272210,2019-11-14,0.04954954954954955,11100,11650,550,3649312
14300,272210,2019-11-13,0.044444444444444446,11250,11100,-150,15462185
14301,272210,2019-11-20,0.0546218487394958,11900,11250,-650,1859794
14302,272210,2019-11-15,0.04721030042918455,11650,12200,550,5304317
14303,272210,2019-11-14,0.04954954954954955,11100,11650,550,3649312
14304,272210,2019-11-13,0.044444444444444446,11250,11100,-150,15462185
14305,272210,2019-11-20,0.0546218487394958,11900,11250,-650,1859794
14306,272210,2019-11-15,0.04721030042918455,11650,12200,550,5304317
14307,272210,2019-11-14,0.04954954954954955,11100,11650,550,3649312
14308,272210,2019-11-13,0.044444444444444446,11250,11100,-150,15462185
14309,272210,2019-11-20,0.0546218487394958,11900,11250,-650,1859794
14310,272210,2019-11-15,0.04721030042918455,11650,12200,550,5304317
14311,272210,2019-11-14,0.04954954954954955,11100,11650,550,3649312
14312,272210,2019-11-13,0.044444444444444446,11250,11100,-150,15462185
14313,272210,2019-11-20,0.0546218487394958,11900,11250,-650,1859794
14314,272210,2019-11-15,0.04721030042918455,11650,12200,550,5304317
14315,272210,2019-11-14,0.04954954954954955,11100,11650,550,3649312
14316,272210,2019-11-13,0.044444444444444446,11250,11100,-150,15462185
14317,272210,2019-11-20,0.0546218487394958,11900,11250,-650,1859794
14318,272210,2019-11-15,0.04721030042918455,11650,12200,550,5304317
14319,272210,2019-11-14,0.04954954954954955,11100,11650,550,3649312
14320,272210,2019-11-13,0.044444444444444446,11250,11100,-150,15462185
14321,272210,2019-11-20,0.0546218487394958,11900,11250,-650,1859794
14322,272210,2019-11-15,0.04721030042918455,11650,12200,550,5304317
14323,272210,2019-11-14,0.04954954954954955,11100,11650,550,3649312
14324,272210,2019-11-13,0.044444444444444446,11250,11100,-150,15462185
14325,272210,2019-11-20,0.0546218487394958,11900,11250,-650,1859794
14326,272210,2019-11-15,0.04721030042918455,11650,12200,550,5304317
14327,272210,2019-11-14,0.04954954954954955,11100,11650,550,3649312
14328,272210,2019-11-13,0.044444444444444446,11250,11100,-150,15462185
14329,272210,2019-11-20,0.0546218487394958,11900,11250,-650,1859794
14330,272210,2019-11-15,0.04721030042918455,11650,12200,550,5304317
14331,272210,2019-11-14,0.04954954954954955,11100,11650,550,3649312
14332,272210,2019-11-13,0.044444444444444446,11250,11100,-150,15462185
14333,272210,2019-11-20,0.0546218487394958,11900,11250,-650,1859794
14334,272210,2019-11-15,0.04721030042918455,11650,12200,550,5304317
14335,272210,2019-11-14,0.04954954954954955,11100,11650,550,3649312
14336,272210,2019-11-13,0.044444444444444446,11250,11100,-150,15462185
14337,272210,2019-11-20,0.0546218487394958,11900,11250,-650,1859794
14338,272210,2019-11-15,0.04721030042918455,11650,12200,550,5304317
14339,272210,2019-11-14,0.04954954954954955,11100,11650,550,3649312
14340,272210,2019-11-13,0.044444444444444446,11250,11100,-150,15462185
14341,272210,2019-11-20,0.0546218487394958,11900,11250,-650,1859794
14342,272210,2019-11-15,0.04721030042918455,11650,12200,550,5304317
14343,272210,2019-11-14,0.04954954954954955,11100,11650,550,3649312
14344,272210,2019-11-13,0.044444444444444446,11250,11100,-150,15462185
14345,272210,2019-11-20,0.0546218487394958,11900,11250,-650,1859794
14346,272210,2019-11-15,0.04721030042918455,11650,12200,550,5304317
14347,272210,2019-11-14,0.04954954954954955,11100,11650,550,3649312
14348,272210,2019-11-13,0.044444444444444446,11250,11100,-150,15462185
14349,272210,2019-11-20,0.0546218487394958,11900,11250,-650,1859794
14350,272210,2019-11-15,0.04721030042918455,11650,12200,550,5304317
14351,272210,2019-11-14,0.04954954954954955,11100,11650,550,3649312
14352,272210,2019-11-13,0.044444444444444446,11250,11100,-150,15462185
14353,272210,2019-11-20,0.0546218487394958,11900,11250,-650,1859794
14354,272210,2019-11-15,0.04721030042918455,11650,12200,550,5304317
14355,272210,2019-11-14,0.04954954954954955,11100,11650,550,3649312
14356,272210,2019-11-13,0.044444444444444446,11250,11100,-150,15462185
14357,272210,2019-11-20,0.0546218487394958,11900,11250,-650,1859794
14358,272210,2019-11-15,0.04721030042918455,11650,12200,550,5304317
14359,272210,2019-11-14,0.04954954954954955,11100,11650,550,3649312
14360,272210,2019-11-13,0.044444444444444446,11250,11100,-150,15462185
14361,272210,2019-11-20,0.0546218487394958,11900,11250,-650,1859794
14362,272210,2019-11-15,0.04721030042918455,11650,12200,550,5304317
14363,272210,2019-11-14,0.04954954954954955,11100,11650,550,3649312
14364,272210,2019-11-13,0.044444444444444446,11250,11100,-150,15462185
14365,272210,2019-11-20,0.0546218487394958,11900,11250,-650,1859794
14366,272210,2019-11-15,0.04721030042918455,11650,12200,550,5304317
14367,272210,2019-11-14,0.04954954954954955,11100,11650,550,3649312
14368,272210,2019-11-13,0.044444444444444446,11250,11100,-150,15462185
14369,272210,2019-11-20,0.0546218487394958,11900,11250,-650,1859794
14370,272210,2019-11-15,0.04721030042918455,11650,12200,550,5304317
14371,272210,2019-11-14,0.04954954954954955,11100,11650,550,3649312
14372,272210,2019-11-13,0.044444444444444446,11250,11100,-150,15462185
14373,272210,2019-11-20,0.0546218487394958,11900,11250,-650,1859794
14374,272210,2019-11-15,0.04721030042918455,11650,12200,550,5304317
14375,272210,2019-11-14,0.04954954954954955,11100,11650,550,3649312
14376,272210,2019-11-13,0.044444444444444446,11250,11100,-150,15462185
14377,272210,2019-11-20,0.0546218487394958,11900,11250,-650,1859794
14378,272210,2019-11-15,0.04721030042918455,11650,12200,550,5304317
14379,272210,2019-11-14,0.04954954954954955,11100,11650,550,3649312
14380,272210,2019-11-13,0.044444444444444446,11250,11100,-150,15462185
14381,272210,2019-11-20,0.0546218487394958,11900,11250,-650,1859794
14382,272210,2019-11-15,0.04721030042918455,11650,12200,550,5304317
14383,272210,2019-11-14,0.04954954954954955,11100,11650,550,3649312
14384,272210,2019-11-13,0.044444444444444446,11250,11100,-150,15462185
14385,272210,2019-11-20,0.0546218487394958,11900,11250,-650,1859794
14386,272210,2019-11-15,0.04721030042918455,11650,12200,550,5304317
14387,272210,2019-11-14,0.04954954954954955,11100,11650,550,3649312
14388,272210,2019-11-13,0.044444444444444446,11250,11100,-150,15462185
14389,272210,2019-11-20,0.0546218487394958,11900,11250,-650,1859794
14390,272210,2019-11-15,0.04721030042918455,11650,12200,550,5304317
14391,272210,2019-11-14,0.04954954954954955,11100,11650,550,3649312
14392,272210,2019-11-13,0.044444444444444446,11250,11100,-150,15462185
14393,272210,2019-11-20,0.0546218487394958,11900,11250,-650,1859794
14394,272210,2019-11-15,0.04721030042918455,11650,12200,550,5304317
14395,272210,2019-11-14,0.04954954954954955,11100,11650,550,3649312
14396,272210,2019-11-13,0.044444444444444446,11250,11100,-150,15462185
14397,272210,2019-11-20,0.0546218487394958,11900,11250,-650,1859794
14398,272210,2019-11-15,0.04721030042918455,11650,12200,550,5304317
14399,272210,2019-11-14,0.04954954954954955,11100,11650,550,3649312
14400,272210,2019-11-13,0.044444444444444446,11250,11100,-150,15462185
14401,272210,2019-11-20,0.0546218487394958,11900,11250,-650,1859794
14402,272210,2019-11-15,0.04721030042918455,11650,12200,550,5304317
14403,272210,2019-11-14,0.04954954954954955,11100,11650,550,3649312
14404,272210,2019-11-13,0.044444444444444446,11250,11100,-150,15462185
14405,272210,2019-11-20,0.0546218487394958,11900,11250,-650,1859794
14406,272210,2019-11-15,0.04721030042918455,11650,12200,550,5304317
14407,272210,2019-11-14,0.04954954954954955,11100,11650,550,3649312
14408,272210,2019-11-13,0.044444444444444446,11250,11100,-150,15462185
14409,272210,2019-11-20,0.0546218487394958,11900,11250,-650,1859794
14410,272210,2019-11-15,0.04721030042918455,11650,12200,550,5304317
14411,272210,2019-11-14,0.04954954954954955,11100,11650,550,3649312
14412,272210,2019-11-13,0.044444444444444446,11250,11100,-150,15462185
14413,272210,2019-11-20,0.0546218487394958,11900,11250,-650,1859794
14414,272210,2019-11-15,0.04721030042918455,11650,12200,550,5304317
14415,272210,2019-11-14,0.04954954954954955,11100,11650,550,3649312
14416,272210,2019-11-13,0.044444444444444446,11250,11100,-150,15462185
14417,272210,2019-11-20,0.0546218487394958,11900,11250,-650,1859794
14418,272210,2019-11-15,0.04721030042918455,11650,12200,550,5304317
14419,272210,2019-11-14,0.04954954954954955,11100,11650,550,3649312
14420,272210,2019-11-13,0.044444444444444446,11250,11100,-150,15462185
14421,272210,2019-11-20,0.0546218487394958,11900,11250,-650,1859794
14422,272210,2019-11-15,0.04721030042918455,11650,12200,550,5304317
14423,272210,2019-11-14,0.04954954954954955,11100,11650,550,3649312
14424,272210,2019-11-13,0.044444444444444446,11250,11100,-150,15462185
14425,272210,2019-11-20,0.0546218487394958,11900,11250,-650,1859794
14426,272210,2019-11-15,0.04721030042918455,11650,12200,550,5304317
14427,272210,2019-11-14,0.04954954954954955,11100,11650,550,3649312
14428,272210,2019-11-13,0.044444444444444446,11250,11100,-150,15462185
14429,272210,2019-11-20,0.0546218487394958,11900,11250,-650,1859794
14430,272210,2019-11-15,0.04721030042918455,11650,12200,550,5304317
14431,272210,2019-11-14,0.04954954954954955,11100,11650,550,3649312
14432,272210,2019-11-13,0.044444444444444446,11250,11100,-150,15462185
14433,272210,2019-11-20,0.0546218487394958,11900,11250,-650,1859794
14434,272210,2019-11-15,0.04721030042918455,11650,12200,550,5304317
14435,272210,2019-11-14,0.04954954954954955,11100,11650,550,3649312
14436,272210,2019-11-13,0.044444444444444446,11250,11100,-150,15462185
14437,272210,2019-11-20,0.0546218487394958,11900,11250,-650,1859794
14438,272210,2019-11-15,0.04721030042918455,11650,12200,550,5304317
14439,272210,2019-11-14,0.04954954954954955,11100,11650,550,3649312
14440,272210,2019-11-13,0.044444444444444446,11250,11100,-150,15462185
14441,272210,2019-11-20,0.0546218487394958,11900,11250,-650,1859794
14442,272210,2019-11-15,0.04721030042918455,11650,12200,550,5304317
14443,272210,2019-11-14,0.04954954954954955,11100,11650,550,3649312
14444,272210,2019-11-13,0.044444444444444446,11250,11100,-150,15462185
14445,272210,2019-11-20,0.0546218487394958,11900,11250,-650,1859794
14446,272210,2019-11-15,0.04721030042918455,11650,12200,550,5304317
14447,272210,2019-11-14,0.04954954954954955,11100,11650,550,3649312
14448,272210,2019-11-13,0.044444444444444446,11250,11100,-150,15462185
14449,272210,2019-11-20,0.0546218487394958,11900,11250,-650,1859794
14450,272210,2019-11-15,0.04721030042918455,11650,12200,550,5304317
14451,272210,2019-11-14,0.04954954954954955,11100,11650,550,3649312
14452,272210,2019-11-13,0.044444444444444446,11250,11100,-150,15462185
14453,272210,2019-11-20,0.0546218487394958,11900,11250,-650,1859794
14454,272210,2019-11-15,0.04721030042918455,11650,12200,550,5304317
14455,272210,2019-11-14,0.04954954954954955,11100,11650,550,3649312
14456,272210,2019-11-13,0.044444444444444446,11250,11100,-150,15462185
14457,272210,2019-11-20,0.0546218487394958,11900,11250,-650,1859794
14458,272210,2019-11-15,0.04721030042918455,11650,12200,550,5304317
14459,272210,2019-11-14,0.04954954954954955,11100,11650,550,3649312
14460,272210,2019-11-13,0.044444444444444446,11250,11100,-150,15462185
14461,272210,2019-11-20,0.0546218487394958,11900,11250,-650,1859794
14462,272210,2019-11-15,0.04721030042918455,11650,12200,550,5304317
14463,272210,2019-11-14,0.04954954954954955,11100,11650,550,3649312
14464,272210,2019-11-13,0.044444444444444446,11250,11100,-150,15462185
14465,272210,2019-11-20,0.0546218487394958,11900,11250,-650,1859794
14466,272210,2019-11-15,0.04721030042918455,11650,12200,550,5304317
14467,272210,2019-11-14,0.04954954954954955,11100,11650,550,3649312
14468,272210,2019-11-13,0.044444444444444446,11250,11100,-150,15462185
14469,272210,2019-11-20,0.0546218487394958,11900,11250,-650,1859794
14470,272210,2019-11-15,0.04721030042918455,11650,12200,550,5304317
14471,272210,2019-11-14,0.04954954954954955,11100,11650,550,3649312
14472,272210,2019-11-13,0.044444444444444446,11250,11100,-150,15462185
14473,272210,2019-11-20,0.0546218487394958,11900,11250,-650,1859794
14474,272210,2019-11-15,0.04721030042918455,11650,12200,550,5304317
14475,272210,2019-11-14,0.04954954954954955,11100,11650,550,3649312
14476,272210,2019-11-13,0.044444444444444446,11250,11100,-150,15462185
14477,272210,2019-11-20,0.0546218487394958,11900,11250,-650,1859794
14478,272210,2019-11-15,0.04721030042918455,11650,12200,550,5304317
14479,272210,2019-11-14,0.04954954954954955,11100,11650,550,3649312
14480,18260,2021-03-30,0.04,187500,195000,7500,256528
14481,18260,2021-02-16,0.043478260869565216,195500,204000,8500,490477
14482,18260,2021-01-29,0.06009615384615385,208000,195500,-12500,501538
14483,18260,2021-01-27,0.04691358024691358,202500,212000,9500,520549
14484,18260,2021-01-11,0.04783599088838269,219500,209000,-10500,1085192
14485,18260,2021-01-08,0.07073170731707316,205000,219500,14500,1543681
14486,18260,2021-01-06,0.04470588235294118,212500,203000,-9500,1101423
14487,18260,2021-01-05,0.1424731182795699,186000,212500,26500,1688082
14488,18260,2021-01-04,0.04201680672268908,178500,186000,7500,542371
14489,18260,2020-10-26,0.05507246376811594,172500,182000,9500,1128886
14490,18260,2020-09-22,0.05352112676056338,177500,168000,-9500,216101
14491,18260,2020-09-09,0.06626506024096386,166000,177000,11000,952329
14492,18260,2020-09-08,0.0473186119873817,158500,166000,7500,496328
14493,18260,2020-08-20,0.04216867469879518,166000,159000,-7000,198717
14494,18260,2020-08-12,0.04229607250755287,165500,172500,7000,291858
14495,18260,2020-06-16,0.06489675516224189,169500,180500,11000,194884
14496,18260,2020-06-15,0.05307262569832402,179000,169500,-9500,258685
14497,18260,2020-05-25,0.0659025787965616,174500,186000,11500,396017
14498,18260,2020-05-07,0.09259259259259259,162000,177000,15000,742642
14499,18260,2020-04-06,0.06920415224913495,144500,154500,10000,261338
14500,18260,2020-04-01,0.056856187290969896,149500,141000,-8500,181130
14501,18260,2020-03-24,0.06569343065693431,137000,146000,9000,201754
14502,18260,2020-03-23,0.05517241379310345,145000,137000,-8000,196608
14503,18260,2020-03-20,0.04316546762589928,139000,145000,6000,243413
14504,18260,2020-03-12,0.05105105105105105,166500,158000,-8500,281229
14505,18260,2020-03-09,0.05056179775280899,178000,169000,-9000,192115
14506,18260,2020-03-04,0.058997050147492625,169500,179500,10000,217843
14507,18260,2020-02-24,0.04960835509138381,191500,182000,-9500,177689
14508,18260,2020-01-28,0.04878048780487805,205000,195000,-10000,130785
14509,18260,2019-08-05,0.045454545454545456,209000,199500,-9500,112592
14510,18260,2019-05-09,0.05176470588235294,212500,201500,-11000,169929
14511,18260,2019-01-11,0.041463414634146344,205000,213500,8500,158863
14512,18260,2018-11-29,0.07277628032345014,185500,199000,13500,259842
14513,18260,2018-11-02,0.05093833780160858,186500,196000,9500,104764
14514,18260,2018-10-26,0.06435643564356436,202000,189000,-13000,219034
14515,18260,2018-08-08,0.05827505827505827,214500,227000,12500,353202
14516,18260,2018-07-09,0.041343669250646,193500,201500,8000,140713
14517,18260,2018-06-19,0.05370843989769821,195500,206000,10500,384185
14518,18260,2018-06-15,0.1400437636761488,228500,196500,-32000,897131
14519,18260,2018-06-01,0.061611374407582936,211000,224000,13000,145063
14520,18260,2018-05-09,0.047961630695443645,208500,218500,10000,191035
14521,18260,2018-05-08,0.04576659038901602,218500,208500,-10000,265570
14522,18260,2018-05-04,0.06623931623931624,234000,218500,-15500,246681
14523,18260,2018-05-02,0.05918367346938776,245000,230500,-14500,236708
14524,18260,2018-04-20,0.05422993492407809,230500,243000,12500,230598
14525,18260,2018-03-08,0.040169133192389,236500,246000,9500,202467
14526,18260,2018-02-23,0.04791666666666667,240000,251500,11500,242628
14527,18260,2018-01-23,0.045174537987679675,243500,254500,11000,251627
14528,18260,2018-01-22,0.043222003929273084,254500,243500,-11000,330445
14529,18260,2018-01-17,0.043478260869565216,253000,264000,11000,580449
14530,18260,2018-01-08,0.09251101321585903,227000,248000,21000,686437
14531,18260,2018-01-04,0.09828009828009827,203500,223500,20000,671048
14532,18260,2017-12-21,0.04611650485436893,206000,196500,-9500,145387
14533,18260,2017-11-30,0.04568527918781726,197000,188000,-9000,188701
14534,18260,2017-10-30,0.06426735218508997,194500,207000,12500,332607
14535,18260,2017-10-20,0.045454545454545456,187000,195500,8500,307816
14536,18260,2017-10-11,0.04105571847507331,170500,177500,7000,204116
14537,18260,2017-07-26,0.08947368421052632,190000,173000,-17000,521931
14538,18260,2017-07-17,0.0410958904109589,182500,190000,7500,215559
14539,18260,2017-06-26,0.05747126436781609,174000,184000,10000,500035
14540,18260,2017-06-22,0.043478260869565216,161000,168000,7000,213951
14541,18260,2017-06-12,0.040345821325648415,173500,166500,-7000,152538
14542,18260,2017-05-19,0.05067567567567568,148000,155500,7500,303009
14543,18260,2017-04-27,0.06484641638225255,146500,137000,-9500,498807
14544,18260,2017-03-24,0.0847457627118644,147500,135000,-12500,486742
14545,18260,2017-03-14,0.050980392156862744,127500,134000,6500,359686
14546,18260,2016-12-21,0.056818181818181816,132000,139500,7500,227943
14547,18260,2016-11-24,0.042105263157894736,142500,136500,-6000,159533
14548,18260,2016-10-05,0.076158940397351,151000,162500,11500,232836
14549,18260,2016-09-29,0.08996539792387544,144500,157500,13000,274077
14550,18260,2016-08-04,0.0440251572327044,159000,166000,7000,197768
14551,14680,2021-05-14,0.04310344827586207,232000,242000,10000,47828
14552,14680,2021-05-12,0.041407867494824016,241500,231500,-10000,87759
14553,14680,2021-05-11,0.045454545454545456,253000,241500,-11500,102594
14554,14680,2021-04-01,0.07676348547717843,241000,259500,18500,117502
14555,14680,2021-03-25,0.057777777777777775,225000,238000,13000,145811
14556,14680,2021-02-25,0.04893617021276596,235000,246500,11500,73350
14557,14680,2021-02-15,0.05442176870748299,220500,232500,12000,115693
14558,14680,2021-02-05,0.0661764705882353,204000,217500,13500,129920
14559,14680,2021-01-28,0.04326923076923077,208000,199000,-9000,130532
14560,14680,2021-01-25,0.045,200000,209000,9000,120386
14561,14680,2021-01-06,0.045454545454545456,198000,189000,-9000,126614
14562,14680,2020-12-30,0.062162162162162166,185000,196500,11500,116792
14563,14680,2020-12-24,0.04843304843304843,175500,184000,8500,105717
14564,14680,2020-12-16,0.04878048780487805,164000,172000,8000,131540
14565,14680,2020-11-18,0.057971014492753624,172500,162500,-10000,138919
14566,14680,2020-11-16,0.06134969325153374,163000,173000,10000,170030
14567,14680,2020-11-13,0.05161290322580645,155000,163000,8000,155958
14568,14680,2020-11-03,0.046263345195729534,140500,147000,6500,57169
14569,14680,2020-10-26,0.0664451827242525,150500,140500,-10000,65114
14570,14680,2020-09-29,0.05653710247349823,141500,149500,8000,112537
14571,14680,2020-09-24,0.045454545454545456,143000,136500,-6500,86622
14572,14680,2020-09-21,0.04,150000,144000,-6000,73575
14573,14680,2020-08-27,0.06129032258064516,155000,164500,9500,288010
14574,14680,2020-08-24,0.04040404040404041,148500,154500,6000,228085
14575,14680,2020-08-20,0.06369426751592357,157000,147000,-10000,183823
14576,14680,2020-08-12,0.06340057636887608,173500,162500,-11000,246881
14577,14680,2020-08-07,0.05521472392638037,163000,172000,9000,214842
14578,14680,2020-08-03,0.0627062706270627,151500,161000,9500,125074
14579,14680,2020-07-24,0.045307443365695796,154500,147500,-7000,91066
14580,14680,2020-07-21,0.0625,144000,153000,9000,135004
14581,14680,2020-07-15,0.04946996466431095,141500,148500,7000,114745
14582,14680,2020-07-09,0.04980842911877394,130500,137000,6500,71654
14583,14680,2020-06-18,0.0611353711790393,114500,121500,7000,217041
14584,14680,2020-06-15,0.0759493670886076,118500,109500,-9000,93956
14585,14680,2020-06-11,0.04583333333333333,120000,114500,-5500,102088
14586,14680,2020-06-10,0.061946902654867256,113000,120000,7000,166822
14587,14680,2020-06-04,0.0502283105022831,109500,115000,5500,295431
14588,14680,2020-06-02,0.08333333333333333,102000,110500,8500,206099
14589,14680,2020-06-01,0.046153846153846156,97500,102000,4500,76507
14590,14680,2020-05-27,0.051643192488262914,106500,101000,-5500,61337
14591,14680,2020-05-26,0.04926108374384237,101500,106500,5000,63031
14592,14680,2020-05-15,0.11630558722919042,87700,97900,10200,276929
14593,14680,2020-05-08,0.06842737094837935,83300,89000,5700,84344
14594,14680,2020-05-04,0.04079254079254079,85800,82300,-3500,55687
14595,14680,2020-04-29,0.047619047619047616,81900,85800,3900,108071
14596,14680,2020-04-17,0.07872078720787208,81300,87700,6400,97219
14597,14680,2020-04-07,0.05025773195876289,77600,81500,3900,101469
14598,14680,2020-04-06,0.04723346828609987,74100,77600,3500,46888
14599,14680,2020-04-01,0.043092522179974654,78900,75500,-3400,54768
14600,14680,2020-03-31,0.040897097625329816,75800,78900,3100,54303
14601,14680,2020-03-25,0.04794520547945205,73000,76500,3500,98027
14602,14680,2020-03-24,0.047345767575322814,69700,73000,3300,88531
14603,14680,2020-03-23,0.059379217273954114,74100,69700,-4400,85191
14604,14680,2020-03-20,0.11933534743202417,66200,74100,7900,64592
14605,14680,2020-03-19,0.11733333333333333,75000,66200,-8800,124313
14606,14680,2020-03-18,0.06367041198501873,80100,75000,-5100,59036
14607,14680,2020-03-13,0.04931192660550459,87200,82900,-4300,90890
14608,14680,2020-03-12,0.041758241758241756,91000,87200,-3800,77363
14609,14680,2020-02-24,0.04251207729468599,103500,99100,-4400,120924
14610,14680,2020-01-16,0.041474654377880185,108500,113000,4500,91684
14611,14680,2019-10-11,0.040342298288508556,81800,85100,3300,71643
14612,14680,2019-07-08,0.0405727923627685,83800,80400,-3400,44037
14613,14680,2019-04-09,0.06097560975609756,82000,87000,5000,75716
14614,14680,2019-01-28,0.05672009864364982,81100,85700,4600,69329
14615,14680,2018-10-12,0.04426002766251729,72300,75500,3200,56502
14616,14680,2018-10-11,0.06589147286821706,77400,72300,-5100,89064
14617,14680,2018-08-07,0.0639386189258312,78200,83200,5000,176787
14618,14680,2018-05-23,0.04207573632538569,71300,74300,3000,139708
14619,14680,2018-04-12,0.04978038067349927,68300,71700,3400,93488
14620,14680,2018-02-21,0.08660351826792964,73900,80300,6400,259758
14621,14680,2018-02-12,0.04065040650406504,73800,76800,3000,170855
14622,14680,2018-02-08,0.055714285714285716,70000,73900,3900,247082
14623,14680,2017-11-24,0.04432855280312908,76700,80100,3400,245215
14624,14680,2017-09-07,0.042953020134228186,74500,77700,3200,161439
14625,14680,2017-07-13,0.0465444287729196,70900,74200,3300,150444
14626,14680,2017-06-16,0.04815864022662889,70600,74000,3400,176622
14627,14680,2017-04-05,0.043137254901960784,76500,79800,3300,42100
14628,14680,2017-01-02,0.04081632653061224,83300,86700,3400,91957
14629,14680,2016-12-29,0.05979643765903308,78600,83300,4700,78651
14630,14680,2016-11-04,0.043795620437956206,82200,85800,3600,57615
14631,14680,2016-10-13,0.04941176470588235,85000,80800,-4200,86197
14632,14680,2016-09-12,0.04047619047619048,84000,80600,-3400,75101
14633,14680,2016-08-30,0.046511627906976744,86000,90000,4000,105197
14634,14680,2016-08-19,0.06302021403091558,84100,89400,5300,185130
14635,14680,2016-08-09,0.09259259259259259,81000,88500,7500,213835
14636,64350,2021-05-12,0.0425531914893617,21150,20250,-900,3478199
14637,64350,2021-05-04,0.04207920792079208,20200,19350,-850,3726812
14638,64350,2021-04-21,0.04906542056074766,21400,20350,-1050,5430329
14639,64350,2021-03-12,0.04522613065326633,19900,20800,900,3604091
14640,64350,2021-02-24,0.04656862745098039,20400,19450,-950,1640361
14641,64350,2021-02-04,0.060453400503778336,19850,21050,1200,3783708
14642,64350,2021-01-21,0.0477326968973747,20950,21950,1000,4711591
14643,64350,2021-01-19,0.04522613065326633,19900,20800,900,3400442
14644,64350,2021-01-11,0.06040268456375839,22350,21000,-1350,11230469
14645,64350,2021-01-05,0.10178117048346055,19650,21650,2000,52212004
14646,64350,2021-01-04,0.14244186046511628,17200,19650,2450,21091762
14647,64350,2020-12-15,0.04923076923076923,16250,17050,800,6412828
14648,64350,2020-12-10,0.04487179487179487,15600,16300,700,5594169
14649,64350,2020-09-25,0.043333333333333335,15000,15650,650,3985539
14650,64350,2020-09-22,0.043076923076923075,16250,15550,-700,2176110
14651,64350,2020-09-21,0.04411764705882353,17000,16250,-750,2325709
14652,64350,2020-09-14,0.04776119402985075,16750,17550,800,4671578
14653,64350,2020-09-07,0.04838709677419355,15500,16250,750,5718522
14654,64350,2020-08-18,0.08359133126934984,16150,14800,-1350,3387147
14655,64350,2020-08-12,0.10833333333333334,18000,16050,-1950,10458600
14656,64350,2020-07-30,0.045584045584045586,17550,18350,800,4489560
14657,64350,2020-07-28,0.1,16000,17600,1600,16865720
14658,64350,2020-07-03,0.040372670807453416,16100,16750,650,2586105
14659,64350,2020-06-25,0.07988165680473373,16900,15550,-1350,4420102
14660,64350,2020-06-24,0.1695501730103806,14450,16900,2450,34078554
14661,64350,2020-06-17,0.056291390728476824,15100,14250,-850,1513292
14662,64350,2020-06-16,0.11851851851851852,13500,15100,1600,2317609
14663,64350,2020-06-15,0.10299003322259136,15050,13500,-1550,1536731
14664,64350,2020-06-09,0.04792332268370607,15650,14900,-750,1704327
14665,64350,2020-06-08,0.04281345565749235,16350,15650,-700,1394490
14666,64350,2020-05-15,0.047337278106508875,16900,16100,-800,1847388
14667,64350,2020-05-14,0.06111111111111111,18000,16900,-1100,2203727
14668,64350,2020-05-11,0.05405405405405406,18500,17500,-1000,1859475
14669,64350,2020-04-21,0.05604719764011799,16950,17900,950,28378145
14670,64350,2020-04-20,0.21505376344086022,13950,16950,3000,14275707
14671,64350,2020-04-16,0.136,12500,14200,1700,5625847
14672,64350,2020-04-14,0.05042016806722689,11900,12500,600,1634848
14673,64350,2020-04-07,0.041666666666666664,12000,12500,500,1764690
14674,64350,2020-04-01,0.06827309236947791,12450,11600,-850,1773579
14675,64350,2020-03-31,0.15813953488372093,10750,12450,1700,6482964
14676,64350,2020-03-25,0.08415841584158416,10100,10950,850,1278832
14677,64350,2020-03-24,0.08719052744886975,9290,10100,810,979252
14678,64350,2020-03-23,0.042268041237113405,9700,9290,-410,836533
14679,64350,2020-03-20,0.096045197740113,8850,9700,850,1394067
14680,64350,2020-03-19,0.10876132930513595,9930,8850,-1080,1620007
14681,64350,2020-03-18,0.04057971014492753,10350,9930,-420,854284
14682,64350,2020-03-13,0.07488986784140969,11350,10500,-850,2102875
14683,64350,2020-03-12,0.092,12500,11350,-1150,1295822
14684,64350,2020-03-11,0.0421455938697318,13050,12500,-550,725031
14685,64350,2020-02-24,0.058823529411764705,14450,13600,-850,847340
14686,64350,2020-02-10,0.04966887417218543,15100,15850,750,633716
14687,64350,2020-01-28,0.06832298136645963,16100,15000,-1100,958055
14688,64350,2020-01-16,0.04871060171919771,17450,16600,-850,1096929
14689,64350,2020-01-13,0.10576923076923077,15600,17250,1650,3474466
14690,64350,2020-01-09,0.07692307692307693,14300,15400,1100,694244
14691,64350,2020-01-08,0.04983388704318937,15050,14300,-750,792494
14692,64350,2019-12-18,0.042483660130718956,15300,15950,650,555849
14693,64350,2019-11-21,0.04672897196261682,16050,15300,-750,732303
14694,64350,2019-10-28,0.054285714285714284,17500,16550,-950,1022584
14695,64350,2019-10-23,0.04696132596685083,18100,17250,-850,584562
14696,64350,2019-10-21,0.043478260869565216,18400,17600,-800,516760
14697,64350,2019-10-07,0.08247422680412371,19400,17800,-1600,1288807
14698,64350,2019-09-25,0.05811138014527845,20650,19450,-1200,1046381
14699,64350,2019-09-16,0.058355437665782495,18850,19950,1100,1683927
14700,64350,2019-09-10,0.0782608695652174,17250,18600,1350,1418860
14701,64350,2019-08-19,0.0660377358490566,15900,16950,1050,650250
14702,64350,2019-08-05,0.07763975155279502,16100,14850,-1250,931951
14703,64350,2019-07-29,0.06609195402298851,17400,16250,-1150,1013290
14704,64350,2019-07-08,0.05048076923076923,20800,19750,-1050,651714
14705,64350,2019-07-03,0.05045871559633028,21800,20700,-1100,964840
14706,64350,2019-07-01,0.05938242280285035,21050,22300,1250,1471852
14707,64350,2019-06-24,0.04,21250,22100,850,889395
14708,64350,2019-06-12,0.056790123456790124,20250,21400,1150,3223226
14709,64350,2019-06-10,0.04404145077720207,19300,20150,850,771690
14710,64350,2019-05-28,0.04639175257731959,19400,20300,900,927229
14711,64350,2019-03-29,0.06164383561643835,21900,23250,1350,1547241
14712,64350,2019-03-15,0.05543237250554324,22550,21300,-1250,2406980
14713,64350,2019-03-06,0.041407867494824016,24150,23150,-1000,1732762
14714,64350,2019-03-04,0.07142857142857142,25900,24050,-1850,4811634
14715,64350,2019-02-28,0.12203389830508475,29500,25900,-3600,4488599
14716,64350,2019-02-26,0.044722719141323794,27950,29200,1250,2774389
14717,64350,2019-02-01,0.07372400756143667,26450,28400,1950,3329269
14718,64350,2019-01-29,0.04735883424408015,27450,26150,-1300,1766229
14719,64350,2019-01-14,0.04770318021201413,28300,29650,1350,2351486
14720,64350,2019-01-03,0.06355140186915888,26750,28450,1700,2698290
14721,64350,2018-12-26,0.051056338028169015,28400,26950,-1450,1892995
14722,64350,2018-12-17,0.0492091388400703,28450,27050,-1400,1514710
14723,64350,2018-12-12,0.0506108202443281,28650,27200,-1450,2568205
14724,64350,2018-12-10,0.04477611940298507,30150,28800,-1350,2254414
14725,64350,2018-12-07,0.046875,28800,30150,1350,2463205
14726,64350,2018-12-03,0.07195571955719557,27100,29050,1950,3583199
14727,64350,2018-11-19,0.05353319057815846,23350,24600,1250,1918888
14728,64350,2018-11-15,0.05393258426966292,22250,23450,1200,1257600
14729,64350,2018-11-07,0.0625,24000,22500,-1500,3366815
14730,64350,2018-11-02,0.07349665924276169,22450,24100,1650,2107592
14731,64350,2018-10-31,0.04585152838427948,22900,21850,-1050,2023114
14732,64350,2018-10-30,0.10361445783132531,20750,22900,2150,6250226
14733,64350,2018-10-29,0.07777777777777778,22500,20750,-1750,2677472
14734,64350,2018-10-26,0.08163265306122448,24500,22500,-2000,2878225
14735,64350,2018-10-24,0.04789272030651341,26100,24850,-1250,1820489
14736,64350,2018-10-22,0.05206463195691203,27850,26400,-1450,1551368
14737,64350,2018-10-11,0.06469500924214418,27050,25300,-1750,3652567
14738,64350,2018-10-10,0.14937106918238993,31800,27050,-4750,4867261
14739,64350,2018-09-21,0.06919275123558484,30350,32450,2100,6477907
14740,64350,2018-09-10,0.05423728813559322,29500,31100,1600,4359753
14741,64350,2018-09-07,0.059245960502693,27850,29500,1650,3992315
14742,64350,2018-08-27,0.11594202898550725,31050,27450,-3600,7069043
14743,64350,2018-08-17,0.041666666666666664,30000,31250,1250,3414181
14744,64350,2018-08-16,0.07142857142857142,28000,30000,2000,7890644
14745,64350,2018-08-10,0.045112781954887216,26600,27800,1200,7301917
14746,64350,2018-07-24,0.18859649122807018,22800,27100,4300,13644316
14747,64350,2018-07-23,0.04801670146137787,23950,22800,-1150,1674533
14748,64350,2018-07-18,0.056862745098039215,25500,24050,-1450,2179799
14749,64350,2018-07-11,0.07916666666666666,24000,25900,1900,5859169
14750,64350,2018-07-09,0.1017274472168906,26050,23400,-2650,3472571
14751,64350,2018-07-06,0.04408817635270541,24950,26050,1100,3657462
14752,64350,2018-07-02,0.08912655971479501,28050,25550,-2500,3464850
14753,64350,2018-06-28,0.05862068965517241,29000,27300,-1700,3692093
14754,64350,2018-06-21,0.05287713841368585,32150,30450,-1700,3202594
14755,64350,2018-06-19,0.051829268292682924,32800,31100,-1700,4483046
14756,64350,2018-06-14,0.12568306010928962,36600,32000,-4600,8252137
14757,64350,2018-06-12,0.046875,38400,36600,-1800,12616070
14758,64350,2018-06-11,0.04918032786885246,36600,38400,1800,6441650
14759,64350,2018-06-05,0.04192355117139334,40550,38850,-1700,22245556
14760,64350,2018-06-01,0.04139715394566624,38650,40250,1600,22001937
14761,64350,2018-05-29,0.06456043956043957,36400,38750,2350,15113382
14762,64350,2018-05-28,0.3,28000,36400,8400,3131890
14763,64350,2018-05-25,0.1919191919191919,34650,28000,-6650,10079385
14764,64350,2018-05-18,0.04843304843304843,35100,36800,1700,4923482
14765,64350,2018-05-16,0.1569115815691158,40150,33850,-6300,13631799
14766,64350,2018-05-14,0.16593886462882096,34350,40050,5700,4645879
14767,64350,2018-05-09,0.06951026856240126,31650,33850,2200,19345621
14768,64350,2018-05-04,0.17777777777777778,27000,31800,4800,22579694
14769,64350,2018-05-03,0.17177914110429449,32600,27000,-5600,25997078
14770,64350,2018-05-02,0.2209737827715356,26700,32600,5900,18670217
14771,64350,2018-04-30,0.29927007299270075,20550,26700,6150,11232336
14772,64350,2018-04-27,0.04314720812182741,19700,20550,850,4958797
14773,64350,2018-04-23,0.07837837837837838,18500,19950,1450,3036339
14774,64350,2018-04-04,0.0473186119873817,15850,16600,750,1004986
14775,64350,2018-03-27,0.04220779220779221,15400,16050,650,325645
14776,64350,2018-03-23,0.04126984126984127,15750,15100,-650,305683
14777,64350,2018-02-05,0.0471976401179941,16950,16150,-800,509303
14778,64350,2018-01-12,0.08288770053475936,18700,17150,-1550,4165872
14779,64350,2017-12-15,0.07222222222222222,18000,19300,1300,177340
14780,64350,2017-12-14,0.08396946564885496,19650,18000,-1650,256665
14781,64350,2017-10-30,0.07042253521126761,17750,19000,1250,482072
14782,64350,2017-09-26,0.06906906906906907,16650,17800,1150,151924
14783,64350,2017-06-20,0.04,22500,21600,-900,578347
14784,64350,2017-04-26,0.0488997555012225,20450,21450,1000,341537
14785,64350,2017-04-07,0.04275534441805225,21050,21950,900,502697
14786,64350,2017-03-07,0.04292929292929293,19800,20650,850,172283
14787,64350,2017-02-09,0.04589371980676329,20700,21650,950,387644
14788,64350,2017-02-02,0.06527415143603134,19150,20400,1250,623017
14789,64350,2016-12-02,0.059895833333333336,19200,18050,-1150,250508
14790,64350,2016-11-14,0.05141388174807198,19450,20450,1000,723810
14791,64350,2016-11-11,0.0456989247311828,18600,19450,850,323657
14792,64350,2016-11-10,0.07204610951008646,17350,18600,1250,281881
14793,64350,2016-11-07,0.059880239520958084,16700,17700,1000,147689
14794,64350,2016-11-01,0.0855614973262032,18700,17100,-1600,353273
14795,64350,2016-10-24,0.04395604395604396,18200,19000,800,276664
14796,64350,2016-10-17,0.04785894206549118,19850,18900,-950,441768
14797,64350,2016-10-14,0.043373493975903614,20750,19850,-900,284362
14798,64350,2016-09-07,0.04291845493562232,23300,22300,-1000,627695
14799,64350,2016-08-18,0.06,22500,23850,1350,1068880
14800,64350,2016-08-09,0.04009433962264151,21200,22050,850,483546
14801,330590,2020-03-23,0.0438034188034188,4680,4475,-205,945277
14802,330590,2020-03-19,0.060240963855421686,4980,4680,-300,1279344
14803,330590,2020-03-13,0.05910852713178295,5160,4855,-305,1861648
14804,330590,2020-02-28,0.0450281425891182,5330,5090,-240,1384005
14805,330590,2019-10-30,0.22865853658536586,6560,6500,-60,46404235
14806,330590,2019-10-30,0.22865853658536586,6560,6500,-60,46404235
14807,330590,2019-10-30,0.22865853658536586,6560,6500,-60,46404235
14808,330590,2019-10-30,0.22865853658536586,6560,6500,-60,46404235
14809,330590,2019-10-30,0.22865853658536586,6560,6500,-60,46404235
14810,330590,2019-10-30,0.22865853658536586,6560,6500,-60,46404235
14811,330590,2019-10-30,0.22865853658536586,6560,6500,-60,46404235
14812,330590,2019-10-30,0.22865853658536586,6560,6500,-60,46404235
14813,330590,2019-10-30,0.22865853658536586,6560,6500,-60,46404235
14814,330590,2019-10-30,0.22865853658536586,6560,6500,-60,46404235
14815,330590,2019-10-30,0.22865853658536586,6560,6500,-60,46404235
14816,330590,2019-10-30,0.22865853658536586,6560,6500,-60,46404235
14817,330590,2019-10-30,0.22865853658536586,6560,6500,-60,46404235
14818,330590,2019-10-30,0.22865853658536586,6560,6500,-60,46404235
14819,330590,2019-10-30,0.22865853658536586,6560,6500,-60,46404235
14820,330590,2019-10-30,0.22865853658536586,6560,6500,-60,46404235
14821,330590,2019-10-30,0.22865853658536586,6560,6500,-60,46404235
14822,330590,2019-10-30,0.22865853658536586,6560,6500,-60,46404235
14823,330590,2019-10-30,0.22865853658536586,6560,6500,-60,46404235
14824,330590,2019-10-30,0.22865853658536586,6560,6500,-60,46404235
14825,330590,2019-10-30,0.22865853658536586,6560,6500,-60,46404235
14826,330590,2019-10-30,0.22865853658536586,6560,6500,-60,46404235
14827,330590,2019-10-30,0.22865853658536586,6560,6500,-60,46404235
14828,330590,2019-10-30,0.22865853658536586,6560,6500,-60,46404235
14829,330590,2019-10-30,0.22865853658536586,6560,6500,-60,46404235
14830,330590,2019-10-30,0.22865853658536586,6560,6500,-60,46404235
14831,330590,2019-10-30,0.22865853658536586,6560,6500,-60,46404235
14832,330590,2019-10-30,0.22865853658536586,6560,6500,-60,46404235
14833,330590,2019-10-30,0.22865853658536586,6560,6500,-60,46404235
14834,330590,2019-10-30,0.22865853658536586,6560,6500,-60,46404235
14835,330590,2019-10-30,0.22865853658536586,6560,6500,-60,46404235
14836,330590,2019-10-30,0.22865853658536586,6560,6500,-60,46404235
14837,330590,2019-10-30,0.22865853658536586,6560,6500,-60,46404235
14838,330590,2019-10-30,0.22865853658536586,6560,6500,-60,46404235
14839,330590,2019-10-30,0.22865853658536586,6560,6500,-60,46404235
14840,330590,2019-10-30,0.22865853658536586,6560,6500,-60,46404235
14841,330590,2019-10-30,0.22865853658536586,6560,6500,-60,46404235
14842,330590,2019-10-30,0.22865853658536586,6560,6500,-60,46404235
14843,330590,2019-10-30,0.22865853658536586,6560,6500,-60,46404235
14844,330590,2019-10-30,0.22865853658536586,6560,6500,-60,46404235
14845,330590,2019-10-30,0.22865853658536586,6560,6500,-60,46404235
14846,330590,2019-10-30,0.22865853658536586,6560,6500,-60,46404235
14847,330590,2019-10-30,0.22865853658536586,6560,6500,-60,46404235
14848,330590,2019-10-30,0.22865853658536586,6560,6500,-60,46404235
14849,330590,2019-10-30,0.22865853658536586,6560,6500,-60,46404235
14850,330590,2019-10-30,0.22865853658536586,6560,6500,-60,46404235
14851,330590,2019-10-30,0.22865853658536586,6560,6500,-60,46404235
14852,330590,2019-10-30,0.22865853658536586,6560,6500,-60,46404235
14853,330590,2019-10-30,0.22865853658536586,6560,6500,-60,46404235
14854,330590,2019-10-30,0.22865853658536586,6560,6500,-60,46404235
14855,330590,2019-10-30,0.22865853658536586,6560,6500,-60,46404235
14856,330590,2019-10-30,0.22865853658536586,6560,6500,-60,46404235
14857,330590,2019-10-30,0.22865853658536586,6560,6500,-60,46404235
14858,330590,2019-10-30,0.22865853658536586,6560,6500,-60,46404235
14859,330590,2019-10-30,0.22865853658536586,6560,6500,-60,46404235
14860,330590,2019-10-30,0.22865853658536586,6560,6500,-60,46404235
14861,330590,2019-10-30,0.22865853658536586,6560,6500,-60,46404235
14862,330590,2019-10-30,0.22865853658536586,6560,6500,-60,46404235
14863,330590,2019-10-30,0.22865853658536586,6560,6500,-60,46404235
14864,330590,2019-10-30,0.22865853658536586,6560,6500,-60,46404235
14865,330590,2019-10-30,0.22865853658536586,6560,6500,-60,46404235
14866,330590,2019-10-30,0.22865853658536586,6560,6500,-60,46404235
14867,330590,2019-10-30,0.22865853658536586,6560,6500,-60,46404235
14868,330590,2019-10-30,0.22865853658536586,6560,6500,-60,46404235
14869,330590,2019-10-30,0.22865853658536586,6560,6500,-60,46404235
14870,330590,2019-10-30,0.22865853658536586,6560,6500,-60,46404235
14871,330590,2019-10-30,0.22865853658536586,6560,6500,-60,46404235
14872,330590,2019-10-30,0.22865853658536586,6560,6500,-60,46404235
14873,330590,2019-10-30,0.22865853658536586,6560,6500,-60,46404235
14874,330590,2019-10-30,0.22865853658536586,6560,6500,-60,46404235
14875,330590,2019-10-30,0.22865853658536586,6560,6500,-60,46404235
14876,330590,2019-10-30,0.22865853658536586,6560,6500,-60,46404235
14877,330590,2019-10-30,0.22865853658536586,6560,6500,-60,46404235
14878,330590,2019-10-30,0.22865853658536586,6560,6500,-60,46404235
14879,330590,2019-10-30,0.22865853658536586,6560,6500,-60,46404235
14880,330590,2019-10-30,0.22865853658536586,6560,6500,-60,46404235
14881,330590,2019-10-30,0.22865853658536586,6560,6500,-60,46404235
14882,330590,2019-10-30,0.22865853658536586,6560,6500,-60,46404235
14883,330590,2019-10-30,0.22865853658536586,6560,6500,-60,46404235
14884,302440,2021-06-03,0.05067567567567568,148000,155500,7500,544525
14885,302440,2021-05-17,0.09246575342465753,146000,159500,13500,1262922
14886,302440,2021-05-12,0.04950495049504951,151500,144000,-7500,725156
14887,302440,2021-05-11,0.06191950464396285,161500,151500,-10000,880658
14888,302440,2021-05-04,0.06020066889632107,149500,158500,9000,1322862
14889,302440,2021-04-29,0.07951070336391437,163500,150500,-13000,1864655
14890,302440,2021-04-28,0.04472843450479233,156500,163500,7000,1697376
14891,302440,2021-04-21,0.07168458781362007,139500,149500,10000,2251136
14892,302440,2021-04-19,0.06439393939393939,132000,140500,8500,3002561
14893,302440,2021-04-15,0.04059040590405904,135500,130000,-5500,854852
14894,302440,2021-04-13,0.041666666666666664,132000,137500,5500,1445824
14895,302440,2021-04-08,0.09606986899563319,114500,125500,11000,2546750
14896,302440,2021-03-31,0.04743083003952569,126500,120500,-6000,1016714
14897,302440,2021-03-29,0.06439393939393939,132000,123500,-8500,1412312
14898,302440,2021-03-22,0.13513513513513514,166500,144000,-22500,4675116
14899,302440,2021-03-18,0.2857142857142857,136500,169000,32500,876189
14900,302440,2021-03-22,0.13513513513513514,166500,144000,-22500,4675116
14901,302440,2021-03-18,0.2857142857142857,136500,169000,32500,876189
14902,302440,2021-03-22,0.13513513513513514,166500,144000,-22500,4675116
14903,302440,2021-03-18,0.2857142857142857,136500,169000,32500,876189
14904,302440,2021-03-22,0.13513513513513514,166500,144000,-22500,4675116
14905,302440,2021-03-18,0.2857142857142857,136500,169000,32500,876189
14906,302440,2021-03-22,0.13513513513513514,166500,144000,-22500,4675116
14907,302440,2021-03-18,0.2857142857142857,136500,169000,32500,876189
14908,302440,2021-03-22,0.13513513513513514,166500,144000,-22500,4675116
14909,302440,2021-03-18,0.2857142857142857,136500,169000,32500,876189
14910,302440,2021-03-22,0.13513513513513514,166500,144000,-22500,4675116
14911,302440,2021-03-18,0.2857142857142857,136500,169000,32500,876189
14912,302440,2021-03-22,0.13513513513513514,166500,144000,-22500,4675116
14913,302440,2021-03-18,0.2857142857142857,136500,169000,32500,876189
14914,302440,2021-03-22,0.13513513513513514,166500,144000,-22500,4675116
14915,302440,2021-03-18,0.2857142857142857,136500,169000,32500,876189
14916,302440,2021-03-22,0.13513513513513514,166500,144000,-22500,4675116
14917,302440,2021-03-18,0.2857142857142857,136500,169000,32500,876189
14918,302440,2021-03-22,0.13513513513513514,166500,144000,-22500,4675116
14919,302440,2021-03-18,0.2857142857142857,136500,169000,32500,876189
14920,302440,2021-03-22,0.13513513513513514,166500,144000,-22500,4675116
14921,302440,2021-03-18,0.2857142857142857,136500,169000,32500,876189
14922,302440,2021-03-22,0.13513513513513514,166500,144000,-22500,4675116
14923,302440,2021-03-18,0.2857142857142857,136500,169000,32500,876189
14924,302440,2021-03-22,0.13513513513513514,166500,144000,-22500,4675116
14925,302440,2021-03-18,0.2857142857142857,136500,169000,32500,876189
14926,302440,2021-03-22,0.13513513513513514,166500,144000,-22500,4675116
14927,302440,2021-03-18,0.2857142857142857,136500,169000,32500,876189
14928,302440,2021-03-22,0.13513513513513514,166500,144000,-22500,4675116
14929,302440,2021-03-18,0.2857142857142857,136500,169000,32500,876189
14930,302440,2021-03-22,0.13513513513513514,166500,144000,-22500,4675116
14931,302440,2021-03-18,0.2857142857142857,136500,169000,32500,876189
14932,302440,2021-03-22,0.13513513513513514,166500,144000,-22500,4675116
14933,302440,2021-03-18,0.2857142857142857,136500,169000,32500,876189
14934,302440,2021-03-22,0.13513513513513514,166500,144000,-22500,4675116
14935,302440,2021-03-18,0.2857142857142857,136500,169000,32500,876189
14936,302440,2021-03-22,0.13513513513513514,166500,144000,-22500,4675116
14937,302440,2021-03-18,0.2857142857142857,136500,169000,32500,876189
14938,302440,2021-03-22,0.13513513513513514,166500,144000,-22500,4675116
14939,302440,2021-03-18,0.2857142857142857,136500,169000,32500,876189
14940,302440,2021-03-22,0.13513513513513514,166500,144000,-22500,4675116
14941,302440,2021-03-18,0.2857142857142857,136500,169000,32500,876189
14942,302440,2021-03-22,0.13513513513513514,166500,144000,-22500,4675116
14943,302440,2021-03-18,0.2857142857142857,136500,169000,32500,876189
14944,302440,2021-03-22,0.13513513513513514,166500,144000,-22500,4675116
14945,302440,2021-03-18,0.2857142857142857,136500,169000,32500,876189
14946,302440,2021-03-22,0.13513513513513514,166500,144000,-22500,4675116
14947,302440,2021-03-18,0.2857142857142857,136500,169000,32500,876189
14948,302440,2021-03-22,0.13513513513513514,166500,144000,-22500,4675116
14949,302440,2021-03-18,0.2857142857142857,136500,169000,32500,876189
14950,302440,2021-03-22,0.13513513513513514,166500,144000,-22500,4675116
14951,302440,2021-03-18,0.2857142857142857,136500,169000,32500,876189
14952,302440,2021-03-22,0.13513513513513514,166500,144000,-22500,4675116
14953,302440,2021-03-18,0.2857142857142857,136500,169000,32500,876189
14954,302440,2021-03-22,0.13513513513513514,166500,144000,-22500,4675116
14955,302440,2021-03-18,0.2857142857142857,136500,169000,32500,876189
14956,302440,2021-03-22,0.13513513513513514,166500,144000,-22500,4675116
14957,302440,2021-03-18,0.2857142857142857,136500,169000,32500,876189
14958,302440,2021-03-22,0.13513513513513514,166500,144000,-22500,4675116
14959,302440,2021-03-18,0.2857142857142857,136500,169000,32500,876189
14960,302440,2021-03-22,0.13513513513513514,166500,144000,-22500,4675116
14961,302440,2021-03-18,0.2857142857142857,136500,169000,32500,876189
14962,302440,2021-03-22,0.13513513513513514,166500,144000,-22500,4675116
14963,302440,2021-03-18,0.2857142857142857,136500,169000,32500,876189
14964,302440,2021-03-22,0.13513513513513514,166500,144000,-22500,4675116
14965,302440,2021-03-18,0.2857142857142857,136500,169000,32500,876189
14966,302440,2021-03-22,0.13513513513513514,166500,144000,-22500,4675116
14967,302440,2021-03-18,0.2857142857142857,136500,169000,32500,876189
14968,302440,2021-03-22,0.13513513513513514,166500,144000,-22500,4675116
14969,302440,2021-03-18,0.2857142857142857,136500,169000,32500,876189
14970,302440,2021-03-22,0.13513513513513514,166500,144000,-22500,4675116
14971,302440,2021-03-18,0.2857142857142857,136500,169000,32500,876189
14972,302440,2021-03-22,0.13513513513513514,166500,144000,-22500,4675116
14973,302440,2021-03-18,0.2857142857142857,136500,169000,32500,876189
14974,302440,2021-03-22,0.13513513513513514,166500,144000,-22500,4675116
14975,302440,2021-03-18,0.2857142857142857,136500,169000,32500,876189
14976,302440,2021-03-22,0.13513513513513514,166500,144000,-22500,4675116
14977,302440,2021-03-18,0.2857142857142857,136500,169000,32500,876189
14978,302440,2021-03-22,0.13513513513513514,166500,144000,-22500,4675116
14979,302440,2021-03-18,0.2857142857142857,136500,169000,32500,876189
14980,302440,2021-03-22,0.13513513513513514,166500,144000,-22500,4675116
14981,302440,2021-03-18,0.2857142857142857,136500,169000,32500,876189
14982,302440,2021-03-22,0.13513513513513514,166500,144000,-22500,4675116
14983,302440,2021-03-18,0.2857142857142857,136500,169000,32500,876189
14984,302440,2021-03-22,0.13513513513513514,166500,144000,-22500,4675116
14985,302440,2021-03-18,0.2857142857142857,136500,169000,32500,876189
14986,302440,2021-03-22,0.13513513513513514,166500,144000,-22500,4675116
14987,302440,2021-03-18,0.2857142857142857,136500,169000,32500,876189
14988,302440,2021-03-22,0.13513513513513514,166500,144000,-22500,4675116
14989,302440,2021-03-18,0.2857142857142857,136500,169000,32500,876189
14990,302440,2021-03-22,0.13513513513513514,166500,144000,-22500,4675116
14991,302440,2021-03-18,0.2857142857142857,136500,169000,32500,876189
14992,302440,2021-03-22,0.13513513513513514,166500,144000,-22500,4675116
14993,302440,2021-03-18,0.2857142857142857,136500,169000,32500,876189
14994,302440,2021-03-22,0.13513513513513514,166500,144000,-22500,4675116
14995,302440,2021-03-18,0.2857142857142857,136500,169000,32500,876189
14996,302440,2021-03-22,0.13513513513513514,166500,144000,-22500,4675116
14997,302440,2021-03-18,0.2857142857142857,136500,169000,32500,876189
14998,302440,2021-03-22,0.13513513513513514,166500,144000,-22500,4675116
14999,302440,2021-03-18,0.2857142857142857,136500,169000,32500,876189
15000,302440,2021-03-22,0.13513513513513514,166500,144000,-22500,4675116
15001,302440,2021-03-18,0.2857142857142857,136500,169000,32500,876189
15002,302440,2021-03-22,0.13513513513513514,166500,144000,-22500,4675116
15003,302440,2021-03-18,0.2857142857142857,136500,169000,32500,876189
15004,302440,2021-03-22,0.13513513513513514,166500,144000,-22500,4675116
15005,302440,2021-03-18,0.2857142857142857,136500,169000,32500,876189
15006,302440,2021-03-22,0.13513513513513514,166500,144000,-22500,4675116
15007,302440,2021-03-18,0.2857142857142857,136500,169000,32500,876189
15008,302440,2021-03-22,0.13513513513513514,166500,144000,-22500,4675116
15009,302440,2021-03-18,0.2857142857142857,136500,169000,32500,876189
15010,302440,2021-03-22,0.13513513513513514,166500,144000,-22500,4675116
15011,302440,2021-03-18,0.2857142857142857,136500,169000,32500,876189
15012,302440,2021-03-22,0.13513513513513514,166500,144000,-22500,4675116
15013,302440,2021-03-18,0.2857142857142857,136500,169000,32500,876189
15014,302440,2021-03-22,0.13513513513513514,166500,144000,-22500,4675116
15015,302440,2021-03-18,0.2857142857142857,136500,169000,32500,876189
15016,302440,2021-03-22,0.13513513513513514,166500,144000,-22500,4675116
15017,302440,2021-03-18,0.2857142857142857,136500,169000,32500,876189
15018,302440,2021-03-22,0.13513513513513514,166500,144000,-22500,4675116
15019,302440,2021-03-18,0.2857142857142857,136500,169000,32500,876189
15020,302440,2021-03-22,0.13513513513513514,166500,144000,-22500,4675116
15021,302440,2021-03-18,0.2857142857142857,136500,169000,32500,876189
15022,302440,2021-03-22,0.13513513513513514,166500,144000,-22500,4675116
15023,302440,2021-03-18,0.2857142857142857,136500,169000,32500,876189
15024,302440,2021-03-22,0.13513513513513514,166500,144000,-22500,4675116
15025,302440,2021-03-18,0.2857142857142857,136500,169000,32500,876189
15026,302440,2021-03-22,0.13513513513513514,166500,144000,-22500,4675116
15027,302440,2021-03-18,0.2857142857142857,136500,169000,32500,876189
15028,302440,2021-03-22,0.13513513513513514,166500,144000,-22500,4675116
15029,302440,2021-03-18,0.2857142857142857,136500,169000,32500,876189
15030,302440,2021-03-22,0.13513513513513514,166500,144000,-22500,4675116
15031,302440,2021-03-18,0.2857142857142857,136500,169000,32500,876189
15032,302440,2021-03-22,0.13513513513513514,166500,144000,-22500,4675116
15033,302440,2021-03-18,0.2857142857142857,136500,169000,32500,876189
15034,302440,2021-03-22,0.13513513513513514,166500,144000,-22500,4675116
15035,302440,2021-03-18,0.2857142857142857,136500,169000,32500,876189
15036,302440,2021-03-22,0.13513513513513514,166500,144000,-22500,4675116
15037,302440,2021-03-18,0.2857142857142857,136500,169000,32500,876189
15038,302440,2021-03-22,0.13513513513513514,166500,144000,-22500,4675116
15039,302440,2021-03-18,0.2857142857142857,136500,169000,32500,876189
15040,302440,2021-03-22,0.13513513513513514,166500,144000,-22500,4675116
15041,302440,2021-03-18,0.2857142857142857,136500,169000,32500,876189
15042,302440,2021-03-22,0.13513513513513514,166500,144000,-22500,4675116
15043,302440,2021-03-18,0.2857142857142857,136500,169000,32500,876189
15044,302440,2021-03-22,0.13513513513513514,166500,144000,-22500,4675116
15045,302440,2021-03-18,0.2857142857142857,136500,169000,32500,876189
15046,302440,2021-03-22,0.13513513513513514,166500,144000,-22500,4675116
15047,302440,2021-03-18,0.2857142857142857,136500,169000,32500,876189
15048,302440,2021-03-22,0.13513513513513514,166500,144000,-22500,4675116
15049,302440,2021-03-18,0.2857142857142857,136500,169000,32500,876189
15050,302440,2021-03-22,0.13513513513513514,166500,144000,-22500,4675116
15051,302440,2021-03-18,0.2857142857142857,136500,169000,32500,876189
15052,302440,2021-03-22,0.13513513513513514,166500,144000,-22500,4675116
15053,302440,2021-03-18,0.2857142857142857,136500,169000,32500,876189
15054,302440,2021-03-22,0.13513513513513514,166500,144000,-22500,4675116
15055,302440,2021-03-18,0.2857142857142857,136500,169000,32500,876189
15056,302440,2021-03-22,0.13513513513513514,166500,144000,-22500,4675116
15057,302440,2021-03-18,0.2857142857142857,136500,169000,32500,876189
15058,302440,2021-03-22,0.13513513513513514,166500,144000,-22500,4675116
15059,302440,2021-03-18,0.2857142857142857,136500,169000,32500,876189
15060,302440,2021-03-22,0.13513513513513514,166500,144000,-22500,4675116
15061,302440,2021-03-18,0.2857142857142857,136500,169000,32500,876189
15062,302440,2021-03-22,0.13513513513513514,166500,144000,-22500,4675116
15063,302440,2021-03-18,0.2857142857142857,136500,169000,32500,876189
15064,302440,2021-03-22,0.13513513513513514,166500,144000,-22500,4675116
15065,302440,2021-03-18,0.2857142857142857,136500,169000,32500,876189
15066,302440,2021-03-22,0.13513513513513514,166500,144000,-22500,4675116
15067,302440,2021-03-18,0.2857142857142857,136500,169000,32500,876189
15068,302440,2021-03-22,0.13513513513513514,166500,144000,-22500,4675116
15069,302440,2021-03-18,0.2857142857142857,136500,169000,32500,876189
15070,302440,2021-03-22,0.13513513513513514,166500,144000,-22500,4675116
15071,302440,2021-03-18,0.2857142857142857,136500,169000,32500,876189
15072,302440,2021-03-22,0.13513513513513514,166500,144000,-22500,4675116
15073,302440,2021-03-18,0.2857142857142857,136500,169000,32500,876189
15074,302440,2021-03-22,0.13513513513513514,166500,144000,-22500,4675116
15075,302440,2021-03-18,0.2857142857142857,136500,169000,32500,876189
15076,302440,2021-03-22,0.13513513513513514,166500,144000,-22500,4675116
15077,302440,2021-03-18,0.2857142857142857,136500,169000,32500,876189
15078,302440,2021-03-22,0.13513513513513514,166500,144000,-22500,4675116
15079,302440,2021-03-18,0.2857142857142857,136500,169000,32500,876189
15080,302440,2021-03-22,0.13513513513513514,166500,144000,-22500,4675116
15081,302440,2021-03-18,0.2857142857142857,136500,169000,32500,876189
15082,302440,2021-03-22,0.13513513513513514,166500,144000,-22500,4675116
15083,302440,2021-03-18,0.2857142857142857,136500,169000,32500,876189
15084,302440,2021-03-22,0.13513513513513514,166500,144000,-22500,4675116
15085,302440,2021-03-18,0.2857142857142857,136500,169000,32500,876189
15086,302440,2021-03-22,0.13513513513513514,166500,144000,-22500,4675116
15087,302440,2021-03-18,0.2857142857142857,136500,169000,32500,876189
15088,302440,2021-03-22,0.13513513513513514,166500,144000,-22500,4675116
15089,302440,2021-03-18,0.2857142857142857,136500,169000,32500,876189
15090,302440,2021-03-22,0.13513513513513514,166500,144000,-22500,4675116
15091,302440,2021-03-18,0.2857142857142857,136500,169000,32500,876189
15092,302440,2021-03-22,0.13513513513513514,166500,144000,-22500,4675116
15093,302440,2021-03-18,0.2857142857142857,136500,169000,32500,876189
15094,302440,2021-03-22,0.13513513513513514,166500,144000,-22500,4675116
15095,302440,2021-03-18,0.2857142857142857,136500,169000,32500,876189
15096,302440,2021-03-22,0.13513513513513514,166500,144000,-22500,4675116
15097,302440,2021-03-18,0.2857142857142857,136500,169000,32500,876189
15098,302440,2021-03-22,0.13513513513513514,166500,144000,-22500,4675116
15099,302440,2021-03-18,0.2857142857142857,136500,169000,32500,876189
15100,302440,2021-03-22,0.13513513513513514,166500,144000,-22500,4675116
15101,302440,2021-03-18,0.2857142857142857,136500,169000,32500,876189
15102,302440,2021-03-22,0.13513513513513514,166500,144000,-22500,4675116
15103,302440,2021-03-18,0.2857142857142857,136500,169000,32500,876189
15104,302440,2021-03-22,0.13513513513513514,166500,144000,-22500,4675116
15105,302440,2021-03-18,0.2857142857142857,136500,169000,32500,876189
15106,302440,2021-03-22,0.13513513513513514,166500,144000,-22500,4675116
15107,302440,2021-03-18,0.2857142857142857,136500,169000,32500,876189
15108,302440,2021-03-22,0.13513513513513514,166500,144000,-22500,4675116
15109,302440,2021-03-18,0.2857142857142857,136500,169000,32500,876189
15110,302440,2021-03-22,0.13513513513513514,166500,144000,-22500,4675116
15111,302440,2021-03-18,0.2857142857142857,136500,169000,32500,876189
15112,302440,2021-03-22,0.13513513513513514,166500,144000,-22500,4675116
15113,302440,2021-03-18,0.2857142857142857,136500,169000,32500,876189
15114,302440,2021-03-22,0.13513513513513514,166500,144000,-22500,4675116
15115,302440,2021-03-18,0.2857142857142857,136500,169000,32500,876189
15116,302440,2021-03-22,0.13513513513513514,166500,144000,-22500,4675116
15117,302440,2021-03-18,0.2857142857142857,136500,169000,32500,876189
15118,302440,2021-03-22,0.13513513513513514,166500,144000,-22500,4675116
15119,302440,2021-03-18,0.2857142857142857,136500,169000,32500,876189
15120,302440,2021-03-22,0.13513513513513514,166500,144000,-22500,4675116
15121,302440,2021-03-18,0.2857142857142857,136500,169000,32500,876189
15122,302440,2021-03-22,0.13513513513513514,166500,144000,-22500,4675116
15123,302440,2021-03-18,0.2857142857142857,136500,169000,32500,876189
15124,302440,2021-03-22,0.13513513513513514,166500,144000,-22500,4675116
15125,8560,2021-05-24,0.042105263157894736,4275,4455,180,6155259
15126,8560,2021-05-17,0.13831967213114754,4880,4205,-675,16356571
15127,8560,2021-05-06,0.04371002132196162,4690,4895,205,2143595
15128,8560,2021-03-31,0.042986425339366516,4420,4610,190,4074105
15129,8560,2020-12-29,0.0743073047858942,3970,3675,-295,8987901
15130,8560,2020-11-16,0.046153846153846156,3575,3740,165,5973480
15131,8560,2020-08-20,0.06025824964131994,3485,3275,-210,4820465
15132,8560,2020-08-12,0.041968162083936326,3455,3600,145,7962588
15133,8560,2020-08-10,0.04477611940298507,3350,3500,150,5735708
15134,8560,2020-08-04,0.10737179487179487,3120,3455,335,10319453
15135,8560,2020-06-25,0.04643962848297214,3230,3080,-150,2788360
15136,8560,2020-06-16,0.04409448818897638,3175,3315,140,2692293
15137,8560,2020-06-15,0.05925925925925926,3375,3175,-200,2962443
15138,8560,2020-06-01,0.0487062404870624,3285,3445,160,2800366
15139,8560,2020-05-29,0.04505813953488372,3440,3285,-155,6007608
15140,8560,2020-05-22,0.04507042253521127,3550,3390,-160,2786246
15141,8560,2020-05-18,0.0578386605783866,3285,3475,190,4150719
15142,8560,2020-04-29,0.06168831168831169,3080,3270,190,6622479
15143,8560,2020-04-17,0.05419580419580419,2860,3015,155,4152343
15144,8560,2020-04-14,0.0427807486631016,2805,2925,120,3565629
15145,8560,2020-04-10,0.06605504587155964,2725,2905,180,6989575
15146,8560,2020-04-03,0.04954128440366973,2725,2590,-135,4515421
15147,8560,2020-04-01,0.053003533568904596,2830,2680,-150,2257775
15148,8560,2020-03-31,0.04044117647058824,2720,2830,110,3151491
15149,8560,2020-03-25,0.07939914163090128,2330,2515,185,7073877
15150,8560,2020-03-24,0.05909090909090909,2200,2330,130,4626769
15151,8560,2020-03-23,0.09465020576131687,2430,2200,-230,3098503
15152,8560,2020-03-20,0.15165876777251186,2110,2430,320,3942213
15153,8560,2020-03-19,0.2199630314232902,2705,2110,-595,6081565
15154,8560,2020-03-18,0.06884681583476764,2905,2705,-200,2713096
15155,8560,2020-03-13,0.06605222734254992,3255,3040,-215,4141093
15156,8560,2020-03-12,0.05377906976744186,3440,3255,-185,3040668
15157,8560,2020-03-09,0.04081632653061224,3675,3525,-150,2503832
15158,8560,2020-01-30,0.05730659025787966,3490,3690,200,7267035
15159,8560,2020-01-09,0.042028985507246375,3450,3595,145,2739820
15160,8560,2019-12-27,0.04187192118226601,4060,3890,-170,3427975
15161,8560,2019-12-06,0.11070998796630566,4155,3695,-460,11560659
15162,8560,2019-08-27,0.04296455424274973,4655,4855,200,3971330
15163,8560,2019-08-02,0.04028197381671702,4965,4765,-200,2116641
15164,8560,2019-07-03,0.04528985507246377,5520,5270,-250,2218799
15165,8560,2019-05-14,0.052123552123552123,5180,4910,-270,6931242
15166,8560,2019-04-01,0.062436028659160696,4885,5190,305,6123261
15167,8560,2019-03-04,0.04026115342763874,4595,4780,185,3679129
15168,8560,2019-02-07,0.04039301310043668,4580,4765,185,3593560
15169,8560,2019-01-02,0.04789719626168224,4280,4075,-205,1925868
15170,8560,2018-11-02,0.0448318804483188,4015,4195,180,3619648
15171,8560,2018-10-22,0.0457516339869281,3825,4000,175,2307997
15172,8560,2018-10-11,0.04081632653061224,3920,3760,-160,2905816
15173,8560,2018-09-11,0.04387096774193548,3875,4045,170,3034191
15174,8560,2018-07-06,0.041176470588235294,3400,3540,140,1897757
15175,8560,2018-05-11,0.04096385542168675,4150,4320,170,4358797
15176,8560,2018-05-04,0.062034739454094295,4030,4280,250,6947361
15177,8560,2018-03-23,0.04903078677309008,4385,4170,-215,3841142
15178,8560,2018-03-09,0.04161979752530934,4445,4630,185,4185108
15179,8560,2018-01-23,0.0412573673870334,5090,5300,210,2973132
15180,8560,2018-01-05,0.05333333333333334,4500,4740,240,4804181
15181,8560,2017-11-01,0.04377104377104377,4455,4650,195,3835676
15182,8560,2017-10-12,0.04938271604938271,4455,4675,220,6119652
15183,8560,2017-09-18,0.06,4500,4770,270,4055596
15184,8560,2017-08-03,0.08103130755064457,5430,4990,-440,6549390
15185,8560,2017-06-29,0.06610703043022036,4765,5080,315,13292092
15186,8560,2017-06-09,0.04673913043478261,4600,4815,215,4703146
15187,8560,2017-05-29,0.08429926238145416,4745,4345,-400,12497193
15188,8560,2017-05-11,0.04322429906542056,4280,4465,185,5501952
15189,8560,2016-12-28,0.06199460916442048,3710,3480,-230,5840903
15190,8560,2016-12-15,0.05500705218617771,3545,3740,195,7269418
15191,8560,2016-11-10,0.05829596412556054,3345,3540,195,3878064
15192,8560,2016-10-14,0.049707602339181284,3420,3590,170,9412637
15193,880,2021-05-17,0.04716981132075472,31800,30300,-1500,1434381
15194,880,2021-05-12,0.07503607503607504,34650,32050,-2600,1713437
15195,880,2021-05-10,0.07301587301587302,31500,33800,2300,1785089
15196,880,2021-05-06,0.04091653027823241,30550,31800,1250,856471
15197,880,2021-01-28,0.04843304843304843,35100,33400,-1700,918372
15198,880,2021-01-22,0.04564315352697095,36150,34500,-1650,1912550
15199,880,2021-01-21,0.15127388535031847,31400,36150,4750,5007958
15200,880,2021-01-07,0.06529209621993128,29100,31000,1900,2129955
15201,880,2020-12-24,0.04291044776119403,26800,27950,1150,1676840
15202,880,2020-11-05,0.04065040650406504,24600,25600,1000,370571
15203,880,2020-10-30,0.04183266932270916,25100,24050,-1050,416180
15204,880,2020-10-21,0.04970178926441352,25150,26400,1250,357918
15205,880,2020-10-05,0.0536779324055666,25150,26500,1350,623832
15206,880,2020-09-22,0.045627376425855515,26300,25100,-1200,785215
15207,880,2020-09-11,0.04643449419568822,30150,28750,-1400,1330831
15208,880,2020-09-04,0.09152542372881356,29500,32200,2700,5522177
15209,880,2020-09-03,0.059245960502693,27850,29500,1650,2158052
15210,880,2020-08-31,0.05363984674329502,26100,27500,1400,1615506
15211,880,2020-08-25,0.05128205128205128,25350,26650,1300,724885
15212,880,2020-08-20,0.04816955684007707,25950,24700,-1250,707860
15213,880,2020-07-29,0.0819327731092437,23800,25750,1950,4687631
15214,880,2020-07-27,0.0437636761487965,22850,23850,1000,437617
15215,880,2020-06-16,0.06904231625835189,22450,24000,1550,1372469
15216,880,2020-06-15,0.08924949290060852,24650,22450,-2200,1457992
15217,880,2020-06-11,0.06284658040665435,27050,25350,-1700,2786127
15218,880,2020-06-10,0.06563039723661486,28950,27050,-1900,4514868
15219,880,2020-06-09,0.26695842450765866,22850,28950,6100,10872062
15220,880,2020-06-08,0.07783018867924528,21200,22850,1650,2427303
15221,880,2020-05-04,0.07729468599033816,20700,19100,-1600,401661
15222,880,2020-04-29,0.06701030927835051,19400,20700,1300,576971
15223,880,2020-04-06,0.07911392405063292,15800,17050,1250,436951
15224,880,2020-03-27,0.04609929078014184,14100,14750,650,791704
15225,880,2020-03-25,0.10546875,12800,14150,1350,774346
15226,880,2020-03-24,0.06224066390041494,12050,12800,750,663746
15227,880,2020-03-23,0.12363636363636364,13750,12050,-1700,726395
15228,880,2020-03-20,0.1,12500,13750,1250,918027
15229,880,2020-03-19,0.15254237288135594,14750,12500,-2250,736924
15230,880,2020-03-18,0.0950920245398773,16300,14750,-1550,427518
15231,880,2020-03-13,0.05817174515235457,18050,17000,-1050,599635
15232,880,2020-03-12,0.06476683937823834,19300,18050,-1250,591724
15233,880,2020-02-24,0.0468384074941452,21350,20350,-1000,285066
15234,880,2020-02-06,0.05,22000,23100,1100,190156
15235,880,2020-01-28,0.05106382978723404,23500,22300,-1200,263117
15236,880,2020-01-08,0.048625792811839326,23650,22500,-1150,445810
15237,880,2020-01-06,0.04276985743380855,24550,23500,-1050,221121
15238,880,2019-10-14,0.0546218487394958,23800,25100,1300,181027
15239,880,2019-08-19,0.048723897911832945,21550,22600,1050,242186
15240,880,2018-10-26,0.05181347150259067,28950,27450,-1500,367097
15241,880,2018-10-11,0.07814992025518341,31350,28900,-2450,590394
15242,880,2018-09-27,0.05055292259083728,31650,33250,1600,537797
15243,880,2018-09-14,0.04038772213247173,30950,32200,1250,385130
15244,880,2018-08-16,0.041158536585365856,32800,31450,-1350,464174
15245,880,2018-08-03,0.06583072100313479,31900,34000,2100,1024617
15246,880,2018-07-20,0.051580698835274545,30050,31600,1550,544253
15247,880,2018-06-27,0.041033434650455926,32900,31550,-1350,389399
15248,880,2018-06-21,0.042105263157894736,33250,31850,-1400,642528
15249,880,2018-05-11,0.04187817258883249,39400,41050,1650,539986
15250,880,2018-01-05,0.06422018348623854,43600,46400,2800,1016729
15251,880,2018-01-02,0.04216867469879518,41500,43250,1750,319909
15252,880,2017-12-13,0.05063291139240506,39500,41500,2000,479003
15253,880,2017-11-13,0.05909090909090909,44000,41400,-2600,569475
15254,880,2017-10-10,0.04772727272727273,44000,46100,2100,357878
15255,880,2017-09-25,0.058315334773218146,46300,43600,-2700,544021
15256,880,2017-08-25,0.042801556420233464,51400,49200,-2200,749687
15257,880,2017-07-10,0.04189044038668099,46550,48500,1950,344556
15258,880,2017-02-24,0.04090267983074753,35450,36900,1450,809647
15259,880,2016-11-18,0.040106951871657755,37400,35900,-1500,441453
15260,880,2016-11-01,0.04551539491298527,37350,35650,-1700,568642
15261,880,2016-10-19,0.05,37000,38850,1850,905761
15262,880,2016-08-10,0.04297994269340974,34900,35450,550,483197
15263,5490,2021-05-20,0.05317769130998703,385500,365000,-20500,743678
15264,5490,2021-05-18,0.05040871934604905,367000,385500,18500,597298
15265,5490,2021-05-06,0.05046480743691899,376500,395500,19000,716999
15266,5490,2021-04-27,0.041379310344827586,362500,377500,15000,734422
15267,5490,2021-04-05,0.05023547880690738,318500,334500,16000,573076
15268,5490,2021-03-22,0.05199306759098787,288500,303500,15000,592657
15269,5490,2021-03-10,0.07413249211356467,317000,293500,-23500,2910722
15270,5490,2021-03-03,0.04912280701754386,285000,299000,14000,794021
15271,5490,2021-02-23,0.04291044776119403,268000,279500,11500,875441
15272,5490,2021-01-05,0.04395604395604396,273000,285000,12000,898657
15273,5490,2020-12-04,0.055666003976143144,251500,265500,14000,662533
15274,5490,2020-12-01,0.049145299145299144,234000,245500,11500,413073
15275,5490,2020-10-23,0.047619047619047616,210000,220000,10000,903396
15276,5490,2020-10-05,0.04591836734693878,196000,205000,9000,723156
15277,5490,2020-08-11,0.042821158690176324,198500,207000,8500,655895
15278,5490,2020-06-29,0.040983606557377046,183000,175500,-7500,371334
15279,5490,2020-06-16,0.07142857142857142,175000,187500,12500,409758
15280,5490,2020-06-15,0.06166219839142091,186500,175000,-11500,467754
15281,5490,2020-06-03,0.07142857142857142,189000,202500,13500,1148869
15282,5490,2020-05-19,0.05325443786982249,169000,178000,9000,724613
15283,5490,2020-04-10,0.08206686930091185,164500,178000,13500,977632
15284,5490,2020-03-27,0.05144694533762058,155500,163500,8000,567062
15285,5490,2020-03-25,0.10652920962199312,145500,161000,15500,581137
15286,5490,2020-03-24,0.05434782608695652,138000,145500,7500,476227
15287,5490,2020-03-23,0.04498269896193772,144500,138000,-6500,457989
15288,5490,2020-03-19,0.05423728813559322,147500,139500,-8000,645668
15289,5490,2020-03-18,0.05144694533762058,155500,147500,-8000,559707
15290,5490,2020-03-17,0.040123456790123455,162000,155500,-6500,547216
15291,5490,2020-03-16,0.05263157894736842,171000,162000,-9000,506250
15292,5490,2020-03-09,0.059895833333333336,192000,180500,-11500,551277
15293,5490,2020-02-06,0.04428904428904429,214500,224000,9500,363840
15294,5490,2020-01-28,0.060291060291060294,240500,226000,-14500,583981
15295,5490,2019-10-25,0.04484304932735426,223000,213000,-10000,627591
15296,5490,2019-09-11,0.060674157303370786,222500,236000,13500,638820
15297,5490,2019-04-01,0.0533596837944664,253000,266500,13500,383947
15298,5490,2019-02-08,0.043478260869565216,276000,264000,-12000,375634
15299,5490,2019-01-30,0.061452513966480445,268500,285000,16500,549605
15300,5490,2019-01-09,0.04073319755600815,245500,255500,10000,377323
15301,5490,2018-12-03,0.048484848484848485,247500,259500,12000,490568
15302,5490,2018-11-02,0.059961315280464215,258500,274000,15500,357961
15303,5490,2018-10-11,0.05514705882352941,272000,257000,-15000,462524
15304,5490,2018-10-04,0.0663265306122449,294000,274500,-19500,694978
15305,5490,2018-07-02,0.0425531914893617,329000,315000,-14000,241273
15306,5490,2018-06-19,0.0449438202247191,356000,340000,-16000,299004
15307,5490,2018-06-07,0.04397163120567376,352500,368000,15500,268336
15308,5490,2018-04-30,0.06125356125356125,351000,372500,21500,357719
15309,5490,2018-04-18,0.04954954954954955,333000,349500,16500,461637
15310,5490,2018-03-27,0.053353658536585365,328000,345500,17500,368550
15311,5490,2018-03-23,0.055800293685756244,340500,321500,-19000,450499
15312,5490,2018-02-28,0.04491413474240423,378500,361500,-17000,285527
15313,5490,2018-01-12,0.054570259208731244,366500,386500,20000,295131
15314,5490,2018-01-03,0.05457227138643068,339000,357500,18500,485812
15315,5490,2017-10-16,0.05846153846153846,325000,344000,19000,508392
15316,5490,2017-08-17,0.04709576138147567,318500,333500,15000,229886
15317,5490,2017-08-11,0.04804804804804805,333000,317000,-16000,553833
15318,5490,2017-05-22,0.049723756906077346,271500,285000,13500,627805
15319,5490,2017-03-22,0.042662116040955635,293000,280500,-12500,533901
15320,5490,2017-03-16,0.05045045045045045,277500,291500,14000,499310
15321,5490,2017-02-24,0.0410958904109589,292000,280000,-12000,479758
15322,5490,2017-01-11,0.0781563126252505,249500,269000,19500,766951
15323,5490,2016-12-13,0.05132743362831858,282500,268000,-14500,627382
15324,5490,2016-12-08,0.060836501901140684,263000,279000,16000,764667
15325,5490,2016-11-10,0.06695464362850972,231500,247000,15500,668966
15326,5490,2016-11-09,0.04536082474226804,242500,231500,-11000,592440
15327,139130,2021-05-06,0.06,8500,9010,510,1879656
15328,139130,2021-04-30,0.043580683156654886,8490,8860,370,3227547
15329,139130,2021-03-23,0.04745762711864407,8850,8430,-420,1797224
15330,139130,2021-03-19,0.06539833531510107,8410,8960,550,5363846
15331,139130,2021-03-15,0.05590851334180432,7870,8310,440,2077296
15332,139130,2021-03-08,0.04654255319148936,7520,7870,350,2349717
15333,139130,2021-03-04,0.04120879120879121,7280,7580,300,2319457
15334,139130,2021-02-05,0.0409711684370258,6590,6860,270,1102918
15335,139130,2021-01-29,0.04066265060240964,6640,6370,-270,737750
15336,139130,2021-01-07,0.058823529411764705,6800,7200,400,1870252
15337,139130,2020-12-29,0.04986149584487535,7220,6860,-360,1101081
15338,139130,2020-12-11,0.05234159779614325,7260,7640,380,1651862
15339,139130,2020-11-11,0.04372355430183357,7090,7400,310,1775511
15340,139130,2020-11-03,0.042042042042042045,6660,6940,280,1613055
15341,139130,2020-11-02,0.07766990291262135,6180,6660,480,1372816
15342,139130,2020-10-30,0.04776579352850539,6490,6180,-310,1679379
15343,139130,2020-10-27,0.04499274310595065,6890,6580,-310,1972748
15344,139130,2020-10-22,0.0438871473354232,6380,6660,280,2906165
15345,139130,2020-10-08,0.04070796460176991,5650,5880,230,1797206
15346,139130,2020-08-18,0.04129263913824058,5570,5340,-230,995976
15347,139130,2020-08-11,0.046296296296296294,5400,5650,250,2270811
15348,139130,2020-06-16,0.06042884990253411,5130,5440,310,1180305
15349,139130,2020-06-03,0.04634581105169341,5610,5870,260,2429411
15350,139130,2020-05-19,0.05951115834218916,4705,4985,280,1409967
15351,139130,2020-04-28,0.046747967479674794,4920,5150,230,2610130
15352,139130,2020-04-27,0.04680851063829787,4700,4920,220,1695570
15353,139130,2020-04-10,0.06528835690968444,4595,4895,300,2007990
15354,139130,2020-04-01,0.04139433551198257,4590,4400,-190,1491399
15355,139130,2020-03-31,0.0625,4320,4590,270,1295413
15356,139130,2020-03-27,0.05328376703841388,4035,4250,215,1968366
15357,139130,2020-03-25,0.11479944674965421,3615,4030,415,2073464
15358,139130,2020-03-24,0.05701754385964912,3420,3615,195,1110315
15359,139130,2020-03-23,0.08064516129032258,3720,3420,-300,1175158
15360,139130,2020-03-20,0.06896551724137931,3480,3720,240,2186265
15361,139130,2020-03-19,0.09256844850065189,3835,3480,-355,2047585
15362,139130,2020-03-18,0.04838709677419355,4030,3835,-195,2119167
15363,139130,2020-03-17,0.07990867579908675,4380,4030,-350,2464448
15364,139130,2020-03-12,0.06719367588932806,5060,4720,-340,2857946
15365,139130,2020-03-09,0.04339622641509434,5300,5070,-230,1418969
15366,139130,2020-02-28,0.041025641025641026,5850,5610,-240,1256864
15367,139130,2020-02-24,0.04508856682769726,6210,5930,-280,1177269
15368,139130,2019-12-27,0.04155495978552279,7460,7150,-310,1135851
15369,139130,2018-08-01,0.057754010695187166,9350,9890,540,1905821
15370,139130,2018-03-14,0.04032258064516129,12400,11900,-500,732955
15371,139130,2018-02-19,0.04741379310344827,11600,12150,550,483411
15372,139130,2018-02-06,0.04182509505703422,13150,12600,-550,1728882
15373,139130,2018-02-05,0.04780876494023904,12550,13150,600,2275021
15374,139130,2017-11-09,0.045871559633027525,9810,9360,-450,1994853
15375,139130,2017-09-05,0.06880733944954129,10900,10150,-750,1211131
15376,139130,2017-06-21,0.04184100418410042,11950,11450,-500,1159669
15377,139130,2017-03-20,0.0425531914893617,11750,11250,-500,647001
15378,139130,2017-02-01,0.0486322188449848,9870,10350,480,980260
15379,69500,2021-01-08,0.04424460431654676,41700,43545,1845,11521190
15380,69500,2020-06-16,0.06142322097378277,26700,28340,1640,13674388
15381,69500,2020-06-15,0.050329005868753336,28115,26700,-1415,19839278
15382,69500,2020-04-01,0.04691716836205107,24085,22955,-1130,18755243
15383,69500,2020-03-25,0.057314897413024084,22420,23705,1285,35369755
15384,69500,2020-03-24,0.09285888374360224,20515,22420,1905,19045947
15385,69500,2020-03-23,0.05872906629961,21795,20515,-1280,22468822
15386,69500,2020-03-20,0.07682806324110672,20240,21795,1555,40017034
15387,69500,2020-03-19,0.07326007326007326,21840,20240,-1600,58833336
15388,69500,2020-03-18,0.05495456512332324,23110,21840,-1270,28297687
15389,69500,2020-03-09,0.04214490674318508,27880,26705,-1175,14239886
15390,69500,2018-10-11,0.04132803043403078,28915,27720,-1195,11753699
15391,10620,2021-06-01,0.05555555555555555,84600,89300,4700,800614
15392,10620,2021-05-27,0.06696428571428571,89600,83600,-6000,1215693
15393,10620,2021-05-20,0.04898828541001065,93900,89300,-4600,702904
15394,10620,2021-05-06,0.10108303249097472,83100,91500,8400,941305
15395,10620,2021-04-30,0.0929936305732484,78500,85800,7300,1963381
15396,10620,2021-04-29,0.043882978723404256,75200,78500,3300,688625
15397,10620,2021-04-26,0.09281437125748503,66800,73000,6200,1010620
15398,10620,2021-04-01,0.04035874439461883,66900,64200,-2700,451189
15399,10620,2021-03-26,0.10207612456747404,57800,63700,5900,1384604
15400,10620,2021-03-15,0.04786324786324787,58500,61300,2800,955978
15401,10620,2021-03-09,0.06934306569343066,54800,58600,3800,1217717
15402,10620,2021-03-08,0.04980842911877394,52200,54800,2600,925264
15403,10620,2021-02-15,0.052525252525252523,49500,52100,2600,686831
15404,10620,2021-02-08,0.05844845908607864,47050,49800,2750,993103
15405,10620,2021-02-01,0.07540603248259861,43100,46350,3250,506609
15406,10620,2021-01-28,0.042116630669546434,46300,44350,-1950,477327
15407,10620,2021-01-18,0.04091816367265469,50100,48050,-2050,554307
15408,10620,2021-01-15,0.040229885057471264,52200,50100,-2100,561764
15409,10620,2021-01-05,0.11502590673575129,48250,53800,5550,2122234
15410,10620,2020-12-11,0.08307045215562565,47550,51500,3950,1211662
15411,10620,2020-11-25,0.05274725274725275,45500,47900,2400,1426590
15412,10620,2020-11-23,0.0743801652892562,42350,45500,3150,1938097
15413,10620,2020-11-20,0.07898089171974522,39250,42350,3100,1077882
15414,10620,2020-11-19,0.0438489646772229,41050,39250,-1800,1223764
15415,10620,2020-11-16,0.10192837465564739,36300,40000,3700,1517480
15416,10620,2020-11-09,0.1309328968903437,30550,34550,4000,1599622
15417,10620,2020-10-26,0.05410122164048865,28650,30200,1550,454633
15418,10620,2020-08-18,0.06259314456035768,33550,31450,-2100,313147
15419,10620,2020-07-21,0.0473186119873817,31700,33200,1500,320929
15420,10620,2020-06-16,0.07936507936507936,31500,34000,2500,200505
15421,10620,2020-06-15,0.08563134978229318,34450,31500,-2950,385992
15422,10620,2020-06-12,0.0496551724137931,36250,34450,-1800,383413
15423,10620,2020-06-03,0.07132867132867132,35750,38300,2550,1188427
15424,10620,2020-05-27,0.1166936790923825,30850,34450,3600,1808199
15425,10620,2020-05-19,0.04152249134948097,28900,30100,1200,424125
15426,10620,2020-05-06,0.04208754208754209,29700,30950,1250,388023
15427,10620,2020-04-29,0.0658578856152513,28850,30750,1900,690246
15428,10620,2020-04-24,0.04132231404958678,30250,29000,-1250,306384
15429,10620,2020-04-23,0.04310344827586207,29000,30250,1250,497137
15430,10620,2020-04-21,0.044189852700491,30550,29200,-1350,423547
15431,10620,2020-04-13,0.04451510333863275,31450,30050,-1400,164053
15432,10620,2020-04-06,0.0456140350877193,28500,29800,1300,242399
15433,10620,2020-04-02,0.04331450094161959,26550,27700,1150,381097
15434,10620,2020-03-31,0.04633204633204633,25900,27100,1200,260914
15435,10620,2020-03-25,0.14888888888888888,22500,25850,3350,501072
15436,10620,2020-03-24,0.058823529411764705,21250,22500,1250,316028
15437,10620,2020-03-23,0.07608695652173914,23000,21250,-1750,207105
15438,10620,2020-03-20,0.12195121951219512,20500,23000,2500,368445
15439,10620,2020-03-19,0.18163672654690619,25050,20500,-4550,596172
15440,10620,2020-03-18,0.0600375234521576,26650,25050,-1600,288182
15441,10620,2020-03-13,0.08237232289950576,30350,27850,-2500,504342
15442,10620,2020-03-12,0.07750759878419453,32900,30350,-2550,344530
15443,10620,2020-03-09,0.10136986301369863,36500,32800,-3700,669264
15444,10620,2020-02-24,0.05477707006369427,39250,37100,-2150,242099
15445,10620,2020-02-06,0.0845771144278607,40200,43600,3400,444664
15446,10620,2020-01-28,0.045104510451045104,45450,43400,-2050,199072
15447,10620,2020-01-10,0.075,44000,47300,3300,436458
15448,10620,2020-01-09,0.05137395459976105,41850,44000,2150,201308
15449,10620,2020-01-08,0.05102040816326531,44100,41850,-2250,238641
15450,10620,2019-11-25,0.04228855721393035,40200,41900,1700,156233
15451,10620,2019-10-30,0.04111111111111111,45000,43150,-1850,210145
15452,10620,2019-10-08,0.06864988558352403,43700,46700,3000,323891
15453,10620,2019-09-09,0.05737704918032787,42700,45150,2450,367805
15454,10620,2019-08-26,0.041463414634146344,41000,39300,-1700,171878
15455,10620,2019-08-19,0.06737120211360634,37850,40400,2550,291652
15456,10620,2019-08-06,0.041025641025641026,39000,37400,-1600,582419
15457,10620,2019-08-02,0.04363207547169811,42400,40550,-1850,309906
15458,10620,2019-07-26,0.055745164960182024,43950,41500,-2450,457641
15459,10620,2019-07-25,0.052801724137931036,46400,43950,-2450,448955
15460,10620,2019-07-09,0.048625792811839326,47300,45000,-2300,309133
15461,10620,2019-06-12,0.046370967741935484,49600,51900,2300,237227
15462,10620,2019-05-09,0.045787545787545784,54600,52100,-2500,268230
15463,10620,2019-03-26,0.048561151079136694,55600,58300,2700,254572
15464,10620,2019-02-01,0.05573248407643312,62800,59300,-3500,1014744
15465,10620,2019-01-31,0.049924357034795766,66100,62800,-3300,1041953
15466,10620,2018-12-26,0.05057096247960848,61300,58200,-3100,563442
15467,10620,2018-12-24,0.0421875,64000,61300,-2700,201328
15468,10620,2018-12-13,0.05718954248366013,61200,64700,3500,481322
15469,10620,2018-12-12,0.04081632653061224,58800,61200,2400,288977
15470,10620,2018-11-16,0.08673469387755102,98000,106500,8500,384572
15471,10620,2018-11-06,0.054945054945054944,91000,96000,5000,228848
15472,10620,2018-11-01,0.07234042553191489,94000,87200,-6800,366471
15473,10620,2018-10-01,0.043478260869565216,103500,108000,4500,218904
15474,10620,2018-09-27,0.057494866529774126,97400,103000,5600,317043
15475,10620,2018-08-28,0.050793650793650794,94500,99300,4800,350826
15476,10620,2018-08-22,0.043907793633369926,91100,95100,4000,393856
15477,10620,2018-08-16,0.05100956429330499,94100,89300,-4800,194941
15478,10620,2018-07-25,0.04161849710982659,86500,90100,3600,270260
15479,10620,2018-07-23,0.05198019801980198,80800,85000,4200,209602
15480,10620,2018-07-11,0.056712962962962965,86400,81500,-4900,325252
15481,10620,2018-06-22,0.04778972520908005,83700,87700,4000,177411
15482,10620,2018-06-18,0.05027932960893855,89500,85000,-4500,272050
15483,10620,2018-06-14,0.04229934924078091,92200,88300,-3900,218298
15484,10620,2018-05-28,0.04145077720207254,96500,92500,-4000,256105
15485,10620,2018-05-04,0.053180396246089674,95900,101000,5100,539266
15486,10620,2018-05-03,0.04125950054288816,92100,95900,3800,272774
15487,10620,2018-04-26,0.10589651022864019,83100,91900,8800,477375
15488,10620,2018-04-05,0.05621621621621622,92500,97700,5200,223312
15489,10620,2018-04-02,0.046,100000,95400,-4600,256506
15490,10620,2018-03-21,0.04225352112676056,106500,111000,4500,174403
15491,10620,2018-03-14,0.05309734513274336,113000,107000,-6000,233925
15492,10620,2018-03-12,0.06542056074766354,107000,114000,7000,205453
15493,10620,2018-03-06,0.05365853658536585,102500,108000,5500,146919
15494,10620,2018-02-23,0.0594059405940594,101000,107000,6000,121787
15495,10620,2018-02-13,0.04251207729468599,103500,99100,-4400,137769
15496,10620,2018-02-07,0.06511627906976744,107500,100500,-7000,120823
15497,10620,2018-02-05,0.061946902654867256,113000,106000,-7000,151966
15498,10620,2018-01-23,0.04878048780487805,102500,107500,5000,165063
15499,10620,2018-01-10,0.056485355648535567,95600,101000,5400,359789
15500,10620,2018-01-08,0.05444444444444444,90000,94900,4900,202052
15501,10620,2018-01-02,0.09275730622617535,78700,86000,7300,291435
15502,10620,2017-12-27,0.16181229773462782,92700,77700,-15000,861842
15503,10620,2017-12-13,0.049493813273340834,88900,93300,4400,184651
15504,10620,2017-12-08,0.06500541711809317,92300,86300,-6000,339655
15505,10620,2017-12-06,0.04048582995951417,98800,94800,-4000,340908
15506,10620,2017-12-05,0.07158351409978309,92200,98800,6600,398332
15507,10620,2017-11-13,0.08571428571428572,105000,96000,-9000,728917
15508,10620,2017-11-10,0.05405405405405406,111000,105000,-6000,504896
15509,10620,2017-10-31,0.07425742574257425,101000,108500,7500,518705
15510,10620,2017-10-16,0.04855371900826446,96800,101500,4700,220465
15511,10620,2017-09-26,0.05005440696409141,91900,96500,4600,150294
15512,10620,2017-09-22,0.04365482233502538,98500,94200,-4300,157635
15513,10620,2017-09-19,0.07368421052631578,95000,102000,7000,293935
15514,10620,2017-09-15,0.05537459283387622,92100,97200,5100,158490
15515,10620,2017-09-12,0.04480874316939891,91500,95600,4100,144172
15516,10620,2017-08-25,0.05555555555555555,99000,104500,5500,211969
15517,10620,2017-08-01,0.05581395348837209,107500,113500,6000,212601
15518,10620,2017-07-21,0.04225352112676056,106500,111000,4500,236296
15519,10620,2017-07-11,0.0430622009569378,104500,100000,-4500,225568
15520,10620,2017-06-29,0.04854368932038835,103000,108000,5000,274002
15521,10620,2017-06-26,0.053811659192825115,111500,105500,-6000,341794
15522,10620,2017-06-14,0.061946902654867256,113000,120000,7000,476013
15523,10620,2017-06-13,0.06103286384976526,106500,113000,6500,302439
15524,10620,2017-06-09,0.05472636815920398,100500,106000,5500,276914
15525,10620,2017-05-25,0.05720122574055159,97900,103500,5600,451047
15526,10620,2017-04-26,0.06939704209328783,87900,94000,6100,415300
15527,10620,2017-04-24,0.052318668252080855,84100,88500,4400,246269
15528,10620,2017-04-13,0.043173862310385065,85700,82000,-3700,287118
15529,10620,2017-03-23,0.07314148681055156,83400,89500,6100,479256
15530,10620,2017-03-16,0.06788511749347259,76600,81800,5200,491718
15531,10620,2017-03-07,0.05517241379310345,72500,76500,4000,512313
15532,10620,2017-02-28,0.07038123167155426,68200,73000,4800,585888
15533,10620,2017-02-21,0.05647840531561462,60200,63600,3400,329349
15534,10620,2017-01-04,0.04093567251461988,68400,65600,-2800,185081
15535,10620,2016-12-12,0.041979010494752625,66700,69500,2800,241451
15536,10620,2016-11-22,0.06,70000,65800,-4200,392919
15537,10620,2016-11-16,0.04888888888888889,67500,70800,3300,524724
15538,10620,2016-11-10,0.04313099041533546,62600,65300,2700,120291
15539,10620,2016-11-09,0.04573170731707317,65600,62600,-3000,291471
15540,10620,2016-11-07,0.048286604361370715,64200,67300,3100,127049
15541,10620,2016-11-01,0.05405405405405406,70300,66500,-3800,328489
15542,10620,2016-10-26,0.06835443037974684,79000,73600,-5400,299495
15543,10620,2016-10-07,0.0534045393858478,74900,78900,4000,279235
15544,10620,2016-09-12,0.059366754617414245,75800,71300,-4500,234321
15545,10620,2016-08-22,0.054678007290400975,82300,77800,-4500,191297
15546,10620,2016-08-04,0.04665071770334928,83600,79700,-3900,155637
15547,4990,2021-05-31,0.06770833333333333,38400,41000,2600,1504539
15548,4990,2021-05-10,0.09423347398030943,35550,38900,3350,1611068
15549,4990,2021-05-03,0.050546448087431695,36600,34750,-1850,790617
15550,4990,2021-01-29,0.04277286135693215,33900,32450,-1450,364026
15551,4990,2021-01-18,0.04395604395604396,36400,34800,-1600,401138
15552,4990,2021-01-11,0.047106325706594884,37150,35400,-1750,583291
15553,4990,2020-11-11,0.07317073170731707,30750,33000,2250,810692
15554,4990,2020-08-18,0.07324364723467862,33450,31000,-2450,408673
15555,4990,2020-07-23,0.054313099041533544,31300,33000,1700,2314217
15556,4990,2020-06-23,0.04588394062078273,37050,35350,-1700,1360984
15557,4990,2020-06-22,0.05706134094151213,35050,37050,2000,1213814
15558,4990,2020-06-16,0.07272727272727272,33000,35400,2400,337718
15559,4990,2020-06-15,0.05172413793103448,34800,33000,-1800,647255
15560,4990,2020-05-22,0.04161073825503356,37250,35700,-1550,490690
15561,4990,2020-05-14,0.04133333333333333,37500,35950,-1550,963014
15562,4990,2020-04-29,0.07506702412868632,37300,40100,2800,20172140
15563,4990,2020-04-28,0.29965156794425085,28700,37300,8600,6209735
15564,4990,2020-04-27,0.0830188679245283,26500,28700,2200,399661
15565,4990,2020-03-25,0.09009009009009009,22200,24200,2000,359348
15566,4990,2020-03-24,0.052132701421800945,21100,22200,1100,288322
15567,4990,2020-03-20,0.051597051597051594,20350,21400,1050,338433
15568,4990,2020-03-19,0.09151785714285714,22400,20350,-2050,297873
15569,4990,2020-03-18,0.052854122621564484,23650,22400,-1250,238157
15570,4990,2020-03-17,0.050200803212851405,24900,23650,-1250,258102
15571,4990,2020-03-13,0.055248618784530384,27150,25650,-1500,469101
15572,4990,2020-03-12,0.06540447504302926,29050,27150,-1900,310050
15573,4990,2020-01-23,0.05994550408719346,36700,38900,2200,760040
15574,4990,2020-01-20,0.05742296918767507,35700,37750,2050,2999304
15575,4990,2019-08-19,0.053691275167785234,29800,31400,1600,183367
15576,4990,2019-08-05,0.06083086053412463,33700,31650,-2050,328855
15577,4990,2019-07-08,0.0496054114994363,44350,42150,-2200,181917
15578,4990,2019-01-02,0.05218216318785579,52700,49950,-2750,161549
15579,4990,2018-11-19,0.04734848484848485,52800,55300,2500,308885
15580,4990,2018-11-15,0.051587301587301584,50400,53000,2600,151306
15581,4990,2018-11-02,0.04266389177939646,48050,50100,2050,176327
15582,4990,2018-10-18,0.04007285974499089,54900,52700,-2200,297278
15583,4990,2018-09-28,0.047706422018348627,54500,57100,2600,333643
15584,4990,2018-09-21,0.045889101338432124,52300,54700,2400,282980
15585,4990,2018-09-13,0.06732673267326733,50500,53900,3400,521389
15586,4990,2018-09-11,0.060291060291060294,48100,51000,2900,453369
15587,4990,2018-07-17,0.05458089668615984,51300,54100,2800,325410
15588,4990,2018-07-04,0.04363636363636364,55000,52600,-2400,207353
15589,4990,2018-04-09,0.05571847507331378,68200,64400,-3800,490368
15590,4990,2018-04-02,0.048818897637795275,63500,66600,3100,333728
15591,4990,2018-02-14,0.060240963855421686,66400,62400,-4000,574852
15592,4990,2018-01-03,0.059541984732824425,65500,69400,3900,846812
15593,4990,2017-12-26,0.05815831987075929,61900,65500,3600,790010
15594,4990,2017-11-22,0.054009819967266774,61100,64400,3300,1906318
15595,4990,2017-11-02,0.057692307692307696,72800,68600,-4200,1329562
15596,4990,2017-10-31,0.05823863636363636,70400,74500,4100,3165055
15597,4990,2017-09-27,0.05142857142857143,175000,166000,-9000,147209
15598,4990,2017-09-25,0.0873015873015873,189000,172500,-16500,44748
15599,4990,2017-04-20,0.08290155440414508,193000,209000,16000,94524
15600,4990,2017-03-08,0.04197530864197531,202500,194000,-8500,43827
15601,4990,2017-03-07,0.04113110539845758,194500,202500,8000,45444
15602,4990,2017-02-02,0.05813953488372093,215000,227500,12500,111740
15603,4990,2017-02-01,0.05392156862745098,204000,215000,11000,92981
15604,4990,2017-01-26,0.05398457583547558,194500,205000,10500,100576
15605,4990,2017-01-20,0.09859154929577464,177500,195000,17500,226697
15606,4990,2016-10-25,0.07756232686980609,180500,194500,14000,126261
15607,102780,2021-01-08,0.044209514656415184,10405,10865,460,1636350
15608,102780,2020-08-20,0.05,7800,7410,-390,376886
15609,102780,2020-06-16,0.054636951833213515,6955,7335,380,1196646
15610,102780,2020-04-01,0.04411764705882353,5780,5525,-255,152789
15611,102780,2020-03-25,0.05248868778280543,5525,5815,290,1978345
15612,102780,2020-03-24,0.08974358974358974,5070,5525,455,1116216
15613,102780,2020-03-20,0.08316221765913757,4870,5275,405,548586
15614,102780,2020-03-19,0.08886810102899906,5345,4870,-475,226223
15615,102780,2020-03-18,0.05731922398589065,5670,5345,-325,1059464
15616,102780,2020-03-16,0.048939641109298535,6130,5830,-300,245912
15617,102780,2020-03-09,0.04503216583273767,6995,6680,-315,320133
15618,102780,2018-10-11,0.04420289855072464,6900,6595,-305,268685
15619,102780,2016-08-18,0.04122722914669223,5215,5430,215,305710
15620,32640,2021-05-11,0.046263345195729534,14050,14700,650,4345232
15621,32640,2021-04-06,0.0411522633744856,12150,12650,500,5066746
15622,32640,2020-11-26,0.04824561403508772,11400,11950,550,6672655
15623,32640,2020-08-18,0.044715447154471545,12300,11750,-550,3295087
15624,32640,2020-08-12,0.04201680672268908,11900,12400,500,5613573
15625,32640,2020-08-10,0.05172413793103448,11600,12200,600,5829345
15626,32640,2020-07-23,0.04132231404958678,12100,11600,-500,6049921
15627,32640,2020-06-15,0.047619047619047616,12600,12000,-600,1977159
15628,32640,2020-05-04,0.0449438202247191,13350,12750,-600,2183559
15629,32640,2020-04-14,0.055793991416309016,11650,12300,650,1987722
15630,32640,2020-04-06,0.08888888888888889,11250,12250,1000,3006547
15631,32640,2020-04-02,0.07582938388625593,10550,11350,800,3139243
15632,32640,2020-03-25,0.04060913705583756,9850,10250,400,3263266
15633,32640,2020-03-24,0.04012671594508976,9470,9850,380,2870350
15634,32640,2020-03-19,0.08446601941747572,10300,9430,-870,3128963
15635,32640,2020-03-18,0.06787330316742081,11050,10300,-750,2309109
15636,32640,2020-03-13,0.04048582995951417,12350,11850,-500,3319611
15637,32640,2019-11-07,0.048327137546468404,13450,14100,650,2956971
15638,32640,2019-05-23,0.06354515050167224,14950,14000,-950,5651464
15639,32640,2019-04-03,0.06070287539936102,15650,14700,-950,9016651
15640,32640,2019-02-08,0.061224489795918366,14700,15600,900,5820324
15641,32640,2019-01-30,0.07120743034055728,16150,15000,-1150,9518645
15642,32640,2019-01-29,0.04154302670623145,16850,16150,-700,3154755
15643,32640,2019-01-21,0.043227665706051875,17350,16600,-750,2372145
15644,32640,2018-11-28,0.060240963855421686,16600,17600,1000,4813489
15645,32640,2018-10-01,0.0546448087431694,18300,17300,-1000,2328303
15646,32640,2018-09-27,0.05654761904761905,16800,17750,950,3263337
15647,32640,2018-09-13,0.04819277108433735,16600,17400,800,3892890
15648,32640,2018-09-12,0.05063291139240506,15800,16600,800,3220757
15649,32640,2018-08-07,0.06811145510835913,16150,15050,-1100,4298753
15650,32640,2018-06-25,0.04844290657439446,14450,13750,-700,2666998
15651,32640,2018-06-18,0.04477611940298507,13400,14000,600,5571628
15652,32640,2018-06-08,0.0642570281124498,12450,13250,800,4874497
15653,32640,2018-06-04,0.04201680672268908,11900,12400,500,1710787
15654,32640,2018-04-13,0.04417670682730924,12450,11900,-550,4540918
15655,32640,2018-02-07,0.04395604395604396,13650,13050,-600,3427259
15656,32640,2018-02-05,0.04152249134948097,14450,13850,-600,1707131
15657,32640,2018-01-18,0.04513888888888889,14400,15050,650,3853961
15658,32640,2018-01-09,0.07829181494661921,14050,15150,1100,3807655
15659,32640,2017-12-13,0.05054151624548736,13850,14550,700,2563821
15660,32640,2017-12-08,0.05517241379310345,14500,13700,-800,3663185
15661,32640,2017-12-05,0.045774647887323945,14200,14850,650,3897750
15662,32640,2017-11-30,0.045283018867924525,13250,13850,600,5122236
15663,32640,2017-11-24,0.04597701149425287,13050,13650,600,2578389
15664,32640,2017-11-22,0.044,12500,13050,550,3206135
15665,32640,2017-08-31,0.06440677966101695,14750,13800,-950,16069220
15666,32640,2017-08-11,0.04472843450479233,15650,14950,-700,4641479
15667,32640,2017-07-10,0.04,15000,15600,600,1452818
15668,32640,2017-06-28,0.061764705882352944,17000,15950,-1050,9148927
15669,32640,2017-05-31,0.04180064308681672,15550,16200,650,3688113
15670,32640,2017-05-18,0.057971014492753624,13800,14600,800,3688795
15671,32640,2017-05-15,0.04,13750,13200,-550,2616713
15672,32640,2017-03-22,0.041666666666666664,14400,15000,600,2549757
15673,32640,2017-03-15,0.046263345195729534,14050,14700,650,2594425
15674,32640,2017-03-02,0.05859375,12800,13550,750,3428244
15675,32640,2017-02-03,0.047619047619047616,11550,12100,550,3147031
15676,32640,2016-11-15,0.043478260869565216,11500,12000,500,1581714
15677,32640,2016-11-01,0.0423728813559322,11800,12300,500,1652538
15678,32640,2016-10-24,0.05652173913043478,11500,12150,650,1594124
15679,336260,2021-06-02,0.0676605504587156,43600,46550,2950,2758739
15680,336260,2021-05-26,0.04228855721393035,40200,41900,1700,1245684
15681,336260,2021-05-10,0.06313131313131314,39600,42100,2500,1370585
15682,336260,2021-05-03,0.10975609756097561,45100,40150,-4950,2904200
15683,336260,2021-04-28,0.05458290422245108,48550,45900,-2650,1998236
15684,336260,2021-04-09,0.042,50000,52100,2100,1344234
15685,336260,2021-03-12,0.06182212581344902,46100,48950,2850,1100650
15686,336260,2021-03-09,0.067,50000,46650,-3350,1768216
15687,336260,2021-03-03,0.07283464566929133,50800,54500,3700,2031946
15688,336260,2021-02-26,0.06716417910447761,53600,50000,-3600,1473679
15689,336260,2021-02-24,0.07142857142857142,56000,52000,-4000,1375099
15690,336260,2021-02-22,0.04054054054054054,59200,56800,-2400,954573
15691,336260,2021-02-15,0.05454545454545454,60500,63800,3300,3157007
15692,336260,2021-01-29,0.06386554621848739,59500,55700,-3800,1970433
15693,336260,2021-01-26,0.04430379746835443,63200,60400,-2800,1976696
15694,336260,2021-01-22,0.11012433392539965,56300,62500,6200,12972968
15695,336260,2021-01-12,0.047038327526132406,57400,54700,-2700,2162242
15696,336260,2021-01-06,0.043859649122807015,57000,54500,-2500,10395186
15697,336260,2021-01-04,0.052336448598130844,53500,56300,2800,1561427
15698,336260,2020-12-29,0.05179282868525897,50200,52800,2600,1988246
15699,336260,2020-12-28,0.04198473282442748,52400,50200,-2200,1676904
15700,336260,2020-12-24,0.04727272727272727,55000,52400,-2600,3152998
15701,336260,2020-12-22,0.060240963855421686,58100,54600,-3500,1432594
15702,336260,2020-12-18,0.05197132616487455,55800,58700,2900,2223066
15703,336260,2020-12-14,0.10703363914373089,49050,54300,5250,4618141
15704,336260,2020-12-09,0.0645879732739421,44900,47800,2900,1590434
15705,336260,2020-12-03,0.05387931034482758,46400,43900,-2500,2675120
15706,336260,2020-12-01,0.041082164328657314,49900,47850,-2050,1109690
15707,336260,2020-11-24,0.12876052948255115,41550,46900,5350,5658057
15708,336260,2020-11-10,0.057579318448883664,42550,45000,2450,2215460
15709,336260,2020-10-28,0.08470290771175727,39550,42900,3350,1112963
15710,336260,2020-10-26,0.07531865585168018,43150,39900,-3250,1641223
15711,336260,2020-10-23,0.07104413347685684,46450,43150,-3300,1672825
15712,336260,2020-10-15,0.05489773950484392,46450,49000,2550,4364787
15713,336260,2020-10-13,0.06674082313681869,44950,47950,3000,2919018
15714,336260,2020-10-12,0.07535885167464115,41800,44950,3150,3101551
15715,336260,2020-10-08,0.05025125628140704,39800,41800,2000,2768314
15716,336260,2020-10-07,0.05992010652463382,37550,39800,2250,4632027
15717,336260,2020-10-06,0.13179190751445086,43250,37550,-5700,17277063
15718,336260,2020-09-29,0.06419753086419754,40500,43100,2600,2555118
15719,336260,2020-09-28,0.04247104247104247,38850,40500,1650,798022
15720,336260,2020-09-24,0.09331797235023041,43400,39350,-4050,1542925
15721,336260,2020-09-23,0.05856832971800434,46100,43400,-2700,1261686
15722,336260,2020-09-21,0.0908203125,51200,46550,-4650,2278370
15723,336260,2020-09-18,0.04299065420560748,53500,51200,-2300,897528
15724,336260,2020-09-09,0.06382978723404255,56400,52800,-3600,2959899
15725,336260,2020-09-08,0.048903878583473864,59300,56400,-2900,9082733
15726,336260,2020-09-07,0.29901423877327493,45650,59300,13650,15047099
15727,336260,2020-09-03,0.04895104895104895,42900,45000,2100,3543447
15728,336260,2020-08-26,0.060945273631840796,40200,42650,2450,1421474
15729,336260,2020-08-20,0.06012269938650307,40750,38300,-2450,1385239
15730,336260,2020-08-19,0.06675392670157068,38200,40750,2550,1169094
15731,336260,2020-08-18,0.1053864168618267,42700,38200,-4500,1927928
15732,336260,2020-08-12,0.045989304812834225,46750,44600,-2150,956296
15733,336260,2020-08-10,0.0731981981981982,44400,47650,3250,2944462
15734,336260,2020-07-27,0.0891566265060241,41500,45200,3700,5306799
15735,336260,2020-07-21,0.0421455938697318,39150,40800,1650,3611390
15736,336260,2020-07-15,0.05212620027434842,36450,38350,1900,5651960
15737,336260,2020-07-14,0.11421628189550426,41150,36450,-4700,8525283
15738,336260,2020-07-13,0.22106824925816024,33700,41150,7450,11098084
15739,336260,2020-07-10,0.0514820592823713,32050,33700,1650,2181200
15740,336260,2020-07-09,0.06478405315614617,30100,32050,1950,1821190
15741,336260,2020-07-01,0.07253086419753087,32400,30050,-2350,1423417
15742,336260,2020-06-23,0.29817444219066935,24650,32000,7350,13230183
15743,336260,2020-06-22,0.07407407407407407,22950,24650,1700,2513663
15744,336260,2020-06-19,0.06134969325153374,24450,22950,-1500,1762206
15745,336260,2020-06-17,0.06794055201698514,23550,25150,1600,4375788
15746,336260,2020-06-16,0.13221153846153846,20800,23550,2750,3693032
15747,336260,2020-06-15,0.1595959595959596,24750,20800,-3950,7626365
15748,336260,2020-06-11,0.21323529411764705,20400,24750,4350,6552619
15749,336260,2020-06-10,0.18950437317784258,17150,20400,3250,6063670
15750,336260,2020-06-09,0.11003236245954692,15450,17150,1700,2887836
15751,336260,2020-06-08,0.08421052631578947,14250,15450,1200,1380468
15752,336260,2020-06-04,0.07920792079207921,15150,13950,-1200,1813361
15753,336260,2020-05-29,0.04777070063694268,15700,14950,-750,1731042
15754,336260,2020-05-28,0.07903780068728522,14550,15700,1150,15695055
15755,336260,2020-05-26,0.18218623481781376,12350,14600,2250,24237621
15756,336260,2020-05-25,0.060085836909871244,11650,12350,700,12634004
15757,336260,2020-05-22,0.06880733944954129,10900,11650,750,8251282
15758,336260,2020-05-20,0.07317073170731707,10250,11000,750,6216589
15759,336260,2020-05-13,0.04020100502512563,9950,10350,400,11504252
15760,336260,2020-05-11,0.2998678996036988,7570,9840,2270,21166142
15761,336260,2020-04-24,0.04308093994778068,7660,7330,-330,981239
15762,336260,2020-04-14,0.1782608695652174,6900,8130,1230,25364531
15763,336260,2020-04-10,0.0625,7360,6900,-460,2912924
15764,336260,2020-04-09,0.058992805755395686,6950,7360,410,8030647
15765,336260,2020-04-08,0.18197278911564627,5880,6950,1070,4786388
15766,336260,2020-04-03,0.04,5500,5720,220,965691
15767,336260,2020-03-27,0.04878048780487805,4920,5160,240,1387499
15768,336260,2020-03-25,0.0700218818380744,4570,4890,320,945421
15769,336260,2020-03-24,0.07783018867924528,4240,4570,330,715317
15770,336260,2020-03-23,0.05145413870246085,4470,4240,-230,565699
15771,336260,2020-03-20,0.06937799043062201,4180,4470,290,1144363
15772,336260,2020-03-19,0.15384615384615385,4940,4180,-760,990240
15773,336260,2020-03-18,0.06261859582542695,5270,4940,-330,633351
15774,336260,2020-03-16,0.06126126126126126,5550,5210,-340,686741
15775,336260,2020-03-13,0.07035175879396985,5970,5550,-420,1553981
15776,336260,2020-03-12,0.1062874251497006,6680,5970,-710,1320670
15777,336260,2020-03-11,0.07093184979137691,7190,6680,-510,1294209
15778,336260,2020-03-09,0.07519788918205805,7580,7010,-570,826363
15779,336260,2020-03-04,0.054945054945054944,7280,7680,400,820640
15780,336260,2020-03-02,0.05952380952380952,6720,7120,400,691041
15781,336260,2020-02-28,0.06276150627615062,7170,6720,-450,1053634
15782,336260,2020-02-27,0.044,7500,7170,-330,1184849
15783,336260,2020-02-24,0.051094890510948905,8220,7800,-420,1408148
15784,336260,2020-02-21,0.05517241379310345,8700,8220,-480,2536545
15785,336260,2020-02-20,0.14624505928853754,7590,8700,1110,4344072
15786,336260,2020-02-04,0.04111405835543767,7540,7850,310,461686
15787,336260,2020-01-31,0.05176767676767677,7920,7510,-410,881162
15788,336260,2020-01-28,0.04481132075471698,8480,8100,-380,1043561
15789,336260,2020-01-09,0.040051679586563305,7740,8050,310,815944
15790,336260,2020-01-08,0.057247259439707675,8210,7740,-470,1878484
15791,336260,2020-01-06,0.04142692750287687,8690,8330,-360,1109156
15792,336260,2019-12-17,0.049008168028004666,8570,8150,-420,1804612
15793,336260,2019-12-11,0.0414572864321608,7960,8290,330,1228865
15794,336260,2019-12-04,0.05054151624548736,8310,7890,-420,1289983
15795,336260,2019-12-03,0.04005006257822278,7990,8310,320,7217850
15796,336260,2019-11-29,0.049516908212560384,8280,7870,-410,1405419
15797,336260,2019-11-21,0.042222222222222223,9000,8620,-380,2539869
15798,336260,2019-11-20,0.04357066950053135,9410,9000,-410,8425856
15799,336260,2019-11-15,0.12040557667934093,7890,8840,950,35194759
15800,336260,2019-11-13,0.04479578392621871,7590,7930,340,3471460
15801,336260,2019-10-30,0.19642857142857142,6720,8040,1320,30865340
15802,336260,2019-10-28,0.059474412171507604,7230,6800,-430,3999829
15803,336260,2019-10-25,0.07307692307692308,7800,7230,-570,13216860
15804,336260,2019-10-23,0.11198208286674133,8930,7930,-1000,28203889
15805,336260,2019-10-22,0.24720670391061453,7160,8930,1770,39020768
15806,336260,2019-10-21,0.29945553539019965,5510,7160,1650,21919889
15807,336260,2019-10-18,0.1601513240857503,7930,5510,-2420,370645
15808,336260,2019-10-23,0.11198208286674133,8930,7930,-1000,28203889
15809,336260,2019-10-22,0.24720670391061453,7160,8930,1770,39020768
15810,336260,2019-10-21,0.29945553539019965,5510,7160,1650,21919889
15811,336260,2019-10-18,0.1601513240857503,7930,5510,-2420,370645
15812,336260,2019-10-23,0.11198208286674133,8930,7930,-1000,28203889
15813,336260,2019-10-22,0.24720670391061453,7160,8930,1770,39020768
15814,336260,2019-10-21,0.29945553539019965,5510,7160,1650,21919889
15815,336260,2019-10-18,0.1601513240857503,7930,5510,-2420,370645
15816,336260,2019-10-23,0.11198208286674133,8930,7930,-1000,28203889
15817,336260,2019-10-22,0.24720670391061453,7160,8930,1770,39020768
15818,336260,2019-10-21,0.29945553539019965,5510,7160,1650,21919889
15819,336260,2019-10-18,0.1601513240857503,7930,5510,-2420,370645
15820,336260,2019-10-23,0.11198208286674133,8930,7930,-1000,28203889
15821,336260,2019-10-22,0.24720670391061453,7160,8930,1770,39020768
15822,336260,2019-10-21,0.29945553539019965,5510,7160,1650,21919889
15823,336260,2019-10-18,0.1601513240857503,7930,5510,-2420,370645
15824,336260,2019-10-23,0.11198208286674133,8930,7930,-1000,28203889
15825,336260,2019-10-22,0.24720670391061453,7160,8930,1770,39020768
15826,336260,2019-10-21,0.29945553539019965,5510,7160,1650,21919889
15827,336260,2019-10-18,0.1601513240857503,7930,5510,-2420,370645
15828,336260,2019-10-23,0.11198208286674133,8930,7930,-1000,28203889
15829,336260,2019-10-22,0.24720670391061453,7160,8930,1770,39020768
15830,336260,2019-10-21,0.29945553539019965,5510,7160,1650,21919889
15831,336260,2019-10-18,0.1601513240857503,7930,5510,-2420,370645
15832,336260,2019-10-23,0.11198208286674133,8930,7930,-1000,28203889
15833,336260,2019-10-22,0.24720670391061453,7160,8930,1770,39020768
15834,336260,2019-10-21,0.29945553539019965,5510,7160,1650,21919889
15835,336260,2019-10-18,0.1601513240857503,7930,5510,-2420,370645
15836,336260,2019-10-23,0.11198208286674133,8930,7930,-1000,28203889
15837,336260,2019-10-22,0.24720670391061453,7160,8930,1770,39020768
15838,336260,2019-10-21,0.29945553539019965,5510,7160,1650,21919889
15839,336260,2019-10-18,0.1601513240857503,7930,5510,-2420,370645
15840,336260,2019-10-23,0.11198208286674133,8930,7930,-1000,28203889
15841,336260,2019-10-22,0.24720670391061453,7160,8930,1770,39020768
15842,336260,2019-10-21,0.29945553539019965,5510,7160,1650,21919889
15843,336260,2019-10-18,0.1601513240857503,7930,5510,-2420,370645
15844,336260,2019-10-23,0.11198208286674133,8930,7930,-1000,28203889
15845,336260,2019-10-22,0.24720670391061453,7160,8930,1770,39020768
15846,336260,2019-10-21,0.29945553539019965,5510,7160,1650,21919889
15847,336260,2019-10-18,0.1601513240857503,7930,5510,-2420,370645
15848,336260,2019-10-23,0.11198208286674133,8930,7930,-1000,28203889
15849,336260,2019-10-22,0.24720670391061453,7160,8930,1770,39020768
15850,336260,2019-10-21,0.29945553539019965,5510,7160,1650,21919889
15851,336260,2019-10-18,0.1601513240857503,7930,5510,-2420,370645
15852,336260,2019-10-23,0.11198208286674133,8930,7930,-1000,28203889
15853,336260,2019-10-22,0.24720670391061453,7160,8930,1770,39020768
15854,336260,2019-10-21,0.29945553539019965,5510,7160,1650,21919889
15855,336260,2019-10-18,0.1601513240857503,7930,5510,-2420,370645
15856,336260,2019-10-23,0.11198208286674133,8930,7930,-1000,28203889
15857,336260,2019-10-22,0.24720670391061453,7160,8930,1770,39020768
15858,336260,2019-10-21,0.29945553539019965,5510,7160,1650,21919889
15859,336260,2019-10-18,0.1601513240857503,7930,5510,-2420,370645
15860,336260,2019-10-23,0.11198208286674133,8930,7930,-1000,28203889
15861,336260,2019-10-22,0.24720670391061453,7160,8930,1770,39020768
15862,336260,2019-10-21,0.29945553539019965,5510,7160,1650,21919889
15863,336260,2019-10-18,0.1601513240857503,7930,5510,-2420,370645
15864,336260,2019-10-23,0.11198208286674133,8930,7930,-1000,28203889
15865,336260,2019-10-22,0.24720670391061453,7160,8930,1770,39020768
15866,336260,2019-10-21,0.29945553539019965,5510,7160,1650,21919889
15867,336260,2019-10-18,0.1601513240857503,7930,5510,-2420,370645
15868,336260,2019-10-23,0.11198208286674133,8930,7930,-1000,28203889
15869,336260,2019-10-22,0.24720670391061453,7160,8930,1770,39020768
15870,336260,2019-10-21,0.29945553539019965,5510,7160,1650,21919889
15871,336260,2019-10-18,0.1601513240857503,7930,5510,-2420,370645
15872,336260,2019-10-23,0.11198208286674133,8930,7930,-1000,28203889
15873,336260,2019-10-22,0.24720670391061453,7160,8930,1770,39020768
15874,336260,2019-10-21,0.29945553539019965,5510,7160,1650,21919889
15875,336260,2019-10-18,0.1601513240857503,7930,5510,-2420,370645
15876,336260,2019-10-23,0.11198208286674133,8930,7930,-1000,28203889
15877,336260,2019-10-22,0.24720670391061453,7160,8930,1770,39020768
15878,336260,2019-10-21,0.29945553539019965,5510,7160,1650,21919889
15879,336260,2019-10-18,0.1601513240857503,7930,5510,-2420,370645
15880,336260,2019-10-23,0.11198208286674133,8930,7930,-1000,28203889
15881,336260,2019-10-22,0.24720670391061453,7160,8930,1770,39020768
15882,336260,2019-10-21,0.29945553539019965,5510,7160,1650,21919889
15883,336260,2019-10-18,0.1601513240857503,7930,5510,-2420,370645
15884,336260,2019-10-23,0.11198208286674133,8930,7930,-1000,28203889
15885,336260,2019-10-22,0.24720670391061453,7160,8930,1770,39020768
15886,336260,2019-10-21,0.29945553539019965,5510,7160,1650,21919889
15887,336260,2019-10-18,0.1601513240857503,7930,5510,-2420,370645
15888,336260,2019-10-23,0.11198208286674133,8930,7930,-1000,28203889
15889,336260,2019-10-22,0.24720670391061453,7160,8930,1770,39020768
15890,336260,2019-10-21,0.29945553539019965,5510,7160,1650,21919889
15891,336260,2019-10-18,0.1601513240857503,7930,5510,-2420,370645
15892,336260,2019-10-23,0.11198208286674133,8930,7930,-1000,28203889
15893,336260,2019-10-22,0.24720670391061453,7160,8930,1770,39020768
15894,336260,2019-10-21,0.29945553539019965,5510,7160,1650,21919889
15895,336260,2019-10-18,0.1601513240857503,7930,5510,-2420,370645
15896,336260,2019-10-23,0.11198208286674133,8930,7930,-1000,28203889
15897,336260,2019-10-22,0.24720670391061453,7160,8930,1770,39020768
15898,336260,2019-10-21,0.29945553539019965,5510,7160,1650,21919889
15899,336260,2019-10-18,0.1601513240857503,7930,5510,-2420,370645
15900,336260,2019-10-23,0.11198208286674133,8930,7930,-1000,28203889
15901,336260,2019-10-22,0.24720670391061453,7160,8930,1770,39020768
15902,336260,2019-10-21,0.29945553539019965,5510,7160,1650,21919889
15903,336260,2019-10-18,0.1601513240857503,7930,5510,-2420,370645
15904,336260,2019-10-23,0.11198208286674133,8930,7930,-1000,28203889
15905,336260,2019-10-22,0.24720670391061453,7160,8930,1770,39020768
15906,336260,2019-10-21,0.29945553539019965,5510,7160,1650,21919889
15907,336260,2019-10-18,0.1601513240857503,7930,5510,-2420,370645
15908,336260,2019-10-23,0.11198208286674133,8930,7930,-1000,28203889
15909,336260,2019-10-22,0.24720670391061453,7160,8930,1770,39020768
15910,336260,2019-10-21,0.29945553539019965,5510,7160,1650,21919889
15911,336260,2019-10-18,0.1601513240857503,7930,5510,-2420,370645
15912,336260,2019-10-23,0.11198208286674133,8930,7930,-1000,28203889
15913,336260,2019-10-22,0.24720670391061453,7160,8930,1770,39020768
15914,336260,2019-10-21,0.29945553539019965,5510,7160,1650,21919889
15915,336260,2019-10-18,0.1601513240857503,7930,5510,-2420,370645
15916,336260,2019-10-23,0.11198208286674133,8930,7930,-1000,28203889
15917,336260,2019-10-22,0.24720670391061453,7160,8930,1770,39020768
15918,336260,2019-10-21,0.29945553539019965,5510,7160,1650,21919889
15919,336260,2019-10-18,0.1601513240857503,7930,5510,-2420,370645
15920,336260,2019-10-23,0.11198208286674133,8930,7930,-1000,28203889
15921,336260,2019-10-22,0.24720670391061453,7160,8930,1770,39020768
15922,336260,2019-10-21,0.29945553539019965,5510,7160,1650,21919889
15923,336260,2019-10-18,0.1601513240857503,7930,5510,-2420,370645
15924,336260,2019-10-23,0.11198208286674133,8930,7930,-1000,28203889
15925,336260,2019-10-22,0.24720670391061453,7160,8930,1770,39020768
15926,336260,2019-10-21,0.29945553539019965,5510,7160,1650,21919889
15927,336260,2019-10-18,0.1601513240857503,7930,5510,-2420,370645
15928,336260,2019-10-23,0.11198208286674133,8930,7930,-1000,28203889
15929,336260,2019-10-22,0.24720670391061453,7160,8930,1770,39020768
15930,336260,2019-10-21,0.29945553539019965,5510,7160,1650,21919889
15931,336260,2019-10-18,0.1601513240857503,7930,5510,-2420,370645
15932,336260,2019-10-23,0.11198208286674133,8930,7930,-1000,28203889
15933,336260,2019-10-22,0.24720670391061453,7160,8930,1770,39020768
15934,336260,2019-10-21,0.29945553539019965,5510,7160,1650,21919889
15935,336260,2019-10-18,0.1601513240857503,7930,5510,-2420,370645
15936,336260,2019-10-23,0.11198208286674133,8930,7930,-1000,28203889
15937,336260,2019-10-22,0.24720670391061453,7160,8930,1770,39020768
15938,336260,2019-10-21,0.29945553539019965,5510,7160,1650,21919889
15939,336260,2019-10-18,0.1601513240857503,7930,5510,-2420,370645
15940,336260,2019-10-23,0.11198208286674133,8930,7930,-1000,28203889
15941,336260,2019-10-22,0.24720670391061453,7160,8930,1770,39020768
15942,336260,2019-10-21,0.29945553539019965,5510,7160,1650,21919889
15943,336260,2019-10-18,0.1601513240857503,7930,5510,-2420,370645
15944,336260,2019-10-23,0.11198208286674133,8930,7930,-1000,28203889
15945,336260,2019-10-22,0.24720670391061453,7160,8930,1770,39020768
15946,336260,2019-10-21,0.29945553539019965,5510,7160,1650,21919889
15947,336260,2019-10-18,0.1601513240857503,7930,5510,-2420,370645
15948,336260,2019-10-23,0.11198208286674133,8930,7930,-1000,28203889
15949,336260,2019-10-22,0.24720670391061453,7160,8930,1770,39020768
15950,336260,2019-10-21,0.29945553539019965,5510,7160,1650,21919889
15951,336260,2019-10-18,0.1601513240857503,7930,5510,-2420,370645
15952,336260,2019-10-23,0.11198208286674133,8930,7930,-1000,28203889
15953,336260,2019-10-22,0.24720670391061453,7160,8930,1770,39020768
15954,336260,2019-10-21,0.29945553539019965,5510,7160,1650,21919889
15955,336260,2019-10-18,0.1601513240857503,7930,5510,-2420,370645
15956,336260,2019-10-23,0.11198208286674133,8930,7930,-1000,28203889
15957,336260,2019-10-22,0.24720670391061453,7160,8930,1770,39020768
15958,336260,2019-10-21,0.29945553539019965,5510,7160,1650,21919889
15959,336260,2019-10-18,0.1601513240857503,7930,5510,-2420,370645
15960,336260,2019-10-23,0.11198208286674133,8930,7930,-1000,28203889
15961,336260,2019-10-22,0.24720670391061453,7160,8930,1770,39020768
15962,336260,2019-10-21,0.29945553539019965,5510,7160,1650,21919889
15963,336260,2019-10-18,0.1601513240857503,7930,5510,-2420,370645
15964,336260,2019-10-23,0.11198208286674133,8930,7930,-1000,28203889
15965,336260,2019-10-22,0.24720670391061453,7160,8930,1770,39020768
15966,336260,2019-10-21,0.29945553539019965,5510,7160,1650,21919889
15967,336260,2019-10-18,0.1601513240857503,7930,5510,-2420,370645
15968,336260,2019-10-23,0.11198208286674133,8930,7930,-1000,28203889
15969,336260,2019-10-22,0.24720670391061453,7160,8930,1770,39020768
15970,336260,2019-10-21,0.29945553539019965,5510,7160,1650,21919889
15971,336260,2019-10-18,0.1601513240857503,7930,5510,-2420,370645
15972,336260,2019-10-23,0.11198208286674133,8930,7930,-1000,28203889
15973,336260,2019-10-22,0.24720670391061453,7160,8930,1770,39020768
15974,336260,2019-10-21,0.29945553539019965,5510,7160,1650,21919889
15975,336260,2019-10-18,0.1601513240857503,7930,5510,-2420,370645
15976,336260,2019-10-23,0.11198208286674133,8930,7930,-1000,28203889
15977,336260,2019-10-22,0.24720670391061453,7160,8930,1770,39020768
15978,336260,2019-10-21,0.29945553539019965,5510,7160,1650,21919889
15979,336260,2019-10-18,0.1601513240857503,7930,5510,-2420,370645
15980,336260,2019-10-23,0.11198208286674133,8930,7930,-1000,28203889
15981,336260,2019-10-22,0.24720670391061453,7160,8930,1770,39020768
15982,336260,2019-10-21,0.29945553539019965,5510,7160,1650,21919889
15983,336260,2019-10-18,0.1601513240857503,7930,5510,-2420,370645
15984,336260,2019-10-23,0.11198208286674133,8930,7930,-1000,28203889
15985,336260,2019-10-22,0.24720670391061453,7160,8930,1770,39020768
15986,336260,2019-10-21,0.29945553539019965,5510,7160,1650,21919889
15987,336260,2019-10-18,0.1601513240857503,7930,5510,-2420,370645
15988,336260,2019-10-23,0.11198208286674133,8930,7930,-1000,28203889
15989,336260,2019-10-22,0.24720670391061453,7160,8930,1770,39020768
15990,336260,2019-10-21,0.29945553539019965,5510,7160,1650,21919889
15991,336260,2019-10-18,0.1601513240857503,7930,5510,-2420,370645
15992,336260,2019-10-23,0.11198208286674133,8930,7930,-1000,28203889
15993,336260,2019-10-22,0.24720670391061453,7160,8930,1770,39020768
15994,336260,2019-10-21,0.29945553539019965,5510,7160,1650,21919889
15995,336260,2019-10-18,0.1601513240857503,7930,5510,-2420,370645
15996,336260,2019-10-23,0.11198208286674133,8930,7930,-1000,28203889
15997,336260,2019-10-22,0.24720670391061453,7160,8930,1770,39020768
15998,336260,2019-10-21,0.29945553539019965,5510,7160,1650,21919889
15999,336260,2019-10-18,0.1601513240857503,7930,5510,-2420,370645
16000,336260,2019-10-23,0.11198208286674133,8930,7930,-1000,28203889
16001,336260,2019-10-22,0.24720670391061453,7160,8930,1770,39020768
16002,336260,2019-10-21,0.29945553539019965,5510,7160,1650,21919889
16003,336260,2019-10-18,0.1601513240857503,7930,5510,-2420,370645
16004,336260,2019-10-23,0.11198208286674133,8930,7930,-1000,28203889
16005,336260,2019-10-22,0.24720670391061453,7160,8930,1770,39020768
16006,336260,2019-10-21,0.29945553539019965,5510,7160,1650,21919889
16007,336260,2019-10-18,0.1601513240857503,7930,5510,-2420,370645
16008,336260,2019-10-23,0.11198208286674133,8930,7930,-1000,28203889
16009,336260,2019-10-22,0.24720670391061453,7160,8930,1770,39020768
16010,336260,2019-10-21,0.29945553539019965,5510,7160,1650,21919889
16011,336260,2019-10-18,0.1601513240857503,7930,5510,-2420,370645
16012,336260,2019-10-23,0.11198208286674133,8930,7930,-1000,28203889
16013,336260,2019-10-22,0.24720670391061453,7160,8930,1770,39020768
16014,336260,2019-10-21,0.29945553539019965,5510,7160,1650,21919889
16015,336260,2019-10-18,0.1601513240857503,7930,5510,-2420,370645
16016,336260,2019-10-23,0.11198208286674133,8930,7930,-1000,28203889
16017,336260,2019-10-22,0.24720670391061453,7160,8930,1770,39020768
16018,336260,2019-10-21,0.29945553539019965,5510,7160,1650,21919889
16019,336260,2019-10-18,0.1601513240857503,7930,5510,-2420,370645
16020,336260,2019-10-23,0.11198208286674133,8930,7930,-1000,28203889
16021,336260,2019-10-22,0.24720670391061453,7160,8930,1770,39020768
16022,336260,2019-10-21,0.29945553539019965,5510,7160,1650,21919889
16023,336260,2019-10-18,0.1601513240857503,7930,5510,-2420,370645
16024,336260,2019-10-23,0.11198208286674133,8930,7930,-1000,28203889
16025,336260,2019-10-22,0.24720670391061453,7160,8930,1770,39020768
16026,336260,2019-10-21,0.29945553539019965,5510,7160,1650,21919889
16027,336260,2019-10-18,0.1601513240857503,7930,5510,-2420,370645
16028,336260,2019-10-23,0.11198208286674133,8930,7930,-1000,28203889
16029,336260,2019-10-22,0.24720670391061453,7160,8930,1770,39020768
16030,336260,2019-10-21,0.29945553539019965,5510,7160,1650,21919889
16031,336260,2019-10-18,0.1601513240857503,7930,5510,-2420,370645
16032,336260,2019-10-23,0.11198208286674133,8930,7930,-1000,28203889
16033,336260,2019-10-22,0.24720670391061453,7160,8930,1770,39020768
16034,336260,2019-10-21,0.29945553539019965,5510,7160,1650,21919889
16035,336260,2019-10-18,0.1601513240857503,7930,5510,-2420,370645
16036,336260,2019-10-23,0.11198208286674133,8930,7930,-1000,28203889
16037,336260,2019-10-22,0.24720670391061453,7160,8930,1770,39020768
16038,336260,2019-10-21,0.29945553539019965,5510,7160,1650,21919889
16039,336260,2019-10-18,0.1601513240857503,7930,5510,-2420,370645
16040,336260,2019-10-23,0.11198208286674133,8930,7930,-1000,28203889
16041,336260,2019-10-22,0.24720670391061453,7160,8930,1770,39020768
16042,336260,2019-10-21,0.29945553539019965,5510,7160,1650,21919889
16043,336260,2019-10-18,0.1601513240857503,7930,5510,-2420,370645
16044,336260,2019-10-23,0.11198208286674133,8930,7930,-1000,28203889
16045,336260,2019-10-22,0.24720670391061453,7160,8930,1770,39020768
16046,336260,2019-10-21,0.29945553539019965,5510,7160,1650,21919889
16047,336260,2019-10-18,0.1601513240857503,7930,5510,-2420,370645
16048,336260,2019-10-23,0.11198208286674133,8930,7930,-1000,28203889
16049,336260,2019-10-22,0.24720670391061453,7160,8930,1770,39020768
16050,336260,2019-10-21,0.29945553539019965,5510,7160,1650,21919889
16051,336260,2019-10-18,0.1601513240857503,7930,5510,-2420,370645
16052,336260,2019-10-23,0.11198208286674133,8930,7930,-1000,28203889
16053,336260,2019-10-22,0.24720670391061453,7160,8930,1770,39020768
16054,336260,2019-10-21,0.29945553539019965,5510,7160,1650,21919889
16055,336260,2019-10-18,0.1601513240857503,7930,5510,-2420,370645
16056,336260,2019-10-23,0.11198208286674133,8930,7930,-1000,28203889
16057,336260,2019-10-22,0.24720670391061453,7160,8930,1770,39020768
16058,336260,2019-10-21,0.29945553539019965,5510,7160,1650,21919889
16059,336260,2019-10-18,0.1601513240857503,7930,5510,-2420,370645
16060,336260,2019-10-23,0.11198208286674133,8930,7930,-1000,28203889
16061,336260,2019-10-22,0.24720670391061453,7160,8930,1770,39020768
16062,336260,2019-10-21,0.29945553539019965,5510,7160,1650,21919889
16063,336260,2019-10-18,0.1601513240857503,7930,5510,-2420,370645
16064,336260,2019-10-23,0.11198208286674133,8930,7930,-1000,28203889
16065,336260,2019-10-22,0.24720670391061453,7160,8930,1770,39020768
16066,336260,2019-10-21,0.29945553539019965,5510,7160,1650,21919889
16067,336260,2019-10-18,0.1601513240857503,7930,5510,-2420,370645
16068,336260,2019-10-23,0.11198208286674133,8930,7930,-1000,28203889
16069,336260,2019-10-22,0.24720670391061453,7160,8930,1770,39020768
16070,336260,2019-10-21,0.29945553539019965,5510,7160,1650,21919889
16071,336260,2019-10-18,0.1601513240857503,7930,5510,-2420,370645
16072,336260,2019-10-23,0.11198208286674133,8930,7930,-1000,28203889
16073,336260,2019-10-22,0.24720670391061453,7160,8930,1770,39020768
16074,336260,2019-10-21,0.29945553539019965,5510,7160,1650,21919889
16075,336260,2019-10-18,0.1601513240857503,7930,5510,-2420,370645
16076,336260,2019-10-23,0.11198208286674133,8930,7930,-1000,28203889
16077,336260,2019-10-22,0.24720670391061453,7160,8930,1770,39020768
16078,336260,2019-10-21,0.29945553539019965,5510,7160,1650,21919889
16079,336260,2019-10-18,0.1601513240857503,7930,5510,-2420,370645
16080,336260,2019-10-23,0.11198208286674133,8930,7930,-1000,28203889
16081,336260,2019-10-22,0.24720670391061453,7160,8930,1770,39020768
16082,336260,2019-10-21,0.29945553539019965,5510,7160,1650,21919889
16083,336260,2019-10-18,0.1601513240857503,7930,5510,-2420,370645
16084,336260,2019-10-23,0.11198208286674133,8930,7930,-1000,28203889
16085,336260,2019-10-22,0.24720670391061453,7160,8930,1770,39020768
16086,336260,2019-10-21,0.29945553539019965,5510,7160,1650,21919889
16087,336260,2019-10-18,0.1601513240857503,7930,5510,-2420,370645
16088,336260,2019-10-23,0.11198208286674133,8930,7930,-1000,28203889
16089,336260,2019-10-22,0.24720670391061453,7160,8930,1770,39020768
16090,336260,2019-10-21,0.29945553539019965,5510,7160,1650,21919889
16091,336260,2019-10-18,0.1601513240857503,7930,5510,-2420,370645
16092,336260,2019-10-23,0.11198208286674133,8930,7930,-1000,28203889
16093,336260,2019-10-22,0.24720670391061453,7160,8930,1770,39020768
16094,336260,2019-10-21,0.29945553539019965,5510,7160,1650,21919889
16095,336260,2019-10-18,0.1601513240857503,7930,5510,-2420,370645
16096,336260,2019-10-23,0.11198208286674133,8930,7930,-1000,28203889
16097,336260,2019-10-22,0.24720670391061453,7160,8930,1770,39020768
16098,336260,2019-10-21,0.29945553539019965,5510,7160,1650,21919889
16099,336260,2019-10-18,0.1601513240857503,7930,5510,-2420,370645
16100,336260,2019-10-23,0.11198208286674133,8930,7930,-1000,28203889
16101,336260,2019-10-22,0.24720670391061453,7160,8930,1770,39020768
16102,336260,2019-10-21,0.29945553539019965,5510,7160,1650,21919889
16103,336260,2019-10-18,0.1601513240857503,7930,5510,-2420,370645
16104,336260,2019-10-23,0.11198208286674133,8930,7930,-1000,28203889
16105,336260,2019-10-22,0.24720670391061453,7160,8930,1770,39020768
16106,336260,2019-10-21,0.29945553539019965,5510,7160,1650,21919889
16107,336260,2019-10-18,0.1601513240857503,7930,5510,-2420,370645
16108,336260,2019-10-23,0.11198208286674133,8930,7930,-1000,28203889
16109,336260,2019-10-22,0.24720670391061453,7160,8930,1770,39020768
16110,336260,2019-10-21,0.29945553539019965,5510,7160,1650,21919889
16111,336260,2019-10-18,0.1601513240857503,7930,5510,-2420,370645
16112,336260,2019-10-23,0.11198208286674133,8930,7930,-1000,28203889
16113,336260,2019-10-22,0.24720670391061453,7160,8930,1770,39020768
16114,336260,2019-10-21,0.29945553539019965,5510,7160,1650,21919889
16115,336260,2019-10-18,0.1601513240857503,7930,5510,-2420,370645
16116,336260,2019-10-23,0.11198208286674133,8930,7930,-1000,28203889
16117,336260,2019-10-22,0.24720670391061453,7160,8930,1770,39020768
16118,336260,2019-10-21,0.29945553539019965,5510,7160,1650,21919889
16119,251270,2021-04-12,0.06463878326996197,131500,140000,8500,941931
16120,251270,2021-02-26,0.05,130000,123500,-6500,396171
16121,251270,2021-02-25,0.05263157894736842,123500,130000,6500,363011
16122,251270,2021-02-04,0.05154639175257732,145500,138000,-7500,820392
16123,251270,2021-02-01,0.060836501901140684,131500,139500,8000,1056831
16124,251270,2021-01-22,0.049586776859504134,121000,127000,6000,888658
16125,251270,2021-01-11,0.05223880597014925,134000,127000,-7000,1242320
16126,251270,2020-12-30,0.04365079365079365,126000,131500,5500,584685
16127,251270,2020-10-30,0.05263157894736842,123500,117000,-6500,442160
16128,251270,2020-10-26,0.04330708661417323,127000,121500,-5500,448855
16129,251270,2020-10-22,0.041353383458646614,133000,127500,-5500,563312
16130,251270,2020-10-15,0.09868421052631579,152000,137000,-15000,1995819
16131,251270,2020-09-24,0.04011461318051576,174500,167500,-7000,905067
16132,251270,2020-09-03,0.12427745664739884,173000,194500,21500,4764031
16133,251270,2020-09-02,0.06461538461538462,162500,173000,10500,1202889
16134,251270,2020-08-31,0.09180327868852459,152500,166500,14000,1798138
16135,251270,2020-08-07,0.07857142857142857,140000,151000,11000,1548323
16136,251270,2020-07-15,0.06296296296296296,135000,126500,-8500,911921
16137,251270,2020-07-13,0.047058823529411764,127500,133500,6000,739238
16138,251270,2020-07-07,0.055793991416309016,116500,123000,6500,1525070
16139,251270,2020-07-06,0.09389671361502347,106500,116500,10000,2030908
16140,251270,2020-07-02,0.09165808444902163,97100,106000,8900,1403159
16141,251270,2020-06-30,0.05567226890756303,95200,100500,5300,724776
16142,251270,2020-06-23,0.06171548117154812,95600,101500,5900,1064185
16143,251270,2020-06-16,0.04643628509719223,92600,96900,4300,309927
16144,251270,2020-05-14,0.08942307692307692,104000,94700,-9300,1205146
16145,251270,2020-05-12,0.055,100000,105500,5500,1060894
16146,251270,2020-05-06,0.04,92500,96200,3700,325862
16147,251270,2020-03-18,0.04878048780487805,94300,89700,-4600,346239
16148,251270,2020-03-13,0.05517241379310345,87000,91800,4800,892080
16149,251270,2020-03-09,0.04432432432432432,92500,88400,-4100,377974
16150,251270,2020-03-04,0.0715909090909091,88000,94300,6300,453992
16151,251270,2020-02-14,0.046038543897216275,93400,97700,4300,540815
16152,251270,2020-02-06,0.04194260485651214,90600,94400,3800,255725
16153,251270,2020-01-28,0.046680497925311204,96400,91900,-4500,242539
16154,251270,2020-01-13,0.0758082497212932,89700,96500,6800,571447
16155,251270,2019-11-13,0.042071197411003236,92700,88800,-3900,403124
16156,251270,2019-10-08,0.04475982532751092,91600,95700,4100,264671
16157,251270,2019-10-07,0.04805491990846682,87400,91600,4200,466800
16158,251270,2019-10-04,0.05411255411255411,92400,87400,-5000,385123
16159,251270,2019-10-02,0.043478260869565216,96600,92400,-4200,249884
16160,251270,2019-08-20,0.05056179775280899,89000,93500,4500,321647
16161,251270,2019-08-14,0.07210401891252956,84600,90700,6100,460427
16162,251270,2019-08-13,0.06208425720620843,90200,84600,-5600,737962
16163,251270,2019-07-10,0.04467005076142132,98500,94100,-4400,664558
16164,251270,2019-07-09,0.05235042735042735,93600,98500,4900,1049234
16165,251270,2019-07-01,0.11061946902654868,113000,100500,-12500,1322257
16166,251270,2019-06-28,0.07755102040816327,122500,113000,-9500,778528
16167,251270,2019-06-25,0.05405405405405406,129500,122500,-7000,507583
16168,251270,2019-06-14,0.0411522633744856,121500,126500,5000,597483
16169,251270,2019-06-07,0.04032258064516129,124000,119000,-5000,385292
16170,251270,2019-06-03,0.048034934497816595,114500,120000,5500,321145
16171,251270,2019-05-15,0.04065040650406504,123000,118000,-5000,467372
16172,251270,2019-05-14,0.046511627906976744,129000,123000,-6000,379799
16173,251270,2019-05-10,0.06072874493927125,123500,131000,7500,377194
16174,251270,2019-04-23,0.04411764705882353,136000,130000,-6000,268321
16175,251270,2019-04-10,0.04065040650406504,123000,128000,5000,287938
16176,251270,2019-04-03,0.04149377593360996,120500,125500,5000,312809
16177,251270,2019-03-26,0.05217391304347826,115000,121000,6000,296414
16178,251270,2019-02-15,0.04032258064516129,124000,119000,-5000,221949
16179,251270,2019-02-13,0.046610169491525424,118000,123500,5500,447866
16180,251270,2019-02-08,0.0867579908675799,109500,119000,9500,1354003
16181,251270,2019-01-04,0.04326923076923077,104000,108500,4500,218348
16182,251270,2019-01-02,0.04932735426008968,111500,106000,-5500,271562
16183,251270,2018-12-27,0.045454545454545456,110000,115000,5000,250236
16184,251270,2018-12-21,0.05045871559633028,109000,114500,5500,510705
16185,251270,2018-12-10,0.06222222222222222,112500,105500,-7000,779248
16186,251270,2018-12-06,0.11952191235059761,125500,110500,-15000,1579206
16187,251270,2018-11-02,0.0502283105022831,109500,115000,5500,301230
16188,251270,2018-10-31,0.051643192488262914,106500,112000,5500,550466
16189,251270,2018-10-30,0.16013071895424835,91800,106500,14700,1159588
16190,251270,2018-10-29,0.082,100000,91800,-8200,799904
16191,251270,2018-10-26,0.07834101382488479,108500,100000,-8500,437001
16192,251270,2018-10-15,0.05785123966942149,121000,114000,-7000,455347
16193,251270,2018-10-08,0.0425531914893617,117500,122500,5000,465353
16194,251270,2018-09-20,0.049107142857142856,112000,117500,5500,664074
16195,251270,2018-08-21,0.05555555555555555,117000,123500,6500,398822
16196,251270,2018-08-16,0.06072874493927125,123500,116000,-7500,1068017
16197,251270,2018-08-09,0.11267605633802817,142000,126000,-16000,1245103
16198,251270,2018-07-16,0.05660377358490566,159000,150000,-9000,486751
16199,251270,2018-07-13,0.04504504504504504,166500,159000,-7500,292058
16200,251270,2018-05-29,0.0429042904290429,151500,158000,6500,831698
16201,251270,2018-05-04,0.04895104895104895,143000,136000,-7000,337502
16202,251270,2018-04-27,0.07575757575757576,132000,142000,10000,1015443
16203,251270,2018-04-04,0.07861635220125786,159000,146500,-12500,612059
16204,251270,2018-03-30,0.04081632653061224,147000,153000,6000,725123
16205,251270,2018-03-09,0.04482758620689655,145000,151500,6500,459122
16206,251270,2018-03-05,0.04666666666666667,150000,143000,-7000,270337
16207,251270,2018-02-28,0.05448717948717949,156000,147500,-8500,899146
16208,251270,2018-02-23,0.0429042904290429,151500,158000,6500,262177
16209,251270,2018-02-12,0.04779411764705882,136000,142500,6500,274326
16210,251270,2018-02-07,0.08169934640522876,153000,140500,-12500,1037686
16211,251270,2018-02-06,0.049689440993788817,161000,153000,-8000,459578
16212,251270,2018-02-05,0.05014749262536873,169500,161000,-8500,257288
16213,251270,2018-01-26,0.06042296072507553,165500,175500,10000,635249
16214,251270,2018-01-04,0.052486187845303865,181000,171500,-9500,617781
16215,251270,2017-12-15,0.042606516290726815,199500,191000,-8500,621734
16216,251270,2017-12-01,0.08284023668639054,169000,183000,14000,617111
16217,251270,2017-11-30,0.055865921787709494,179000,169000,-10000,511746
16218,251270,2017-11-28,0.043010752688172046,186000,178000,-8000,476893
16219,251270,2017-11-21,0.04087193460490463,183500,191000,7500,501789
16220,251270,2017-11-06,0.06571428571428571,175000,186500,11500,759611
16221,251270,2017-10-18,0.04129793510324484,169500,176500,7000,729789
16222,251270,2017-10-17,0.052795031055900624,161000,169500,8500,775357
16223,251270,2017-10-13,0.087248322147651,149000,162000,13000,905002
16224,251270,2017-09-08,0.04746835443037975,158000,150500,-7500,369958
16225,251270,2017-09-06,0.04318936877076412,150500,157000,6500,408286
16226,251270,2017-08-30,0.048109965635738834,145500,152500,7000,389665
16227,251270,2017-08-24,0.08362369337979095,143500,155500,12000,1363312
16228,251270,2017-08-16,0.04198473282442748,131000,136500,5500,335214
16229,251270,2017-08-04,0.04395604395604396,136500,130500,-6000,505939
16230,251270,2017-07-07,0.0472972972972973,148000,155000,7000,452333
16231,251270,2017-06-29,0.040268456375838924,149000,155000,6000,305111
16232,251270,2017-06-12,0.050335570469798654,149000,141500,-7500,1361725
16233,251270,2017-06-08,0.04361370716510903,160500,153500,-7000,1255870
16234,251270,2017-06-02,0.0462046204620462,151500,158500,7000,1005171
16235,251270,2017-05-17,0.07692307692307693,156000,144000,-12000,2006418
16236,251270,2017-05-17,0.07692307692307693,156000,144000,-12000,2006418
16237,251270,2017-05-17,0.07692307692307693,156000,144000,-12000,2006418
16238,251270,2017-05-17,0.07692307692307693,156000,144000,-12000,2006418
16239,251270,2017-05-17,0.07692307692307693,156000,144000,-12000,2006418
16240,251270,2017-05-17,0.07692307692307693,156000,144000,-12000,2006418
16241,251270,2017-05-17,0.07692307692307693,156000,144000,-12000,2006418
16242,251270,2017-05-17,0.07692307692307693,156000,144000,-12000,2006418
16243,251270,2017-05-17,0.07692307692307693,156000,144000,-12000,2006418
16244,251270,2017-05-17,0.07692307692307693,156000,144000,-12000,2006418
16245,251270,2017-05-17,0.07692307692307693,156000,144000,-12000,2006418
16246,251270,2017-05-17,0.07692307692307693,156000,144000,-12000,2006418
16247,251270,2017-05-17,0.07692307692307693,156000,144000,-12000,2006418
16248,251270,2017-05-17,0.07692307692307693,156000,144000,-12000,2006418
16249,251270,2017-05-17,0.07692307692307693,156000,144000,-12000,2006418
16250,251270,2017-05-17,0.07692307692307693,156000,144000,-12000,2006418
16251,251270,2017-05-17,0.07692307692307693,156000,144000,-12000,2006418
16252,251270,2017-05-17,0.07692307692307693,156000,144000,-12000,2006418
16253,251270,2017-05-17,0.07692307692307693,156000,144000,-12000,2006418
16254,251270,2017-05-17,0.07692307692307693,156000,144000,-12000,2006418
16255,35720,2021-05-27,0.04602510460251046,119500,125000,5500,7398732
16256,35720,2021-04-06,0.08366533864541832,502000,544000,42000,1724958
16257,35720,2021-03-11,0.041304347826086954,460000,479000,19000,928091
16258,35720,2021-03-10,0.04308390022675737,441000,460000,19000,899669
16259,35720,2021-02-10,0.06182212581344902,461000,489500,28500,1814483
16260,35720,2021-01-11,0.04377880184331797,434000,453000,19000,3157747
16261,35720,2021-01-08,0.0782608695652174,402500,434000,31500,2466715
16262,35720,2020-12-04,0.04144385026737968,374000,389500,15500,1561745
16263,35720,2020-11-10,0.04172274562584118,371500,356000,-15500,1105100
16264,35720,2020-11-04,0.06835066864784546,336500,359500,23000,1431026
16265,35720,2020-09-28,0.049786628733997154,351500,369000,17500,674705
16266,35720,2020-08-27,0.047193877551020405,392000,410500,18500,1981840
16267,35720,2020-08-18,0.04275862068965517,362500,378000,15500,3032037
16268,35720,2020-08-03,0.06550218340611354,343500,366000,22500,1636803
16269,35720,2020-07-20,0.046153846153846156,325000,310000,-15000,1534422
16270,35720,2020-07-16,0.045925925925925926,337500,322000,-15500,1941508
16271,35720,2020-07-09,0.08384146341463415,328000,355500,27500,2463503
16272,35720,2020-07-08,0.05636070853462158,310500,328000,17500,1869663
16273,35720,2020-07-02,0.059369202226345084,269500,285500,16000,1378545
16274,35720,2020-06-16,0.041584158415841586,252500,263000,10500,915456
16275,35720,2020-06-15,0.05075187969924812,266000,252500,-13500,1549230
16276,35720,2020-05-25,0.08502024291497975,247000,268000,21000,2653776
16277,35720,2020-05-22,0.04,237500,247000,9500,1887064
16278,35720,2020-05-20,0.05227272727272727,220000,231500,11500,1773960
16279,35720,2020-05-06,0.06970509383378017,186500,199500,13000,2035947
16280,35720,2020-04-23,0.0480225988700565,177000,185500,8500,1509799
16281,35720,2020-04-02,0.04318936877076412,150500,157000,6500,1043790
16282,35720,2020-03-24,0.07665505226480836,143500,154500,11000,1271387
16283,35720,2020-03-23,0.04013377926421405,149500,143500,-6000,1569378
16284,35720,2020-03-20,0.11567164179104478,134000,149500,15500,1765756
16285,35720,2020-03-19,0.04964539007092199,141000,134000,-7000,2157141
16286,35720,2020-03-18,0.04406779661016949,147500,141000,-6500,1107527
16287,35720,2020-03-16,0.07232704402515723,159000,147500,-11500,1252484
16288,35720,2020-03-12,0.047337278106508875,169000,161000,-8000,1218070
16289,35720,2020-03-09,0.045584045584045586,175500,167500,-8000,805638
16290,35720,2020-02-19,0.04395604395604396,182000,190000,8000,1362998
16291,35720,2020-02-13,0.040697674418604654,172000,179000,7000,1877980
16292,35720,2019-12-05,0.041666666666666664,156000,149500,-6500,841460
16293,35720,2019-08-05,0.04669260700389105,128500,122500,-6000,597268
16294,35720,2019-07-08,0.04119850187265917,133500,128000,-5500,581000
16295,35720,2019-05-17,0.06741573033707865,133500,124500,-9000,5222004
16296,35720,2019-05-14,0.042801556420233464,128500,134000,5500,1360661
16297,35720,2019-05-03,0.04065040650406504,123000,128000,5000,1098989
16298,35720,2019-04-16,0.06334841628959276,110500,117500,7000,1744272
16299,35720,2019-04-15,0.07804878048780488,102500,110500,8000,1228969
16300,35720,2019-03-19,0.046511627906976744,107500,102500,-5000,605054
16301,35720,2019-03-04,0.04830917874396135,103500,108500,5000,853038
16302,35720,2019-02-26,0.052899287894201424,98300,103500,5200,1238902
16303,35720,2018-12-20,0.046296296296296294,108000,103000,-5000,579446
16304,35720,2018-11-26,0.041666666666666664,108000,112500,4500,460406
16305,35720,2018-11-19,0.04390243902439024,102500,107000,4500,346393
16306,35720,2018-11-08,0.04602510460251046,95600,100000,4400,644793
16307,35720,2018-11-02,0.05477980665950591,93100,98200,5100,409600
16308,35720,2018-10-25,0.05040322580645161,99200,94200,-5000,1024715
16309,35720,2018-10-11,0.052884615384615384,104000,98500,-5500,957608
16310,35720,2018-08-09,0.0546218487394958,119000,125500,6500,1622449
16311,35720,2018-08-07,0.05726872246696035,113500,120000,6500,742353
16312,35720,2018-06-22,0.06542056074766354,107000,114000,7000,651617
16313,35720,2018-03-23,0.05434782608695652,138000,130500,-7500,1233587
16314,35720,2018-03-13,0.040740740740740744,135000,140500,5500,1320091
16315,35720,2018-03-06,0.07723577235772358,123000,132500,9500,1167882
16316,35720,2018-02-27,0.06504065040650407,123000,131000,8000,1272000
16317,35720,2018-02-09,0.06719367588932806,126500,118000,-8500,2074927
16318,35720,2018-02-05,0.0627177700348432,143500,134500,-9000,1624472
16319,35720,2018-01-17,0.046263345195729534,140500,134000,-6500,2415858
16320,35720,2018-01-11,0.06020066889632107,149500,140500,-9000,2474827
16321,35720,2018-01-10,0.04777070063694268,157000,149500,-7500,1656798
16322,35720,2018-01-04,0.04697986577181208,149000,156000,7000,2265019
16323,35720,2018-01-02,0.06934306569343066,137000,146500,9500,1345951
16324,35720,2017-12-27,0.10714285714285714,126000,139500,13500,1561744
16325,35720,2017-12-18,0.056140350877192984,142500,134500,-8000,1462446
16326,35720,2017-11-30,0.05862068965517241,145000,136500,-8500,1808464
16327,35720,2017-11-22,0.040372670807453416,161000,154500,-6500,4520630
16328,35720,2017-11-01,0.04861111111111111,144000,151000,7000,1022580
16329,35720,2017-10-26,0.0410958904109589,146000,140000,-6000,1893626
16330,35720,2017-10-18,0.05714285714285714,157500,148500,-9000,1640427
16331,35720,2017-10-13,0.0438871473354232,159500,152500,-7000,2543079
16332,35720,2017-10-12,0.059800664451827246,150500,159500,9000,1304122
16333,35720,2017-09-20,0.040145985401459854,137000,142500,5500,1321516
16334,35720,2017-09-05,0.0502092050209205,119500,125500,6000,1049572
16335,35720,2017-07-31,0.08108108108108109,111000,120000,9000,3120156
16336,35720,2017-07-05,0.042726347914547304,98300,102500,4200,596647
16337,35720,2017-06-12,0.04371584699453552,109800,105000,-4800,1280193
16338,35720,2017-04-20,0.04128440366972477,87200,90800,3600,1559946
16339,35720,2017-04-03,0.04693140794223827,83100,87000,3900,862856
16340,35720,2017-02-21,0.04245283018867924,84800,88400,3600,1573781
16341,35720,2017-02-09,0.07017543859649122,79800,85400,5600,1550608
16342,35720,2017-01-04,0.05375,80000,84300,4300,1224395
16343,35720,2017-01-03,0.04302477183833116,76700,80000,3300,445180
16344,35720,2016-12-09,0.04062909567496723,76300,79400,3100,300441
16345,35720,2016-11-16,0.056578947368421055,76000,80300,4300,566246
16346,35720,2016-11-10,0.11781206171107994,71300,79700,8400,1182920
16347,35720,2016-11-09,0.040376850605652756,74300,71300,-3000,529993
16348,35720,2016-11-02,0.04423592493297587,74600,71300,-3300,640159
16349,35720,2016-10-31,0.04020100502512563,79600,76400,-3200,498234
16350,35720,2016-10-05,0.05295566502463054,81200,85500,4300,728681
16351,17800,2021-06-01,0.046125461254612546,54200,56700,2500,1136357
16352,17800,2021-05-07,0.052127659574468084,47000,49450,2450,1592058
16353,17800,2021-02-16,0.04499437570303712,44450,46450,2000,1122919
16354,17800,2021-01-11,0.04745762711864407,44250,42150,-2100,1199677
16355,17800,2021-01-07,0.05125148986889154,41950,44100,2150,1692915
16356,17800,2020-11-04,0.04078947368421053,38000,39550,1550,1070604
16357,17800,2020-08-20,0.0574052812858783,43550,41050,-2500,412362
16358,17800,2020-08-18,0.06852248394004283,46700,43500,-3200,475007
16359,17800,2020-07-03,0.06308169596690796,48350,51400,3050,457887
16360,17800,2020-06-19,0.0684931506849315,73000,68000,-5000,2294635
16361,17800,2020-06-18,0.2807017543859649,57000,73000,16000,5583799
16362,17800,2020-06-16,0.08608058608058608,54600,59300,4700,274620
16363,17800,2020-06-15,0.09752066115702479,60500,54600,-5900,457743
16364,17800,2020-04-21,0.04696969696969697,66000,62900,-3100,1931381
16365,17800,2020-04-16,0.06930693069306931,60600,64800,4200,1149875
16366,17800,2020-04-01,0.050788091068301226,57100,54200,-2900,477452
16367,17800,2020-03-31,0.09177820267686425,52300,57100,4800,1559841
16368,17800,2020-03-27,0.052845528455284556,49200,51800,2600,403031
16369,17800,2020-03-25,0.043149946062567425,46350,48350,2000,409765
16370,17800,2020-03-24,0.11821471652593486,41450,46350,4900,378727
16371,17800,2020-03-20,0.10729023383768914,36350,40250,3900,531140
16372,17800,2020-03-19,0.16819221967963388,43700,36350,-7350,721864
16373,17800,2020-03-13,0.08737864077669903,51500,47000,-4500,817976
16374,17800,2020-03-12,0.0703971119133574,55400,51500,-3900,502084
16375,17800,2020-02-25,0.05950095969289827,52100,55200,3100,429127
16376,17800,2020-02-24,0.07295373665480427,56200,52100,-4100,516063
16377,17800,2020-01-28,0.06432748538011696,68400,64000,-4400,360297
16378,17800,2020-01-13,0.05413533834586466,66500,70100,3600,615219
16379,17800,2020-01-09,0.07096774193548387,62000,66400,4400,360961
16380,17800,2020-01-08,0.05343511450381679,65500,62000,-3500,407894
16381,17800,2019-10-23,0.07462686567164178,80400,74400,-6000,1197886
16382,17800,2019-10-07,0.11035267349260523,87900,78200,-9700,913837
16383,17800,2019-09-25,0.05698924731182796,93000,87700,-5300,560111
16384,17800,2019-09-16,0.04452054794520548,87600,91500,3900,603595
16385,17800,2019-09-10,0.08535031847133757,78500,85200,6700,628960
16386,17800,2019-08-19,0.04302477183833116,76700,80000,3300,364351
16387,17800,2019-08-05,0.08774193548387096,77500,70700,-6800,506403
16388,17800,2019-07-29,0.046511627906976744,81700,77900,-3800,340237
16389,17800,2019-07-11,0.07340553549939831,83100,89200,6100,520856
16390,17800,2019-07-09,0.04161849710982659,86500,82900,-3600,458641
16391,17800,2019-07-08,0.07188841201716738,93200,86500,-6700,588792
16392,17800,2019-07-03,0.05093555093555094,96200,91300,-4900,621927
16393,17800,2019-07-01,0.08489525909592062,90700,98400,7700,1401054
16394,17800,2019-06-19,0.0436241610738255,89400,93300,3900,453512
16395,17800,2019-06-10,0.05017921146953405,83700,87900,4200,422009
16396,17800,2019-05-17,0.0414572864321608,79600,82900,3300,453254
16397,17800,2019-03-29,0.10506798516687268,80900,89400,8500,1813826
16398,17800,2019-03-18,0.05363984674329502,78300,82500,4200,683262
16399,17800,2019-03-15,0.06896551724137931,84100,78300,-5800,1741611
16400,17800,2019-03-06,0.04640883977900553,90500,86300,-4200,1312794
16401,17800,2019-03-04,0.053515215110178385,95300,90200,-5100,2516424
16402,17800,2019-02-28,0.18547008547008548,117000,95300,-21700,2931794
16403,17800,2019-02-25,0.0625,120000,112500,-7500,1669520
16404,17800,2019-02-21,0.04081632653061224,122500,117500,-5000,940891
16405,17800,2019-02-01,0.06756756756756757,111000,118500,7500,1016758
16406,17800,2019-01-29,0.05217391304347826,115000,109000,-6000,780313
16407,17800,2019-01-14,0.048034934497816595,114500,120000,5500,1071630
16408,17800,2019-01-11,0.045662100456621,109500,114500,5000,819900
16409,17800,2018-12-27,0.06960081883316274,97700,104500,6800,1147423
16410,17800,2018-12-26,0.05603864734299517,103500,97700,-5800,1088673
16411,17800,2018-12-20,0.064034151547492,93700,99700,6000,910460
16412,17800,2018-12-17,0.050515463917525774,97000,92100,-4900,716082
16413,17800,2018-12-12,0.04229607250755287,99300,95100,-4200,874160
16414,17800,2018-12-10,0.052132701421800945,105500,100000,-5500,941954
16415,17800,2018-12-03,0.06296691568836713,93700,99600,5900,1021304
16416,17800,2018-11-19,0.05784204671857619,89900,95100,5200,917813
16417,17800,2018-11-15,0.0929951690821256,82800,90500,7700,958346
16418,17800,2018-11-08,0.04495747266099635,82300,86000,3700,793373
16419,17800,2018-11-07,0.07838745800671892,89300,82300,-7000,2065398
16420,17800,2018-11-02,0.08982035928143713,83500,91000,7500,739981
16421,17800,2018-11-01,0.04767879548306148,79700,83500,3800,610390
16422,17800,2018-10-30,0.0799475753604194,76300,82400,6100,1048517
16423,17800,2018-10-29,0.07402912621359223,82400,76300,-6100,819090
16424,17800,2018-10-26,0.0429732868757259,86100,82400,-3700,685808
16425,17800,2018-10-24,0.048087431693989074,91500,87100,-4400,834021
16426,17800,2018-10-22,0.07317073170731707,102500,95000,-7500,894028
16427,17800,2018-10-15,0.05454545454545454,99000,93600,-5400,1195279
16428,17800,2018-10-12,0.0454065469904963,94700,99000,4300,1135781
16429,17800,2018-10-11,0.08058252427184466,103000,94700,-8300,2124497
16430,17800,2018-10-10,0.17928286852589642,125500,103000,-22500,2307574
16431,17800,2018-10-04,0.10480349344978165,114500,126500,12000,1656604
16432,17800,2018-09-21,0.11627906976744186,107500,120000,12500,2268709
16433,17800,2018-09-19,0.07048458149779736,113500,105500,-8000,2004320
16434,17800,2018-09-10,0.0825242718446602,103000,111500,8500,1108621
16435,17800,2018-09-07,0.10160427807486631,93500,103000,9500,1230105
16436,17800,2018-08-27,0.11826923076923077,104000,91700,-12300,1832149
16437,17800,2018-08-14,0.05181347150259067,96500,101500,5000,958500
16438,17800,2018-08-13,0.05392156862745098,102000,96500,-5500,1346799
16439,17800,2018-08-10,0.0851063829787234,94000,102000,8000,1464303
16440,17800,2018-07-31,0.04008438818565401,94800,91000,-3800,1020919
16441,17800,2018-07-26,0.07451923076923077,83200,89400,6200,1159961
16442,17800,2018-07-24,0.12141882673942701,73300,82200,8900,1827285
16443,17800,2018-07-23,0.04928664072632944,77100,73300,-3800,493644
16444,17800,2018-07-18,0.05080545229244114,80700,76600,-4100,561368
16445,17800,2018-07-13,0.04408060453400504,79400,82900,3500,681129
16446,17800,2018-07-11,0.04907161803713528,75400,79100,3700,939180
16447,17800,2018-07-09,0.13182897862232779,84200,73100,-11100,1533986
16448,17800,2018-07-06,0.056461731493099125,79700,84200,4500,906705
16449,17800,2018-07-05,0.04892601431980907,83800,79700,-4100,1070288
16450,17800,2018-07-02,0.08258928571428571,89600,82200,-7400,962950
16451,17800,2018-06-29,0.04918032786885246,85400,89600,4200,1115807
16452,17800,2018-06-28,0.051111111111111114,90000,85400,-4600,1097918
16453,17800,2018-06-26,0.08415841584158416,101000,92500,-8500,1199742
16454,17800,2018-06-19,0.045662100456621,109500,104500,-5000,743195
16455,17800,2018-06-14,0.14225941422594143,119500,102500,-17000,2285482
16456,17800,2018-06-11,0.06437768240343347,116500,124000,7500,1249508
16457,17800,2018-06-08,0.04897959183673469,122500,116500,-6000,1227743
16458,17800,2018-06-01,0.06367041198501873,133500,125000,-8500,2042739
16459,17800,2018-05-30,0.12663755458515283,114500,129000,14500,3873218
16460,17800,2018-05-28,0.2945914844649022,86900,112500,25600,2883716
16461,17800,2018-05-25,0.16842105263157894,104500,86900,-17600,4512494
16462,17800,2018-05-17,0.041474654377880185,108500,104000,-4500,2664794
16463,17800,2018-05-16,0.10330578512396695,121000,108500,-12500,3197960
16464,17800,2018-05-15,0.056768558951965066,114500,121000,6500,1694259
16465,17800,2018-05-11,0.046948356807511735,106500,111500,5000,2048831
16466,17800,2018-05-09,0.11396303901437371,97400,108500,11100,2098580
16467,17800,2018-05-04,0.08116883116883117,92400,99900,7500,1151534
16468,17800,2018-05-03,0.07042253521126761,99400,92400,-7000,1066672
16469,17800,2018-05-02,0.04423076923076923,104000,99400,-4600,1787574
16470,17800,2018-04-30,0.10756123535676251,93900,104000,10100,2937539
16471,17800,2018-04-23,0.04757281553398058,103000,98100,-4900,2192213
16472,17800,2018-04-19,0.16331096196868009,89400,104000,14600,3455161
16473,17800,2018-04-18,0.053003533568904596,84900,89400,4500,1272875
16474,17800,2018-04-13,0.048239895697522815,76700,80400,3700,834721
16475,17800,2018-03-20,0.05088757396449704,84500,80200,-4300,795582
16476,17800,2018-03-19,0.13119143239625167,74700,84500,9800,1766991
16477,17800,2018-03-09,0.22620904836193448,64100,78600,14500,3150138
16478,17800,2018-03-07,0.0944055944055944,57200,62600,5400,1585083
16479,17800,2018-02-13,0.04569420035149385,56900,59500,2600,161112
16480,17800,2018-01-25,0.08013937282229965,57400,62000,4600,678319
16481,17800,2017-09-26,0.051991150442477874,45200,47550,2350,146903
16482,17800,2017-09-25,0.06418219461697723,48300,45200,-3100,203058
16483,17800,2017-07-31,0.05291005291005291,56700,53700,-3000,324167
16484,17800,2017-05-16,0.047987616099071206,64600,61500,-3100,352318
16485,17800,2017-05-04,0.04501607717041801,62200,65000,2800,249854
16486,17800,2017-04-26,0.04326123128119801,60100,62700,2600,324180
16487,17800,2017-03-24,0.04047217537942664,59300,61700,2400,460861
16488,17800,2017-02-10,0.043859649122807015,57000,59500,2500,300322
16489,17800,2017-02-03,0.04194630872483222,59600,57100,-2500,120240
16490,17800,2016-12-29,0.08506616257088846,52900,57400,4500,489098
16491,17800,2016-12-26,0.043478260869565216,55200,52800,-2400,266629
16492,17800,2016-11-30,0.04145936981757877,60300,57800,-2500,145899
16493,17800,2016-11-10,0.04310344827586207,58000,60500,2500,155323
16494,17800,2016-11-02,0.06944444444444445,57600,53600,-4000,210798
16495,17800,2016-10-31,0.05723905723905724,59400,56000,-3400,208138
16496,17800,2016-10-10,0.04173106646058733,64700,67400,2700,99119
16497,17800,2016-08-17,0.05116959064327485,68400,71900,3500,393504
16498,17800,2016-08-12,0.07874015748031496,63500,68500,5000,460056
16499,17800,2016-08-11,0.061872909698996656,59800,63500,3700,326893
16500,71050,2021-05-12,0.04090909090909091,110000,105500,-4500,573857
16501,71050,2021-05-03,0.049107142857142856,112000,106500,-5500,577530
16502,71050,2021-04-29,0.07112970711297072,119500,111000,-8500,724660
16503,71050,2021-04-26,0.05555555555555555,108000,114000,6000,522174
16504,71050,2021-04-20,0.057692307692307696,104000,110000,6000,584101
16505,71050,2021-04-08,0.0423728813559322,94400,98400,4000,1190539
16506,71050,2021-04-02,0.05023364485981308,85600,89900,4300,668505
16507,71050,2021-02-26,0.051086956521739134,92000,87300,-4700,952376
16508,71050,2021-02-15,0.05889145496535797,86600,91700,5100,920239
16509,71050,2021-02-01,0.04059040590405904,81300,84600,3300,378764
16510,71050,2021-01-29,0.05465116279069768,86000,81300,-4700,761747
16511,71050,2021-01-28,0.042316258351893093,89800,86000,-3800,794811
16512,71050,2021-01-19,0.04028436018957346,84400,87800,3400,404137
16513,71050,2021-01-06,0.04819277108433735,83000,87000,4000,1626783
16514,71050,2021-01-04,0.04177215189873418,79000,82300,3300,736512
16515,71050,2020-11-16,0.043243243243243246,74000,77200,3200,688676
16516,71050,2020-11-11,0.06482758620689655,72500,77200,4700,1057131
16517,71050,2020-10-21,0.055636896046852125,68300,72100,3800,467790
16518,71050,2020-09-22,0.0488771466314399,75700,72000,-3700,840493
16519,71050,2020-09-10,0.051248357424441525,76100,80000,3900,1103534
16520,71050,2020-09-08,0.046228710462287104,82200,78400,-3800,1534809
16521,71050,2020-09-07,0.19130434782608696,69000,82200,13200,3486985
16522,71050,2020-09-02,0.050793650793650794,63000,66200,3200,914269
16523,71050,2020-08-27,0.04146730462519936,62700,60100,-2600,452250
16524,71050,2020-08-25,0.0782312925170068,58800,63400,4600,602646
16525,71050,2020-08-20,0.051070840197693576,60700,57600,-3100,649718
16526,71050,2020-08-18,0.05642633228840126,63800,60200,-3600,885028
16527,71050,2020-08-10,0.1076158940397351,60400,66900,6500,1075156
16528,71050,2020-08-07,0.050434782608695654,57500,60400,2900,589577
16529,71050,2020-08-05,0.08582089552238806,53600,58200,4600,1189232
16530,71050,2020-08-04,0.046875,51200,53600,2400,606381
16531,71050,2020-08-03,0.0513347022587269,48700,51200,2500,603757
16532,71050,2020-07-21,0.045548654244306416,48300,50500,2200,653869
16533,71050,2020-07-13,0.053864168618266976,42700,45000,2300,428892
16534,71050,2020-06-16,0.048304213771839674,48650,51000,2350,336320
16535,71050,2020-06-15,0.0715648854961832,52400,48650,-3750,458717
16536,71050,2020-06-01,0.04554079696394687,52700,55100,2400,415894
16537,71050,2020-05-26,0.0421377183967112,48650,50700,2050,380488
16538,71050,2020-05-22,0.04873294346978557,51300,48800,-2500,398456
16539,71050,2020-05-19,0.07883369330453564,46300,49950,3650,705386
16540,71050,2020-05-04,0.04491017964071856,50100,47850,-2250,446697
16541,71050,2020-04-29,0.05584826132771338,47450,50100,2650,648728
16542,71050,2020-04-17,0.08030803080308031,45450,49100,3650,655648
16543,71050,2020-04-06,0.0447427293064877,44700,46700,2000,246932
16544,71050,2020-04-01,0.09547738693467336,49750,45000,-4750,363100
16545,71050,2020-03-25,0.2535760728218466,38450,48200,9750,746504
16546,71050,2020-03-24,0.2015625,32000,38450,6450,662454
16547,71050,2020-03-23,0.13630229419703105,37050,32000,-5050,721787
16548,71050,2020-03-20,0.05605095541401274,39250,37050,-2200,899740
16549,71050,2020-03-19,0.13830954994511527,45550,39250,-6300,410100
16550,71050,2020-03-18,0.058884297520661155,48400,45550,-2850,232774
16551,71050,2020-03-17,0.06019417475728155,51500,48400,-3100,332055
16552,71050,2020-03-16,0.060218978102189784,54800,51500,-3300,308312
16553,71050,2020-03-12,0.06403940886699508,60900,57000,-3900,333966
16554,71050,2020-03-09,0.04866562009419152,63700,60600,-3100,182042
16555,71050,2020-02-24,0.05697151424287856,66700,62900,-3800,202661
16556,71050,2020-02-06,0.059541984732824425,65500,69400,3900,252251
16557,71050,2020-01-28,0.06334231805929919,74200,69500,-4700,299548
16558,71050,2019-11-04,0.05341246290801187,67400,71000,3600,237029
16559,71050,2019-09-16,0.05858854860186418,75100,79500,4400,480508
16560,71050,2019-08-30,0.04782608695652174,69000,72300,3300,206692
16561,71050,2019-07-19,0.04177545691906005,76600,79800,3200,255920
16562,71050,2019-06-19,0.04832214765100671,74500,78100,3600,204042
16563,71050,2019-05-15,0.048265460030165915,66300,69500,3200,450492
16564,71050,2019-04-03,0.04984423676012461,64200,67400,3200,301116
16565,71050,2019-03-15,0.043478260869565216,62100,64800,2700,309458
16566,71050,2019-02-08,0.05927051671732523,65800,61900,-3900,305090
16567,71050,2019-01-24,0.04508856682769726,62100,64900,2800,242548
16568,71050,2019-01-15,0.0686106346483705,58300,62300,4000,322675
16569,71050,2019-01-07,0.05964912280701754,57000,60400,3400,261447
16570,71050,2019-01-02,0.043697478991596636,59500,56900,-2600,215914
16571,71050,2018-12-06,0.04129793510324484,67800,65000,-2800,210706
16572,71050,2018-11-02,0.07642276422764227,61500,66200,4700,335114
16573,71050,2018-10-23,0.048589341692789965,63800,60700,-3100,333163
16574,71050,2018-10-11,0.053353658536585365,65600,62100,-3500,467888
16575,71050,2018-10-10,0.058823529411764705,69700,65600,-4100,383586
16576,71050,2018-10-02,0.041005291005291,75600,72500,-3100,197568
16577,71050,2018-09-14,0.042335766423357665,68500,71400,2900,361384
16578,71050,2018-08-27,0.04838709677419355,68200,71500,3300,361223
16579,71050,2018-08-21,0.04747320061255743,65300,68400,3100,261581
16580,71050,2018-08-02,0.04184100418410042,71700,68700,-3000,201064
16581,71050,2018-07-16,0.04203821656050955,78500,75200,-3300,207663
16582,71050,2018-06-18,0.042458100558659215,89500,85700,-3800,294059
16583,71050,2018-06-14,0.048625792811839326,94600,90000,-4600,271973
16584,71050,2018-05-28,0.04250797024442083,94100,98100,4000,147478
16585,71050,2018-05-10,0.046964490263459335,87300,91400,4100,163452
16586,71050,2018-04-24,0.049338146811071,83100,87200,4100,311711
16587,71050,2018-04-13,0.0525,80000,84200,4200,326332
16588,71050,2018-03-12,0.04232164449818621,82700,86200,3500,278920
16589,71050,2018-03-09,0.07263294422827497,77100,82700,5600,349050
16590,71050,2018-02-28,0.05307599517490953,82900,78500,-4400,342919
16591,71050,2018-02-13,0.0430622009569378,83600,80000,-3600,354662
16592,71050,2018-01-23,0.06884057971014493,82800,88500,5700,350365
16593,71050,2018-01-12,0.08083441981747067,76700,82900,6200,498377
16594,71050,2018-01-08,0.0896551724137931,72500,79000,6500,288808
16595,71050,2018-01-05,0.0476878612716763,69200,72500,3300,239570
16596,71050,2017-11-14,0.041474654377880185,65100,67800,2700,276205
16597,71050,2017-10-12,0.0799347471451876,61300,66200,4900,441752
16598,71050,2017-08-03,0.05416666666666667,72000,68100,-3900,425818
16599,71050,2017-07-28,0.061391541609822645,73300,68800,-4500,491192
16600,71050,2017-06-09,0.05845181674565561,63300,67000,3700,351730
16601,71050,2017-05-16,0.061567164179104475,53600,56900,3300,473965
16602,71050,2017-04-21,0.04103671706263499,46300,48200,1900,276883
16603,71050,2016-11-18,0.05232558139534884,43000,40750,-2250,208463
16604,71050,2016-08-05,0.04293785310734463,44250,42350,-1900,241330
16605,10120,2021-03-09,0.06605504587155964,54500,58100,3600,281046
16606,10120,2021-02-26,0.04006677796327212,59900,57500,-2400,191700
16607,10120,2021-01-29,0.04503105590062112,64400,61500,-2900,363252
16608,10120,2021-01-28,0.04309063893016345,67300,64400,-2900,266697
16609,10120,2021-01-19,0.04420731707317073,65600,68500,2900,219416
16610,10120,2021-01-07,0.1393188854489164,64600,73600,9000,1136816
16611,10120,2020-12-22,0.0640625,64000,59900,-4100,358437
16612,10120,2020-12-21,0.07023411371237458,59800,64000,4200,495405
16613,10120,2020-12-10,0.05225225225225225,55500,58400,2900,650394
16614,10120,2020-12-09,0.055133079847908745,52600,55500,2900,330857
16615,10120,2020-11-23,0.05054151624548736,55400,58200,2800,392966
16616,10120,2020-11-09,0.05252918287937743,51400,54100,2700,262233
16617,10120,2020-11-05,0.04,50000,52000,2000,190472
16618,10120,2020-10-08,0.05326460481099656,58200,61300,3100,403270
16619,10120,2020-10-05,0.047787610619469026,56500,59200,2700,211949
16620,10120,2020-09-22,0.0547008547008547,58500,55300,-3200,227533
16621,10120,2020-09-08,0.08831908831908832,70200,64000,-6200,541738
16622,10120,2020-09-04,0.16722972972972974,59200,69100,9900,962836
16623,10120,2020-09-03,0.045936395759717315,56600,59200,2600,202273
16624,10120,2020-09-01,0.04990757855822551,54100,56800,2700,164389
16625,10120,2020-08-25,0.042884990253411304,51300,53500,2200,90711
16626,10120,2020-08-20,0.040152963671128104,52300,50200,-2100,134347
16627,10120,2020-08-18,0.05605786618444846,55300,52200,-3100,113168
16628,10120,2020-07-28,0.06333333333333334,60000,56200,-3800,311409
16629,10120,2020-07-23,0.047619047619047616,58800,61600,2800,251703
16630,10120,2020-07-22,0.05755395683453238,55600,58800,3200,252524
16631,10120,2020-07-13,0.053266331658291456,49750,52400,2650,164874
16632,10120,2020-06-24,0.053156146179401995,45150,47550,2400,204734
16633,10120,2020-06-16,0.041666666666666664,40800,42500,1700,125791
16634,10120,2020-06-15,0.06742857142857143,43750,40800,-2950,132101
16635,10120,2020-06-03,0.054371002132196165,46900,49450,2550,273224
16636,10120,2020-05-26,0.102803738317757,42800,47200,4400,299150
16637,10120,2020-05-21,0.05512820512820513,39000,41150,2150,200690
16638,10120,2020-04-07,0.06986301369863014,36500,39050,2550,152547
16639,10120,2020-04-06,0.06569343065693431,34250,36500,2250,122019
16640,10120,2020-03-31,0.05343511450381679,32750,34500,1750,175572
16641,10120,2020-03-26,0.050505050505050504,29700,31200,1500,262796
16642,10120,2020-03-25,0.07220216606498195,27700,29700,2000,263813
16643,10120,2020-03-24,0.041353383458646614,26600,27700,1100,258515
16644,10120,2020-03-23,0.10286677908937605,29650,26600,-3050,193141
16645,10120,2020-03-20,0.1360153256704981,26100,29650,3550,161714
16646,10120,2020-03-19,0.1152542372881356,29500,26100,-3400,204582
16647,10120,2020-03-18,0.07232704402515723,31800,29500,-2300,206515
16648,10120,2020-03-17,0.06881405563689605,34150,31800,-2350,210517
16649,10120,2020-03-16,0.05662983425414365,36200,34150,-2050,136240
16650,10120,2020-03-13,0.07179487179487179,39000,36200,-2800,167088
16651,10120,2020-03-12,0.05454545454545454,41250,39000,-2250,141781
16652,10120,2020-03-11,0.04844290657439446,43350,41250,-2100,76592
16653,10120,2020-02-28,0.041758241758241756,45500,43600,-1900,100121
16654,10120,2019-08-19,0.049596309111880045,43350,45500,2150,51665
16655,10120,2019-05-28,0.04004329004329004,46200,48050,1850,135181
16656,10120,2019-05-27,0.04054054054054054,44400,46200,1800,87820
16657,10120,2019-02-20,0.04770992366412214,52400,54900,2500,289427
16658,10120,2019-01-09,0.04512067156348373,47650,49800,2150,131528
16659,10120,2019-01-07,0.043243243243243246,46250,48250,2000,119444
16660,10120,2018-12-10,0.05223880597014925,53600,50800,-2800,113550
16661,10120,2018-12-07,0.042801556420233464,51400,53600,2200,126946
16662,10120,2018-11-20,0.04093567251461988,51300,49200,-2100,183173
16663,10120,2018-11-07,0.04043392504930966,50700,48650,-2050,200609
16664,10120,2018-11-05,0.046992481203007516,53200,50700,-2500,209527
16665,10120,2018-11-02,0.04518664047151277,50900,53200,2300,198450
16666,10120,2018-10-29,0.16191275167785235,59600,49950,-9650,537235
16667,10120,2018-10-08,0.04096045197740113,70800,67900,-2900,133715
16668,10120,2018-08-06,0.04043126684636118,74200,71200,-3000,102712
16669,10120,2018-07-27,0.052083333333333336,76800,72800,-4000,394065
16670,10120,2018-07-17,0.04613297150610583,73700,77100,3400,231920
16671,10120,2018-06-20,0.054016620498614956,72200,76100,3900,148947
16672,10120,2018-06-14,0.05037783375314862,79400,75400,-4000,158490
16673,10120,2018-05-29,0.05452292441140025,80700,76300,-4400,202445
16674,10120,2018-05-28,0.0994550408719346,73400,80700,7300,408835
16675,10120,2018-05-25,0.05412371134020619,77600,73400,-4200,342505
16676,10120,2018-05-14,0.049479166666666664,76800,80600,3800,409956
16677,10120,2018-05-10,0.0792507204610951,69400,74900,5500,354997
16678,10120,2018-05-08,0.05652759084791386,74300,70100,-4200,267436
16679,10120,2018-05-03,0.06794871794871794,78000,72700,-5300,344538
16680,10120,2018-05-02,0.13702623906705538,68600,78000,9400,768725
16681,10120,2018-04-30,0.04892966360856269,65400,68600,3200,352677
16682,10120,2018-03-12,0.0582010582010582,56700,60000,3300,221172
16683,10120,2018-02-19,0.06227106227106227,54600,58000,3400,239816
16684,10120,2018-02-05,0.040983606557377046,61000,58500,-2500,289038
16685,10120,2018-02-02,0.11594202898550725,69000,61000,-8000,639583
16686,10120,2018-01-10,0.05365126676602087,67100,70700,3600,170879
16687,10120,2017-12-15,0.0773109243697479,59500,64100,4600,166447
16688,10120,2017-12-14,0.052547770700636945,62800,59500,-3300,107088
16689,10120,2017-12-13,0.053691275167785234,59600,62800,3200,102663
16690,10120,2017-10-31,0.04903677758318739,57100,59900,2800,233419
16691,10120,2017-07-24,0.048417132216014895,53700,56300,2600,154364
16692,10120,2017-01-31,0.07115628970775095,39350,42150,2800,235783
16693,10120,2016-10-28,0.06916764361078546,42650,39700,-2950,369116
16694,4490,2021-06-02,0.059009483667017915,94900,100500,5600,390271
16695,4490,2021-05-25,0.04772234273318872,92200,96600,4400,215735
16696,4490,2021-05-21,0.05849889624724062,90600,95900,5300,618557
16697,4490,2021-05-18,0.056778679026651215,86300,91200,4900,228554
16698,4490,2021-05-17,0.04733009708737864,82400,86300,3900,129481
16699,4490,2021-04-20,0.04124860646599777,89700,93400,3700,358849
16700,4490,2021-04-13,0.18766066838046272,77800,92400,14600,2072771
16701,4490,2021-02-24,0.08415841584158416,101000,92500,-8500,396006
16702,4490,2021-02-22,0.04563106796116505,103000,98300,-4700,191801
16703,4490,2021-02-17,0.0547945205479452,109500,103500,-6000,225970
16704,4490,2021-02-09,0.06763285024154589,103500,110500,7000,407252
16705,4490,2021-02-05,0.04054054054054054,111000,106500,-4500,344962
16706,4490,2021-02-02,0.051587301587301584,126000,119500,-6500,960057
16707,4490,2021-02-01,0.2413793103448276,101500,126000,24500,1025713
16708,4490,2021-01-29,0.09777777777777778,112500,101500,-11000,837354
16709,4490,2021-01-28,0.13127413127413126,129500,112500,-17000,1051900
16710,4490,2021-01-27,0.16666666666666666,111000,129500,18500,768929
16711,4490,2021-01-25,0.06635071090047394,105500,112500,7000,377236
16712,4490,2021-01-22,0.09781477627471384,96100,105500,9400,681652
16713,4490,2021-01-19,0.16391509433962265,84800,98700,13900,941689
16714,4490,2021-01-15,0.06837606837606838,81900,87500,5600,524158
16715,4490,2021-01-12,0.05889145496535797,86600,81500,-5100,322303
16716,4490,2021-01-07,0.16025641025641027,78000,90500,12500,1626641
16717,4490,2021-01-06,0.08786610878661087,71700,78000,6300,626075
16718,4490,2021-01-05,0.044,75000,71700,-3300,358720
16719,4490,2021-01-04,0.08853410740203194,68900,75000,6100,653195
16720,4490,2020-12-28,0.06060606060606061,62700,66500,3800,338653
16721,4490,2020-12-23,0.29936305732484075,47100,61200,14100,2522085
16722,4490,2020-12-22,0.07827788649706457,51100,47100,-4000,276653
16723,4490,2020-12-18,0.1770956316410862,42350,49850,7500,837656
16724,4490,2020-12-14,0.0576036866359447,43400,40900,-2500,126500
16725,4490,2020-12-09,0.05385556915544676,40850,43050,2200,257053
16726,4490,2020-12-08,0.047435897435897434,39000,40850,1850,158211
16727,4490,2020-12-01,0.04100227790432802,43900,42100,-1800,212922
16728,4490,2020-11-30,0.04648390941597139,41950,43900,1950,209194
16729,4490,2020-11-27,0.09102730819245773,38450,41950,3500,153936
16730,4490,2020-11-20,0.058823529411764705,34000,36000,2000,142696
16731,4490,2020-11-16,0.06441717791411043,32600,34700,2100,248678
16732,4490,2020-08-20,0.07058823529411765,29750,27650,-2100,76149
16733,4490,2020-06-16,0.04738562091503268,30600,32050,1450,81670
16734,4490,2020-06-15,0.049689440993788817,32200,30600,-1600,67608
16735,4490,2020-06-09,0.04626865671641791,33500,31950,-1550,79881
16736,4490,2020-06-08,0.072,31250,33500,2250,112190
16737,4490,2020-05-26,0.0410958904109589,29200,30400,1200,63498
16738,4490,2020-05-04,0.04844290657439446,28900,27500,-1400,66798
16739,4490,2020-04-27,0.04159132007233273,27650,28800,1150,33804
16740,4490,2020-04-06,0.04854368932038835,25750,27000,1250,53056
16741,4490,2020-03-24,0.06304347826086956,23000,24450,1450,40210
16742,4490,2020-03-23,0.11538461538461539,26000,23000,-3000,48915
16743,4490,2020-03-20,0.15555555555555556,22500,26000,3500,56794
16744,4490,2020-03-19,0.11937377690802348,25550,22500,-3050,72914
16745,4490,2020-03-18,0.04127579737335835,26650,25550,-1100,43595
16746,4490,2020-03-13,0.06164383561643835,29200,27400,-1800,48732
16747,4490,2020-03-12,0.05194805194805195,30800,29200,-1600,43279
16748,4490,2020-02-06,0.04806201550387597,32250,33800,1550,23977
16749,4490,2019-11-13,0.04539559014267185,38550,40300,1750,26369
16750,4490,2019-10-16,0.050452781371280724,38650,40600,1950,20051
16751,4490,2019-07-25,0.04157043879907621,43300,41500,-1800,20809
16752,4490,2019-07-12,0.04503464203233257,43300,45250,1950,28837
16753,4490,2019-07-05,0.05734767025089606,41850,44250,2400,33112
16754,4490,2019-03-12,0.046674445740956826,42850,44850,2000,41025
16755,4490,2019-03-04,0.04342581423401689,41450,43250,1800,49845
16756,4490,2018-12-13,0.043824701195219126,37650,39300,1650,43182
16757,4490,2018-11-28,0.051351351351351354,37000,38900,1900,53929
16758,4490,2018-11-06,0.047619047619047616,35700,37400,1700,27870
16759,4490,2018-11-02,0.04698972099853157,34050,35650,1600,21014
16760,4490,2018-10-31,0.04154302670623145,33700,35100,1400,26170
16761,4490,2018-09-14,0.043243243243243246,37000,38600,1600,44955
16762,4490,2018-08-23,0.04035874439461883,33450,34800,1350,32978
16763,4490,2018-05-16,0.0481203007518797,33250,34850,1600,74635
16764,4490,2018-02-09,0.06160458452722063,34900,37050,2150,62462
16765,4490,2017-11-15,0.044977511244377814,33350,34850,1500,62157
16766,4490,2017-06-28,0.041666666666666664,38400,40000,1600,33111
16767,326030,2021-04-20,0.048458149779735685,113500,119000,5500,727766
16768,326030,2021-03-02,0.05084745762711865,118000,112000,-6000,1558796
16769,326030,2021-02-26,0.06349206349206349,126000,118000,-8000,1993882
16770,326030,2021-02-24,0.17288135593220338,147500,122000,-25500,12426682
16771,326030,2021-01-04,0.08579881656804733,169000,154500,-14500,3338448
16772,326030,2020-12-01,0.05333333333333334,187500,177500,-10000,667685
16773,326030,2020-11-27,0.05013927576601671,179500,188500,9000,911681
16774,326030,2020-11-04,0.06289308176100629,159000,169000,10000,913673
16775,326030,2020-10-21,0.041935483870967745,155000,161500,6500,449038
16776,326030,2020-10-05,0.10223642172523961,156500,140500,-16000,1368552
16777,326030,2020-09-11,0.051490514905149054,184500,175000,-9500,827865
16778,326030,2020-09-04,0.04395604395604396,182000,190000,8000,1263233
16779,326030,2020-09-02,0.06140350877192982,171000,181500,10500,1273960
16780,326030,2020-09-01,0.045871559633027525,163500,171000,7500,388140
16781,326030,2020-08-18,0.04201680672268908,178500,171000,-7500,429385
16782,326030,2020-08-14,0.04032258064516129,186000,178500,-7500,512876
16783,326030,2020-08-10,0.07541899441340782,179000,192500,13500,1791403
16784,326030,2020-07-17,0.04087193460490463,183500,191000,7500,1109080
16785,326030,2020-07-15,0.0610079575596817,188500,177000,-11500,1859251
16786,326030,2020-07-14,0.052763819095477386,199000,188500,-10500,1389588
16787,326030,2020-07-09,0.052995391705069124,217000,205500,-11500,1897646
16788,326030,2020-07-06,0.3,165000,214500,49500,7126211
16789,326030,2020-07-03,0.2992125984251969,127000,165000,38000,711921
16790,326030,2020-07-02,0.15384615384615385,188500,127000,-61500,698642
16791,326030,2020-07-14,0.052763819095477386,199000,188500,-10500,1389588
16792,326030,2020-07-09,0.052995391705069124,217000,205500,-11500,1897646
16793,326030,2020-07-06,0.3,165000,214500,49500,7126211
16794,326030,2020-07-03,0.2992125984251969,127000,165000,38000,711921
16795,326030,2020-07-02,0.15384615384615385,188500,127000,-61500,698642
16796,326030,2020-07-14,0.052763819095477386,199000,188500,-10500,1389588
16797,326030,2020-07-09,0.052995391705069124,217000,205500,-11500,1897646
16798,326030,2020-07-06,0.3,165000,214500,49500,7126211
16799,326030,2020-07-03,0.2992125984251969,127000,165000,38000,711921
16800,326030,2020-07-02,0.15384615384615385,188500,127000,-61500,698642
16801,326030,2020-07-14,0.052763819095477386,199000,188500,-10500,1389588
16802,326030,2020-07-09,0.052995391705069124,217000,205500,-11500,1897646
16803,326030,2020-07-06,0.3,165000,214500,49500,7126211
16804,326030,2020-07-03,0.2992125984251969,127000,165000,38000,711921
16805,326030,2020-07-02,0.15384615384615385,188500,127000,-61500,698642
16806,326030,2020-07-14,0.052763819095477386,199000,188500,-10500,1389588
16807,326030,2020-07-09,0.052995391705069124,217000,205500,-11500,1897646
16808,326030,2020-07-06,0.3,165000,214500,49500,7126211
16809,326030,2020-07-03,0.2992125984251969,127000,165000,38000,711921
16810,326030,2020-07-02,0.15384615384615385,188500,127000,-61500,698642
16811,326030,2020-07-14,0.052763819095477386,199000,188500,-10500,1389588
16812,326030,2020-07-09,0.052995391705069124,217000,205500,-11500,1897646
16813,326030,2020-07-06,0.3,165000,214500,49500,7126211
16814,326030,2020-07-03,0.2992125984251969,127000,165000,38000,711921
16815,326030,2020-07-02,0.15384615384615385,188500,127000,-61500,698642
16816,326030,2020-07-14,0.052763819095477386,199000,188500,-10500,1389588
16817,326030,2020-07-09,0.052995391705069124,217000,205500,-11500,1897646
16818,326030,2020-07-06,0.3,165000,214500,49500,7126211
16819,326030,2020-07-03,0.2992125984251969,127000,165000,38000,711921
16820,326030,2020-07-02,0.15384615384615385,188500,127000,-61500,698642
16821,326030,2020-07-14,0.052763819095477386,199000,188500,-10500,1389588
16822,326030,2020-07-09,0.052995391705069124,217000,205500,-11500,1897646
16823,326030,2020-07-06,0.3,165000,214500,49500,7126211
16824,326030,2020-07-03,0.2992125984251969,127000,165000,38000,711921
16825,326030,2020-07-02,0.15384615384615385,188500,127000,-61500,698642
16826,326030,2020-07-14,0.052763819095477386,199000,188500,-10500,1389588
16827,326030,2020-07-09,0.052995391705069124,217000,205500,-11500,1897646
16828,326030,2020-07-06,0.3,165000,214500,49500,7126211
16829,326030,2020-07-03,0.2992125984251969,127000,165000,38000,711921
16830,326030,2020-07-02,0.15384615384615385,188500,127000,-61500,698642
16831,326030,2020-07-14,0.052763819095477386,199000,188500,-10500,1389588
16832,326030,2020-07-09,0.052995391705069124,217000,205500,-11500,1897646
16833,326030,2020-07-06,0.3,165000,214500,49500,7126211
16834,326030,2020-07-03,0.2992125984251969,127000,165000,38000,711921
16835,326030,2020-07-02,0.15384615384615385,188500,127000,-61500,698642
16836,326030,2020-07-14,0.052763819095477386,199000,188500,-10500,1389588
16837,326030,2020-07-09,0.052995391705069124,217000,205500,-11500,1897646
16838,326030,2020-07-06,0.3,165000,214500,49500,7126211
16839,326030,2020-07-03,0.2992125984251969,127000,165000,38000,711921
16840,326030,2020-07-02,0.15384615384615385,188500,127000,-61500,698642
16841,326030,2020-07-14,0.052763819095477386,199000,188500,-10500,1389588
16842,326030,2020-07-09,0.052995391705069124,217000,205500,-11500,1897646
16843,326030,2020-07-06,0.3,165000,214500,49500,7126211
16844,326030,2020-07-03,0.2992125984251969,127000,165000,38000,711921
16845,326030,2020-07-02,0.15384615384615385,188500,127000,-61500,698642
16846,326030,2020-07-14,0.052763819095477386,199000,188500,-10500,1389588
16847,326030,2020-07-09,0.052995391705069124,217000,205500,-11500,1897646
16848,326030,2020-07-06,0.3,165000,214500,49500,7126211
16849,326030,2020-07-03,0.2992125984251969,127000,165000,38000,711921
16850,326030,2020-07-02,0.15384615384615385,188500,127000,-61500,698642
16851,326030,2020-07-14,0.052763819095477386,199000,188500,-10500,1389588
16852,326030,2020-07-09,0.052995391705069124,217000,205500,-11500,1897646
16853,326030,2020-07-06,0.3,165000,214500,49500,7126211
16854,326030,2020-07-03,0.2992125984251969,127000,165000,38000,711921
16855,326030,2020-07-02,0.15384615384615385,188500,127000,-61500,698642
16856,326030,2020-07-14,0.052763819095477386,199000,188500,-10500,1389588
16857,326030,2020-07-09,0.052995391705069124,217000,205500,-11500,1897646
16858,326030,2020-07-06,0.3,165000,214500,49500,7126211
16859,326030,2020-07-03,0.2992125984251969,127000,165000,38000,711921
16860,326030,2020-07-02,0.15384615384615385,188500,127000,-61500,698642
16861,326030,2020-07-14,0.052763819095477386,199000,188500,-10500,1389588
16862,326030,2020-07-09,0.052995391705069124,217000,205500,-11500,1897646
16863,326030,2020-07-06,0.3,165000,214500,49500,7126211
16864,326030,2020-07-03,0.2992125984251969,127000,165000,38000,711921
16865,326030,2020-07-02,0.15384615384615385,188500,127000,-61500,698642
16866,326030,2020-07-14,0.052763819095477386,199000,188500,-10500,1389588
16867,326030,2020-07-09,0.052995391705069124,217000,205500,-11500,1897646
16868,326030,2020-07-06,0.3,165000,214500,49500,7126211
16869,326030,2020-07-03,0.2992125984251969,127000,165000,38000,711921
16870,326030,2020-07-02,0.15384615384615385,188500,127000,-61500,698642
16871,326030,2020-07-14,0.052763819095477386,199000,188500,-10500,1389588
16872,326030,2020-07-09,0.052995391705069124,217000,205500,-11500,1897646
16873,326030,2020-07-06,0.3,165000,214500,49500,7126211
16874,326030,2020-07-03,0.2992125984251969,127000,165000,38000,711921
16875,326030,2020-07-02,0.15384615384615385,188500,127000,-61500,698642
16876,326030,2020-07-14,0.052763819095477386,199000,188500,-10500,1389588
16877,326030,2020-07-09,0.052995391705069124,217000,205500,-11500,1897646
16878,326030,2020-07-06,0.3,165000,214500,49500,7126211
16879,326030,2020-07-03,0.2992125984251969,127000,165000,38000,711921
16880,326030,2020-07-02,0.15384615384615385,188500,127000,-61500,698642
16881,326030,2020-07-14,0.052763819095477386,199000,188500,-10500,1389588
16882,326030,2020-07-09,0.052995391705069124,217000,205500,-11500,1897646
16883,326030,2020-07-06,0.3,165000,214500,49500,7126211
16884,326030,2020-07-03,0.2992125984251969,127000,165000,38000,711921
16885,326030,2020-07-02,0.15384615384615385,188500,127000,-61500,698642
16886,326030,2020-07-14,0.052763819095477386,199000,188500,-10500,1389588
16887,326030,2020-07-09,0.052995391705069124,217000,205500,-11500,1897646
16888,326030,2020-07-06,0.3,165000,214500,49500,7126211
16889,326030,2020-07-03,0.2992125984251969,127000,165000,38000,711921
16890,326030,2020-07-02,0.15384615384615385,188500,127000,-61500,698642
16891,326030,2020-07-14,0.052763819095477386,199000,188500,-10500,1389588
16892,326030,2020-07-09,0.052995391705069124,217000,205500,-11500,1897646
16893,326030,2020-07-06,0.3,165000,214500,49500,7126211
16894,326030,2020-07-03,0.2992125984251969,127000,165000,38000,711921
16895,326030,2020-07-02,0.15384615384615385,188500,127000,-61500,698642
16896,326030,2020-07-14,0.052763819095477386,199000,188500,-10500,1389588
16897,326030,2020-07-09,0.052995391705069124,217000,205500,-11500,1897646
16898,326030,2020-07-06,0.3,165000,214500,49500,7126211
16899,326030,2020-07-03,0.2992125984251969,127000,165000,38000,711921
16900,326030,2020-07-02,0.15384615384615385,188500,127000,-61500,698642
16901,326030,2020-07-14,0.052763819095477386,199000,188500,-10500,1389588
16902,326030,2020-07-09,0.052995391705069124,217000,205500,-11500,1897646
16903,326030,2020-07-06,0.3,165000,214500,49500,7126211
16904,326030,2020-07-03,0.2992125984251969,127000,165000,38000,711921
16905,326030,2020-07-02,0.15384615384615385,188500,127000,-61500,698642
16906,326030,2020-07-14,0.052763819095477386,199000,188500,-10500,1389588
16907,326030,2020-07-09,0.052995391705069124,217000,205500,-11500,1897646
16908,326030,2020-07-06,0.3,165000,214500,49500,7126211
16909,326030,2020-07-03,0.2992125984251969,127000,165000,38000,711921
16910,326030,2020-07-02,0.15384615384615385,188500,127000,-61500,698642
16911,326030,2020-07-14,0.052763819095477386,199000,188500,-10500,1389588
16912,326030,2020-07-09,0.052995391705069124,217000,205500,-11500,1897646
16913,326030,2020-07-06,0.3,165000,214500,49500,7126211
16914,326030,2020-07-03,0.2992125984251969,127000,165000,38000,711921
16915,326030,2020-07-02,0.15384615384615385,188500,127000,-61500,698642
16916,326030,2020-07-14,0.052763819095477386,199000,188500,-10500,1389588
16917,326030,2020-07-09,0.052995391705069124,217000,205500,-11500,1897646
16918,326030,2020-07-06,0.3,165000,214500,49500,7126211
16919,326030,2020-07-03,0.2992125984251969,127000,165000,38000,711921
16920,326030,2020-07-02,0.15384615384615385,188500,127000,-61500,698642
16921,326030,2020-07-14,0.052763819095477386,199000,188500,-10500,1389588
16922,326030,2020-07-09,0.052995391705069124,217000,205500,-11500,1897646
16923,326030,2020-07-06,0.3,165000,214500,49500,7126211
16924,326030,2020-07-03,0.2992125984251969,127000,165000,38000,711921
16925,326030,2020-07-02,0.15384615384615385,188500,127000,-61500,698642
16926,326030,2020-07-14,0.052763819095477386,199000,188500,-10500,1389588
16927,326030,2020-07-09,0.052995391705069124,217000,205500,-11500,1897646
16928,326030,2020-07-06,0.3,165000,214500,49500,7126211
16929,326030,2020-07-03,0.2992125984251969,127000,165000,38000,711921
16930,326030,2020-07-02,0.15384615384615385,188500,127000,-61500,698642
16931,326030,2020-07-14,0.052763819095477386,199000,188500,-10500,1389588
16932,326030,2020-07-09,0.052995391705069124,217000,205500,-11500,1897646
16933,326030,2020-07-06,0.3,165000,214500,49500,7126211
16934,326030,2020-07-03,0.2992125984251969,127000,165000,38000,711921
16935,326030,2020-07-02,0.15384615384615385,188500,127000,-61500,698642
16936,326030,2020-07-14,0.052763819095477386,199000,188500,-10500,1389588
16937,326030,2020-07-09,0.052995391705069124,217000,205500,-11500,1897646
16938,326030,2020-07-06,0.3,165000,214500,49500,7126211
16939,326030,2020-07-03,0.2992125984251969,127000,165000,38000,711921
16940,326030,2020-07-02,0.15384615384615385,188500,127000,-61500,698642
16941,326030,2020-07-14,0.052763819095477386,199000,188500,-10500,1389588
16942,326030,2020-07-09,0.052995391705069124,217000,205500,-11500,1897646
16943,326030,2020-07-06,0.3,165000,214500,49500,7126211
16944,326030,2020-07-03,0.2992125984251969,127000,165000,38000,711921
16945,326030,2020-07-02,0.15384615384615385,188500,127000,-61500,698642
16946,326030,2020-07-14,0.052763819095477386,199000,188500,-10500,1389588
16947,326030,2020-07-09,0.052995391705069124,217000,205500,-11500,1897646
16948,326030,2020-07-06,0.3,165000,214500,49500,7126211
16949,326030,2020-07-03,0.2992125984251969,127000,165000,38000,711921
16950,326030,2020-07-02,0.15384615384615385,188500,127000,-61500,698642
16951,326030,2020-07-14,0.052763819095477386,199000,188500,-10500,1389588
16952,326030,2020-07-09,0.052995391705069124,217000,205500,-11500,1897646
16953,326030,2020-07-06,0.3,165000,214500,49500,7126211
16954,326030,2020-07-03,0.2992125984251969,127000,165000,38000,711921
16955,326030,2020-07-02,0.15384615384615385,188500,127000,-61500,698642
16956,326030,2020-07-14,0.052763819095477386,199000,188500,-10500,1389588
16957,326030,2020-07-09,0.052995391705069124,217000,205500,-11500,1897646
16958,326030,2020-07-06,0.3,165000,214500,49500,7126211
16959,326030,2020-07-03,0.2992125984251969,127000,165000,38000,711921
16960,326030,2020-07-02,0.15384615384615385,188500,127000,-61500,698642
16961,326030,2020-07-14,0.052763819095477386,199000,188500,-10500,1389588
16962,326030,2020-07-09,0.052995391705069124,217000,205500,-11500,1897646
16963,326030,2020-07-06,0.3,165000,214500,49500,7126211
16964,326030,2020-07-03,0.2992125984251969,127000,165000,38000,711921
16965,326030,2020-07-02,0.15384615384615385,188500,127000,-61500,698642
16966,326030,2020-07-14,0.052763819095477386,199000,188500,-10500,1389588
16967,326030,2020-07-09,0.052995391705069124,217000,205500,-11500,1897646
16968,326030,2020-07-06,0.3,165000,214500,49500,7126211
16969,326030,2020-07-03,0.2992125984251969,127000,165000,38000,711921
16970,326030,2020-07-02,0.15384615384615385,188500,127000,-61500,698642
16971,326030,2020-07-14,0.052763819095477386,199000,188500,-10500,1389588
16972,326030,2020-07-09,0.052995391705069124,217000,205500,-11500,1897646
16973,326030,2020-07-06,0.3,165000,214500,49500,7126211
16974,326030,2020-07-03,0.2992125984251969,127000,165000,38000,711921
16975,326030,2020-07-02,0.15384615384615385,188500,127000,-61500,698642
16976,326030,2020-07-14,0.052763819095477386,199000,188500,-10500,1389588
16977,326030,2020-07-09,0.052995391705069124,217000,205500,-11500,1897646
16978,326030,2020-07-06,0.3,165000,214500,49500,7126211
16979,326030,2020-07-03,0.2992125984251969,127000,165000,38000,711921
16980,326030,2020-07-02,0.15384615384615385,188500,127000,-61500,698642
16981,326030,2020-07-14,0.052763819095477386,199000,188500,-10500,1389588
16982,326030,2020-07-09,0.052995391705069124,217000,205500,-11500,1897646
16983,326030,2020-07-06,0.3,165000,214500,49500,7126211
16984,326030,2020-07-03,0.2992125984251969,127000,165000,38000,711921
16985,326030,2020-07-02,0.15384615384615385,188500,127000,-61500,698642
16986,326030,2020-07-14,0.052763819095477386,199000,188500,-10500,1389588
16987,326030,2020-07-09,0.052995391705069124,217000,205500,-11500,1897646
16988,326030,2020-07-06,0.3,165000,214500,49500,7126211
16989,326030,2020-07-03,0.2992125984251969,127000,165000,38000,711921
16990,326030,2020-07-02,0.15384615384615385,188500,127000,-61500,698642
16991,326030,2020-07-14,0.052763819095477386,199000,188500,-10500,1389588
16992,326030,2020-07-09,0.052995391705069124,217000,205500,-11500,1897646
16993,326030,2020-07-06,0.3,165000,214500,49500,7126211
16994,326030,2020-07-03,0.2992125984251969,127000,165000,38000,711921
16995,326030,2020-07-02,0.15384615384615385,188500,127000,-61500,698642
16996,326030,2020-07-14,0.052763819095477386,199000,188500,-10500,1389588
16997,326030,2020-07-09,0.052995391705069124,217000,205500,-11500,1897646
16998,326030,2020-07-06,0.3,165000,214500,49500,7126211
16999,326030,2020-07-03,0.2992125984251969,127000,165000,38000,711921
17000,326030,2020-07-02,0.15384615384615385,188500,127000,-61500,698642
17001,326030,2020-07-14,0.052763819095477386,199000,188500,-10500,1389588
17002,326030,2020-07-09,0.052995391705069124,217000,205500,-11500,1897646
17003,326030,2020-07-06,0.3,165000,214500,49500,7126211
17004,326030,2020-07-03,0.2992125984251969,127000,165000,38000,711921
17005,326030,2020-07-02,0.15384615384615385,188500,127000,-61500,698642
17006,326030,2020-07-14,0.052763819095477386,199000,188500,-10500,1389588
17007,326030,2020-07-09,0.052995391705069124,217000,205500,-11500,1897646
17008,326030,2020-07-06,0.3,165000,214500,49500,7126211
17009,326030,2020-07-03,0.2992125984251969,127000,165000,38000,711921
17010,326030,2020-07-02,0.15384615384615385,188500,127000,-61500,698642
17011,326030,2020-07-14,0.052763819095477386,199000,188500,-10500,1389588
17012,326030,2020-07-09,0.052995391705069124,217000,205500,-11500,1897646
17013,326030,2020-07-06,0.3,165000,214500,49500,7126211
17014,326030,2020-07-03,0.2992125984251969,127000,165000,38000,711921
17015,326030,2020-07-02,0.15384615384615385,188500,127000,-61500,698642
17016,326030,2020-07-14,0.052763819095477386,199000,188500,-10500,1389588
17017,326030,2020-07-09,0.052995391705069124,217000,205500,-11500,1897646
17018,326030,2020-07-06,0.3,165000,214500,49500,7126211
17019,326030,2020-07-03,0.2992125984251969,127000,165000,38000,711921
17020,326030,2020-07-02,0.15384615384615385,188500,127000,-61500,698642
17021,326030,2020-07-14,0.052763819095477386,199000,188500,-10500,1389588
17022,326030,2020-07-09,0.052995391705069124,217000,205500,-11500,1897646
17023,326030,2020-07-06,0.3,165000,214500,49500,7126211
17024,326030,2020-07-03,0.2992125984251969,127000,165000,38000,711921
17025,326030,2020-07-02,0.15384615384615385,188500,127000,-61500,698642
17026,326030,2020-07-14,0.052763819095477386,199000,188500,-10500,1389588
17027,326030,2020-07-09,0.052995391705069124,217000,205500,-11500,1897646
17028,326030,2020-07-06,0.3,165000,214500,49500,7126211
17029,326030,2020-07-03,0.2992125984251969,127000,165000,38000,711921
17030,326030,2020-07-02,0.15384615384615385,188500,127000,-61500,698642
17031,326030,2020-07-14,0.052763819095477386,199000,188500,-10500,1389588
17032,326030,2020-07-09,0.052995391705069124,217000,205500,-11500,1897646
17033,326030,2020-07-06,0.3,165000,214500,49500,7126211
17034,326030,2020-07-03,0.2992125984251969,127000,165000,38000,711921
17035,326030,2020-07-02,0.15384615384615385,188500,127000,-61500,698642
17036,326030,2020-07-14,0.052763819095477386,199000,188500,-10500,1389588
17037,326030,2020-07-09,0.052995391705069124,217000,205500,-11500,1897646
17038,326030,2020-07-06,0.3,165000,214500,49500,7126211
17039,326030,2020-07-03,0.2992125984251969,127000,165000,38000,711921
17040,326030,2020-07-02,0.15384615384615385,188500,127000,-61500,698642
17041,326030,2020-07-14,0.052763819095477386,199000,188500,-10500,1389588
17042,326030,2020-07-09,0.052995391705069124,217000,205500,-11500,1897646
17043,326030,2020-07-06,0.3,165000,214500,49500,7126211
17044,326030,2020-07-03,0.2992125984251969,127000,165000,38000,711921
17045,326030,2020-07-02,0.15384615384615385,188500,127000,-61500,698642
17046,326030,2020-07-14,0.052763819095477386,199000,188500,-10500,1389588
17047,326030,2020-07-09,0.052995391705069124,217000,205500,-11500,1897646
17048,326030,2020-07-06,0.3,165000,214500,49500,7126211
17049,326030,2020-07-03,0.2992125984251969,127000,165000,38000,711921
17050,326030,2020-07-02,0.15384615384615385,188500,127000,-61500,698642
17051,326030,2020-07-14,0.052763819095477386,199000,188500,-10500,1389588
17052,326030,2020-07-09,0.052995391705069124,217000,205500,-11500,1897646
17053,326030,2020-07-06,0.3,165000,214500,49500,7126211
17054,326030,2020-07-03,0.2992125984251969,127000,165000,38000,711921
17055,326030,2020-07-02,0.15384615384615385,188500,127000,-61500,698642
17056,326030,2020-07-14,0.052763819095477386,199000,188500,-10500,1389588
17057,326030,2020-07-09,0.052995391705069124,217000,205500,-11500,1897646
17058,326030,2020-07-06,0.3,165000,214500,49500,7126211
17059,326030,2020-07-03,0.2992125984251969,127000,165000,38000,711921
17060,326030,2020-07-02,0.15384615384615385,188500,127000,-61500,698642
17061,326030,2020-07-14,0.052763819095477386,199000,188500,-10500,1389588
17062,326030,2020-07-09,0.052995391705069124,217000,205500,-11500,1897646
17063,326030,2020-07-06,0.3,165000,214500,49500,7126211
17064,326030,2020-07-03,0.2992125984251969,127000,165000,38000,711921
17065,326030,2020-07-02,0.15384615384615385,188500,127000,-61500,698642
17066,326030,2020-07-14,0.052763819095477386,199000,188500,-10500,1389588
17067,326030,2020-07-09,0.052995391705069124,217000,205500,-11500,1897646
17068,326030,2020-07-06,0.3,165000,214500,49500,7126211
17069,326030,2020-07-03,0.2992125984251969,127000,165000,38000,711921
17070,326030,2020-07-02,0.15384615384615385,188500,127000,-61500,698642
17071,326030,2020-07-14,0.052763819095477386,199000,188500,-10500,1389588
17072,326030,2020-07-09,0.052995391705069124,217000,205500,-11500,1897646
17073,326030,2020-07-06,0.3,165000,214500,49500,7126211
17074,326030,2020-07-03,0.2992125984251969,127000,165000,38000,711921
17075,326030,2020-07-02,0.15384615384615385,188500,127000,-61500,698642
17076,326030,2020-07-14,0.052763819095477386,199000,188500,-10500,1389588
17077,326030,2020-07-09,0.052995391705069124,217000,205500,-11500,1897646
17078,326030,2020-07-06,0.3,165000,214500,49500,7126211
17079,326030,2020-07-03,0.2992125984251969,127000,165000,38000,711921
17080,326030,2020-07-02,0.15384615384615385,188500,127000,-61500,698642
17081,326030,2020-07-14,0.052763819095477386,199000,188500,-10500,1389588
17082,326030,2020-07-09,0.052995391705069124,217000,205500,-11500,1897646
17083,326030,2020-07-06,0.3,165000,214500,49500,7126211
17084,326030,2020-07-03,0.2992125984251969,127000,165000,38000,711921
17085,326030,2020-07-02,0.15384615384615385,188500,127000,-61500,698642
17086,326030,2020-07-14,0.052763819095477386,199000,188500,-10500,1389588
17087,326030,2020-07-09,0.052995391705069124,217000,205500,-11500,1897646
17088,326030,2020-07-06,0.3,165000,214500,49500,7126211
17089,326030,2020-07-03,0.2992125984251969,127000,165000,38000,711921
17090,326030,2020-07-02,0.15384615384615385,188500,127000,-61500,698642
17091,326030,2020-07-14,0.052763819095477386,199000,188500,-10500,1389588
17092,326030,2020-07-09,0.052995391705069124,217000,205500,-11500,1897646
17093,326030,2020-07-06,0.3,165000,214500,49500,7126211
17094,326030,2020-07-03,0.2992125984251969,127000,165000,38000,711921
17095,326030,2020-07-02,0.15384615384615385,188500,127000,-61500,698642
17096,326030,2020-07-14,0.052763819095477386,199000,188500,-10500,1389588
17097,326030,2020-07-09,0.052995391705069124,217000,205500,-11500,1897646
17098,326030,2020-07-06,0.3,165000,214500,49500,7126211
17099,326030,2020-07-03,0.2992125984251969,127000,165000,38000,711921
17100,326030,2020-07-02,0.15384615384615385,188500,127000,-61500,698642
17101,326030,2020-07-14,0.052763819095477386,199000,188500,-10500,1389588
17102,326030,2020-07-09,0.052995391705069124,217000,205500,-11500,1897646
17103,326030,2020-07-06,0.3,165000,214500,49500,7126211
17104,326030,2020-07-03,0.2992125984251969,127000,165000,38000,711921
17105,326030,2020-07-02,0.15384615384615385,188500,127000,-61500,698642
17106,326030,2020-07-14,0.052763819095477386,199000,188500,-10500,1389588
17107,326030,2020-07-09,0.052995391705069124,217000,205500,-11500,1897646
17108,326030,2020-07-06,0.3,165000,214500,49500,7126211
17109,326030,2020-07-03,0.2992125984251969,127000,165000,38000,711921
17110,326030,2020-07-02,0.15384615384615385,188500,127000,-61500,698642
17111,326030,2020-07-14,0.052763819095477386,199000,188500,-10500,1389588
17112,326030,2020-07-09,0.052995391705069124,217000,205500,-11500,1897646
17113,326030,2020-07-06,0.3,165000,214500,49500,7126211
17114,326030,2020-07-03,0.2992125984251969,127000,165000,38000,711921
17115,326030,2020-07-02,0.15384615384615385,188500,127000,-61500,698642
17116,326030,2020-07-14,0.052763819095477386,199000,188500,-10500,1389588
17117,326030,2020-07-09,0.052995391705069124,217000,205500,-11500,1897646
17118,326030,2020-07-06,0.3,165000,214500,49500,7126211
17119,326030,2020-07-03,0.2992125984251969,127000,165000,38000,711921
17120,326030,2020-07-02,0.15384615384615385,188500,127000,-61500,698642
17121,326030,2020-07-14,0.052763819095477386,199000,188500,-10500,1389588
17122,326030,2020-07-09,0.052995391705069124,217000,205500,-11500,1897646
17123,326030,2020-07-06,0.3,165000,214500,49500,7126211
17124,326030,2020-07-03,0.2992125984251969,127000,165000,38000,711921
17125,326030,2020-07-02,0.15384615384615385,188500,127000,-61500,698642
17126,326030,2020-07-14,0.052763819095477386,199000,188500,-10500,1389588
17127,326030,2020-07-09,0.052995391705069124,217000,205500,-11500,1897646
17128,326030,2020-07-06,0.3,165000,214500,49500,7126211
17129,326030,2020-07-03,0.2992125984251969,127000,165000,38000,711921
17130,326030,2020-07-02,0.15384615384615385,188500,127000,-61500,698642
17131,326030,2020-07-14,0.052763819095477386,199000,188500,-10500,1389588
17132,326030,2020-07-09,0.052995391705069124,217000,205500,-11500,1897646
17133,326030,2020-07-06,0.3,165000,214500,49500,7126211
17134,326030,2020-07-03,0.2992125984251969,127000,165000,38000,711921
17135,326030,2020-07-02,0.15384615384615385,188500,127000,-61500,698642
17136,326030,2020-07-14,0.052763819095477386,199000,188500,-10500,1389588
17137,326030,2020-07-09,0.052995391705069124,217000,205500,-11500,1897646
17138,326030,2020-07-06,0.3,165000,214500,49500,7126211
17139,326030,2020-07-03,0.2992125984251969,127000,165000,38000,711921
17140,326030,2020-07-02,0.15384615384615385,188500,127000,-61500,698642
17141,326030,2020-07-14,0.052763819095477386,199000,188500,-10500,1389588
17142,326030,2020-07-09,0.052995391705069124,217000,205500,-11500,1897646
17143,326030,2020-07-06,0.3,165000,214500,49500,7126211
17144,326030,2020-07-03,0.2992125984251969,127000,165000,38000,711921
17145,326030,2020-07-02,0.15384615384615385,188500,127000,-61500,698642
17146,326030,2020-07-14,0.052763819095477386,199000,188500,-10500,1389588
17147,326030,2020-07-09,0.052995391705069124,217000,205500,-11500,1897646
17148,326030,2020-07-06,0.3,165000,214500,49500,7126211
17149,326030,2020-07-03,0.2992125984251969,127000,165000,38000,711921
17150,326030,2020-07-02,0.15384615384615385,188500,127000,-61500,698642
17151,326030,2020-07-14,0.052763819095477386,199000,188500,-10500,1389588
17152,326030,2020-07-09,0.052995391705069124,217000,205500,-11500,1897646
17153,326030,2020-07-06,0.3,165000,214500,49500,7126211
17154,326030,2020-07-03,0.2992125984251969,127000,165000,38000,711921
17155,326030,2020-07-02,0.15384615384615385,188500,127000,-61500,698642
17156,326030,2020-07-14,0.052763819095477386,199000,188500,-10500,1389588
17157,326030,2020-07-09,0.052995391705069124,217000,205500,-11500,1897646
17158,326030,2020-07-06,0.3,165000,214500,49500,7126211
17159,326030,2020-07-03,0.2992125984251969,127000,165000,38000,711921
17160,326030,2020-07-02,0.15384615384615385,188500,127000,-61500,698642
17161,326030,2020-07-14,0.052763819095477386,199000,188500,-10500,1389588
17162,326030,2020-07-09,0.052995391705069124,217000,205500,-11500,1897646
17163,326030,2020-07-06,0.3,165000,214500,49500,7126211
17164,326030,2020-07-03,0.2992125984251969,127000,165000,38000,711921
17165,326030,2020-07-02,0.15384615384615385,188500,127000,-61500,698642
17166,326030,2020-07-14,0.052763819095477386,199000,188500,-10500,1389588
17167,326030,2020-07-09,0.052995391705069124,217000,205500,-11500,1897646
17168,326030,2020-07-06,0.3,165000,214500,49500,7126211
17169,326030,2020-07-03,0.2992125984251969,127000,165000,38000,711921
17170,326030,2020-07-02,0.15384615384615385,188500,127000,-61500,698642
17171,326030,2020-07-14,0.052763819095477386,199000,188500,-10500,1389588
17172,326030,2020-07-09,0.052995391705069124,217000,205500,-11500,1897646
17173,326030,2020-07-06,0.3,165000,214500,49500,7126211
17174,326030,2020-07-03,0.2992125984251969,127000,165000,38000,711921
17175,326030,2020-07-02,0.15384615384615385,188500,127000,-61500,698642
17176,326030,2020-07-14,0.052763819095477386,199000,188500,-10500,1389588
17177,326030,2020-07-09,0.052995391705069124,217000,205500,-11500,1897646
17178,326030,2020-07-06,0.3,165000,214500,49500,7126211
17179,326030,2020-07-03,0.2992125984251969,127000,165000,38000,711921
17180,326030,2020-07-02,0.15384615384615385,188500,127000,-61500,698642
17181,326030,2020-07-14,0.052763819095477386,199000,188500,-10500,1389588
17182,326030,2020-07-09,0.052995391705069124,217000,205500,-11500,1897646
17183,326030,2020-07-06,0.3,165000,214500,49500,7126211
17184,326030,2020-07-03,0.2992125984251969,127000,165000,38000,711921
17185,326030,2020-07-02,0.15384615384615385,188500,127000,-61500,698642
17186,326030,2020-07-14,0.052763819095477386,199000,188500,-10500,1389588
17187,326030,2020-07-09,0.052995391705069124,217000,205500,-11500,1897646
17188,326030,2020-07-06,0.3,165000,214500,49500,7126211
17189,326030,2020-07-03,0.2992125984251969,127000,165000,38000,711921
17190,326030,2020-07-02,0.15384615384615385,188500,127000,-61500,698642
17191,326030,2020-07-14,0.052763819095477386,199000,188500,-10500,1389588
17192,326030,2020-07-09,0.052995391705069124,217000,205500,-11500,1897646
17193,326030,2020-07-06,0.3,165000,214500,49500,7126211
17194,326030,2020-07-03,0.2992125984251969,127000,165000,38000,711921
17195,326030,2020-07-02,0.15384615384615385,188500,127000,-61500,698642
17196,326030,2020-07-14,0.052763819095477386,199000,188500,-10500,1389588
17197,326030,2020-07-09,0.052995391705069124,217000,205500,-11500,1897646
17198,326030,2020-07-06,0.3,165000,214500,49500,7126211
17199,326030,2020-07-03,0.2992125984251969,127000,165000,38000,711921
17200,326030,2020-07-02,0.15384615384615385,188500,127000,-61500,698642
17201,326030,2020-07-14,0.052763819095477386,199000,188500,-10500,1389588
17202,326030,2020-07-09,0.052995391705069124,217000,205500,-11500,1897646
17203,326030,2020-07-06,0.3,165000,214500,49500,7126211
17204,326030,2020-07-03,0.2992125984251969,127000,165000,38000,711921
17205,326030,2020-07-02,0.15384615384615385,188500,127000,-61500,698642
17206,326030,2020-07-14,0.052763819095477386,199000,188500,-10500,1389588
17207,326030,2020-07-09,0.052995391705069124,217000,205500,-11500,1897646
17208,326030,2020-07-06,0.3,165000,214500,49500,7126211
17209,326030,2020-07-03,0.2992125984251969,127000,165000,38000,711921
17210,326030,2020-07-02,0.15384615384615385,188500,127000,-61500,698642
17211,326030,2020-07-14,0.052763819095477386,199000,188500,-10500,1389588
17212,326030,2020-07-09,0.052995391705069124,217000,205500,-11500,1897646
17213,326030,2020-07-06,0.3,165000,214500,49500,7126211
17214,326030,2020-07-03,0.2992125984251969,127000,165000,38000,711921
17215,326030,2020-07-02,0.15384615384615385,188500,127000,-61500,698642
17216,326030,2020-07-14,0.052763819095477386,199000,188500,-10500,1389588
17217,326030,2020-07-09,0.052995391705069124,217000,205500,-11500,1897646
17218,326030,2020-07-06,0.3,165000,214500,49500,7126211
17219,326030,2020-07-03,0.2992125984251969,127000,165000,38000,711921
17220,326030,2020-07-02,0.15384615384615385,188500,127000,-61500,698642
17221,326030,2020-07-14,0.052763819095477386,199000,188500,-10500,1389588
17222,326030,2020-07-09,0.052995391705069124,217000,205500,-11500,1897646
17223,326030,2020-07-06,0.3,165000,214500,49500,7126211
17224,326030,2020-07-03,0.2992125984251969,127000,165000,38000,711921
17225,326030,2020-07-02,0.15384615384615385,188500,127000,-61500,698642
17226,326030,2020-07-14,0.052763819095477386,199000,188500,-10500,1389588
17227,326030,2020-07-09,0.052995391705069124,217000,205500,-11500,1897646
17228,326030,2020-07-06,0.3,165000,214500,49500,7126211
17229,326030,2020-07-03,0.2992125984251969,127000,165000,38000,711921
17230,326030,2020-07-02,0.15384615384615385,188500,127000,-61500,698642
17231,326030,2020-07-14,0.052763819095477386,199000,188500,-10500,1389588
17232,326030,2020-07-09,0.052995391705069124,217000,205500,-11500,1897646
17233,326030,2020-07-06,0.3,165000,214500,49500,7126211
17234,326030,2020-07-03,0.2992125984251969,127000,165000,38000,711921
17235,326030,2020-07-02,0.15384615384615385,188500,127000,-61500,698642
17236,326030,2020-07-14,0.052763819095477386,199000,188500,-10500,1389588
17237,326030,2020-07-09,0.052995391705069124,217000,205500,-11500,1897646
17238,326030,2020-07-06,0.3,165000,214500,49500,7126211
17239,326030,2020-07-03,0.2992125984251969,127000,165000,38000,711921
17240,326030,2020-07-02,0.15384615384615385,188500,127000,-61500,698642
17241,326030,2020-07-14,0.052763819095477386,199000,188500,-10500,1389588
17242,326030,2020-07-09,0.052995391705069124,217000,205500,-11500,1897646
17243,326030,2020-07-06,0.3,165000,214500,49500,7126211
17244,326030,2020-07-03,0.2992125984251969,127000,165000,38000,711921
17245,326030,2020-07-02,0.15384615384615385,188500,127000,-61500,698642
17246,326030,2020-07-14,0.052763819095477386,199000,188500,-10500,1389588
17247,326030,2020-07-09,0.052995391705069124,217000,205500,-11500,1897646
17248,326030,2020-07-06,0.3,165000,214500,49500,7126211
17249,326030,2020-07-03,0.2992125984251969,127000,165000,38000,711921
17250,326030,2020-07-02,0.15384615384615385,188500,127000,-61500,698642
17251,326030,2020-07-14,0.052763819095477386,199000,188500,-10500,1389588
17252,326030,2020-07-09,0.052995391705069124,217000,205500,-11500,1897646
17253,326030,2020-07-06,0.3,165000,214500,49500,7126211
17254,326030,2020-07-03,0.2992125984251969,127000,165000,38000,711921
17255,326030,2020-07-02,0.15384615384615385,188500,127000,-61500,698642
17256,326030,2020-07-14,0.052763819095477386,199000,188500,-10500,1389588
17257,326030,2020-07-09,0.052995391705069124,217000,205500,-11500,1897646
17258,326030,2020-07-06,0.3,165000,214500,49500,7126211
17259,326030,2020-07-03,0.2992125984251969,127000,165000,38000,711921
17260,326030,2020-07-02,0.15384615384615385,188500,127000,-61500,698642
17261,326030,2020-07-14,0.052763819095477386,199000,188500,-10500,1389588
17262,326030,2020-07-09,0.052995391705069124,217000,205500,-11500,1897646
17263,326030,2020-07-06,0.3,165000,214500,49500,7126211
17264,326030,2020-07-03,0.2992125984251969,127000,165000,38000,711921
17265,326030,2020-07-02,0.15384615384615385,188500,127000,-61500,698642
17266,326030,2020-07-14,0.052763819095477386,199000,188500,-10500,1389588
17267,326030,2020-07-09,0.052995391705069124,217000,205500,-11500,1897646
17268,326030,2020-07-06,0.3,165000,214500,49500,7126211
17269,326030,2020-07-03,0.2992125984251969,127000,165000,38000,711921
17270,15760,2021-05-26,0.05421686746987952,24900,26250,1350,13694345
17271,15760,2021-05-24,0.052854122621564484,23650,24900,1250,11452950
17272,15760,2021-03-22,0.047619047619047616,24150,23000,-1150,9591472
17273,15760,2021-03-16,0.06451612903225806,23250,24750,1500,11037032
17274,15760,2020-12-22,0.044563279857397504,28050,26800,-1250,10254371
17275,15760,2020-12-18,0.08846153846153847,26000,28300,2300,45727935
17276,15760,2020-12-17,0.1016949152542373,23600,26000,2400,20413429
17277,15760,2020-12-10,0.0625,22400,23800,1400,22910345
17278,15760,2020-12-09,0.04186046511627907,21500,22400,900,5821012
17279,15760,2020-11-24,0.04640371229698376,21550,22550,1000,13150194
17280,15760,2020-08-25,0.05263157894736842,19950,21000,1050,6875039
17281,15760,2020-08-20,0.040865384615384616,20800,19950,-850,5547124
17282,15760,2020-08-18,0.06378132118451026,21950,20550,-1400,7925993
17283,15760,2020-08-13,0.04106280193236715,20700,21550,850,12573404
17284,15760,2020-08-11,0.07969151670951156,19450,21000,1550,18946719
17285,15760,2020-07-13,0.06951871657754011,18700,20000,1300,7671410
17286,15760,2020-06-16,0.04773869346733668,19900,20850,950,2156035
17287,15760,2020-06-15,0.0591016548463357,21150,19900,-1250,3684568
17288,15760,2020-05-15,0.04967602591792657,23150,22000,-1150,6091140
17289,15760,2020-05-14,0.05227272727272727,22000,23150,1150,6104579
17290,15760,2020-05-04,0.0440251572327044,23850,22800,-1050,3220563
17291,15760,2020-04-27,0.057649667405764965,22550,23850,1300,4919955
17292,15760,2020-04-22,0.04186046511627907,21500,22400,900,5593049
17293,15760,2020-04-16,0.04481132075471698,21200,20250,-950,4168986
17294,15760,2020-04-10,0.04699738903394256,19150,20050,900,5388823
17295,15760,2020-03-24,0.07803468208092486,17300,18650,1350,3570950
17296,15760,2020-03-20,0.06461538461538462,16250,17300,1050,3694677
17297,15760,2020-03-19,0.049707602339181284,17100,16250,-850,4836755
17298,15760,2020-03-18,0.05263157894736842,18050,17100,-950,3598889
17299,15760,2020-03-17,0.05,19000,18050,-950,5782189
17300,15760,2020-03-13,0.04866180048661801,20550,19550,-1000,5709867
17301,15760,2020-03-11,0.05454545454545454,22000,20800,-1200,5941894
17302,15760,2020-03-09,0.08056872037914692,21100,22800,1700,10031547
17303,15760,2020-02-28,0.07792207792207792,23100,21300,-1800,7589705
17304,15760,2019-11-06,0.061386138613861385,25250,26800,1550,7144202
17305,15760,2019-08-19,0.04048582995951417,24700,25700,1000,1043295
17306,15760,2019-08-01,0.044802867383512544,27900,26650,-1250,1743468
17307,15760,2019-07-23,0.04807692307692308,26000,27250,1250,3452971
17308,15760,2019-05-31,0.04208416833667335,24950,26000,1050,3100087
17309,15760,2019-01-09,0.0535966149506347,35450,33550,-1900,2794012
17310,15760,2018-11-26,0.06159420289855073,27600,29300,1700,2250623
17311,15760,2018-11-14,0.04570383912248629,27350,28600,1250,2815013
17312,15760,2018-10-24,0.04182509505703422,26300,27400,1100,2845565
17313,15760,2018-10-23,0.045372050816696916,27550,26300,-1250,1510227
17314,15760,2018-10-11,0.05731225296442688,25300,23850,-1450,3191957
17315,15760,2018-06-27,0.042028985507246375,34500,33050,-1450,2261762
17316,15760,2018-06-22,0.060790273556231005,32900,34900,2000,2668943
17317,15760,2018-05-14,0.043356643356643354,35750,37300,1550,2129346
17318,15760,2018-04-03,0.05112781954887218,33250,34950,1700,4540936
17319,15760,2017-05-10,0.05786026200873363,45800,43150,-2650,5973723
17320,15760,2017-02-20,0.0603448275862069,40600,43050,2450,3577876
17321,15760,2016-12-28,0.04148936170212766,47000,45050,-1950,1870429
17322,15760,2016-12-01,0.043010752688172046,46500,44500,-2000,2557351
17323,15760,2016-11-15,0.04590163934426229,45750,47850,2100,2433736
17324,51600,2021-06-01,0.04668838219326819,46050,43900,-2150,841591
17325,51600,2021-05-26,0.09558823529411764,40800,44700,3900,1344903
17326,51600,2021-05-20,0.048567870485678705,40150,42100,1950,1088713
17327,51600,2021-05-18,0.04015544041450777,38600,40150,1550,1006648
17328,51600,2021-05-13,0.09195402298850575,34800,38000,3200,1253531
17329,51600,2021-04-23,0.043055555555555555,36000,34450,-1550,672203
17330,51600,2021-04-22,0.05417276720351391,34150,36000,1850,1300001
17331,51600,2021-04-19,0.04027777777777778,36000,34550,-1450,675357
17332,51600,2021-04-15,0.05065123010130246,34550,36300,1750,1017518
17333,51600,2020-12-29,0.05128205128205128,31200,29600,-1600,654841
17334,51600,2020-12-18,0.04628099173553719,30250,31650,1400,1462255
17335,51600,2020-08-11,0.05245346869712352,29550,31100,1550,801517
17336,51600,2020-06-16,0.042662116040955635,29300,30550,1250,226565
17337,51600,2020-06-15,0.048701298701298704,30800,29300,-1500,262705
17338,51600,2020-04-16,0.045871559633027525,32700,31200,-1500,248249
17339,51600,2020-04-07,0.052715654952076675,31300,32950,1650,202659
17340,51600,2020-04-06,0.04159733777038269,30050,31300,1250,139011
17341,51600,2020-04-02,0.051056338028169015,28400,29850,1450,173681
17342,51600,2020-03-27,0.04529616724738676,28700,30000,1300,222623
17343,51600,2020-03-26,0.04936014625228519,27350,28700,1350,264029
17344,51600,2020-03-25,0.058027079303675046,25850,27350,1500,219641
17345,51600,2020-03-24,0.044444444444444446,24750,25850,1100,228585
17346,51600,2020-03-23,0.07992565055762081,26900,24750,-2150,275575
17347,51600,2020-03-19,0.06525573192239859,28350,26500,-1850,291425
17348,51600,2020-03-12,0.049766718506998445,32150,30550,-1600,245405
17349,51600,2020-01-30,0.04677623261694058,39550,37700,-1850,227864
17350,51600,2019-10-10,0.04698972099853157,34050,32450,-1600,273704
17351,51600,2019-06-25,0.0486322188449848,32900,31300,-1600,308720
17352,51600,2019-05-20,0.04024767801857585,32300,31000,-1300,279183
17353,51600,2019-05-15,0.06901615271659324,34050,31700,-2350,476260
17354,51600,2019-04-29,0.059490084985835696,35300,37400,2100,398155
17355,51600,2019-02-18,0.06259314456035768,33550,35650,2100,649765
17356,51600,2019-01-30,0.06456692913385827,31750,33800,2050,352503
17357,51600,2019-01-14,0.04608294930875576,32550,34050,1500,281541
17358,51600,2019-01-04,0.05511811023622047,31750,33500,1750,348167
17359,51600,2018-12-18,0.06456456456456457,33300,35450,2150,626793
17360,51600,2018-11-26,0.04421768707482993,29400,30700,1300,518550
17361,51600,2018-11-15,0.05065666041275797,26650,28000,1350,362811
17362,51600,2018-11-02,0.040740740740740744,27000,28100,1100,208095
17363,51600,2018-09-18,0.04722222222222222,36000,34300,-1700,238407
17364,51600,2018-07-06,0.04434250764525994,32700,34150,1450,214137
17365,51600,2018-07-02,0.07152875175315568,35650,33100,-2550,472426
17366,51600,2018-06-25,0.04366197183098591,35500,37050,1550,274681
17367,51600,2018-06-18,0.06896551724137931,39150,36450,-2700,439700
17368,51600,2018-05-29,0.047619047619047616,43050,41000,-2050,395687
17369,51600,2018-05-28,0.04363636363636364,41250,43050,1800,275751
17370,51600,2018-05-03,0.15588235294117647,51000,43050,-7950,1535065
17371,51600,2018-04-19,0.06483516483516484,45500,48450,2950,526149
17372,51600,2018-04-04,0.05303030303030303,46200,43750,-2450,247710
17373,51600,2018-03-28,0.04310344827586207,46400,44400,-2000,178906
17374,51600,2018-03-19,0.043968432919954906,44350,46300,1950,499627
17375,51600,2018-03-15,0.042352941176470586,42500,44300,1800,340293
17376,51600,2018-02-05,0.04263093788063337,41050,39300,-1750,189551
17377,51600,2018-01-10,0.045513654096228866,38450,40200,1750,292867
17378,51600,2017-12-21,0.04066985645933014,41800,40100,-1700,178242
17379,51600,2017-11-24,0.04533333333333334,37500,39200,1700,252730
17380,51600,2017-11-09,0.04425837320574163,41800,39950,-1850,658435
17381,51600,2017-10-23,0.06462212486308871,45650,42700,-2950,500913
17382,51600,2017-09-27,0.04244694132334582,40050,41750,1700,183839
17383,51600,2017-08-01,0.04555555555555556,45000,47050,2050,365606
17384,51600,2017-07-26,0.04186046511627907,43000,44800,1800,218515
17385,51600,2017-07-14,0.08417508417508418,44550,40800,-3750,880270
17386,51600,2017-06-19,0.05673076923076923,52000,49050,-2950,612368
17387,51600,2017-05-04,0.04070796460176991,56500,58800,2300,175757
17388,51600,2017-03-22,0.04498269896193772,57800,60400,2600,209676
17389,51600,2017-03-07,0.04817275747508306,60200,63100,2900,280066
17390,51600,2017-02-24,0.04203152364273205,57100,59500,2400,796422
17391,51600,2016-12-12,0.042704626334519574,56200,58600,2400,157360
17392,51600,2016-11-17,0.06468531468531469,57200,60900,3700,198963
17393,51600,2016-10-21,0.04204753199268738,54700,57000,2300,1032565
17394,51600,2016-10-07,0.0427807486631016,56100,53700,-2400,271375
17395,51600,2016-09-22,0.040257648953301126,62100,59600,-2500,301506
17396,51600,2016-08-19,0.04885057471264368,69600,66200,-3400,180420
17397,10130,2021-05-18,0.04945054945054945,455000,477500,22500,69019
17398,10130,2021-05-10,0.04061470911086718,455500,474000,18500,119166
17399,10130,2021-05-06,0.046223224351747465,443500,464000,20500,125707
17400,10130,2021-04-29,0.06440281030444965,427000,454500,27500,313326
17401,10130,2021-04-22,0.045454545454545456,418000,437000,19000,144277
17402,10130,2021-02-24,0.04041570438799076,433000,415500,-17500,82728
17403,10130,2021-02-01,0.06773399014778325,406000,433500,27500,182305
17404,10130,2021-01-11,0.040955631399317405,439500,421500,-18000,198304
17405,10130,2021-01-05,0.12718204488778054,401000,452000,51000,403605
17406,10130,2020-12-21,0.04315659679408138,405500,423000,17500,100060
17407,10130,2020-10-22,0.04183535762483131,370500,386000,15500,104078
17408,10130,2020-09-28,0.04252400548696845,364500,380000,15500,36852
17409,10130,2020-08-12,0.041065482796892344,450500,432000,-18500,132334
17410,10130,2020-08-06,0.053864168618266976,427000,450000,23000,103885
17411,10130,2020-08-05,0.040194884287454324,410500,427000,16500,99434
17412,10130,2020-07-27,0.08849557522123894,395500,430500,35000,174593
17413,10130,2020-07-22,0.07994579945799458,369000,398500,29500,257220
17414,10130,2020-07-01,0.05373134328358209,335000,353000,18000,72220
17415,10130,2020-06-16,0.07017543859649122,342000,366000,24000,48490
17416,10130,2020-06-15,0.06684856753069578,366500,342000,-24500,85127
17417,10130,2020-05-04,0.04533678756476684,386000,368500,-17500,114221
17418,10130,2020-04-16,0.05641025641025641,390000,412000,22000,78432
17419,10130,2020-04-02,0.05788712011577424,345500,365500,20000,55880
17420,10130,2020-03-25,0.06379821958456973,337000,358500,21500,86495
17421,10130,2020-03-24,0.1423728813559322,295000,337000,42000,73129
17422,10130,2020-03-19,0.07413249211356467,317000,293500,-23500,90482
17423,10130,2020-03-18,0.10325318246110325,353500,317000,-36500,113397
17424,10130,2020-03-09,0.042735042735042736,409500,392000,-17500,67829
17425,10130,2020-02-19,0.05491990846681922,437000,461000,24000,110265
17426,10130,2020-02-06,0.08516129032258064,387500,420500,33000,159287
17427,10130,2019-08-08,0.05052878965922444,425500,447000,21500,57033
17428,10130,2019-07-26,0.04039301310043668,458000,439500,-18500,60945
17429,10130,2019-07-01,0.04411764705882353,476000,455000,-21000,67563
17430,10130,2019-01-03,0.041273584905660375,424000,441500,17500,50422
17431,10130,2018-11-13,0.040293040293040296,409500,426000,16500,105853
17432,10130,2018-11-02,0.05473965287049399,374500,395000,20500,36350
17433,10130,2018-09-13,0.041561712846347604,397000,413500,16500,68033
17434,10130,2018-07-24,0.049399198931909215,374500,393000,18500,68441
17435,10130,2018-07-10,0.04306864064602961,371500,387500,16000,39414
17436,10130,2018-05-14,0.04,437500,455000,17500,54470
17437,10130,2018-01-09,0.06012024048096192,499000,529000,30000,86740
17438,10130,2017-10-27,0.06938775510204082,490000,524000,34000,93355
17439,10130,2017-10-26,0.06130268199233716,522000,490000,-32000,134369
17440,10130,2017-10-10,0.04944500504540868,495500,520000,24500,77152
17441,10130,2017-08-17,0.04712041884816754,477500,500000,22500,80097
17442,10130,2017-07-25,0.04703247480403135,446500,467500,21000,138557
17443,10130,2017-02-07,0.10574948665297741,487000,435500,-51500,263301
17444,10130,2017-01-11,0.05943691345151199,479500,508000,28500,85089
17445,10130,2016-12-05,0.046858359957401494,469500,491500,22000,72929
17446,10130,2016-11-14,0.04387755102040816,490000,468500,-21500,101756
17447,10130,2016-10-25,0.057385759829968117,470500,443500,-27000,110352
17448,28050,2021-06-02,0.05291005291005291,18900,19900,1000,5243489
17449,28050,2021-05-26,0.043478260869565216,19550,18700,-850,4437406
17450,28050,2021-05-18,0.042666666666666665,18750,19550,800,3978098
17451,28050,2021-05-11,0.07262569832402235,17900,19200,1300,7301175
17452,28050,2021-05-06,0.0650887573964497,16900,18000,1100,4995155
17453,28050,2021-05-04,0.05322128851540616,17850,16900,-950,6579569
17454,28050,2021-04-26,0.06389776357827476,15650,16650,1000,6167997
17455,28050,2021-04-15,0.06451612903225806,13950,14850,900,14510847
17456,28050,2021-03-23,0.0425531914893617,14100,13500,-600,3140131
17457,28050,2021-03-08,0.05859375,12800,13550,750,6204871
17458,28050,2021-02-24,0.04059040590405904,13550,13000,-550,1660158
17459,28050,2021-02-23,0.04230769230769231,13000,13550,550,2999903
17460,28050,2021-01-29,0.05363984674329502,13050,12350,-700,2893642
17461,28050,2020-11-16,0.08368200836820083,11950,12950,1000,7529222
17462,28050,2020-11-10,0.0611353711790393,11450,12150,700,9164978
17463,28050,2020-10-30,0.12980769230769232,10400,11750,1350,30355537
17464,28050,2020-10-16,0.05825242718446602,10300,10900,600,2133466
17465,28050,2020-08-20,0.04602510460251046,11950,11400,-550,1856984
17466,28050,2020-08-18,0.04435483870967742,12400,11850,-550,1702325
17467,28050,2020-07-15,0.05416666666666667,12000,12650,650,3717863
17468,28050,2020-07-06,0.04132231404958678,12100,12600,500,1329656
17469,28050,2020-06-30,0.04700854700854701,11700,12250,550,1689659
17470,28050,2020-06-25,0.04065040650406504,12300,11800,-500,1317534
17471,28050,2020-06-16,0.05652173913043478,11500,12150,650,1485493
17472,28050,2020-06-15,0.07630522088353414,12450,11500,-950,2312235
17473,28050,2020-06-12,0.04597701149425287,13050,12450,-600,2470115
17474,28050,2020-06-03,0.09274193548387097,12400,13550,1150,8146839
17475,28050,2020-05-28,0.0411522633744856,12150,11650,-500,3675531
17476,28050,2020-05-27,0.0611353711790393,11450,12150,700,5313934
17477,28050,2020-05-19,0.04954954954954955,11100,11650,550,3301584
17478,28050,2020-05-06,0.07207207207207207,11100,11900,800,3456511
17479,28050,2020-04-29,0.04072398190045249,11050,11500,450,3139442
17480,28050,2020-04-17,0.04090909090909091,11000,11450,450,2764096
17481,28050,2020-04-02,0.0486322188449848,9870,10350,480,3355276
17482,28050,2020-03-26,0.07332624867162593,9410,10100,690,7857943
17483,28050,2020-03-25,0.2079589216944801,7790,9410,1620,6919451
17484,28050,2020-03-24,0.10183875530410184,7070,7790,720,2771615
17485,28050,2020-03-23,0.07339449541284404,7630,7070,-560,2523898
17486,28050,2020-03-20,0.07920792079207921,7070,7630,560,3918606
17487,28050,2020-03-19,0.1228287841191067,8060,7070,-990,6956184
17488,28050,2020-03-18,0.18255578093306288,9860,8060,-1800,7548719
17489,28050,2020-03-17,0.07417840375586854,10650,9860,-790,4370610
17490,28050,2020-03-16,0.04054054054054054,11100,10650,-450,1731143
17491,28050,2020-03-13,0.06722689075630252,11900,11100,-800,3387922
17492,28050,2020-03-12,0.05179282868525897,12550,11900,-650,2013921
17493,28050,2020-03-09,0.08602150537634409,13950,12750,-1200,2783576
17494,28050,2020-02-24,0.05211726384364821,15350,14550,-800,1630190
17495,28050,2020-02-06,0.04892966360856269,16350,17150,800,1755947
17496,28050,2020-02-03,0.04057971014492753,17250,16550,-700,1801090
17497,28050,2019-11-04,0.04748603351955307,17900,18750,850,1977773
17498,28050,2019-10-30,0.05654761904761905,16800,17750,950,2966313
17499,28050,2019-09-16,0.060790273556231005,16450,17450,1000,2261619
17500,28050,2019-07-29,0.042071197411003236,15450,16100,650,1467653
17501,28050,2019-06-03,0.09880239520958084,16700,15050,-1650,5741163
17502,28050,2019-04-23,0.04075235109717868,15950,16600,650,1565886
17503,28050,2019-02-01,0.06865671641791045,16750,15600,-1150,6061856
17504,28050,2018-12-27,0.05421686746987952,16600,17500,900,1341636
17505,28050,2018-12-19,0.04043126684636118,18550,17800,-750,2904711
17506,28050,2018-11-28,0.06162464985994398,17850,18950,1100,2453256
17507,28050,2018-11-14,0.06301369863013699,18250,17100,-1150,3059170
17508,28050,2018-11-01,0.0410958904109589,18250,17500,-750,1470488
17509,28050,2018-10-30,0.040697674418604654,17200,17900,700,1666375
17510,28050,2018-10-29,0.06172839506172839,16200,17200,1000,2821508
17511,28050,2018-10-26,0.047058823529411764,17000,16200,-800,1520051
17512,28050,2018-10-11,0.06905370843989769,19550,18200,-1350,2602240
17513,28050,2018-09-28,0.057534246575342465,18250,19300,1050,4141605
17514,28050,2018-09-13,0.042042042042042045,16650,17350,700,2419127
17515,28050,2018-09-10,0.04,16250,16900,650,1448697
17516,28050,2018-07-23,0.0436241610738255,14900,15550,650,1513961
17517,28050,2018-07-02,0.04472843450479233,15650,14950,-700,1056619
17518,28050,2018-06-20,0.06206896551724138,14500,15400,900,1951293
17519,28050,2018-06-01,0.06233062330623306,18450,17300,-1150,5870197
17520,28050,2018-05-21,0.06683168316831684,20200,18850,-1350,20435332
17521,28050,2018-05-14,0.0647887323943662,17750,18900,1150,5004824
17522,28050,2018-04-30,0.04664723032069971,17150,17950,800,2093324
17523,28050,2018-04-05,0.046242774566473986,17300,18100,800,2562080
17524,28050,2018-03-13,0.05,18000,17100,-900,5989833
17525,28050,2018-03-12,0.08108108108108109,16650,18000,1350,5866300
17526,28050,2018-03-06,0.06229508196721312,15250,16200,950,1936892
17527,28050,2018-02-19,0.045307443365695796,15450,16150,700,2554651
17528,28050,2018-02-14,0.05821917808219178,14600,15450,850,2389281
17529,28050,2018-02-09,0.0429042904290429,15150,14500,-650,3548290
17530,28050,2018-02-07,0.08814589665653495,16450,15000,-1450,4458353
17531,28050,2018-02-05,0.040229885057471264,17400,16700,-700,4085643
17532,28050,2018-01-25,0.06309148264984227,15850,16850,1000,5358116
17533,28050,2018-01-23,0.04983388704318937,15050,15800,750,2652586
17534,28050,2018-01-16,0.05161290322580645,15500,14700,-800,4264456
17535,28050,2018-01-10,0.08391608391608392,14300,15500,1200,9631405
17536,28050,2018-01-04,0.06563706563706563,12950,13800,850,5006285
17537,28050,2018-01-02,0.05241935483870968,12400,13050,650,2031799
17538,28050,2017-12-13,0.040983606557377046,12200,12700,500,2186857
17539,28050,2017-12-11,0.04263565891472868,12900,12350,-550,4011839
17540,28050,2017-12-06,0.06993006993006994,14300,13300,-1000,7137402
17541,28050,2017-12-04,0.06870229007633588,13100,14000,900,8506647
17542,28050,2017-11-27,0.04198473282442748,13100,12550,-550,2759739
17543,28050,2017-11-07,0.047058823529411764,12750,13350,600,6701641
17544,28050,2017-11-06,0.04081632653061224,12250,12750,500,3238490
17545,28050,2017-10-27,0.04602510460251046,11950,12500,550,6592235
17546,28050,2017-09-26,0.05339805825242718,10300,10850,550,1703675
17547,28050,2017-09-19,0.06220095693779904,10450,11100,650,4846630
17548,28050,2017-08-25,0.04926108374384237,10150,10650,500,6318166
17549,28050,2017-08-07,0.08121827411167512,9850,10650,800,5723736
17550,28050,2017-07-31,0.06422018348623854,10900,10200,-700,4707638
17551,28050,2017-06-23,0.04310344827586207,11600,12100,500,1530707
17552,28050,2017-05-16,0.045081967213114756,12200,12750,550,3567760
17553,28050,2017-04-27,0.06037735849056604,13250,12450,-800,5282669
17554,28050,2017-03-16,0.04838709677419355,12400,13000,600,3882266
17555,28050,2017-03-09,0.06390977443609022,13300,12450,-850,6871629
17556,28050,2017-02-20,0.053061224489795916,12250,11600,-650,4174380
17557,28050,2017-02-09,0.044897959183673466,12250,12800,550,2768805
17558,28050,2017-01-31,0.05,12000,12600,600,3914402
17559,28050,2017-01-23,0.07906976744186046,10750,11600,850,4088563
17560,28050,2017-01-17,0.04,11250,10800,-450,3640437
17561,28050,2016-12-21,0.04950495049504951,10100,10600,500,2469477
17562,28050,2016-12-12,0.06601731601731602,9240,9850,610,2508641
17563,28050,2016-11-10,0.05683060109289618,9150,9670,520,1568619
17564,28050,2016-11-09,0.04984423676012461,9630,9150,-480,2790432
17565,28050,2016-10-31,0.07156862745098039,10200,9470,-730,3603933
17566,28050,2016-09-01,0.04,11250,11700,450,2442359
17567,28050,2016-08-29,0.04291845493562232,11650,11150,-500,3812778
17568,28050,2016-08-22,0.04405286343612335,11350,11850,500,7844241
17569,28050,2016-08-19,0.07582938388625593,10550,11350,800,5769897
17570,88980,2020-03-19,0.05145631067961165,10300,9770,-530,4075089
17571,185750,2021-05-03,0.06115107913669065,139000,130500,-8500,198109
17572,185750,2021-04-29,0.0410958904109589,146000,140000,-6000,157437
17573,185750,2021-04-28,0.04659498207885305,139500,146000,6500,873035
17574,185750,2021-04-21,0.06060606060606061,148500,139500,-9000,576461
17575,185750,2021-03-25,0.04609929078014184,141000,134500,-6500,373851
17576,185750,2021-03-23,0.05921052631578947,152000,143000,-9000,347257
17577,185750,2021-03-18,0.20256410256410257,195000,155500,-39500,1294834
17578,185750,2021-03-17,0.16417910447761194,167500,195000,27500,2429331
17579,185750,2021-03-16,0.05345911949685535,159000,167500,8500,255463
17580,185750,2021-03-09,0.06976744186046512,172000,160000,-12000,288901
17581,185750,2021-03-08,0.08994708994708994,189000,172000,-17000,451947
17582,185750,2021-03-04,0.0659025787965616,174500,186000,11500,439876
17583,185750,2021-02-24,0.04597701149425287,174000,166000,-8000,178192
17584,185750,2021-02-23,0.04657534246575343,182500,174000,-8500,125897
17585,185750,2021-02-19,0.04120879120879121,182000,189500,7500,154830
17586,185750,2021-02-17,0.042105263157894736,190000,182000,-8000,122123
17587,185750,2021-02-04,0.04289544235924933,186500,178500,-8000,200494
17588,185750,2021-01-29,0.061381074168797956,195500,183500,-12000,273594
17589,185750,2021-01-28,0.05555555555555555,207000,195500,-11500,207543
17590,185750,2021-01-21,0.040100250626566414,199500,207500,8000,242392
17591,185750,2021-01-18,0.05463182897862233,210500,199000,-11500,305616
17592,185750,2021-01-15,0.0787746170678337,228500,210500,-18000,599971
17593,185750,2021-01-14,0.12839506172839507,202500,228500,26000,3046540
17594,185750,2021-01-11,0.04337899543378995,219000,209500,-9500,245894
17595,185750,2021-01-08,0.04782608695652174,230000,219000,-11000,274929
17596,185750,2020-12-30,0.046189376443418015,216500,226500,10000,1296036
17597,185750,2020-12-29,0.04377880184331797,217000,216500,-500,274469
17598,185750,2020-12-28,0.04824561403508772,228000,217000,-11000,377724
17599,185750,2020-12-23,0.08571428571428572,245000,224000,-21000,785661
17600,185750,2020-12-22,0.06130268199233716,261000,245000,-16000,813404
17601,185750,2020-12-21,0.07186858316221766,243500,261000,17500,3588462
17602,185750,2020-12-18,0.25839793281653745,193500,243500,50000,3603607
17603,185750,2020-12-17,0.051630434782608696,184000,193500,9500,349933
17604,185750,2020-12-14,0.056657223796033995,176500,186500,10000,1107072
17605,185750,2020-12-08,0.06182795698924731,186000,174500,-11500,213715
17606,185750,2020-12-07,0.04788732394366197,177500,186000,8500,812977
17607,185750,2020-12-04,0.04411764705882353,170000,177500,7500,259487
17608,185750,2020-11-30,0.06097560975609756,164000,174000,10000,1525305
17609,185750,2020-11-24,0.047058823529411764,170000,162000,-8000,285271
17610,185750,2020-11-23,0.10290237467018469,189500,170000,-19500,590295
17611,185750,2020-11-20,0.17701863354037267,161000,189500,28500,2970156
17612,185750,2020-11-03,0.09698996655518395,149500,164000,14500,154540
17613,185750,2020-10-30,0.040880503144654086,159000,152500,-6500,77891
17614,185750,2020-10-27,0.04375,160000,153000,-7000,67973
17615,185750,2020-10-12,0.043859649122807015,171000,178500,7500,117004
17616,185750,2020-09-22,0.05475504322766571,173500,164000,-9500,136884
17617,185750,2020-09-21,0.046703296703296704,182000,173500,-8500,96593
17618,185750,2020-09-01,0.041237113402061855,194000,186000,-8000,559121
17619,185750,2020-08-31,0.060109289617486336,183000,194000,11000,773872
17620,185750,2020-08-26,0.043701799485861184,194500,186000,-8500,198868
17621,185750,2020-08-24,0.05289672544080604,198500,188000,-10500,244541
17622,185750,2020-08-21,0.057007125890736345,210500,198500,-12000,399266
17623,185750,2020-08-20,0.07948717948717948,195000,210500,15500,1195147
17624,185750,2020-08-19,0.09859154929577464,177500,195000,17500,359391
17625,185750,2020-08-14,0.061764705882352944,170000,180500,10500,377848
17626,185750,2020-08-12,0.05722070844686648,183500,173000,-10500,251005
17627,185750,2020-08-06,0.059278350515463915,194000,182500,-11500,695560
17628,185750,2020-08-05,0.07777777777777778,180000,194000,14000,4980715
17629,185750,2020-08-04,0.2996389891696751,138500,180000,41500,2165681
17630,185750,2020-07-23,0.06274509803921569,127500,135500,8000,331126
17631,185750,2020-07-16,0.043824701195219126,125500,120000,-5500,79527
17632,185750,2020-07-13,0.040160642570281124,124500,129500,5000,112491
17633,185750,2020-07-10,0.05063291139240506,118500,124500,6000,156541
17634,185750,2020-07-06,0.048672566371681415,113000,118500,5500,113029
17635,185750,2020-06-19,0.06746031746031746,126000,117500,-8500,288747
17636,185750,2020-06-18,0.1,140000,126000,-14000,788123
17637,185750,2020-06-17,0.19148936170212766,117500,140000,22500,356296
17638,185750,2020-06-16,0.0779816513761468,109000,117500,8500,263206
17639,185750,2020-06-15,0.0603448275862069,116000,109000,-7000,175754
17640,185750,2020-06-12,0.04035874439461883,111500,116000,4500,163644
17641,185750,2020-06-09,0.10775427995971802,99300,110000,10700,355753
17642,185750,2020-04-07,0.040697674418604654,86000,89500,3500,63624
17643,185750,2020-04-06,0.05134474327628362,81800,86000,4200,37869
17644,185750,2020-04-01,0.04352941176470588,85000,81300,-3700,66251
17645,185750,2020-03-31,0.1273209549071618,75400,85000,9600,80861
17646,185750,2020-03-25,0.05794947994056464,67300,71200,3900,77922
17647,185750,2020-03-24,0.09787928221859707,61300,67300,6000,63559
17648,185750,2020-03-23,0.0598159509202454,65200,61300,-3900,63929
17649,185750,2020-03-19,0.10987482614742698,71900,64000,-7900,75245
17650,185750,2020-03-16,0.04076433121019108,78500,75300,-3200,51450
17651,185750,2020-02-11,0.04086021505376344,93000,96800,3800,38386
17652,185750,2019-12-23,0.058823529411764705,91800,97200,5400,52115
17653,185750,2019-10-31,0.04475982532751092,91600,95700,4100,62667
17654,185750,2019-08-05,0.057803468208092484,86500,81500,-5000,30234
17655,185750,2019-07-19,0.05357142857142857,89600,94400,4800,39809
17656,185750,2019-06-18,0.05,92000,96600,4600,47506
17657,185750,2018-12-05,0.04245283018867924,106000,110500,4500,55101
17658,185750,2018-11-02,0.04372842347525892,86900,90700,3800,34790
17659,185750,2018-10-11,0.04554455445544554,101000,96400,-4600,49385
17660,185750,2018-10-10,0.04716981132075472,106000,101000,-5000,51307
17661,185750,2018-07-31,0.07731958762886598,97000,104500,7500,88326
17662,185750,2018-07-04,0.04568527918781726,98500,103000,4500,38977
17663,185750,2018-05-30,0.05045871559633028,109000,103500,-5500,105400
17664,185750,2018-04-23,0.044,125000,119500,-5500,86423
17665,185750,2018-04-10,0.045454545454545456,132000,138000,6000,111408
17666,185750,2018-03-23,0.050980392156862744,127500,121000,-6500,54019
17667,185750,2018-02-28,0.05128205128205128,136500,129500,-7000,54057
17668,185750,2018-02-06,0.04363636363636364,137500,131500,-6000,101053
17669,185750,2018-01-25,0.04421768707482993,147000,153500,6500,79565
17670,185750,2018-01-05,0.045112781954887216,133000,139000,6000,34748
17671,185750,2018-01-04,0.04316546762589928,139000,133000,-6000,35143
17672,185750,2017-12-22,0.05813953488372093,129000,136500,7500,51259
17673,185750,2017-12-11,0.04417670682730924,124500,130000,5500,31982
17674,185750,2017-12-05,0.04727272727272727,137500,131000,-6500,53091
17675,185750,2017-11-22,0.07958477508650519,144500,133000,-11500,183112
17676,185750,2017-11-20,0.06415094339622641,132500,141000,8500,106737
17677,185750,2017-11-03,0.04888888888888889,112500,118000,5500,94343
17678,185750,2017-06-05,0.045081967213114756,122000,127500,5500,130485
17679,185750,2017-05-08,0.046610169491525424,118000,123500,5500,132204
17680,185750,2017-04-03,0.049773755656108594,110500,116000,5500,158954
17681,185750,2017-03-24,0.043478260869565216,103500,108000,4500,65256
17682,185750,2017-02-17,0.05188679245283019,106000,111500,5500,216724
17683,185750,2017-02-15,0.04926108374384237,101500,106500,5000,91326
17684,185750,2016-12-13,0.09014675052410902,95400,104000,8600,161383
17685,185750,2016-11-10,0.12012987012987013,92400,103500,11100,194934
17686,185750,2016-11-02,0.04488517745302714,95800,91500,-4300,69321
17687,185750,2016-10-28,0.04430379746835443,94800,90600,-4200,67684
17688,185750,2016-09-30,0.06481481481481481,108000,101000,-7000,168232
17689,185750,2016-09-23,0.06318956870611836,99700,106000,6300,113325
17690,185750,2016-09-20,0.07483731019522777,92200,99100,6900,129329
17691,241560,2021-06-03,0.040145985401459854,54800,52600,-2200,572505
17692,241560,2021-06-02,0.0703125,51200,54800,3600,1097343
17693,241560,2021-05-18,0.041666666666666664,48000,50000,2000,290408
17694,241560,2021-05-06,0.10606060606060606,46200,51100,4900,1599371
17695,241560,2021-04-27,0.04909284951974386,46850,49150,2300,673960
17696,241560,2021-04-26,0.05756207674943566,44300,46850,2550,358220
17697,241560,2021-03-31,0.04337050805452292,40350,42100,1750,629895
17698,241560,2021-03-30,0.04156769596199525,42100,40350,-1750,1174241
17699,241560,2021-03-29,0.06447534766118837,39550,42100,2550,1169886
17700,241560,2021-03-26,0.06891891891891892,37000,39550,2550,801902
17701,241560,2021-02-26,0.06231884057971015,34500,32350,-2150,613639
17702,241560,2021-02-24,0.04721030042918455,34950,33300,-1650,344879
17703,241560,2021-02-09,0.06376360808709176,32150,34200,2050,2053077
17704,241560,2021-02-03,0.044444444444444446,31500,32900,1400,396771
17705,241560,2021-01-29,0.06327160493827161,32400,30350,-2050,408877
17706,241560,2021-01-28,0.04424778761061947,33900,32400,-1500,404774
17707,241560,2021-01-07,0.07049180327868852,30500,32650,2150,1956745
17708,241560,2020-11-10,0.06239737274220033,30450,32350,1900,928826
17709,241560,2020-11-04,0.046031746031746035,31500,30050,-1450,864774
17710,241560,2020-11-02,0.09012131715771231,28850,31450,2600,954289
17711,241560,2020-10-27,0.05663430420711974,30900,29150,-1750,845881
17712,241560,2020-10-21,0.06814310051107325,29350,31350,2000,1673174
17713,241560,2020-10-19,0.08592321755027423,27350,29700,2350,1637795
17714,241560,2020-10-05,0.05018587360594796,26900,28250,1350,455091
17715,241560,2020-09-24,0.05474452554744526,27400,25900,-1500,727008
17716,241560,2020-09-07,0.05947955390334572,26900,28500,1600,2332252
17717,241560,2020-08-18,0.07375643224699828,29150,27000,-2150,581899
17718,241560,2020-08-12,0.046181172291296625,28150,29450,1300,822247
17719,241560,2020-07-21,0.078125,25600,27600,2000,4416478
17720,241560,2020-06-30,0.041584158415841586,25250,26300,1050,488509
17721,241560,2020-06-25,0.06227106227106227,27300,25600,-1700,756942
17722,241560,2020-06-18,0.05025996533795494,28850,27400,-1450,1011728
17723,241560,2020-06-16,0.18052738336713997,24650,29100,4450,6663269
17724,241560,2020-06-15,0.08022388059701492,26800,24650,-2150,817600
17725,241560,2020-06-12,0.06457242582897033,28650,26800,-1850,886740
17726,241560,2020-06-09,0.058084772370486655,31850,30000,-1850,1561116
17727,241560,2020-06-08,0.17744916820702403,27050,31850,4800,6247437
17728,241560,2020-06-03,0.06336633663366337,25250,26850,1600,2476409
17729,241560,2020-05-22,0.05521472392638037,24450,23100,-1350,523787
17730,241560,2020-05-19,0.0650759219088937,23050,24550,1500,980151
17731,241560,2020-05-06,0.046052631578947366,22800,23850,1050,434022
17732,241560,2020-04-24,0.06418219461697723,24150,22600,-1550,686023
17733,241560,2020-04-20,0.1091314031180401,22450,24900,2450,2632247
17734,241560,2020-04-10,0.07109004739336493,21100,22600,1500,3419128
17735,241560,2020-04-06,0.051597051597051594,20350,21400,1050,662927
17736,241560,2020-04-02,0.05476190476190476,21000,19850,-1150,1573164
17737,241560,2020-04-01,0.16991643454038996,17950,21000,3050,1481838
17738,241560,2020-03-31,0.0436046511627907,17200,17950,750,490408
17739,241560,2020-03-30,0.05234159779614325,18150,17200,-950,514919
17740,241560,2020-03-27,0.04610951008645533,17350,18150,800,421583
17741,241560,2020-03-25,0.10032362459546926,15450,17000,1550,444939
17742,241560,2020-03-24,0.08041958041958042,14300,15450,1150,264171
17743,241560,2020-03-20,0.072992700729927,13700,14700,1000,566771
17744,241560,2020-03-19,0.20116618075801748,17150,13700,-3450,527847
17745,241560,2020-03-18,0.14035087719298245,19950,17150,-2800,413009
17746,241560,2020-03-17,0.07209302325581396,21500,19950,-1550,320999
17747,241560,2020-03-13,0.13168724279835392,24300,21100,-3200,599321
17748,241560,2020-03-12,0.04142011834319527,25350,24300,-1050,316449
17749,241560,2020-03-11,0.055865921787709494,26850,25350,-1500,320509
17750,241560,2020-02-24,0.04092526690391459,28100,26950,-1150,259355
17751,241560,2019-12-20,0.04264705882352941,34000,35450,1450,179380
17752,241560,2019-09-30,0.04424778761061947,33900,35400,1500,150175
17753,241560,2019-08-09,0.04685212298682284,34150,35750,1600,187141
17754,241560,2019-08-06,0.0524822695035461,35250,33400,-1850,268381
17755,241560,2019-05-02,0.053208137715179966,31950,33650,1700,518629
17756,241560,2019-02-13,0.07525325615050651,34550,31950,-2600,584110
17757,241560,2019-01-09,0.04113924050632911,31600,32900,1300,249939
17758,241560,2018-11-30,0.07334273624823695,35450,32850,-2600,5744519
17759,241560,2018-09-27,0.040207522697795074,38550,40100,1550,374354
17760,241560,2018-08-31,0.05794947994056464,33650,35600,1950,1625917
17761,241560,2018-06-14,0.048600883652430045,33950,32300,-1650,1291817
17762,241560,2018-02-08,0.049132947976878616,34600,36300,1700,317016
17763,241560,2017-12-05,0.04836415362731152,35150,36850,1700,623531
17764,241560,2017-08-31,0.05532503457814661,36150,38150,2000,456786
17765,241560,2017-08-24,0.04172274562584118,37150,35600,-1550,408954
17766,241560,2017-05-18,0.04896907216494845,38800,36900,-1900,974183
17767,241560,2017-03-17,0.04145077720207254,38600,40200,1600,743734
17768,241560,2017-02-09,0.044,37500,35850,-1650,614183
17769,241560,2017-01-26,0.0792507204610951,34700,37450,2750,1125650
17770,241560,2016-12-05,0.041916167664670656,33400,34800,1400,827683
17771,241560,2016-11-30,0.040172166427546625,34850,33450,-1400,1004454
17772,241560,2016-11-23,0.04200542005420054,36900,35350,-1550,2028435
17773,241560,2016-11-22,0.06956521739130435,34500,36900,2400,4432520
17774,241560,2016-11-23,0.04200542005420054,36900,35350,-1550,2028435
17775,241560,2016-11-22,0.06956521739130435,34500,36900,2400,4432520
17776,241560,2016-11-23,0.04200542005420054,36900,35350,-1550,2028435
17777,241560,2016-11-22,0.06956521739130435,34500,36900,2400,4432520
17778,241560,2016-11-23,0.04200542005420054,36900,35350,-1550,2028435
17779,241560,2016-11-22,0.06956521739130435,34500,36900,2400,4432520
17780,241560,2016-11-23,0.04200542005420054,36900,35350,-1550,2028435
17781,241560,2016-11-22,0.06956521739130435,34500,36900,2400,4432520
17782,241560,2016-11-23,0.04200542005420054,36900,35350,-1550,2028435
17783,241560,2016-11-22,0.06956521739130435,34500,36900,2400,4432520
17784,241560,2016-11-23,0.04200542005420054,36900,35350,-1550,2028435
17785,241560,2016-11-22,0.06956521739130435,34500,36900,2400,4432520
17786,241560,2016-11-23,0.04200542005420054,36900,35350,-1550,2028435
17787,241560,2016-11-22,0.06956521739130435,34500,36900,2400,4432520
17788,10140,2021-06-01,0.05289256198347107,6050,6370,320,37838069
17789,10140,2021-05-06,0.16201117318435754,7160,6000,-1160,86311678
17790,10140,2021-04-26,0.042134831460674156,7120,7420,300,11661016
17791,10140,2021-03-31,0.052845528455284556,7380,7770,390,28523314
17792,10140,2021-03-26,0.060029282576866766,6830,7240,410,49173711
17793,10140,2021-03-24,0.058823529411764705,6460,6840,380,18784631
17794,10140,2021-02-01,0.04669887278582931,6210,6500,290,5002573
17795,10140,2021-01-29,0.04314329738058552,6490,6210,-280,6739849
17796,10140,2020-11-23,0.15692821368948248,5990,6930,940,164797515
17797,10140,2020-11-16,0.05823627287853577,6010,6360,350,16357782
17798,10140,2020-11-10,0.05,5600,5880,280,22827650
17799,10140,2020-11-09,0.08317214700193423,5170,5600,430,16670623
17800,10140,2020-09-07,0.057803468208092484,5190,5490,300,11770081
17801,10140,2020-08-25,0.0425531914893617,5170,5390,220,5981996
17802,10140,2020-08-20,0.06077348066298342,5430,5100,-330,6376963
17803,10140,2020-08-18,0.06260869565217392,5750,5390,-360,6106960
17804,10140,2020-08-11,0.044036697247706424,5450,5690,240,9897702
17805,10140,2020-08-03,0.06118881118881119,5720,5370,-350,10302925
17806,10140,2020-07-21,0.05851063829787234,5640,5970,330,28432176
17807,10140,2020-07-10,0.04,5750,5520,-230,5445413
17808,10140,2020-06-16,0.05950413223140496,6050,6410,360,12867859
17809,10140,2020-06-15,0.09836065573770492,6710,6050,-660,19737027
17810,10140,2020-06-03,0.1833616298811545,5890,6970,1080,112218100
17811,10140,2020-06-02,0.1827309236947791,4980,5890,910,65095218
17812,10140,2020-05-27,0.11529680365296803,4380,4885,505,46344404
17813,10140,2020-05-25,0.049576783555018135,4135,4340,205,8697158
17814,10140,2020-05-19,0.04938271604938271,4050,4250,200,7491196
17815,10140,2020-04-29,0.04767726161369193,4090,4285,195,10054461
17816,10140,2020-04-13,0.04888888888888889,4500,4280,-220,6749487
17817,10140,2020-04-06,0.04567901234567901,4050,4235,185,7587278
17818,10140,2020-04-02,0.057441253263707574,3830,4050,220,6150190
17819,10140,2020-03-25,0.1390532544378698,3380,3850,470,17811521
17820,10140,2020-03-24,0.08507223113964688,3115,3380,265,7976385
17821,10140,2020-03-23,0.10488505747126436,3480,3115,-365,7400603
17822,10140,2020-03-20,0.04819277108433735,3320,3480,160,11535243
17823,10140,2020-03-19,0.12860892388451445,3810,3320,-490,12107486
17824,10140,2020-03-18,0.072992700729927,4110,3810,-300,7340315
17825,10140,2020-03-16,0.05510907003444317,4355,4115,-240,8090165
17826,10140,2020-03-13,0.12550200803212852,4980,4355,-625,18096082
17827,10140,2020-03-12,0.08118081180811808,5420,4980,-440,9370399
17828,10140,2020-03-09,0.12131147540983607,6100,5360,-740,13781433
17829,10140,2020-02-28,0.042692939244663386,6090,5830,-260,4356891
17830,10140,2020-02-24,0.0546875,6400,6050,-350,4329219
17831,10140,2020-02-06,0.06697819314641744,6420,6850,430,6990985
17832,10140,2020-01-10,0.04488078541374474,7130,7450,320,5772540
17833,10140,2019-11-25,0.04380664652567976,6620,6910,290,5466781
17834,10140,2019-10-30,0.05844155844155844,7700,7250,-450,5817744
17835,10140,2019-08-30,0.08848314606741572,7120,7750,630,6282075
17836,10140,2019-08-20,0.046831955922865015,7260,7600,340,5964673
17837,10140,2019-08-19,0.07079646017699115,6780,7260,480,4665524
17838,10140,2019-07-25,0.05519053876478318,7610,7190,-420,5459003
17839,10140,2019-01-31,0.04597701149425287,8700,9100,400,22579819
17840,10140,2019-01-28,0.05006257822277847,7990,8390,400,11925826
17841,10140,2019-01-21,0.04730617608409987,7610,7970,360,6898974
17842,10140,2018-12-27,0.04201680672268908,7140,7440,300,3184508
17843,10140,2018-12-26,0.05305039787798409,7540,7140,-400,4587872
17844,10140,2018-12-13,0.07702523240371846,7530,8110,580,12004191
17845,10140,2018-11-16,0.0584958217270195,7180,7600,420,5276681
17846,10140,2018-11-14,0.04306864064602961,7430,7110,-320,4358769
17847,10140,2018-11-08,0.057352941176470586,6800,7190,390,4417623
17848,10140,2018-11-02,0.04566929133858268,6350,6640,290,3922156
17849,10140,2018-11-01,0.08764367816091954,6960,6350,-610,11091162
17850,10140,2018-10-08,0.0691358024691358,8100,7540,-560,5832477
17851,10140,2018-08-20,0.055891238670694864,6620,6990,370,7206085
17852,10140,2018-08-14,0.04375,6400,6680,280,3411754
17853,10140,2018-06-22,0.040229885057471264,6960,7240,280,3514880
17854,10140,2018-05-28,0.04498714652956298,7780,7430,-350,9560626
17855,10140,2018-05-08,0.05660377358490566,7420,7840,420,13181057
17856,10140,2018-04-10,0.057177615571776155,8220,7750,-470,7709998
17857,10140,2018-04-09,0.04846938775510204,7840,8220,380,8381329
17858,10140,2018-04-05,0.04161073825503356,7450,7760,310,5381441
17859,10140,2018-03-14,0.04745762711864407,8850,8430,-420,4778057
17860,10140,2018-03-12,0.07475490196078431,8160,8770,610,7907387
17861,10140,2018-03-08,0.08792650918635171,7620,8290,670,8522230
17862,10140,2018-02-14,0.05219454329774614,8430,8870,440,2703964
17863,10140,2018-02-06,0.041304347826086954,9200,8820,-380,6087551
17864,10140,2018-01-25,0.07683741648106904,8980,9670,690,13510266
17865,10140,2018-01-23,0.05517241379310345,8700,9180,480,6340740
17866,10140,2018-01-17,0.042081949058693245,9030,8650,-380,5776107
17867,10140,2018-01-10,0.0811138014527845,8260,8930,670,11546984
17868,10140,2018-01-04,0.05148005148005148,7770,8170,400,11274259
17869,10140,2018-01-02,0.04365620736698499,7330,7650,320,5554598
17870,10140,2017-12-28,0.047142857142857146,7000,7330,330,6911107
17871,10140,2017-12-14,0.046235138705416116,7570,7220,-350,11494408
17872,10140,2017-12-08,0.11162790697674418,8600,7640,-960,24268886
17873,10140,2017-12-07,0.04017857142857143,8960,8600,-360,15384435
17874,10140,2017-12-06,0.28888888888888886,12600,8960,-3640,42091497
17875,10140,2017-11-27,0.052845528455284556,12300,11650,-650,8186195
17876,10140,2017-11-22,0.041666666666666664,12000,12500,500,3649497
17877,10140,2017-11-10,0.04905660377358491,13250,12600,-650,4783532
17878,10140,2017-11-07,0.05327868852459016,12200,12850,650,7789213
17879,10140,2017-11-03,0.043478260869565216,11500,12000,500,4107614
17880,10140,2017-10-27,0.05405405405405406,11100,11700,600,3756997
17881,10140,2017-10-11,0.0547945205479452,10950,11550,600,3405093
17882,10140,2017-09-26,0.09803921568627451,10200,11200,1000,5364571
17883,10140,2017-09-22,0.0410958904109589,10950,10500,-450,2458593
17884,10140,2017-09-15,0.06532663316582915,9950,10600,650,5438116
17885,10140,2017-08-23,0.0430622009569378,10450,10900,450,2855796
17886,10140,2017-08-01,0.04017857142857143,11200,11650,450,1897379
17887,10140,2017-07-28,0.049586776859504134,12100,11500,-600,4216562
17888,10140,2017-07-18,0.041666666666666664,12000,11500,-500,3560199
17889,10140,2017-06-23,0.04048582995951417,12350,12850,500,3178325
17890,10140,2017-06-13,0.06504065040650407,12300,13100,800,7953616
17891,10140,2017-05-25,0.06722689075630252,11900,12700,800,7548777
17892,10140,2017-03-30,0.05194805194805195,11550,10950,-600,4980342
17893,10140,2017-03-07,0.05106382978723404,11750,12350,600,5272415
17894,10140,2017-01-05,0.05359056806002144,9330,9830,500,6078466
17895,10140,2016-12-12,0.07111111111111111,9000,9640,640,3959574
17896,10140,2016-12-01,0.05903614457831325,8300,8790,490,3906321
17897,10140,2016-11-24,0.04049493813273341,8890,8530,-360,2484057
17898,10140,2016-11-14,0.04314159292035398,9040,9430,390,2146021
17899,10140,2016-11-09,0.043243243243243246,9250,8850,-400,2332990
17900,10140,2016-10-21,0.052742616033755275,9480,9980,500,4412671
17901,10140,2016-08-23,0.04081632653061224,9800,10200,400,2509659
17902,10140,2016-08-16,0.060085836909871244,9320,9880,560,4095185
17903,7070,2021-05-31,0.053691275167785234,37250,39250,2000,1801163
17904,7070,2021-03-16,0.04059539918809202,36950,38450,1500,1016336
17905,7070,2021-03-03,0.04178272980501393,35900,37400,1500,777888
17906,7070,2020-10-19,0.04505813953488372,34400,35950,1550,1065599
17907,7070,2020-10-14,0.04149377593360996,36150,34650,-1500,739178
17908,7070,2020-10-12,0.09711684370257967,32950,36150,3200,1868585
17909,7070,2020-08-20,0.057352941176470586,34000,32050,-1950,372691
17910,7070,2020-08-18,0.06827880512091039,35150,32750,-2400,623963
17911,7070,2020-05-25,0.07475490196078431,40800,43850,3050,742290
17912,7070,2020-05-14,0.07,40000,42800,2800,1734947
17913,7070,2020-05-13,0.041666666666666664,38400,40000,1600,726854
17914,7070,2020-04-27,0.16613418530351437,31300,36500,5200,2303525
17915,7070,2020-04-01,0.06310679611650485,30900,28950,-1950,281137
17916,7070,2020-03-31,0.06551724137931035,29000,30900,1900,348311
17917,7070,2020-03-25,0.06261510128913444,27150,28850,1700,254012
17918,7070,2020-03-24,0.046242774566473986,25950,27150,1200,168773
17919,7070,2020-03-23,0.08947368421052632,28500,25950,-2550,227836
17920,7070,2020-03-20,0.08571428571428572,26250,28500,2250,302467
17921,7070,2020-03-19,0.0979381443298969,29100,26250,-2850,387862
17922,7070,2019-08-01,0.045576407506702415,37300,39000,1700,319830
17923,7070,2019-04-12,0.046632124352331605,38600,40400,1800,242241
17924,7070,2019-01-10,0.0651890482398957,38350,35850,-2500,854146
17925,7070,2018-11-22,0.04131054131054131,35100,36550,1450,302858
17926,7070,2018-11-20,0.0410958904109589,36500,35000,-1500,239431
17927,7070,2018-11-02,0.06382978723404255,35250,37500,2250,660006
17928,7070,2018-10-31,0.040106951871657755,37400,35900,-1500,650054
17929,7070,2018-10-10,0.07378129117259552,37950,40750,2800,459308
17930,7070,2018-09-13,0.05851063829787234,37600,39800,2200,386288
17931,7070,2018-08-10,0.06896551724137931,33350,35650,2300,1186747
17932,7070,2018-07-20,0.07751937984496124,32250,29750,-2500,1642649
17933,7070,2018-07-18,0.043731778425655975,34300,32800,-1500,569168
17934,7070,2018-07-16,0.10704960835509138,38300,34200,-4100,1411330
17935,7070,2018-07-03,0.047058823529411764,42500,40500,-2000,313687
17936,7070,2018-06-07,0.056818181818181816,39600,41850,2250,752875
17937,7070,2018-06-04,0.05408970976253298,37900,39950,2050,446848
17938,7070,2018-05-24,0.05075445816186557,36450,38300,1850,306933
17939,7070,2018-05-16,0.045871559633027525,38150,36400,-1750,408966
17940,7070,2018-05-02,0.0793010752688172,37200,40150,2950,1297966
17941,7070,2018-04-30,0.09090909090909091,34100,37200,3100,904035
17942,7070,2018-04-18,0.04747774480712166,33700,35300,1600,193081
17943,7070,2018-04-03,0.06101190476190476,33600,35650,2050,604356
17944,7070,2018-03-30,0.06351791530944625,30700,32650,1950,354700
17945,7070,2018-03-26,0.0453857791225416,33050,31550,-1500,348357
17946,7070,2018-03-09,0.04011887072808321,33650,35000,1350,455305
17947,7070,2018-01-31,0.04534313725490196,40800,38950,-1850,652100
17948,7070,2018-01-09,0.05548387096774193,38750,40900,2150,319511
17949,7070,2017-12-22,0.052840158520475564,37850,39850,2000,318367
17950,7070,2017-12-21,0.04177215189873418,39500,37850,-1650,362101
17951,7070,2017-12-11,0.04964539007092199,42300,40200,-2100,397932
17952,7070,2017-12-05,0.058394160583941604,41100,43500,2400,772748
17953,7070,2017-11-29,0.060240963855421686,37350,39600,2250,1066529
17954,7070,2017-11-20,0.04507042253521127,35500,37100,1600,267018
17955,7070,2017-11-07,0.06726457399103139,33450,35700,2250,1035651
17956,7070,2017-09-01,0.04708798017348203,40350,38450,-1900,875431
17957,7070,2017-08-03,0.14959016393442623,48800,41500,-7300,2221068
17958,7070,2017-07-17,0.06161616161616162,49500,46450,-3050,678729
17959,7070,2017-06-12,0.040492957746478875,56800,54500,-2300,337060
17960,7070,2017-05-08,0.043726235741444866,52600,54900,2300,398705
17961,7070,2017-02-10,0.046966731898238745,51100,53500,2400,527343
17962,7070,2017-02-03,0.04008016032064128,49900,51900,2000,347095
17963,7070,2017-02-02,0.04038461538461539,52000,49900,-2100,306836
17964,7070,2016-10-28,0.060935799782372145,45950,48750,2800,614115
17965,7070,2016-09-23,0.04898828541001065,46950,49250,2300,327429
17966,180640,2021-06-02,0.06859756097560976,65600,70100,4500,617560
17967,180640,2021-05-28,0.040875912408759124,68500,65700,-2800,338953
17968,180640,2021-05-25,0.059654631083202514,63700,67500,3800,601420
17969,180640,2021-05-17,0.1018363939899833,59900,66000,6100,1429921
17970,180640,2021-05-11,0.055855855855855854,55500,58600,3100,662805
17971,180640,2021-05-10,0.08187134502923976,51300,55500,4200,312127
17972,180640,2021-05-03,0.08828828828828829,55500,50600,-4900,326196
17973,180640,2021-04-08,0.04271844660194175,51500,53700,2200,160283
17974,180640,2021-04-06,0.043478260869565216,52900,50600,-2300,323239
17975,180640,2021-04-05,0.078397212543554,57400,52900,-4500,415129
17976,180640,2020-12-15,0.044374009508716325,63100,60300,-2800,385189
17977,180640,2020-12-14,0.041033434650455926,65800,63100,-2700,352796
17978,180640,2020-12-02,0.06593406593406594,72800,68000,-4800,1069964
17979,180640,2020-11-17,0.08880778588807786,82200,74900,-7300,1730811
17980,180640,2020-11-16,0.056555269922879174,77800,82200,4400,11647662
17981,180640,2020-11-13,0.08254716981132075,84800,77800,-7000,1341803
17982,180640,2020-11-09,0.05357142857142857,84000,88500,4500,363151
17983,180640,2020-11-02,0.05756358768406961,74700,79000,4300,288218
17984,180640,2020-10-12,0.04269972451790634,72600,75700,3100,251717
17985,180640,2020-10-08,0.0629575402635432,68300,72600,4300,339718
17986,180640,2020-09-24,0.05160390516039052,71700,68000,-3700,198486
17987,180640,2020-09-22,0.04336399474375821,76100,72800,-3300,141939
17988,180640,2020-09-21,0.049937578027465665,80100,76100,-4000,165282
17989,180640,2020-09-18,0.04025974025974026,77000,80100,3100,713371
17990,180640,2020-08-31,0.042582417582417584,72800,75900,3100,222908
17991,180640,2020-08-20,0.06218905472636816,80400,75400,-5000,350660
17992,180640,2020-07-23,0.047058823529411764,93500,89100,-4400,589245
17993,180640,2020-07-22,0.049796747967479675,98400,93500,-4900,690224
17994,180640,2020-07-21,0.04792332268370607,93900,98400,4500,770077
17995,180640,2020-07-13,0.05187637969094923,90600,95300,4700,987500
17996,180640,2020-07-08,0.05035128805620609,85400,89700,4300,928496
17997,180640,2020-07-01,0.07855361596009976,80200,86500,6300,1175743
17998,180640,2020-06-16,0.04230317273795535,85100,88700,3600,568194
17999,180640,2020-06-15,0.07197382769901854,91700,85100,-6600,817979
18000,180640,2020-06-12,0.07373737373737374,99000,91700,-7300,1334421
18001,180640,2020-06-11,0.05656350053361793,93700,99000,5300,4241916
18002,180640,2020-06-01,0.055619930475086905,86300,91100,4800,1560942
18003,180640,2020-05-29,0.07502679528403002,93300,86300,-7000,2574010
18004,180640,2020-05-28,0.04596412556053812,89200,93300,4100,2697830
18005,180640,2020-05-26,0.14213197969543148,78800,90000,11200,8007371
18006,180640,2020-05-13,0.12896174863387977,91500,79700,-11800,2353631
18007,180640,2020-05-11,0.06566820276497695,86800,92500,5700,1991449
18008,180640,2020-05-07,0.04342581423401689,82900,86500,3600,1965513
18009,180640,2020-05-04,0.04942528735632184,87000,82700,-4300,976706
18010,180640,2020-04-24,0.09154929577464789,85200,93000,7800,9390503
18011,180640,2020-04-20,0.2602739726027397,109500,81000,-28500,6522949
18012,180640,2020-04-17,0.28823529411764703,85000,109500,24500,13623107
18013,180640,2020-04-09,0.050188205771643665,79700,83700,4000,6732369
18014,180640,2020-04-08,0.0743321718931475,86100,79700,-6400,3804445
18015,180640,2020-04-07,0.2317596566523605,69900,86100,16200,8186102
18016,180640,2020-04-03,0.055248618784530384,72400,68400,-4000,1790590
18017,180640,2020-04-02,0.10617283950617284,81000,72400,-8600,2788795
18018,180640,2020-04-01,0.0901749663526245,74300,81000,6700,7791191
18019,180640,2020-03-30,0.29895104895104896,57200,74300,17100,6733285
18020,180640,2020-03-27,0.2985244040862656,44050,57200,13150,10585018
18021,180640,2020-03-25,0.06338028169014084,42600,45300,2700,3690263
18022,180640,2020-03-24,0.2692967409948542,58300,42600,-15700,9170002
18023,180640,2020-03-23,0.09380863039399624,53300,58300,5000,6514432
18024,180640,2020-03-20,0.2984165651644336,41050,53300,12250,6293980
18025,180640,2020-03-18,0.18451242829827916,52300,42650,-9650,2400703
18026,180640,2020-03-17,0.10902896081771721,58700,52300,-6400,1544437
18027,180640,2020-03-13,0.04643449419568822,60300,57500,-2800,2724014
18028,180640,2020-03-11,0.0765625,64000,59100,-4900,1714407
18029,180640,2020-03-09,0.10325318246110325,70700,63400,-7300,3318153
18030,180640,2020-03-06,0.14510278113663846,82700,70700,-12000,5952356
18031,180640,2020-03-04,0.04826732673267327,80800,84700,3900,6419975
18032,180640,2020-03-03,0.20059435364041606,67300,80800,13500,9410961
18033,180640,2020-02-27,0.08333333333333333,60000,65000,5000,7972161
18034,180640,2020-02-26,0.1650485436893204,51500,60000,8500,7891424
18035,180640,2020-02-13,0.10344827586206896,43500,48000,4500,6799473
18036,180640,2020-02-12,0.09848484848484848,39600,43500,3900,2936011
18037,180640,2020-01-09,0.05037783375314862,39700,41700,2000,1285296
18038,180640,2019-12-26,0.0979020979020979,42900,38700,-4200,4859653
18039,180640,2019-12-24,0.07142857142857142,46200,42900,-3300,12581857
18040,180640,2019-12-23,0.2,38500,46200,7700,9527785
18041,180640,2019-12-04,0.04032258064516129,37200,38700,1500,612087
18042,180640,2019-11-28,0.07749627421758569,33550,36150,2600,1027608
18043,180640,2019-11-06,0.05132192846034215,32150,33800,1650,726332
18044,180640,2019-11-04,0.07345575959933222,29950,32150,2200,962980
18045,180640,2019-10-30,0.0451505016722408,29900,31250,1350,509950
18046,180640,2019-10-01,0.046125461254612546,27100,28350,1250,363575
18047,180640,2019-07-29,0.05244122965641953,27650,26200,-1450,1026875
18048,180640,2019-07-08,0.06788079470198675,30200,28150,-2050,1259237
18049,180640,2019-06-24,0.09329446064139942,34300,31100,-3200,5112886
18050,180640,2019-06-21,0.15099009900990099,40400,34300,-6100,6543734
18051,180640,2019-06-18,0.04712041884816754,38200,40000,1800,1564694
18052,180640,2019-06-14,0.048207663782447466,40450,38500,-1950,1745062
18053,180640,2019-06-05,0.05441354292623942,41350,43600,2250,2757098
18054,180640,2019-05-27,0.0980603448275862,46400,41850,-4550,2341330
18055,180640,2019-05-24,0.04858757062146893,44250,46400,2150,3340078
18056,180640,2019-05-14,0.12568306010928962,36600,41200,4600,6388022
18057,180640,2019-04-23,0.07206068268015171,39550,36700,-2850,3126733
18058,180640,2019-04-22,0.04078947368421053,38000,39550,1550,4970394
18059,180640,2019-04-17,0.06490384615384616,41600,38900,-2700,6390672
18060,180640,2019-04-16,0.04914285714285714,43750,41600,-2150,11375406
18061,180640,2019-04-12,0.29896907216494845,33950,44100,10150,11917137
18062,180640,2019-04-10,0.0912106135986733,30150,32900,2750,10341401
18063,180640,2019-04-08,0.20634920634920634,25200,30400,5200,11006226
18064,180640,2019-03-22,0.048582995951417005,24700,25900,1200,1269655
18065,180640,2019-03-21,0.060836501901140684,26300,24700,-1600,1727513
18066,180640,2019-03-04,0.09411764705882353,25500,27900,2400,1423353
18067,180640,2019-02-18,0.04275092936802974,26900,25750,-1150,1025801
18068,180640,2019-01-25,0.04088586030664395,29350,28150,-1200,1165609
18069,180640,2019-01-18,0.04159733777038269,30050,31300,1250,766574
18070,180640,2018-12-28,0.06289308176100629,31800,29800,-2000,3090364
18071,180640,2018-12-20,0.06403940886699508,30450,32400,1950,2988804
18072,180640,2018-12-13,0.05442176870748299,29400,31000,1600,1577394
18073,180640,2018-11-29,0.07095709570957096,30300,32450,2150,1990534
18074,180640,2018-11-27,0.06491228070175438,28500,30350,1850,1754834
18075,180640,2018-11-21,0.04498269896193772,28900,30200,1300,2752397
18076,180640,2018-11-20,0.09056603773584905,26500,28900,2400,3591398
18077,180640,2018-11-19,0.06690140845070422,28400,26500,-1900,7806047
18078,180640,2018-11-16,0.14747474747474748,24750,28400,3650,7877754
18079,180640,2018-11-14,0.12582781456953643,22650,25500,2850,4415619
18080,180640,2018-11-02,0.09230769230769231,19500,21300,1800,974505
18081,180640,2018-10-17,0.042105263157894736,19000,19800,800,393973
18082,180640,2018-10-10,0.04215456674473068,21350,20450,-900,618415
18083,180640,2018-09-13,0.05513784461152882,19950,21050,1100,1227328
18084,180640,2018-09-11,0.06043956043956044,18200,19300,1100,967770
18085,180640,2018-09-07,0.05714285714285714,17500,18500,1000,504923
18086,180640,2018-08-17,0.05588235294117647,17000,17950,950,1206195
18087,180640,2018-07-31,0.06051873198847262,17350,18400,1050,777308
18088,180640,2018-07-26,0.044642857142857144,16800,17550,750,532994
18089,180640,2018-07-13,0.04956268221574344,17150,18000,850,566293
18090,180640,2018-07-10,0.04142011834319527,16900,17600,700,806366
18091,180640,2018-07-02,0.05029585798816568,16900,16050,-850,730434
18092,180640,2018-06-27,0.05337078651685393,17800,16850,-950,1172825
18093,180640,2018-06-21,0.08072916666666667,19200,17650,-1550,1182835
18094,180640,2018-06-15,0.05542725173210162,21650,20450,-1200,705316
18095,180640,2018-06-07,0.05803571428571429,22400,21100,-1300,984247
18096,180640,2018-05-31,0.06912442396313365,21700,23200,1500,553363
18097,180640,2018-05-23,0.05227272727272727,22000,20850,-1150,632228
18098,180640,2018-05-15,0.046610169491525424,23600,22500,-1100,384604
18099,180640,2018-05-11,0.040632054176072234,22150,23050,900,524941
18100,180640,2018-05-09,0.0502092050209205,23900,22700,-1200,1084996
18101,180640,2018-04-24,0.04285714285714286,24500,25550,1050,2193096
18102,180640,2018-04-23,0.06753812636165578,22950,24500,1550,1220977
18103,180640,2018-04-12,0.06423982869379015,23350,21850,-1500,864161
18104,180640,2018-04-03,0.05813953488372093,21500,22750,1250,1651660
18105,180640,2018-03-30,0.06091370558375635,19700,20900,1200,509412
18106,180640,2018-03-23,0.0488997555012225,20450,19450,-1000,354581
18107,180640,2018-01-24,0.056372549019607844,20400,21550,1150,872364
18108,180640,2018-01-02,0.04918032786885246,18300,19200,900,579561
18109,180640,2017-12-13,0.05128205128205128,17550,18450,900,532645
18110,180640,2017-12-08,0.04497354497354497,18900,18050,-850,1113741
18111,180640,2017-11-17,0.0481283422459893,18700,19600,900,2100124
18112,180640,2017-11-15,0.05454545454545454,19250,18200,-1050,1228014
18113,180640,2017-11-10,0.04030226700251889,19850,19050,-800,1621229
18114,180640,2017-11-02,0.05841121495327103,21400,20150,-1250,1135296
18115,180640,2017-10-26,0.05741626794258373,20900,22100,1200,823989
18116,180640,2017-10-19,0.05472636815920398,20100,21200,1100,649808
18117,180640,2017-10-18,0.05511811023622047,19050,20100,1050,743354
18118,180640,2017-09-21,0.04415011037527594,22650,21650,-1000,568478
18119,180640,2017-09-11,0.07142857142857142,21000,22500,1500,578931
18120,180640,2017-08-08,0.06300813008130081,24600,26150,1550,1132138
18121,180640,2017-08-03,0.04809619238476954,24950,23750,-1200,502416
18122,180640,2017-08-02,0.057203389830508475,23600,24950,1350,517542
18123,180640,2017-07-26,0.040983606557377046,24400,23400,-1000,662504
18124,180640,2017-07-14,0.044444444444444446,24750,23650,-1100,778904
18125,180640,2017-07-03,0.045283018867924525,26500,25300,-1200,892358
18126,180640,2017-06-02,0.05806451612903226,23250,24600,1350,987983
18127,180640,2017-05-25,0.042316258351893093,22450,23400,950,600477
18128,180640,2017-05-04,0.0413625304136253,20550,21400,850,676670
18129,180640,2017-04-25,0.046153846153846156,19500,20400,900,767307
18130,180640,2017-03-31,0.04533333333333334,18750,19600,850,859583
18131,180640,2017-03-21,0.042134831460674156,17800,18550,750,1174532
18132,180640,2017-03-17,0.0626865671641791,16750,17800,1050,1342105
18133,180640,2017-03-03,0.04833836858006042,16550,15750,-800,964844
18134,180640,2017-01-25,0.042071197411003236,15450,14800,-650,606791
18135,180640,2017-01-02,0.04234527687296417,15350,14700,-650,645361
18136,180640,2016-12-05,0.043859649122807015,17100,16350,-750,433246
18137,180640,2016-12-01,0.05337078651685393,17800,16850,-950,843988
18138,180640,2016-11-15,0.08074534161490683,16100,17400,1300,1481575
18139,180640,2016-11-11,0.05654761904761905,16800,15850,-950,904684
18140,180640,2016-09-22,0.055248618784530384,18100,19100,1000,903361
18141,180640,2016-09-09,0.041666666666666664,19200,18400,-800,1300309
18142,180640,2016-09-01,0.05263157894736842,19000,20000,1000,1715643
18143,180640,2016-08-30,0.0584958217270195,17950,19000,1050,3073453
18144,180640,2016-08-24,0.04437869822485207,16900,17650,750,824068
18145,180640,2016-08-23,0.08648648648648649,18500,16900,-1600,1761000
18146,180640,2016-08-17,0.09476309226932668,20050,18150,-1900,1824502
18147,180640,2016-08-12,0.046753246753246755,19250,20150,900,1702186
18148,180640,2016-08-11,0.06353591160220995,18100,19250,1150,2314445
18149,180640,2016-08-04,0.041666666666666664,18000,17250,-750,491764
18150,1440,2021-06-03,0.18377088305489261,2095,2480,385,282167672
18151,1440,2021-05-31,0.20771513353115728,1685,2035,350,251213465
18152,1440,2021-05-28,0.09771986970684039,1535,1685,150,88983037
18153,1440,2021-05-26,0.08992805755395683,1390,1515,125,98444370
18154,1440,2021-05-25,0.057034220532319393,1315,1390,75,42586566
18155,1440,2021-05-21,0.06,1250,1325,75,54622246
18156,1440,2021-05-10,0.06198347107438017,1210,1285,75,50543701
18157,1440,2021-05-04,0.048034934497816595,1145,1200,55,44001464
18158,1440,2021-04-08,0.0425531914893617,1175,1225,50,59108797
18159,1440,2021-04-06,0.04504504504504504,1110,1160,50,22534136
18160,1440,2021-03-31,0.07407407407407407,1080,1160,80,36036769
18161,1440,2021-03-30,0.1111111111111111,1215,1080,-135,52509801
18162,1440,2021-03-29,0.08,1125,1215,90,77611298
18163,1440,2021-03-26,0.046511627906976744,1075,1125,50,33412749
18164,1440,2021-03-25,0.06435643564356436,1010,1075,65,49845275
18165,1440,2021-03-22,0.050761421319796954,985,1035,50,19436828
18166,1440,2021-03-12,0.04838709677419355,930,975,45,16177055
18167,1440,2021-02-23,0.20634920634920634,1260,1000,-260,244684482
18168,1440,2021-02-10,0.040983606557377046,1220,1270,50,16629449
18169,1440,2021-02-01,0.09049773755656108,1105,1205,100,20817539
18170,1440,2021-01-29,0.06751054852320675,1185,1105,-80,17223509
18171,1440,2021-01-28,0.052,1250,1185,-65,14842165
18172,1440,2021-01-25,0.08996539792387544,1445,1315,-130,201057803
18173,1440,2021-01-22,0.04332129963898917,1385,1445,60,20669239
18174,1440,2020-12-29,0.046153846153846156,1300,1360,60,4836746
18175,1440,2020-12-28,0.047619047619047616,1365,1300,-65,7684819
18176,1440,2020-12-23,0.06896551724137931,1450,1350,-100,17111317
18177,1440,2020-12-22,0.04918032786885246,1525,1450,-75,12436607
18178,1440,2020-12-16,0.09574468085106383,1410,1545,135,107954207
18179,1440,2020-12-10,0.07196969696969698,1320,1415,95,63607154
18180,1440,2020-12-08,0.040892193308550186,1345,1290,-55,13318123
18181,1440,2020-12-04,0.07042253521126761,1420,1320,-100,29729786
18182,1440,2020-12-01,0.05519480519480519,1540,1455,-85,10968486
18183,1440,2020-11-27,0.17870722433460076,1315,1550,235,27624526
18184,1440,2020-11-26,0.06048387096774194,1240,1315,75,13753899
18185,1440,2020-11-20,0.29979035639413,954,1240,286,281265461
18186,1440,2020-11-19,0.05066079295154185,908,954,46,18035416
18187,1440,2020-11-16,0.05460750853242321,879,927,48,11161146
18188,1440,2020-11-09,0.054437869822485205,845,891,46,10212263
18189,1440,2020-10-21,0.04404761904761905,840,877,37,11109604
18190,1440,2020-10-16,0.06424242424242424,825,878,53,117458548
18191,1440,2020-10-12,0.06343283582089553,804,855,51,7699531
18192,1440,2020-09-07,0.0988095238095238,840,923,83,116289586
18193,1440,2020-09-04,0.1111111111111111,756,840,84,119908148
18194,1440,2020-09-03,0.06779661016949153,708,756,48,9804143
18195,1440,2020-08-20,0.0425531914893617,705,675,-30,4696407
18196,1440,2020-08-18,0.04663923182441701,729,695,-34,5180165
18197,1440,2020-08-11,0.0496551724137931,725,761,36,8148570
18198,1440,2020-07-31,0.11197339246119734,902,801,-101,69066380
18199,1440,2020-07-28,0.04610655737704918,976,931,-45,10228360
18200,1440,2020-07-27,0.05242718446601942,1030,976,-54,18708702
18201,1440,2020-07-24,0.24246079613992763,829,1030,201,61410953
18202,1440,2020-07-20,0.19306184012066366,663,791,128,33816020
18203,1440,2020-06-16,0.05185185185185185,675,710,35,1425843
18204,1440,2020-06-15,0.08536585365853659,738,675,-63,3297998
18205,1440,2020-05-27,0.04461942257217848,762,796,34,8303403
18206,1440,2020-05-20,0.048812664907651716,758,795,37,8460981
18207,1440,2020-05-08,0.1492753623188406,690,793,103,29993983
18208,1440,2020-05-06,0.04153846153846154,650,677,27,2552620
18209,1440,2020-04-10,0.04433497536945813,609,636,27,4236171
18210,1440,2020-04-08,0.0948905109489051,548,600,52,5017707
18211,1440,2020-04-07,0.06614785992217899,514,548,34,2526612
18212,1440,2020-03-31,0.041237113402061855,485,505,20,1683251
18213,1440,2020-03-25,0.06904761904761905,420,449,29,1340279
18214,1440,2020-03-23,0.04,425,408,-17,887666
18215,1440,2020-03-20,0.04938271604938271,405,425,20,1301188
18216,1440,2020-03-19,0.14556962025316456,474,405,-69,2428699
18217,1440,2020-03-17,0.04339250493096647,507,485,-22,1066810
18218,1440,2020-03-13,0.053406998158379376,543,514,-29,1933946
18219,1440,2020-02-24,0.04576271186440678,590,563,-27,1757953
18220,1440,2019-10-30,0.06837606837606838,585,625,40,14592367
18221,1440,2019-09-30,0.047244094488188976,635,605,-30,5146314
18222,1440,2019-09-27,0.09671848013816926,579,635,56,31603613
18223,1440,2019-08-26,0.04187604690117253,597,572,-25,707938
18224,1440,2019-08-05,0.07321131447587355,601,557,-44,2011429
18225,1440,2019-07-29,0.07109737248840804,647,601,-46,1708185
18226,1440,2019-05-24,0.04664391353811149,879,838,-41,2204185
18227,1440,2019-05-16,0.04385026737967915,935,894,-41,2487844
18228,1440,2019-04-22,0.04285714285714286,1050,1005,-45,4466612
18229,1440,2019-04-18,0.11688311688311688,1155,1020,-135,55826590
18230,1440,2019-02-28,0.04219409282700422,1185,1135,-50,719097
18231,1440,2019-02-13,0.043668122270742356,1145,1195,50,2385665
18232,1440,2019-02-01,0.05357142857142857,1120,1180,60,1546878
18233,1440,2018-10-29,0.0448780487804878,1025,979,-46,1469118
18234,1440,2018-10-10,0.04938271604938271,1215,1155,-60,851535
18235,1440,2018-08-13,0.04132231404958678,1210,1160,-50,906173
18236,1440,2018-07-24,0.0547945205479452,1095,1155,60,1584245
18237,1440,2018-07-02,0.04633204633204633,1295,1235,-60,1205765
18238,1440,2018-06-27,0.040892193308550186,1345,1290,-55,2064712
18239,1440,2018-06-19,0.04794520547945205,1460,1390,-70,2304516
18240,1440,2018-06-14,0.065625,1600,1495,-105,3479892
18241,1440,2018-06-11,0.050473186119873815,1585,1665,80,3152012
18242,1440,2018-06-01,0.04261363636363636,1760,1685,-75,5133079
18243,1440,2018-05-29,0.0737913486005089,1965,1820,-145,13094070
18244,1440,2018-05-28,0.21296296296296297,1620,1965,345,28296471
18245,1440,2018-05-25,0.0847457627118644,1770,1620,-150,10105910
18246,1440,2018-05-21,0.05319148936170213,1880,1780,-100,10154814
18247,1440,2018-05-17,0.07365439093484419,1765,1895,130,53394687
18248,1440,2018-05-16,0.2326086956521739,2300,1765,-535,95048008
18249,1440,2018-05-15,0.2994350282485876,1770,2300,530,41430593
18250,1440,2018-05-08,0.06172839506172839,1620,1720,100,6175293
18251,1440,2018-05-03,0.04105571847507331,1705,1635,-70,1884619
18252,1440,2018-04-30,0.12333333333333334,1500,1685,185,8169752
18253,1440,2018-04-19,0.09523809523809523,1365,1495,130,7322786
18254,1440,2018-03-23,0.04316546762589928,1390,1330,-60,836736
18255,1440,2018-02-20,0.04247104247104247,1295,1350,55,7104503
18256,1440,2018-02-02,0.044673539518900345,1455,1390,-65,1249080
18257,1440,2018-01-29,0.051094890510948905,1370,1440,70,3843904
18258,1440,2018-01-17,0.11764705882352941,1190,1330,140,18801504
18259,1440,2018-01-08,0.07758620689655173,1160,1250,90,2872952
18260,1440,2017-09-06,0.04980842911877394,1305,1370,65,1666327
18261,1440,2017-08-14,0.072,1250,1340,90,3207156
18262,1440,2017-08-10,0.061371841155234655,1385,1300,-85,2468652
18263,1440,2017-08-09,0.11693548387096774,1240,1385,145,12435091
18264,1440,2017-05-18,0.10115606936416185,1730,1555,-175,8511466
18265,1440,2017-01-19,0.04145077720207254,1930,2010,80,4320585
18266,1440,2016-11-15,0.0425,2000,1915,-85,1252785
18267,1440,2016-11-11,0.07049608355091384,1915,2050,135,2478679
18268,1440,2016-11-10,0.043596730245231606,1835,1915,80,424231
18269,1440,2016-11-09,0.04922279792746114,1930,1835,-95,1010500
18270,1440,2016-11-03,0.040983606557377046,1830,1905,75,1402516
18271,3490,2021-06-02,0.061514195583596214,31700,33650,1950,11787950
18272,3490,2021-05-25,0.05396290050590219,29650,31250,1600,9971928
18273,3490,2021-05-17,0.040955631399317405,29300,30500,1200,8708514
18274,3490,2021-05-10,0.06630824372759857,27900,29750,1850,10012006
18275,3490,2021-05-06,0.04743833017077799,26350,27600,1250,5975426
18276,3490,2021-03-26,0.04664179104477612,26800,28050,1250,4755324
18277,3490,2021-02-08,0.04666666666666667,30000,31400,1400,7227875
18278,3490,2021-01-25,0.09298998569384835,34950,30350,-4600,12392646
18279,3490,2021-01-22,0.057488653555219364,33050,34950,1900,11501503
18280,3490,2021-01-19,0.041050903119868636,30450,31700,1250,3076678
18281,3490,2021-01-18,0.05287713841368585,32150,30450,-1700,4329133
18282,3490,2021-01-14,0.0755336617405583,30450,32750,2300,11572949
18283,3490,2021-01-11,0.043010752688172046,27900,29100,1200,18754274
18284,3490,2020-11-17,0.08905380333951762,26950,24550,-2400,29343022
18285,3490,2020-11-16,0.12526096033402923,23950,26950,3000,74509096
18286,3490,2020-11-12,0.042801556420233464,25700,24600,-1100,7048416
18287,3490,2020-11-11,0.05979381443298969,24250,25700,1450,12939812
18288,3490,2020-11-10,0.11238532110091744,21800,24250,2450,18803992
18289,3490,2020-11-09,0.04807692307692308,20800,21800,1000,5125236
18290,3490,2020-10-12,0.04556962025316456,19750,20650,900,4863798
18291,3490,2020-08-20,0.04619565217391304,18400,17550,-850,2206150
18292,3490,2020-08-18,0.0641025641025641,19500,18250,-1250,3203963
18293,3490,2020-08-07,0.055248618784530384,18100,19100,1000,15844472
18294,3490,2020-08-06,0.04927536231884058,17250,18100,850,5637601
18295,3490,2020-07-27,0.043478260869565216,18400,17600,-800,3293141
18296,3490,2020-07-21,0.07756232686980609,18050,19450,1400,3701663
18297,3490,2020-07-16,0.04,17500,18200,700,2300332
18298,3490,2020-06-15,0.04040404040404041,19800,19000,-800,1311311
18299,3490,2020-06-05,0.06331877729257641,22900,20600,-2300,7552462
18300,3490,2020-06-03,0.05924170616113744,21100,22350,1250,3549822
18301,3490,2020-05-26,0.046511627906976744,19350,20250,900,2295923
18302,3490,2020-05-19,0.08033240997229917,18050,19500,1450,4285639
18303,3490,2020-04-20,0.0645933014354067,20900,19550,-1350,6811234
18304,3490,2020-04-17,0.0663265306122449,19600,20900,1300,10793150
18305,3490,2020-04-09,0.04450261780104712,19100,19950,850,2675324
18306,3490,2020-03-26,0.05763688760806916,17350,18350,1000,4960871
18307,3490,2020-03-25,0.15666666666666668,15000,17350,2350,4564606
18308,3490,2020-03-24,0.04895104895104895,14300,15000,700,2680025
18309,3490,2020-03-23,0.06229508196721312,15250,14300,-950,3347088
18310,3490,2020-03-20,0.1213235294117647,13600,15250,1650,7782231
18311,3490,2020-03-19,0.24861878453038674,18100,13600,-4500,5231313
18312,3490,2020-03-18,0.08585858585858586,19800,18100,-1700,1426430
18313,3490,2020-03-13,0.05069124423963134,21700,20600,-1100,1799050
18314,3490,2020-03-12,0.046153846153846156,22750,21700,-1050,1355702
18315,3490,2020-03-06,0.05179282868525897,25100,23800,-1300,1520202
18316,3490,2020-03-05,0.04583333333333333,24000,25100,1100,2216940
18317,3490,2020-03-04,0.07142857142857142,22400,24000,1600,1459603
18318,3490,2020-02-24,0.06157112526539278,23550,22100,-1450,1633736
18319,3490,2020-02-04,0.06625258799171843,24150,25750,1600,1956707
18320,3490,2020-01-28,0.06692913385826772,25400,23700,-1700,1668337
18321,3490,2020-01-23,0.04150943396226415,26500,25400,-1100,757735
18322,3490,2020-01-09,0.043726235741444866,26300,27450,1150,614807
18323,3490,2019-12-23,0.046762589928057555,27800,29100,1300,1847155
18324,3490,2019-12-06,0.054989816700611,24550,25900,1350,812762
18325,3490,2019-11-15,0.05058365758754864,25700,27000,1300,686734
18326,3490,2019-10-14,0.05603448275862069,23200,24500,1300,1109046
18327,3490,2019-09-11,0.043668122270742356,22900,23900,1000,1362509
18328,3490,2019-08-05,0.040776699029126215,25750,24700,-1050,641816
18329,3490,2019-04-16,0.05033112582781457,37750,35850,-1900,2834762
18330,3490,2019-04-15,0.060393258426966294,35600,37750,2150,6712935
18331,3490,2019-04-12,0.0755287009063444,33100,35600,2500,2617556
18332,3490,2019-03-28,0.05271084337349398,33200,31450,-1750,1008170
18333,3490,2019-01-30,0.046742209631728045,35300,36950,1650,1081739
18334,3490,2019-01-25,0.04264099037138927,36350,34800,-1550,1033315
18335,3490,2018-11-30,0.04491017964071856,33400,31900,-1500,890923
18336,3490,2018-11-14,0.09427609427609428,29700,32500,2800,2705130
18337,3490,2018-11-02,0.04634581105169341,28050,29350,1300,1462021
18338,3490,2018-10-31,0.06395348837209303,25800,27450,1650,641164
18339,3490,2018-10-11,0.06261510128913444,27150,25450,-1700,881536
18340,3490,2018-07-02,0.04070796460176991,28250,27100,-1150,740922
18341,3490,2018-06-29,0.04436229205175601,27050,28250,1200,568197
18342,3490,2018-06-21,0.05546218487394958,29750,28100,-1650,1069115
18343,3490,2018-06-18,0.0421875,32000,30650,-1350,953419
18344,3490,2018-04-12,0.06545961002785515,35900,33550,-2350,1340498
18345,3490,2018-04-03,0.046579330422125184,34350,35950,1600,1488174
18346,3490,2018-03-29,0.04472843450479233,31300,32700,1400,762724
18347,3490,2018-03-23,0.04791344667697063,32350,30800,-1550,1026973
18348,3490,2018-01-02,0.060561299852289516,33850,35900,2050,1360084
18349,3490,2017-12-13,0.06774193548387097,31000,33100,2100,1669018
18350,3490,2017-11-17,0.05475040257648953,31050,32750,1700,2631860
18351,3490,2017-10-26,0.05901639344262295,30500,32300,1800,1358053
18352,3490,2017-10-19,0.05612244897959184,29400,31050,1650,806595
18353,3490,2017-07-26,0.04143646408839779,36200,34700,-1500,860548
18354,3490,2017-06-19,0.051560379918588875,36850,38750,1900,1032867
18355,3490,2017-05-04,0.06320907617504051,30850,32800,1950,1689919
18356,3490,2017-03-21,0.04215851602023609,29650,30900,1250,1028182
18357,3490,2017-03-09,0.05037313432835821,26800,28150,1350,1168555
18358,3490,2017-03-03,0.04770318021201413,28300,26950,-1350,963489
18359,3490,2017-02-21,0.041121495327102804,26750,27850,1100,1443824
18360,3490,2016-11-11,0.057003257328990226,30700,28950,-1750,845022
18361,3490,2016-09-27,0.04360902255639098,33250,34700,1450,808493
18362,3490,2016-09-22,0.05434782608695652,32200,33950,1750,858426
18363,3490,2016-09-09,0.040697674418604654,34400,33000,-1400,890950
18364,3490,2016-09-01,0.09508716323296355,31550,34550,3000,2673595
18365,3490,2016-08-30,0.06872852233676977,29100,31100,2000,2046185
18366,3490,2016-08-23,0.07425742574257425,30300,28050,-2250,1632246
18367,3490,2016-08-10,0.04225352112676056,28400,29600,1200,770204
18368,11170,2021-05-12,0.04326123128119801,300500,287500,-13000,397425
18369,11170,2021-05-06,0.053726169844020795,288500,304000,15500,373716
18370,11170,2021-05-03,0.05756578947368421,304000,286500,-17500,481861
18371,11170,2021-02-25,0.07107438016528926,302500,324000,21500,514784
18372,11170,2021-02-24,0.07208588957055215,326000,302500,-23500,497132
18373,11170,2021-02-23,0.07947019867549669,302000,326000,24000,1193010
18374,11170,2021-02-10,0.041237113402061855,291000,303000,12000,494419
18375,11170,2021-02-08,0.04929577464788732,284000,298000,14000,617328
18376,11170,2021-02-05,0.05185185185185185,270000,284000,14000,234939
18377,11170,2021-01-29,0.04918032786885246,274500,261000,-13500,276795
18378,11170,2021-01-15,0.04746835443037975,316000,301000,-15000,305414
18379,11170,2021-01-12,0.08869565217391304,287500,313000,25500,1405533
18380,11170,2021-01-11,0.044850498338870434,301000,287500,-13500,576371
18381,11170,2021-01-07,0.07420494699646643,283000,304000,21000,711593
18382,11170,2020-12-30,0.043478260869565216,264500,276000,11500,386964
18383,11170,2020-11-13,0.04308797127468582,278500,266500,-12000,407336
18384,11170,2020-11-11,0.04664179104477612,268000,280500,12500,421936
18385,11170,2020-11-09,0.092,250000,273000,23000,610378
18386,11170,2020-11-03,0.055201698513800426,235500,248500,13000,334468
18387,11170,2020-10-28,0.0670995670995671,231000,246500,15500,424322
18388,11170,2020-10-26,0.04216867469879518,249000,238500,-10500,412612
18389,11170,2020-10-20,0.06053811659192825,223000,236500,13500,440130
18390,11170,2020-10-08,0.052873563218390804,217500,229000,11500,608306
18391,11170,2020-10-05,0.08396946564885496,196500,213000,16500,577344
18392,11170,2020-09-22,0.04941176470588235,212500,202000,-10500,258209
18393,11170,2020-09-14,0.07160493827160494,202500,217000,14500,527310
18394,11170,2020-09-07,0.12021857923497267,183000,205000,22000,926441
18395,11170,2020-08-20,0.0584958217270195,179500,169000,-10500,239731
18396,11170,2020-08-18,0.06382978723404255,188000,176000,-12000,232471
18397,11170,2020-08-10,0.08262108262108261,175500,190000,14500,722396
18398,11170,2020-08-06,0.04678362573099415,171000,179000,8000,555578
18399,11170,2020-07-13,0.050746268656716415,167500,176000,8500,207859
18400,11170,2020-06-19,0.07309941520467836,171000,183500,12500,450459
18401,11170,2020-06-15,0.06515580736543909,176500,165000,-11500,273285
18402,11170,2020-06-12,0.04076086956521739,184000,176500,-7500,200268
18403,11170,2020-06-03,0.04736842105263158,190000,199000,9000,468452
18404,11170,2020-05-11,0.043478260869565216,195500,187000,-8500,317474
18405,11170,2020-05-04,0.09048723897911833,215500,196000,-19500,477632
18406,11170,2020-04-27,0.05176470588235294,212500,223500,11000,242427
18407,11170,2020-04-23,0.06683168316831684,202000,215500,13500,333824
18408,11170,2020-04-14,0.06944444444444445,180000,192500,12500,379858
18409,11170,2020-04-10,0.04857142857142857,175000,183500,8500,236744
18410,11170,2020-04-03,0.055401662049861494,180500,170500,-10000,260421
18411,11170,2020-04-01,0.05181347150259067,193000,183000,-10000,237629
18412,11170,2020-03-31,0.06629834254143646,181000,193000,12000,309889
18413,11170,2020-03-30,0.043227665706051875,173500,181000,7500,214671
18414,11170,2020-03-27,0.042042042042042045,166500,173500,7000,191362
18415,11170,2020-03-25,0.10067114093959731,149000,164000,15000,259386
18416,11170,2020-03-24,0.08363636363636363,137500,149000,11500,234454
18417,11170,2020-03-23,0.06779661016949153,147500,137500,-10000,242745
18418,11170,2020-03-20,0.2606837606837607,117000,147500,30500,301848
18419,11170,2020-03-19,0.1552346570397112,138500,117000,-21500,313242
18420,11170,2020-03-18,0.06734006734006734,148500,138500,-10000,167057
18421,11170,2020-03-17,0.04807692307692308,156000,148500,-7500,253166
18422,11170,2020-03-16,0.06865671641791045,167500,156000,-11500,204473
18423,11170,2020-03-13,0.04285714285714286,175000,167500,-7500,342322
18424,11170,2020-03-12,0.05405405405405406,185000,175000,-10000,285394
18425,11170,2020-03-10,0.06705539358600583,171500,183000,11500,338908
18426,11170,2020-03-06,0.04087193460490463,183500,176000,-7500,241901
18427,11170,2020-02-24,0.04020100502512563,199000,191000,-8000,123898
18428,11170,2020-02-06,0.07848101265822785,197500,213000,15500,339549
18429,11170,2020-01-28,0.06220095693779904,209000,196000,-13000,306075
18430,11170,2020-01-14,0.045346062052505964,209500,219000,9500,244681
18431,11170,2019-11-04,0.053763440860215055,232500,220000,-12500,351305
18432,11170,2019-09-25,0.04065040650406504,246000,236000,-10000,155164
18433,11170,2019-09-10,0.04051172707889126,234500,244000,9500,209719
18434,11170,2019-09-05,0.053811659192825115,223000,235000,12000,244799
18435,11170,2019-08-26,0.046153846153846156,227500,217000,-10500,123804
18436,11170,2019-08-05,0.046153846153846156,227500,217000,-10500,199012
18437,11170,2019-03-07,0.05161290322580645,310000,294000,-16000,265132
18438,11170,2019-02-18,0.05396290050590219,296500,312500,16000,291907
18439,11170,2019-02-13,0.05799648506151142,284500,301000,16500,263470
18440,11170,2019-02-08,0.05592105263157895,304000,287000,-17000,211071
18441,11170,2019-01-07,0.06237816764132553,256500,272500,16000,224976
18442,11170,2019-01-04,0.041121495327102804,267500,256500,-11000,261091
18443,11170,2018-12-27,0.05414551607445008,295500,279500,-16000,210430
18444,11170,2018-12-19,0.048417132216014895,268500,281500,13000,154744
18445,11170,2018-12-10,0.04488330341113106,278500,266000,-12500,188927
18446,11170,2018-12-03,0.05871559633027523,272500,288500,16000,367898
18447,11170,2018-11-26,0.05045045045045045,277500,291500,14000,176942
18448,11170,2018-11-20,0.04288164665523156,291500,279000,-12500,148924
18449,11170,2018-11-02,0.07735849056603773,265000,285500,20500,364391
18450,11170,2018-10-29,0.04664179104477612,268000,255500,-12500,188029
18451,11170,2018-10-26,0.046263345195729534,281000,268000,-13000,189936
18452,11170,2018-10-24,0.064453125,256000,272500,16500,282081
18453,11170,2018-10-18,0.04981549815498155,271000,257500,-13500,159115
18454,11170,2018-10-04,0.06375227686703097,274500,257000,-17500,359452
18455,11170,2018-09-11,0.041666666666666664,300000,287500,-12500,347855
18456,11170,2018-08-22,0.049773755656108594,331500,315000,-16500,413988
18457,11170,2018-08-01,0.0584144645340751,359500,338500,-21000,240735
18458,11170,2018-07-26,0.05522388059701493,335000,353500,18500,137756
18459,11170,2018-07-02,0.05172413793103448,348000,330000,-18000,139554
18460,11170,2018-06-19,0.04194857916102842,369500,354000,-15500,197082
18461,11170,2018-06-14,0.045992115637319315,380500,363000,-17500,240480
18462,11170,2018-05-04,0.05172413793103448,406000,385000,-21000,163487
18463,11170,2018-03-05,0.04741833508956796,474500,452000,-22500,164203
18464,11170,2018-02-23,0.04180790960451977,442500,461000,18500,159729
18465,11170,2018-02-09,0.04887218045112782,399000,418500,19500,297735
18466,11170,2018-02-07,0.04854368932038835,412000,392000,-20000,202328
18467,11170,2018-01-29,0.041820418204182044,406500,423500,17000,163648
18468,11170,2018-01-08,0.09103840682788052,351500,383500,32000,490208
18469,11170,2017-11-13,0.0481283422459893,374000,356000,-18000,244307
18470,11170,2017-10-30,0.04768041237113402,388000,369500,-18500,373636
18471,11170,2017-10-13,0.046357615894039736,377500,395000,17500,202758
18472,11170,2017-09-15,0.051407588739290085,408500,387500,-21000,301246
18473,11170,2017-08-04,0.04780876494023904,376500,394500,18000,249827
18474,11170,2017-06-30,0.04084720121028744,330500,344000,13500,254326
18475,11170,2017-05-22,0.0641025641025641,351000,373500,22500,446013
18476,11170,2017-05-02,0.04532163742690058,342000,357500,15500,235616
18477,11170,2017-02-24,0.04479578392621871,379500,362500,-17000,278996
18478,11170,2017-01-31,0.04076433121019108,392500,376500,-16000,97755
18479,11170,2016-12-06,0.04940119760479042,334000,350500,16500,176448
18480,11170,2016-12-01,0.05754276827371695,321500,340000,18500,177336
18481,11170,2016-11-10,0.044673539518900345,291000,304000,13000,135512
18482,11170,2016-10-13,0.04508856682769726,310500,296500,-14000,138911
18483,11170,2016-08-29,0.04070796460176991,282500,271000,-11500,120921
18484,11170,2016-08-03,0.04409448818897638,317500,303500,-14000,128855
18485,4000,2021-05-28,0.05221518987341772,63200,66500,3300,647787
18486,4000,2021-04-28,0.05442176870748299,73500,69500,-4000,338453
18487,4000,2021-04-16,0.1140495867768595,60500,67400,6900,1389614
18488,4000,2021-04-05,0.06412478336221837,57700,61400,3700,564191
18489,4000,2021-03-22,0.04604051565377532,54300,56800,2500,279340
18490,4000,2021-01-22,0.0411663807890223,58300,60700,2400,692156
18491,4000,2021-01-20,0.051094890510948905,54800,57600,2800,334442
18492,4000,2020-11-19,0.0916030534351145,52400,57200,4800,577950
18493,4000,2020-11-03,0.044989775051124746,48900,51100,2200,122513
18494,4000,2020-10-20,0.04267161410018553,53900,51600,-2300,240273
18495,4000,2020-09-24,0.06774809160305344,52400,48850,-3550,221371
18496,4000,2020-09-23,0.07157464212678936,48900,52400,3500,321854
18497,4000,2020-09-21,0.04206500956022945,52300,50100,-2200,170643
18498,4000,2020-09-08,0.053691275167785234,59600,56400,-3200,478854
18499,4000,2020-09-07,0.12452830188679245,53000,59600,6600,1294134
18500,4000,2020-09-04,0.10416666666666667,48000,53000,5000,835129
18501,4000,2020-09-03,0.06312292358803986,45150,48000,2850,311879
18502,4000,2020-08-21,0.09243697478991597,41650,45500,3850,145012
18503,4000,2020-08-20,0.06299212598425197,44450,41650,-2800,147562
18504,4000,2020-08-14,0.04384133611691023,47900,45800,-2100,134581
18505,4000,2020-08-04,0.10423825887743414,43650,48200,4550,435096
18506,4000,2020-07-29,0.041766109785202864,41900,43650,1750,143599
18507,4000,2020-07-08,0.11366384522370013,41350,46050,4700,672752
18508,4000,2020-07-07,0.04025157232704402,39750,41350,1600,497976
18509,4000,2020-07-06,0.1555232558139535,34400,39750,5350,982025
18510,4000,2020-06-16,0.08345120226308345,35350,38300,2950,206351
18511,4000,2020-05-20,0.04644808743169399,36600,38300,1700,161411
18512,4000,2020-04-29,0.05548037889039242,36950,39000,2050,318543
18513,4000,2020-04-23,0.08787878787878788,33000,35900,2900,168892
18514,4000,2020-04-14,0.04716981132075472,31800,33300,1500,96671
18515,4000,2020-04-01,0.05152979066022544,31050,29450,-1600,124508
18516,4000,2020-03-24,0.1062124248496994,24950,27600,2650,113054
18517,4000,2020-03-23,0.0724907063197026,26900,24950,-1950,135107
18518,4000,2020-03-20,0.12552301255230125,23900,26900,3000,152909
18519,4000,2020-03-19,0.11645101663585952,27050,23900,-3150,165380
18520,4000,2020-03-13,0.061488673139158574,30900,29000,-1900,189005
18521,4000,2020-03-12,0.05214723926380368,32600,30900,-1700,150691
18522,4000,2020-02-28,0.059490084985835696,35300,33200,-2100,248660
18523,4000,2020-02-24,0.04749679075738126,38950,37100,-1850,102029
18524,4000,2020-02-11,0.05154639175257732,38800,40800,2000,144213
18525,4000,2020-01-28,0.04463208685162847,41450,39600,-1850,93863
18526,4000,2020-01-08,0.05826397146254459,42050,39600,-2450,175093
18527,4000,2019-07-29,0.041501976284584984,50600,48500,-2100,77340
18528,4000,2019-06-17,0.05283757338551859,51100,53800,2700,279941
18529,4000,2019-06-12,0.04184100418410042,47800,49800,2000,177310
18530,4000,2019-05-28,0.047520661157024795,48400,50700,2300,245469
18531,4000,2019-05-22,0.06564551422319474,45700,48700,3000,190207
18532,4000,2019-04-29,0.055135135135135134,46250,48800,2550,117175
18533,4000,2019-04-18,0.05242718446601942,51500,48800,-2700,142744
18534,4000,2019-04-01,0.07142857142857142,44100,47250,3150,163554
18535,4000,2019-02-18,0.040625,48000,49950,1950,214556
18536,4000,2019-02-13,0.05402425578831312,45350,47800,2450,292294
18537,4000,2019-01-30,0.04081632653061224,44100,45900,1800,216921
18538,4000,2019-01-25,0.07647058823529412,42500,45750,3250,423400
18539,4000,2018-11-28,0.04438964241676942,40550,42350,1800,211149
18540,4000,2018-11-08,0.05472636815920398,40200,42400,2200,177710
18541,4000,2018-11-07,0.04399524375743163,42050,40200,-1850,221430
18542,4000,2018-10-29,0.07345971563981042,42200,39100,-3100,237350
18543,4000,2018-10-26,0.05803571428571429,44800,42200,-2600,271714
18544,4000,2018-10-23,0.05619146722164412,48050,45350,-2700,105266
18545,4000,2018-10-22,0.06659267480577137,45050,48050,3000,133621
18546,4000,2018-10-18,0.04072883172561629,46650,44750,-1900,127523
18547,4000,2018-09-17,0.07553956834532374,55600,51400,-4200,278646
18548,4000,2018-09-10,0.047038327526132406,57400,54700,-2700,176406
18549,4000,2018-07-26,0.04873949579831933,59500,62400,2900,172523
18550,4000,2018-07-04,0.04111842105263158,60800,58300,-2500,286608
18551,4000,2018-05-31,0.05864197530864197,64800,68600,3800,242713
18552,4000,2018-05-08,0.06351550960118169,67700,63400,-4300,207485
18553,4000,2018-04-17,0.045317220543806644,66200,69200,3000,97833
18554,4000,2018-03-08,0.06493506493506493,69300,73800,4500,178257
18555,4000,2018-03-06,0.07057057057057058,66600,71300,4700,158529
18556,4000,2018-02-23,0.05187319884726225,69400,73000,3600,129300
18557,4000,2018-02-20,0.04143646408839779,72400,69400,-3000,88813
18558,4000,2018-01-30,0.04395604395604396,72800,76000,3200,365927
18559,4000,2018-01-12,0.045454545454545456,66000,69000,3000,155773
18560,4000,2018-01-09,0.044630404463040445,71700,68500,-3200,201892
18561,4000,2018-01-05,0.07309486780715396,64300,69000,4700,290424
18562,4000,2017-12-15,0.05472636815920398,60300,63600,3300,180355
18563,4000,2017-12-13,0.05660377358490566,63600,60000,-3600,509990
18564,4000,2017-12-11,0.06589785831960461,60700,64700,4000,343351
18565,4000,2017-11-21,0.20408163265306123,49000,59000,10000,1122544
18566,4000,2017-11-01,0.11801242236024845,40250,45000,4750,371192
18567,4000,2017-09-18,0.04280618311533888,42050,40250,-1800,107307
18568,4000,2017-07-14,0.06965174129353234,40200,43000,2800,364775
18569,4000,2017-05-22,0.04767726161369193,40900,42850,1950,285325
18570,4000,2017-05-19,0.09066666666666667,37500,40900,3400,301767
18571,4000,2017-03-16,0.06912442396313365,32550,34800,2250,182125
18572,4000,2016-12-15,0.041379310344827586,29000,30200,1200,123325
18573,4000,2016-09-30,0.04696969696969697,33000,31450,-1550,144839
18574,34730,2021-04-09,0.05017921146953405,279000,293000,14000,694443
18575,34730,2021-03-30,0.04655493482309125,268500,281000,12500,581621
18576,34730,2021-03-26,0.076171875,256000,275500,19500,833364
18577,34730,2021-03-25,0.04918032786885246,244000,256000,12000,420832
18578,34730,2021-03-02,0.04380952380952381,262500,274000,11500,405669
18579,34730,2021-02-26,0.052346570397111915,277000,262500,-14500,548833
18580,34730,2021-02-25,0.045283018867924525,265000,277000,12000,329598
18581,34730,2021-02-01,0.05787781350482315,311000,329000,18000,584069
18582,34730,2021-01-28,0.04874446085672083,338500,322000,-16500,795974
18583,34730,2021-01-26,0.04225352112676056,355000,340000,-15000,946865
18584,34730,2021-01-25,0.08231707317073171,328000,355000,27000,803628
18585,34730,2021-01-20,0.08090614886731391,309000,334000,25000,1358636
18586,34730,2021-01-13,0.05328596802841918,281500,296500,15000,1017559
18587,34730,2021-01-07,0.08424908424908426,273000,296000,23000,1946685
18588,34730,2021-01-06,0.08548707753479125,251500,273000,21500,2378756
18589,34730,2020-12-11,0.0411522633744856,243000,253000,10000,590106
18590,34730,2020-12-02,0.06997742663656885,221500,237000,15500,1065538
18591,34730,2020-12-01,0.04728132387706856,211500,221500,10000,316450
18592,34730,2020-11-16,0.04784688995215311,209000,219000,10000,475806
18593,34730,2020-11-11,0.06153846153846154,195000,207000,12000,590944
18594,34730,2020-09-24,0.05012531328320802,199500,189500,-10000,309274
18595,34730,2020-08-31,0.044642857142857144,224000,214000,-10000,487729
18596,34730,2020-08-28,0.04186046511627907,215000,224000,9000,446589
18597,34730,2020-08-25,0.04716981132075472,212000,222000,10000,237042
18598,34730,2020-08-20,0.058426966292134834,222500,209500,-13000,396676
18599,34730,2020-08-18,0.047109207708779445,233500,222500,-11000,304434
18600,34730,2020-08-05,0.04793028322440087,229500,240500,11000,721764
18601,34730,2020-08-04,0.05517241379310345,217500,229500,12000,464562
18602,34730,2020-07-14,0.04536082474226804,242500,231500,-11000,729003
18603,34730,2020-07-02,0.06228956228956229,297000,278500,-18500,2892772
18604,34730,2020-06-24,0.07431340872374798,309500,286500,-23000,3591128
18605,34730,2020-06-23,0.05631399317406143,293000,309500,16500,1550365
18606,34730,2020-06-19,0.050243111831442464,308500,293000,-15500,1451060
18607,34730,2020-06-15,0.08960573476702509,279000,304000,25000,4331754
18608,34730,2020-06-12,0.08560311284046693,257000,279000,22000,1298434
18609,34730,2020-06-05,0.07306889352818371,239500,257000,17500,871235
18610,34730,2020-05-28,0.043052837573385516,255500,244500,-11000,675566
18611,34730,2020-05-26,0.05070993914807302,246500,259000,12500,763255
18612,34730,2020-05-25,0.0787746170678337,228500,246500,18000,737103
18613,34730,2020-05-20,0.10173697270471464,201500,222000,20500,1317938
18614,34730,2020-05-18,0.10989010989010989,182000,202000,20000,630281
18615,34730,2020-04-17,0.0443213296398892,180500,188500,8000,244505
18616,34730,2020-04-10,0.04678362573099415,171000,179000,8000,279238
18617,34730,2020-03-31,0.046875,160000,167500,7500,342668
18618,34730,2020-03-27,0.045307443365695796,154500,161500,7000,465790
18619,34730,2020-03-25,0.12313432835820895,134000,150500,16500,771051
18620,34730,2020-03-24,0.24074074074074073,108000,134000,26000,771510
18621,34730,2020-03-23,0.1111111111111111,121500,108000,-13500,336085
18622,34730,2020-03-20,0.13551401869158877,107000,121500,14500,444841
18623,34730,2020-03-19,0.13709677419354838,124000,107000,-17000,541476
18624,34730,2020-03-18,0.10144927536231885,138000,124000,-14000,387932
18625,34730,2020-03-17,0.05154639175257732,145500,138000,-7500,306127
18626,34730,2020-03-16,0.07911392405063292,158000,145500,-12500,275952
18627,34730,2020-03-12,0.06285714285714286,175000,164000,-11000,413438
18628,34730,2020-03-09,0.05398457583547558,194500,184000,-10500,267208
18629,34730,2020-02-28,0.04239401496259352,200500,192000,-8500,231899
18630,34730,2020-02-24,0.04941176470588235,212500,202000,-10500,246357
18631,34730,2020-01-28,0.04149377593360996,241000,231000,-10000,136552
18632,34730,2020-01-08,0.048638132295719845,257000,244500,-12500,175476
18633,34730,2019-11-22,0.04797047970479705,271000,258000,-13000,509755
18634,34730,2019-10-24,0.04612159329140461,238500,249500,11000,261073
18635,34730,2019-10-01,0.09803921568627451,204000,224000,20000,372320
18636,34730,2019-09-16,0.06372549019607843,204000,217000,13000,283391
18637,34730,2019-05-29,0.04184100418410042,239000,229000,-10000,148233
18638,34730,2019-02-12,0.043726235741444866,263000,274500,11500,130509
18639,34730,2018-11-12,0.04389312977099236,262000,273500,11500,87713
18640,34730,2018-10-11,0.0595446584938704,285500,268500,-17000,147543
18641,34730,2018-07-25,0.051094890510948905,274000,260000,-14000,301800
18642,34730,2018-03-06,0.055357142857142855,280000,295500,15500,178629
18643,34730,2018-01-25,0.047540983606557376,305000,319500,14500,210974
18644,34730,2017-10-10,0.043402777777777776,288000,300500,12500,193764
18645,34730,2017-06-01,0.04204753199268738,273500,285000,11500,393625
18646,34730,2016-10-17,0.050359712230215826,208500,219000,10500,241975
18647,34730,2016-08-19,0.04241071428571429,224000,214500,-9500,205429
18648,34730,2016-08-04,0.043373493975903614,207500,216500,9000,151970
18649,1450,2021-05-17,0.04032258064516129,24800,23800,-1000,1151645
18650,1450,2021-05-13,0.043933054393305436,23900,24950,1050,1732371
18651,1450,2021-05-12,0.05719921104536489,25350,23900,-1450,2022900
18652,1450,2021-05-06,0.0407725321888412,23300,24250,950,1005182
18653,1450,2021-02-22,0.043583535108958835,20650,21550,900,1537160
18654,1450,2020-11-03,0.043933054393305436,23900,24950,1050,269716
18655,1450,2020-10-30,0.052845528455284556,24600,23300,-1300,366010
18656,1450,2020-10-27,0.05152671755725191,26200,24850,-1350,410185
18657,1450,2020-10-22,0.06903765690376569,23900,25550,1650,677119
18658,1450,2020-08-20,0.05439330543933055,23900,22600,-1300,359573
18659,1450,2020-08-12,0.04042553191489362,23500,24450,950,525863
18660,1450,2020-08-11,0.06334841628959276,22100,23500,1400,500378
18661,1450,2020-07-10,0.04338394793926247,23050,22050,-1000,414641
18662,1450,2020-06-29,0.04219409282700422,23700,22700,-1000,224409
18663,1450,2020-06-25,0.04554455445544554,25250,24100,-1150,150311
18664,1450,2020-06-23,0.041237113402061855,24250,25250,1000,326585
18665,1450,2020-06-15,0.05030181086519115,24850,23600,-1250,436356
18666,1450,2020-06-11,0.07513416815742398,27950,25850,-2100,634307
18667,1450,2020-06-09,0.06538461538461539,26000,27700,1700,649727
18668,1450,2020-05-18,0.0449438202247191,26700,25500,-1200,487550
18669,1450,2020-05-08,0.041749502982107355,25150,26200,1050,280146
18670,1450,2020-05-04,0.05172413793103448,26100,24750,-1350,441855
18671,1450,2020-04-23,0.043121149897330596,24350,25400,1050,591687
18672,1450,2020-04-10,0.0457516339869281,22950,24000,1050,470861
18673,1450,2020-04-02,0.0947867298578199,21100,23100,2000,401701
18674,1450,2020-04-01,0.0684326710816777,22650,21100,-1550,288423
18675,1450,2020-03-31,0.06588235294117648,21250,22650,1400,373747
18676,1450,2020-03-27,0.055,20000,21100,1100,379625
18677,1450,2020-03-25,0.0862533692722372,18550,20150,1600,524855
18678,1450,2020-03-20,0.0423728813559322,17700,18450,750,616369
18679,1450,2020-03-19,0.04838709677419355,18600,17700,-900,677705
18680,1450,2020-03-16,0.05234159779614325,18150,19100,950,392252
18681,1450,2020-03-09,0.056372549019607844,20400,19250,-1150,392502
18682,1450,2020-03-02,0.048672566371681415,22600,21500,-1100,539063
18683,1450,2020-02-27,0.06960556844547564,21550,23050,1500,559895
18684,1450,2019-12-20,0.04639175257731959,29100,27750,-1350,491873
18685,1450,2019-12-12,0.05272727272727273,27500,28950,1450,722053
18686,1450,2019-11-07,0.052830188679245285,26500,27900,1400,422281
18687,1450,2019-11-04,0.041584158415841586,25250,26300,1050,261461
18688,1450,2019-10-11,0.06147540983606557,24400,25900,1500,578431
18689,1450,2019-08-23,0.043121149897330596,24350,23300,-1050,595793
18690,1450,2019-08-12,0.05128205128205128,25350,24050,-1300,266971
18691,1450,2019-08-08,0.040983606557377046,24400,25400,1000,387762
18692,1450,2019-08-07,0.04500978473581213,25550,24400,-1150,516755
18693,1450,2019-07-19,0.04331450094161959,26550,27700,1150,332374
18694,1450,2019-05-13,0.08575380359612725,36150,33050,-3100,649262
18695,1450,2018-11-01,0.04665071770334928,41800,39850,-1950,420757
18696,1450,2018-10-31,0.05289672544080604,39700,41800,2100,295605
18697,1450,2018-10-30,0.044524669073405534,41550,39700,-1850,367650
18698,1450,2018-10-15,0.04230769230769231,39000,40650,1650,429741
18699,1450,2018-09-27,0.07926023778071334,37850,40850,3000,1044083
18700,1450,2018-07-23,0.055800293685756244,34050,35950,1900,444472
18701,1450,2018-07-04,0.04227405247813411,34300,35750,1450,332820
18702,1450,2018-06-21,0.0481283422459893,37400,35600,-1800,334758
18703,1450,2018-06-18,0.05890804597701149,34800,36850,2050,316118
18704,1450,2018-05-30,0.041428571428571426,35000,33550,-1450,300242
18705,1450,2018-05-23,0.0472972972972973,37000,35250,-1750,504737
18706,1450,2018-03-23,0.05392156862745098,40800,38600,-2200,371211
18707,1450,2018-03-22,0.05974025974025974,38500,40800,2300,422987
18708,1450,2018-03-02,0.04963680387409201,41300,39250,-2050,511830
18709,1450,2017-12-13,0.04524886877828054,44200,46200,2000,243525
18710,1450,2017-12-04,0.04711425206124853,42450,44450,2000,244641
18711,1450,2017-10-10,0.04194260485651214,45300,47200,1900,364440
18712,1450,2017-08-01,0.08370044052863436,45400,49200,3800,424308
18713,1450,2017-07-21,0.04072398190045249,44200,46000,1800,203613
18714,1450,2017-07-10,0.0430622009569378,41800,43600,1800,224266
18715,1450,2017-02-16,0.04580152671755725,32750,31250,-1500,1111194
18716,1450,2017-02-03,0.04966887417218543,30200,31700,1500,816498
18717,1450,2017-01-19,0.044274809160305344,32750,31300,-1450,436013
18718,1450,2017-01-18,0.05305466237942122,31100,32750,1650,579032
18719,1450,2016-12-21,0.08166189111747851,34900,32050,-2850,968905
18720,1450,2016-11-23,0.050143266475644696,34900,36650,1750,505146
18721,1450,2016-11-08,0.043824701195219126,37650,36000,-1650,317215
18722,1450,2016-11-07,0.044382801664355064,36050,37650,1600,491240
18723,1450,2016-10-10,0.047619047619047616,34650,36300,1650,179232
18724,1450,2016-10-05,0.04423592493297587,37300,35650,-1650,495917
18725,1450,2016-09-05,0.0446685878962536,34700,36250,1550,327303
18726,34220,2021-05-18,0.04279279279279279,22200,23150,950,3287855
18727,34220,2021-05-11,0.05273833671399594,24650,23350,-1300,6080934
18728,34220,2021-04-22,0.060240963855421686,24900,26400,1500,10914551
18729,34220,2021-04-06,0.0508130081300813,24600,25850,1250,14103251
18730,34220,2021-04-05,0.07423580786026202,22900,24600,1700,9200249
18731,34220,2021-02-26,0.046413502109704644,23700,22600,-1100,5206863
18732,34220,2021-02-24,0.05454545454545454,24750,23400,-1350,4020060
18733,34220,2021-02-15,0.04631578947368421,23750,24850,1100,5495342
18734,34220,2021-02-01,0.04597701149425287,21750,22750,1000,4883218
18735,34220,2021-01-29,0.05434782608695652,23000,21750,-1250,6345072
18736,34220,2021-01-27,0.04979253112033195,24100,22900,-1200,8529941
18737,34220,2021-01-21,0.09647058823529411,21250,23300,2050,28035650
18738,34220,2021-01-14,0.05134474327628362,20450,21500,1050,9918191
18739,34220,2020-12-23,0.0641399416909621,17150,18250,1100,41667728
18740,34220,2020-12-15,0.06845238095238096,16800,17950,1150,12241478
18741,34220,2020-09-24,0.050314465408805034,15900,15100,-800,2427886
18742,34220,2020-09-07,0.04377104377104377,14850,15500,650,7013744
18743,34220,2020-08-24,0.13108614232209737,13350,15100,1750,16215702
18744,34220,2020-08-21,0.06374501992031872,12550,13350,800,5879552
18745,34220,2020-08-18,0.051094890510948905,13700,13000,-700,4192002
18746,34220,2020-08-10,0.06048387096774194,12400,13150,750,5966549
18747,34220,2020-07-07,0.046875,12800,12200,-600,4885103
18748,34220,2020-07-06,0.09871244635193133,11650,12800,1150,6978606
18749,34220,2020-06-25,0.041666666666666664,12000,11500,-500,1823799
18750,34220,2020-06-16,0.06363636363636363,11000,11700,700,2563988
18751,34220,2020-06-15,0.055793991416309016,11650,11000,-650,3822273
18752,34220,2020-06-12,0.0411522633744856,12150,11650,-500,4066174
18753,34220,2020-06-08,0.05371900826446281,12100,12750,650,5597187
18754,34220,2020-06-03,0.06306306306306306,11100,11800,700,8077649
18755,34220,2020-06-02,0.04225352112676056,10650,11100,450,5562644
18756,34220,2020-06-01,0.04411764705882353,10200,10650,450,2552725
18757,34220,2020-05-22,0.04205607476635514,10700,10250,-450,2796866
18758,34220,2020-04-06,0.04225352112676056,10650,11100,450,1901519
18759,34220,2020-04-01,0.04504504504504504,11100,10600,-500,2231413
18760,34220,2020-03-27,0.046511627906976744,10750,11250,500,5865020
18761,34220,2020-03-25,0.04878048780487805,10250,10750,500,4920992
18762,34220,2020-03-24,0.09391675560298826,9370,10250,880,3739858
18763,34220,2020-03-23,0.09029126213592233,10300,9370,-930,3396532
18764,34220,2020-03-20,0.15730337078651685,8900,10300,1400,4192287
18765,34220,2020-03-19,0.10821643286573146,9980,8900,-1080,7779555
18766,34220,2020-03-18,0.06728971962616823,10700,9980,-720,3593393
18767,34220,2020-03-16,0.04424778761061947,11300,10800,-500,4055023
18768,34220,2020-03-13,0.06611570247933884,12100,11300,-800,8381686
18769,34220,2020-03-12,0.06563706563706563,12950,12100,-850,5584879
18770,34220,2020-03-09,0.07773851590106007,14150,13050,-1100,3743057
18771,34220,2020-02-28,0.0456140350877193,14250,13600,-650,3704643
18772,34220,2020-02-06,0.0440251572327044,15900,16600,700,3835888
18773,34220,2020-02-04,0.06312292358803986,15050,16000,950,4247243
18774,34220,2020-01-31,0.04406779661016949,14750,15400,650,4270468
18775,34220,2020-01-08,0.04281345565749235,16350,15650,-700,2625706
18776,34220,2019-12-09,0.09523809523809523,14700,16100,1400,7738658
18777,34220,2019-11-28,0.05734767025089606,13950,14750,800,4722787
18778,34220,2019-11-05,0.05434782608695652,13800,14550,750,2978553
18779,34220,2019-08-30,0.0648854961832061,13100,13950,850,4674155
18780,34220,2019-08-05,0.04779411764705882,13600,12950,-650,6358682
18781,34220,2019-08-02,0.05555555555555555,14400,13600,-800,4849174
18782,34220,2019-07-31,0.07936507936507936,15750,14500,-1250,12170624
18783,34220,2019-07-08,0.04885057471264368,17400,16550,-850,2269949
18784,34220,2019-06-21,0.04644808743169399,18300,17450,-850,3206330
18785,34220,2019-06-20,0.07017543859649122,17100,18300,1200,4157464
18786,34220,2019-05-09,0.042666666666666665,18750,17950,-800,2819720
18787,34220,2019-05-07,0.041237113402061855,19400,18600,-800,2709965
18788,34220,2019-04-24,0.06352941176470588,21250,19900,-1350,3839009
18789,34220,2019-04-09,0.04819277108433735,20750,21750,1000,3635185
18790,34220,2019-02-21,0.04846938775510204,19600,20550,950,4282357
18791,34220,2019-01-31,0.043037974683544304,19750,18900,-850,4145813
18792,34220,2019-01-10,0.042105263157894736,19000,19800,800,3059417
18793,34220,2018-12-13,0.05187319884726225,17350,18250,900,4303965
18794,34220,2018-11-28,0.05187319884726225,17350,18250,900,2743583
18795,34220,2018-11-09,0.05588235294117647,17000,17950,950,3566050
18796,34220,2018-11-02,0.05757575757575758,16500,17450,950,2250229
18797,34220,2018-10-23,0.0521978021978022,18200,17250,-950,3792907
18798,34220,2018-10-12,0.05187319884726225,17350,18250,900,2560059
18799,34220,2018-09-11,0.049528301886792456,21200,20150,-1050,3546663
18800,34220,2018-08-22,0.04086021505376344,23250,22300,-950,3260031
18801,34220,2018-08-08,0.04424778761061947,22600,21600,-1000,4132999
18802,34220,2018-07-26,0.04156479217603912,20450,21300,850,3770513
18803,34220,2018-07-25,0.046620046620046623,21450,20450,-1000,4548875
18804,34220,2018-07-19,0.054187192118226604,20300,21400,1100,4084153
18805,34220,2018-07-09,0.04722222222222222,18000,18850,850,2976090
18806,34220,2018-06-29,0.045714285714285714,17500,18300,800,4454897
18807,34220,2018-06-28,0.04371584699453552,18300,17500,-800,3166935
18808,34220,2018-06-18,0.04245283018867924,21200,20300,-900,4274096
18809,34220,2018-06-15,0.04288939051918736,22150,21200,-950,4193942
18810,34220,2018-05-29,0.05227272727272727,22000,23150,1150,4490612
18811,34220,2018-05-11,0.04017857142857143,22400,23300,900,2342673
18812,34220,2018-01-23,0.05853658536585366,30750,32550,1800,9952861
18813,34220,2018-01-16,0.06896551724137931,29000,31000,2000,8051821
18814,34220,2017-11-21,0.06020066889632107,29900,31700,1800,9244310
18815,34220,2017-10-20,0.048109965635738834,29100,30500,1400,5039655
18816,34220,2017-10-12,0.0512396694214876,30250,28700,-1550,7527765
18817,34220,2017-09-19,0.05,34000,32300,-1700,8209512
18818,34220,2017-09-05,0.06446280991735537,30250,32200,1950,6391055
18819,34220,2017-07-20,0.08165997322623829,37350,34300,-3050,13883506
18820,34220,2017-07-04,0.0533515731874145,36550,38500,1950,4768875
18821,34220,2017-06-13,0.07736389684813753,34900,37600,2700,5879867
18822,34220,2017-06-12,0.04904632152588556,36700,34900,-1800,5350754
18823,34220,2017-06-07,0.042709867452135494,33950,35400,1450,4874654
18824,34220,2017-05-30,0.061258278145695365,30200,32050,1850,7849718
18825,34220,2017-05-26,0.0415944540727903,28850,30050,1200,5303654
18826,34220,2017-04-27,0.04936305732484077,31400,29850,-1550,5097192
18827,34220,2017-03-29,0.04280821917808219,29200,30450,1250,3222461
18828,34220,2017-01-25,0.04251968503937008,31750,30400,-1350,3640103
18829,34220,2016-12-06,0.046762589928057555,27800,29100,1300,1349604
18830,34220,2016-11-09,0.04553734061930783,27450,26200,-1250,2101154
18831,34220,2016-10-28,0.04391891891891892,29600,28300,-1300,2194023
18832,34220,2016-10-07,0.04401408450704225,28400,29650,1250,2062704
18833,34220,2016-09-08,0.048859934853420196,30700,29200,-1500,1864611
18834,128940,2021-05-27,0.05688622754491018,334000,353000,19000,127862
18835,128940,2021-05-14,0.053237410071942444,347500,329000,-18500,130105
18836,128940,2021-04-23,0.059077809798270896,347000,367500,20500,243269
18837,128940,2021-04-15,0.04678362573099415,342000,358000,16000,264673
18838,128940,2021-04-07,0.051118210862619806,313000,329000,16000,60348
18839,128940,2021-03-12,0.044189852700491,305500,319000,13500,66747
18840,128940,2021-03-02,0.06997084548104957,343000,319000,-24000,246189
18841,128940,2021-02-25,0.041666666666666664,336000,350000,14000,68808
18842,128940,2021-01-29,0.08482676224611709,418500,383000,-35500,245144
18843,128940,2021-01-27,0.07142857142857142,378000,405000,27000,713054
18844,128940,2021-01-25,0.058011049723756904,362000,383000,21000,167129
18845,128940,2021-01-18,0.04160887656033287,360500,345500,-15000,68405
18846,128940,2021-01-07,0.042328042328042326,378000,394000,16000,246771
18847,128940,2021-01-06,0.04419889502762431,362000,378000,16000,636828
18848,128940,2020-12-30,0.05164992826398852,348500,366500,18000,271094
18849,128940,2020-12-29,0.07424242424242425,330000,348500,18500,169190
18850,128940,2020-12-22,0.04922644163150492,355500,338000,-17500,103708
18851,128940,2020-12-08,0.04,375000,360000,-15000,394297
18852,128940,2020-12-03,0.04423592493297587,373000,356500,-16500,185258
18853,128940,2020-11-27,0.0819423368740516,329500,356500,27000,444284
18854,128940,2020-11-19,0.048,312500,327500,15000,272999
18855,128940,2020-11-18,0.07388316151202749,291000,312500,21500,283849
18856,128940,2020-11-03,0.05018587360594796,269000,282500,13500,92186
18857,128940,2020-10-23,0.046125461254612546,271000,283500,12500,68407
18858,128940,2020-10-16,0.05420560747663551,267500,282000,14500,68431
18859,128940,2020-10-06,0.04570383912248629,273500,286000,12500,98198
18860,128940,2020-09-24,0.050724637681159424,276000,262000,-14000,80286
18861,128940,2020-08-27,0.04100946372239748,317000,304000,-13000,103383
18862,128940,2020-08-25,0.04421768707482993,294000,307000,13000,139237
18863,128940,2020-08-18,0.048939641109298535,306500,291500,-15000,176877
18864,128940,2020-08-10,0.08203677510608204,353500,324500,-29000,667247
18865,128940,2020-08-05,0.2990990990990991,277500,360500,83000,514265
18866,128940,2020-07-29,0.07381370826010544,284500,263500,-21000,236540
18867,128940,2020-07-28,0.15182186234817813,247000,284500,37500,1627889
18868,128940,2020-07-16,0.056842105263157895,237500,251000,13500,141164
18869,128940,2020-06-16,0.041015625,256000,266500,10500,115445
18870,128940,2020-06-05,0.056795131845841784,246500,260500,14000,197246
18871,128940,2020-05-14,0.09498207885304659,279000,252500,-26500,354250
18872,128940,2020-05-08,0.06563706563706563,259000,276000,17000,154534
18873,128940,2020-04-01,0.06118546845124283,261500,245500,-16000,61523
18874,128940,2020-03-31,0.05443548387096774,248000,261500,13500,75733
18875,128940,2020-03-25,0.05010893246187364,229500,241000,11500,65397
18876,128940,2020-03-24,0.06496519721577726,215500,229500,14000,62513
18877,128940,2020-03-23,0.05066079295154185,227000,215500,-11500,51487
18878,128940,2020-03-20,0.04128440366972477,218000,227000,9000,73900
18879,128940,2020-03-19,0.07430997876857749,235500,218000,-17500,82505
18880,128940,2020-03-13,0.07321772639691715,259500,240500,-19000,97335
18881,128940,2020-03-12,0.04066543438077634,270500,259500,-11000,81336
18882,128940,2020-03-05,0.04797047970479705,271000,284000,13000,68356
18883,128940,2020-02-24,0.05434782608695652,276000,261000,-15000,64895
18884,128940,2019-12-27,0.04241435562805873,306500,288000,-18500,166626
18885,128940,2019-12-10,0.06875,320000,298000,-22000,229698
18886,128940,2019-11-29,0.04054054054054054,333000,319500,-13500,39604
18887,128940,2019-11-21,0.041791044776119404,335000,321000,-14000,42498
18888,128940,2019-10-25,0.040123456790123455,324000,337000,13000,144113
18889,128940,2019-10-23,0.06765676567656766,303000,323500,20500,129967
18890,128940,2019-10-07,0.044642857142857144,280000,292500,12500,49897
18891,128940,2019-10-01,0.04528985507246377,276000,288500,12500,34034
18892,128940,2019-09-17,0.04869565217391304,287500,301500,14000,103774
18893,128940,2019-08-21,0.046263345195729534,281000,294000,13000,53267
18894,128940,2019-08-09,0.07649253731343283,268000,288500,20500,81006
18895,128940,2019-08-05,0.07191780821917808,292000,271000,-21000,68481
18896,128940,2019-07-04,0.27261761158021713,414500,301500,-113000,791120
18897,128940,2019-02-19,0.04633620689655173,464000,485500,21500,99775
18898,128940,2019-02-11,0.0400890868596882,449000,467000,18000,68570
18899,128940,2018-12-20,0.0641025641025641,468000,438000,-30000,151511
18900,128940,2018-12-04,0.04194260485651214,453000,472000,19000,73115
18901,128940,2018-11-05,0.056511056511056514,407000,430000,23000,120592
18902,128940,2018-10-23,0.05473204104903079,438500,414500,-24000,53604
18903,128940,2018-10-01,0.061,500000,469500,-30500,117081
18904,128940,2018-08-27,0.04229934924078091,461000,480500,19500,105889
18905,128940,2018-08-13,0.07439824945295405,457000,423000,-34000,115953
18906,128940,2018-08-06,0.04866743916570104,431500,452500,21000,71682
18907,128940,2018-07-25,0.05227272727272727,440000,417000,-23000,59146
18908,128940,2018-07-04,0.08487084870848709,406500,441000,34500,91373
18909,128940,2018-06-22,0.04962779156327544,403000,423000,20000,46523
18910,128940,2018-06-19,0.06868451688009314,429500,400000,-29500,108716
18911,128940,2018-05-23,0.045,500000,477500,-22500,67045
18912,128940,2018-05-09,0.05981941309255079,443000,469500,26500,80894
18913,128940,2018-04-26,0.04061470911086718,455500,474000,18500,71969
18914,128940,2018-04-23,0.0700507614213198,492500,458000,-34500,145202
18915,128940,2018-04-10,0.083984375,512000,555000,43000,182538
18916,128940,2018-03-12,0.06471816283924843,479000,510000,31000,115466
18917,128940,2018-03-06,0.05159165751920966,455500,479000,23500,92983
18918,128940,2018-02-28,0.05510204081632653,490000,463000,-27000,142214
18919,128940,2018-02-19,0.08502772643253234,541000,495000,-46000,527313
18920,128940,2018-02-06,0.06333973128598848,521000,554000,33000,216132
18921,128940,2018-02-05,0.07460035523978685,563000,521000,-42000,132115
18922,128940,2018-02-01,0.04690117252931323,597000,569000,-28000,137676
18923,128940,2018-01-23,0.05,560000,588000,28000,67710
18924,128940,2018-01-12,0.05982905982905983,585000,620000,35000,202299
18925,128940,2017-12-11,0.06728971962616823,535000,571000,36000,79741
18926,128940,2017-12-07,0.04316546762589928,556000,532000,-24000,81751
18927,128940,2017-11-30,0.043697478991596636,595000,569000,-26000,99594
18928,128940,2017-11-22,0.0410958904109589,584000,560000,-24000,114796
18929,128940,2017-11-15,0.09497206703910614,537000,588000,51000,359915
18930,128940,2017-11-13,0.04743083003952569,506000,530000,24000,125614
18931,128940,2017-11-03,0.04742268041237113,485000,508000,23000,156915
18932,128940,2017-11-01,0.07659115426105717,463500,499000,35500,251688
18933,128940,2017-10-30,0.04643962848297214,484500,462000,-22500,132032
18934,128940,2017-10-25,0.04133858267716536,508000,487000,-21000,145831
18935,128940,2017-10-19,0.07291666666666667,480000,515000,35000,327206
18936,128940,2017-10-12,0.04859611231101512,463000,485500,22500,159936
18937,128940,2017-10-10,0.0484048404840484,454500,476500,22000,161969
18938,128940,2017-09-29,0.054524361948955914,431000,454500,23500,201366
18939,128940,2017-09-19,0.06288532675709001,405500,431000,25500,238657
18940,128940,2017-08-28,0.0728744939271255,370500,397500,27000,260032
18941,128940,2017-08-18,0.05772005772005772,346500,366500,20000,124945
18942,128940,2017-08-03,0.04073033707865169,356000,341500,-14500,149934
18943,128940,2017-06-28,0.054388133498145856,404500,382500,-22000,197053
18944,128940,2017-06-16,0.05653710247349823,424500,400500,-24000,222827
18945,128940,2017-06-09,0.054707379134860054,393000,414500,21500,324268
18946,128940,2017-05-31,0.04087193460490463,367000,382000,15000,339295
18947,128940,2017-05-23,0.04207573632538569,356500,371500,15000,236966
18948,128940,2017-05-11,0.07790368271954674,353000,380500,27500,356748
18949,128940,2017-05-08,0.10268562401263823,316500,349000,32500,483332
18950,128940,2017-02-01,0.041666666666666664,288000,300000,12000,119011
18951,128940,2017-01-13,0.04152249134948097,289000,301000,12000,174934
18952,128940,2017-01-02,0.06873977086743044,305500,284500,-21000,298485
18953,128940,2016-12-29,0.10410557184750734,341000,305500,-35500,432668
18954,128940,2016-12-07,0.10760401721664276,348500,311000,-37500,860669
18955,128940,2016-12-01,0.04341926729986431,368500,352500,-16000,85892
18956,128940,2016-11-23,0.04456824512534819,359000,343000,-16000,180790
18957,128940,2016-11-18,0.04569190600522193,383000,365500,-17500,131789
18958,128940,2016-11-10,0.12150837988826815,358000,401500,43500,344974
18959,128940,2016-11-09,0.044058744993324434,374500,358000,-16500,227646
18960,128940,2016-11-03,0.05247376311844078,333500,351000,17500,165848
18961,128940,2016-11-02,0.044412607449856735,349000,333500,-15500,168212
18962,128940,2016-10-28,0.08679706601466992,409000,373500,-35500,233299
18963,128940,2016-10-07,0.06104328523862375,450500,423000,-27500,485284
18964,128940,2016-10-04,0.07283464566929133,508000,471000,-37000,1163160
18965,128940,2016-09-30,0.18064516129032257,620000,508000,-112000,1800563
18966,128940,2016-09-20,0.0518783542039356,559000,588000,29000,116311
18967,128940,2016-08-23,0.042735042735042736,585000,610000,25000,83960
18968,35250,2021-05-25,0.06653620352250489,25550,27250,1700,3681876
18969,35250,2021-03-04,0.044,25000,26100,1100,3434034
18970,35250,2021-01-12,0.05063291139240506,23700,24900,1200,2679231
18971,35250,2020-11-11,0.0515695067264574,22300,23450,1150,2233904
18972,35250,2020-10-12,0.07339449541284404,21800,23400,1600,2848581
18973,35250,2020-08-20,0.04783599088838269,21950,20900,-1050,878512
18974,35250,2020-08-18,0.04946236559139785,23250,22100,-1150,1052861
18975,35250,2020-06-16,0.04943820224719101,22250,23350,1100,961986
18976,35250,2020-06-15,0.06512605042016807,23800,22250,-1550,913933
18977,35250,2020-05-28,0.06095238095238095,26250,24650,-1600,2098021
18978,35250,2020-05-27,0.0437375745526839,25150,26250,1100,2447025
18979,35250,2020-05-20,0.05042016806722689,23800,25000,1200,2267014
18980,35250,2020-05-13,0.04201680672268908,23800,22800,-1000,1272235
18981,35250,2020-04-16,0.04219409282700422,23700,24700,1000,1636066
18982,35250,2020-04-09,0.12289156626506025,20750,23300,2550,3190691
18983,35250,2020-04-06,0.07238605898123325,18650,20000,1350,1134267
18984,35250,2020-04-01,0.06582278481012659,19750,18450,-1300,1179317
18985,35250,2020-03-25,0.06027397260273973,18250,19350,1100,832297
18986,35250,2020-03-24,0.12307692307692308,16250,18250,2000,863640
18987,35250,2020-03-23,0.06609195402298851,17400,16250,-1150,1149502
18988,35250,2020-03-19,0.08648648648648649,18500,16900,-1600,1359042
18989,35250,2020-03-18,0.06565656565656566,19800,18500,-1300,685727
18990,35250,2020-03-17,0.05263157894736842,20900,19800,-1100,852460
18991,35250,2020-03-12,0.04338394793926247,23050,22050,-1000,966872
18992,35250,2020-02-28,0.0440251572327044,23850,22800,-1050,962204
18993,35250,2020-02-24,0.0499001996007984,25050,23800,-1250,687517
18994,35250,2019-04-12,0.0432,31250,32600,1350,640551
18995,35250,2019-02-15,0.0723589001447178,34550,32050,-2500,2770596
18996,35250,2018-12-14,0.04671532846715328,34250,32650,-1600,512360
18997,35250,2018-11-29,0.06589785831960461,30350,32350,2000,1455692
18998,35250,2018-08-10,0.07835820895522388,26800,28900,2100,2206212
18999,35250,2018-06-21,0.040421792618629174,28450,27300,-1150,620613
19000,35250,2018-04-20,0.041666666666666664,27600,28750,1150,1890896
19001,35250,2018-02-09,0.04936305732484077,31400,29850,-1550,781360
19002,35250,2018-01-02,0.07902298850574713,34800,32050,-2750,2012609
19003,35250,2017-11-14,0.05322128851540616,35700,37600,1900,831991
19004,35250,2017-07-27,0.04384724186704385,35350,36900,1550,619451
19005,35250,2017-05-16,0.042801556420233464,38550,36900,-1650,499267
19006,35250,2017-03-22,0.043115438108484005,35950,37500,1550,834410
19007,35250,2017-01-09,0.04160887656033287,36050,34550,-1500,672511
19008,35250,2016-11-30,0.040376850605652756,37150,35650,-1500,808262
19009,35250,2016-11-03,0.0563564875491481,38150,36000,-2150,823904
19010,4020,2021-05-20,0.05565217391304348,57500,54300,-3200,2065329
19011,4020,2021-05-18,0.04735883424408015,54900,57500,2600,1272595
19012,4020,2021-05-13,0.0594059405940594,60600,57000,-3600,2148949
19013,4020,2021-05-06,0.05605786618444846,55300,58400,3100,1936183
19014,4020,2021-04-30,0.04965753424657534,58400,55500,-2900,2681652
19015,4020,2021-04-27,0.09038461538461538,52000,56700,4700,5322376
19016,4020,2021-04-05,0.06283280085197018,46950,49900,2950,2666471
19017,4020,2021-03-29,0.04310344827586207,46400,48400,2000,3629480
19018,4020,2021-03-26,0.04035874439461883,44600,46400,1800,2695386
19019,4020,2021-03-25,0.050647820965842166,42450,44600,2150,1720814
19020,4020,2021-03-10,0.05263157894736842,43700,41400,-2300,1467881
19021,4020,2021-03-03,0.042997542997543,40700,42450,1750,1338879
19022,4020,2021-01-29,0.04785276073619632,40750,38800,-1950,1823111
19023,4020,2021-01-28,0.04342723004694836,42600,40750,-1850,1418701
19024,4020,2021-01-19,0.06074766355140187,42800,45400,2600,1661286
19025,4020,2021-01-08,0.05174353205849269,44450,46750,2300,4466707
19026,4020,2021-01-07,0.04834905660377359,42400,44450,2050,2582523
19027,4020,2021-01-05,0.05703883495145631,41200,43550,2350,3075718
19028,4020,2021-01-04,0.04040404040404041,39600,41200,1600,1837076
19029,4020,2020-12-09,0.07248322147651007,37250,39950,2700,2590180
19030,4020,2020-12-04,0.07692307692307693,35100,37800,2700,3296317
19031,4020,2020-12-02,0.04011887072808321,33650,35000,1350,2140495
19032,4020,2020-12-01,0.05817610062893082,31800,33650,1850,1258823
19033,4020,2020-11-23,0.04081632653061224,31850,33150,1300,1384830
19034,4020,2020-11-10,0.05237315875613748,30550,32150,1600,2380965
19035,4020,2020-11-02,0.04498269896193772,28900,30200,1300,1180933
19036,4020,2020-10-27,0.05687203791469194,31650,29850,-1800,2291770
19037,4020,2020-10-15,0.07027027027027027,27750,29700,1950,4561744
19038,4020,2020-10-13,0.06415094339622641,26500,28200,1700,4046369
19039,4020,2020-10-05,0.09146341463414634,24600,26850,2250,2252397
19040,4020,2020-09-24,0.040983606557377046,24400,23400,-1000,585773
19041,4020,2020-08-24,0.04921259842519685,25400,26650,1250,1126401
19042,4020,2020-08-20,0.06839186691312385,27050,25200,-1850,1566337
19043,4020,2020-08-18,0.07167832167832168,28600,26550,-2050,1767042
19044,4020,2020-08-06,0.06477732793522267,24700,26300,1600,1898879
19045,4020,2020-08-04,0.041407867494824016,24150,25150,1000,1200080
19046,4020,2020-07-23,0.05156537753222836,27150,25750,-1400,2404899
19047,4020,2020-07-20,0.100418410041841,23900,26300,2400,4640073
19048,4020,2020-07-16,0.05357142857142857,22400,23600,1200,2602241
19049,4020,2020-07-15,0.07951807228915662,20750,22400,1650,3484654
19050,4020,2020-06-16,0.06506024096385542,20750,22100,1350,930222
19051,4020,2020-06-15,0.08791208791208792,22750,20750,-2000,1257492
19052,4020,2020-06-12,0.04811715481171548,23900,22750,-1150,1303372
19053,4020,2020-06-04,0.047524752475247525,25250,24050,-1200,3052110
19054,4020,2020-06-03,0.1425339366515837,22100,25250,3150,7488883
19055,4020,2020-05-27,0.056790123456790124,20250,21400,1150,1886161
19056,4020,2020-05-19,0.049738219895287955,19100,20050,950,1242550
19057,4020,2020-04-29,0.09367088607594937,19750,21600,1850,2376088
19058,4020,2020-04-10,0.08333333333333333,18600,20150,1550,3203954
19059,4020,2020-04-09,0.04201680672268908,17850,18600,750,1214050
19060,4020,2020-04-01,0.0584958217270195,17950,16900,-1050,877766
19061,4020,2020-03-25,0.15562913907284767,15100,17450,2350,1780108
19062,4020,2020-03-24,0.1482889733840304,13150,15100,1950,1018706
19063,4020,2020-03-23,0.040145985401459854,13700,13150,-550,961766
19064,4020,2020-03-19,0.1608832807570978,15850,13300,-2550,1972700
19065,4020,2020-03-18,0.08115942028985507,17250,15850,-1400,1349690
19066,4020,2020-03-17,0.04696132596685083,18100,17250,-850,997979
19067,4020,2020-03-16,0.05235602094240838,19100,18100,-1000,947994
19068,4020,2020-03-13,0.06372549019607843,20400,19100,-1300,1489380
19069,4020,2020-03-12,0.07900677200902935,22150,20400,-1750,1367404
19070,4020,2020-03-09,0.055327868852459015,24400,23050,-1350,556063
19071,4020,2020-02-28,0.046,25000,23850,-1150,843962
19072,4020,2020-02-24,0.055658627087198514,26950,25450,-1500,713587
19073,4020,2020-02-06,0.06283662477558348,27850,29600,1750,618382
19074,4020,2020-01-28,0.05414551607445008,29550,27950,-1600,758978
19075,4020,2020-01-08,0.04406779661016949,29500,28200,-1300,956084
19076,4020,2019-04-01,0.0400890868596882,44900,46700,1800,304864
19077,4020,2019-03-05,0.045317220543806644,49650,47400,-2250,621315
19078,4020,2019-01-09,0.0787746170678337,45700,49300,3600,742736
19079,4020,2018-12-03,0.06612529002320186,43100,45950,2850,849900
19080,4020,2018-11-06,0.04275534441805225,42100,43900,1800,427919
19081,4020,2018-11-02,0.048134777376654635,41550,43550,2000,491216
19082,4020,2018-10-26,0.05458515283842795,45800,43300,-2500,971790
19083,4020,2018-10-11,0.05218216318785579,52700,49950,-2750,653970
19084,4020,2018-09-11,0.042704626334519574,56200,53800,-2400,647652
19085,4020,2018-07-30,0.04873294346978557,51300,53800,2500,630285
19086,4020,2018-07-09,0.04554455445544554,50500,48200,-2300,833563
19087,4020,2018-07-02,0.04182509505703422,52600,50400,-2200,647501
19088,4020,2018-06-27,0.05253623188405797,55200,52300,-2900,908199
19089,4020,2018-06-14,0.06919275123558484,60700,56500,-4200,2096119
19090,4020,2018-06-08,0.06172839506172839,64800,60800,-4000,6870194
19091,4020,2018-05-29,0.06101190476190476,67200,63100,-4100,2264107
19092,4020,2018-05-28,0.14480408858603067,58700,67200,8500,6637458
19093,4020,2018-05-25,0.04084967320261438,61200,58700,-2500,1363697
19094,4020,2018-05-16,0.05829596412556054,66900,63000,-3900,1789916
19095,4020,2018-05-14,0.04885496183206107,65500,68700,3200,2029868
19096,4020,2018-05-10,0.04784688995215311,62700,65700,3000,1966270
19097,4020,2018-04-30,0.12639405204460966,53800,60600,6800,2932677
19098,4020,2018-04-19,0.04826254826254826,51800,54300,2500,1207130
19099,4020,2017-12-18,0.046822742474916385,59800,57000,-2800,586887
19100,4020,2017-11-03,0.04203152364273205,57100,59500,2400,730943
19101,4020,2017-10-27,0.04936014625228519,54700,57400,2700,713770
19102,4020,2017-09-26,0.04518664047151277,50900,53200,2300,354194
19103,4020,2017-05-22,0.042704626334519574,56200,58600,2400,1056976
19104,4020,2017-04-13,0.0564373897707231,56700,53500,-3200,1098685
19105,4020,2017-02-01,0.044673539518900345,58200,60800,2600,498322
19106,4020,2017-01-11,0.05830388692579505,56600,59900,3300,1039584
19107,4020,2016-08-09,0.049214659685863874,47750,50100,2350,449900
19108,3000,2021-05-13,0.05909090909090909,22000,20700,-1300,1352149
19109,3000,2021-05-10,0.07913669064748201,20850,22500,1650,1374240
19110,3000,2021-05-03,0.04157043879907621,21650,20750,-900,874764
19111,3000,2021-03-16,0.08836206896551724,23200,25250,2050,5090656
19112,3000,2021-03-08,0.046413502109704644,23700,22600,-1100,1653006
19113,3000,2021-03-04,0.09760589318600368,27150,24500,-2650,4003321
19114,3000,2021-03-03,0.04423076923076923,26000,27150,1150,10915227
19115,3000,2021-03-02,0.06642728904847396,27850,26000,-1850,23695164
19116,3000,2021-02-26,0.29836829836829837,21450,27850,6400,23561207
19117,3000,2021-02-08,0.07766990291262135,25750,23750,-2000,3121432
19118,3000,2021-02-05,0.20327102803738317,21400,25750,4350,14715885
19119,3000,2021-02-04,0.04035874439461883,22300,21400,-900,582591
19120,3000,2021-01-29,0.042735042735042736,23400,22400,-1000,773507
19121,3000,2021-01-18,0.061420345489443376,26050,24450,-1600,994798
19122,3000,2021-01-15,0.040515653775322284,27150,26050,-1100,1924869
19123,3000,2021-01-14,0.07524752475247524,25250,27150,1900,4182366
19124,3000,2021-01-11,0.06306306306306306,27750,26000,-1750,2148379
19125,3000,2020-12-28,0.04132231404958678,30250,29000,-1250,2737389
19126,3000,2020-12-24,0.04310344827586207,29000,30250,1250,5049939
19127,3000,2020-12-23,0.12650602409638553,33200,29000,-4200,4682090
19128,3000,2020-12-22,0.05413105413105413,35100,33200,-1900,4269266
19129,3000,2020-12-21,0.08500772797527048,32350,35100,2750,15784958
19130,3000,2020-12-18,0.06239737274220033,30450,32350,1900,17830000
19131,3000,2020-12-17,0.04245283018867924,31800,30450,-1350,4197707
19132,3000,2020-12-14,0.18461538461538463,26000,30800,4800,21097380
19133,3000,2020-12-11,0.050505050505050504,24750,26000,1250,6591543
19134,3000,2020-12-07,0.04693877551020408,24500,25650,1150,1459538
19135,3000,2020-11-05,0.0411522633744856,24300,25300,1000,670773
19136,3000,2020-11-03,0.044967880085653104,23350,24400,1050,586790
19137,3000,2020-10-30,0.05858585858585859,24750,23300,-1450,718980
19138,3000,2020-10-26,0.06666666666666667,25500,23800,-1700,899681
19139,3000,2020-10-22,0.04779411764705882,27200,25900,-1300,560289
19140,3000,2020-10-15,0.0498220640569395,28100,26700,-1400,877499
19141,3000,2020-09-24,0.0686106346483705,29150,27150,-2000,1275848
19142,3000,2020-09-22,0.04942339373970346,30350,28850,-1500,1867363
19143,3000,2020-09-18,0.0410958904109589,32850,31500,-1350,3624054
19144,3000,2020-09-09,0.04155124653739612,36100,34600,-1500,1457639
19145,3000,2020-08-28,0.04950495049504951,40400,38400,-2000,12458415
19146,3000,2020-08-27,0.06596306068601583,37900,40400,2500,6988757
19147,3000,2020-08-21,0.04,37500,36000,-1500,1897692
19148,3000,2020-08-20,0.05337078651685393,35600,37500,1900,4222952
19149,3000,2020-08-14,0.041891891891891894,37000,35450,-1550,1948915
19150,3000,2020-07-23,0.10066225165562914,37750,41550,3800,26146894
19151,3000,2020-07-22,0.07926829268292683,41000,37750,-3250,13185010
19152,3000,2020-07-21,0.05670103092783505,38800,41000,2200,25998663
19153,3000,2020-07-20,0.11654676258992806,34750,38800,4050,14850667
19154,3000,2020-07-16,0.046413502109704644,35550,33900,-1650,1799837
19155,3000,2020-07-15,0.04563758389261745,37250,35550,-1700,4063593
19156,3000,2020-07-13,0.04885057471264368,34800,36500,1700,5570762
19157,3000,2020-06-26,0.0791268758526603,36650,33750,-2900,4418824
19158,3000,2020-06-19,0.072992700729927,41100,38100,-3000,5896504
19159,3000,2020-06-18,0.08874172185430464,37750,41100,3350,12198613
19160,3000,2020-06-16,0.061366806136680614,35850,38050,2200,7094135
19161,3000,2020-06-15,0.07958921694480103,38950,35850,-3100,15065944
19162,3000,2020-06-12,0.04144385026737968,37400,38950,1550,13173095
19163,3000,2020-06-09,0.24098360655737705,30500,37850,7350,36291673
19164,3000,2020-06-05,0.0692167577413479,27450,29350,1900,8351038
19165,3000,2020-05-19,0.07375643224699828,29150,27000,-2150,7066779
19166,3000,2020-05-18,0.07763401109057301,27050,29150,2100,11567944
19167,3000,2020-05-13,0.04891304347826087,27600,26250,-1350,3626227
19168,3000,2020-05-12,0.13347022587268995,24350,27600,3250,17499955
19169,3000,2020-05-04,0.05938697318007663,26100,24550,-1550,3461530
19170,3000,2020-04-17,0.06902356902356903,29700,27650,-2050,10522053
19171,3000,2020-04-16,0.07220216606498195,27700,29700,2000,31799978
19172,3000,2020-04-14,0.2449438202247191,22250,27700,5450,39910164
19173,3000,2020-04-13,0.08436213991769548,24300,22250,-2050,3775183
19174,3000,2020-04-09,0.0457516339869281,22950,24000,1050,10361424
19175,3000,2020-04-08,0.04573804573804574,24050,22950,-1100,3939262
19176,3000,2020-04-07,0.07677543186180422,26050,24050,-2000,6422355
19177,3000,2020-04-06,0.09915611814345991,23700,26050,2350,10621158
19178,3000,2020-04-03,0.041758241758241756,22750,23700,950,12675620
19179,3000,2020-04-01,0.07100591715976332,25350,23550,-1800,14812349
19180,3000,2020-03-31,0.3,19500,25350,5850,24440577
19181,3000,2020-03-30,0.1048158640226629,17650,19500,1850,6298741
19182,3000,2020-03-27,0.04336043360433604,18450,17650,-800,6539182
19183,3000,2020-03-24,0.050445103857566766,16850,17700,850,4271833
19184,3000,2020-03-23,0.0480225988700565,17700,16850,-850,4535079
19185,3000,2020-03-20,0.041176470588235294,17000,17700,700,7593404
19186,3000,2020-03-19,0.13712374581939799,14950,17000,2050,9329193
19187,3000,2020-03-18,0.09393939393939393,16500,14950,-1550,4596522
19188,3000,2020-03-17,0.07142857142857142,15400,16500,1100,5790043
19189,3000,2020-03-16,0.07228915662650602,16600,15400,-1200,7618556
19190,3000,2020-03-13,0.05063291139240506,15800,16600,800,8565479
19191,3000,2020-03-12,0.07058823529411765,17000,15800,-1200,8672712
19192,3000,2020-03-11,0.10052910052910052,18900,17000,-1900,10405111
19193,3000,2020-03-10,0.29896907216494845,14550,18900,4350,5685311
19194,3000,2020-03-05,0.07924528301886792,13250,14300,1050,545518
19195,3000,2020-03-02,0.04780876494023904,12550,13150,600,986821
19196,3000,2020-02-28,0.04198473282442748,13100,12550,-550,219372
19197,3000,2020-02-24,0.07246376811594203,13800,12800,-1000,337874
19198,3000,2020-01-09,0.045454545454545456,13200,13800,600,347697
19199,3000,2020-01-06,0.06159420289855073,13800,12950,-850,394381
19200,3000,2019-11-04,0.041237113402061855,14550,15150,600,255178
19201,3000,2019-08-28,0.053231939163498096,13150,13850,700,118694
19202,3000,2019-08-08,0.04182509505703422,13150,13700,550,284927
19203,3000,2019-08-05,0.12987012987012986,15400,13400,-2000,726769
19204,3000,2019-07-09,0.041916167664670656,16700,16000,-700,401983
19205,3000,2019-06-25,0.050397877984084884,18850,17900,-950,358187
19206,3000,2019-05-31,0.06647398843930635,17300,18450,1150,802529
19207,3000,2019-05-30,0.0581039755351682,16350,17300,950,1069542
19208,3000,2019-05-15,0.06626506024096386,16600,17700,1100,636203
19209,3000,2019-05-13,0.055232558139534885,17200,16250,-950,408273
19210,3000,2019-05-09,0.05555555555555555,18000,17000,-1000,610637
19211,3000,2019-03-29,0.04020100502512563,19900,19100,-800,1656294
19212,3000,2019-02-20,0.05154639175257732,24250,23000,-1250,1180132
19213,3000,2018-12-27,0.06620209059233449,28700,24000,-4700,589873
19214,3000,2018-11-06,0.041928721174004195,23850,24850,1000,213732
19215,3000,2018-11-02,0.06772009029345373,22150,23650,1500,220078
19216,3000,2018-10-26,0.04935622317596566,23300,22150,-1150,309900
19217,3000,2018-10-11,0.0783132530120482,24900,22950,-1950,496944
19218,3000,2018-07-03,0.04535637149028078,23150,22100,-1050,540927
19219,3000,2018-06-19,0.07037037037037037,27000,25100,-1900,356880
19220,3000,2018-05-02,0.06538461538461539,26000,27700,1700,834736
19221,3000,2018-04-23,0.06043956043956044,27300,25650,-1650,675580
19222,3000,2018-04-12,0.06829268292682927,30750,28650,-2100,1200586
19223,3000,2018-04-09,0.09888059701492537,26800,29450,2650,1645180
19224,3000,2018-04-04,0.0547945205479452,25550,26950,1400,1718289
19225,3000,2018-03-23,0.05533596837944664,25300,23900,-1400,456967
19226,3000,2018-02-05,0.04500978473581213,25550,24400,-1150,392019
19227,3000,2018-02-01,0.04891304347826087,27600,26250,-1350,503302
19228,3000,2018-01-30,0.07547169811320754,26500,28500,2000,1896004
19229,3000,2018-01-04,0.04681647940074907,26700,25450,-1250,661681
19230,3000,2018-01-03,0.12184873949579832,23800,26700,2900,2093633
19231,3000,2017-11-14,0.05042016806722689,23800,25000,1200,443374
19232,3000,2017-05-31,0.045662100456621,21900,22900,1000,436293
19233,3000,2017-05-08,0.04018912529550828,21150,22000,850,309950
19234,3000,2017-02-15,0.05482456140350877,22800,24050,1250,175622
19235,3000,2016-12-13,0.06500956022944551,26150,27850,1700,396300
19236,3000,2016-12-12,0.06300813008130081,24600,26150,1550,282307
19237,3000,2016-11-10,0.09090909090909091,23650,25800,2150,193452
19238,3000,2016-11-09,0.046370967741935484,24800,23650,-1150,280534
19239,3000,2016-11-02,0.05179282868525897,25100,23800,-1300,207072
19240,3000,2016-10-31,0.0421455938697318,26100,25000,-1100,166923
19241,3000,2016-09-30,0.05081967213114754,30500,28950,-1550,449014
19242,3000,2016-08-09,0.04448398576512456,28100,29350,1250,220322
19243,9150,2021-05-12,0.0625,176000,165000,-11000,1978102
19244,9150,2021-03-02,0.0633245382585752,189500,201500,12000,1104639
19245,9150,2021-01-19,0.04810126582278481,197500,207000,9500,948876
19246,9150,2021-01-13,0.054404145077720206,193000,203500,10500,2946385
19247,9150,2021-01-08,0.06043956043956044,182000,193000,11000,1490294
19248,9150,2020-12-29,0.056716417910447764,167500,177000,9500,1167680
19249,9150,2020-11-13,0.04878048780487805,143500,150500,7000,1730367
19250,9150,2020-08-20,0.0708955223880597,134000,124500,-9500,1028248
19251,9150,2020-07-28,0.04710144927536232,138000,144500,6500,1373437
19252,9150,2020-07-22,0.040293040293040296,136500,142000,5500,1750571
19253,9150,2020-07-21,0.04198473282442748,131000,136500,5500,1092107
19254,9150,2020-06-16,0.06451612903225806,124000,132000,8000,768348
19255,9150,2020-06-15,0.057034220532319393,131500,124000,-7500,769516
19256,9150,2020-06-10,0.042801556420233464,128500,134000,5500,1293070
19257,9150,2020-05-06,0.045662100456621,109500,114500,5000,884474
19258,9150,2020-04-17,0.08571428571428572,105000,114000,9000,2444154
19259,9150,2020-04-06,0.06918238993710692,95400,102000,6600,1642997
19260,9150,2020-03-24,0.10986547085201794,89200,99000,9800,1608106
19261,9150,2020-03-23,0.07468879668049792,96400,89200,-7200,1434217
19262,9150,2020-03-20,0.12485414235705951,85700,96400,10700,2158834
19263,9150,2020-03-19,0.11558307533539731,96900,85700,-11200,2639619
19264,9150,2020-03-18,0.059223300970873784,103000,96900,-6100,1992989
19265,9150,2020-03-16,0.07207207207207207,111000,103000,-8000,1640758
19266,9150,2020-03-12,0.06967213114754098,122000,113500,-8500,2613065
19267,9150,2020-03-11,0.05058365758754864,128500,122000,-6500,1375292
19268,9150,2020-03-10,0.044715447154471545,123000,128500,5500,1377581
19269,9150,2020-03-09,0.06463878326996197,131500,123000,-8500,1271059
19270,9150,2020-02-28,0.04182509505703422,131500,126000,-5500,1472050
19271,9150,2020-02-11,0.06015037593984962,133000,141000,8000,1510533
19272,9150,2020-02-04,0.072,125000,134000,9000,1124528
19273,9150,2020-01-30,0.04905660377358491,132500,126000,-6500,1115743
19274,9150,2020-01-09,0.056,125000,132000,7000,1402192
19275,9150,2019-11-11,0.05603448275862069,116000,109500,-6500,1014932
19276,9150,2019-09-19,0.04016477857878476,97100,101000,3900,1592520
19277,9150,2019-09-05,0.0593311758360302,92700,98200,5500,3257453
19278,9150,2019-08-26,0.04190260475651189,88300,84600,-3700,1105933
19279,9150,2019-08-14,0.04794520547945205,87600,91800,4200,1088073
19280,9150,2019-07-16,0.041304347826086954,92000,95800,3800,1641908
19281,9150,2019-04-17,0.049107142857142856,112000,117500,5500,2382798
19282,9150,2019-03-27,0.0539714867617108,98200,103500,5300,1924182
19283,9150,2019-02-28,0.044642857142857144,112000,107000,-5000,1674724
19284,9150,2019-02-12,0.056074766355140186,107000,113000,6000,2711585
19285,9150,2019-01-29,0.07075471698113207,106000,113500,7500,3658161
19286,9150,2019-01-25,0.10606060606060606,99000,109500,10500,4169300
19287,9150,2019-01-14,0.040774719673802244,98100,94100,-4000,1506639
19288,9150,2019-01-09,0.06015037593984962,93100,98700,5600,1995921
19289,9150,2019-01-03,0.06,100000,94000,-6000,2242797
19290,9150,2018-12-27,0.050761421319796954,98500,103500,5000,1338258
19291,9150,2018-12-14,0.06880733944954129,109000,101500,-7500,3174288
19292,9150,2018-12-10,0.05150214592274678,116500,110500,-6000,1792137
19293,9150,2018-12-03,0.04149377593360996,120500,125500,5000,1492039
19294,9150,2018-11-20,0.048034934497816595,114500,109000,-5500,1630336
19295,9150,2018-11-15,0.04017857142857143,112000,116500,4500,1483985
19296,9150,2018-11-12,0.041666666666666664,120000,115000,-5000,2153274
19297,9150,2018-11-09,0.04,125000,120000,-5000,2377256
19298,9150,2018-11-06,0.06343283582089553,134000,125500,-8500,3259269
19299,9150,2018-11-01,0.11016949152542373,118000,131000,13000,4171021
19300,9150,2018-10-30,0.07555555555555556,112500,121000,8500,3146241
19301,9150,2018-10-24,0.0622568093385214,128500,120500,-8000,3548987
19302,9150,2018-10-23,0.05860805860805861,136500,128500,-8000,1939614
19303,9150,2018-10-12,0.056,125000,132000,7000,2083832
19304,9150,2018-10-11,0.049429657794676805,131500,125000,-6500,2211351
19305,9150,2018-09-14,0.04827586206896552,145000,152000,7000,873332
19306,9150,2018-09-12,0.042483660130718956,153000,146500,-6500,1756437
19307,9150,2018-08-27,0.04262295081967213,152500,159000,6500,872233
19308,9150,2018-08-21,0.0749063670411985,133500,143500,10000,1251586
19309,9150,2018-08-10,0.057432432432432436,148000,139500,-8500,1964817
19310,9150,2018-08-06,0.04416403785488959,158500,151500,-7000,904004
19311,9150,2018-07-30,0.06134969325153374,163000,153000,-10000,1060421
19312,9150,2018-07-24,0.07432432432432433,148000,159000,11000,1060592
19313,9150,2018-07-13,0.041666666666666664,156000,162500,6500,996142
19314,9150,2018-07-09,0.04377104377104377,148500,155000,6500,897046
19315,9150,2018-07-04,0.0594059405940594,151500,142500,-9000,1033259
19316,9150,2018-06-20,0.07042253521126761,142000,152000,10000,1186214
19317,9150,2018-06-07,0.04316546762589928,139000,145000,6000,819096
19318,9150,2018-05-31,0.050980392156862744,127500,134000,6500,1310135
19319,9150,2018-05-21,0.04583333333333333,120000,125500,5500,892586
19320,9150,2018-05-17,0.04048582995951417,123500,118500,-5000,1036518
19321,9150,2018-05-09,0.04741379310344827,116000,121500,5500,1287493
19322,9150,2018-05-04,0.04072398190045249,110500,115000,4500,1046778
19323,9150,2018-05-03,0.05555555555555555,117000,110500,-6500,2001664
19324,9150,2018-04-24,0.05263157894736842,123500,117000,-6500,1365265
19325,9150,2018-04-16,0.06329113924050633,118500,126000,7500,1931596
19326,9150,2018-04-12,0.06944444444444445,108000,115500,7500,2888785
19327,9150,2018-01-05,0.08299595141700405,98800,107000,8200,2045463
19328,9150,2017-11-17,0.0430622009569378,104500,109000,4500,2119111
19329,9150,2017-11-13,0.0430622009569378,104500,100000,-4500,751762
19330,9150,2017-11-07,0.04,100000,104000,4000,865030
19331,9150,2017-10-30,0.059670781893004114,97200,103000,5800,1490876
19332,9150,2017-10-10,0.049019607843137254,102000,107000,5000,908194
19333,9150,2017-09-11,0.04807692307692308,104000,109000,5000,1348094
19334,9150,2017-08-14,0.04061470911086718,91100,94800,3700,695261
19335,9150,2017-07-28,0.081,100000,91900,-8100,2581821
19336,9150,2017-07-13,0.045,100000,104500,4500,1521245
19337,9150,2017-07-03,0.04411764705882353,102000,97500,-4500,1559815
19338,9150,2017-06-28,0.0639269406392694,109500,102500,-7000,1868011
19339,9150,2017-06-26,0.0945273631840796,100500,110000,9500,1520608
19340,9150,2017-06-22,0.05263157894736842,95000,100000,5000,1925614
19341,9150,2017-06-19,0.049217002237136466,89400,93800,4400,1173788
19342,9150,2017-06-12,0.0429732868757259,86100,82400,-3700,1006493
19343,9150,2017-03-29,0.045454545454545456,66000,69000,3000,993872
19344,9150,2017-03-13,0.04081632653061224,58800,61200,2400,729098
19345,9150,2017-02-24,0.04111842105263158,60800,58300,-2500,855809
19346,9150,2017-02-09,0.041742286751361164,55100,57400,2300,667152
19347,9150,2016-11-15,0.06623931623931624,46800,49900,3100,1766428
19348,9150,2016-11-07,0.04824561403508772,45600,47800,2200,364493
19349,9150,2016-09-12,0.0755813953488372,51600,47700,-3900,1958606
19350,9150,2016-08-18,0.056896551724137934,58000,61300,3300,1158876
19351,9150,2016-08-04,0.06521739130434782,55200,58800,3600,1198425
19352,11200,2021-05-20,0.07467911318553092,42850,46050,3200,14847741
19353,11200,2021-05-13,0.0661764705882353,47600,44450,-3150,28785777
19354,11200,2021-05-12,0.07207207207207207,44400,47600,3200,20954229
19355,11200,2021-05-07,0.06766917293233082,39900,42600,2700,20814694
19356,11200,2021-05-06,0.11921458625525946,35650,39900,4250,16629073
19357,11200,2021-05-03,0.05739795918367347,39200,36950,-2250,16483961
19358,11200,2021-04-28,0.06793478260869565,36800,39300,2500,19976442
19359,11200,2021-04-26,0.09711684370257967,32950,36150,3200,21050328
19360,11200,2021-04-19,0.07223113964686999,31150,33400,2250,13334501
19361,11200,2021-04-16,0.04355108877721943,29850,31150,1300,10454456
19362,11200,2021-04-07,0.04631217838765009,29150,30500,1350,10760811
19363,11200,2021-04-01,0.041379310344827586,29000,27800,-1200,18982890
19364,11200,2021-03-30,0.09208400646203554,30950,28100,-2850,26785243
19365,11200,2021-03-29,0.09370424597364568,34150,30950,-3200,41757002
19366,11200,2021-03-26,0.15959252971137522,29450,34150,4700,54130619
19367,11200,2021-03-23,0.07156308851224105,26550,28450,1900,26263232
19368,11200,2021-03-22,0.08588957055214724,24450,26550,2100,17226746
19369,11200,2021-03-18,0.05357142857142857,22400,23600,1200,9731574
19370,11200,2021-03-10,0.08684863523573201,20150,21900,1750,15519474
19371,11200,2021-03-09,0.08823529411764706,22100,20150,-1950,32684736
19372,11200,2021-03-05,0.0812807881773399,20300,21950,1650,22893847
19373,11200,2021-03-03,0.0851063829787234,18800,20400,1600,20737131
19374,11200,2021-02-25,0.08235294117647059,17000,18400,1400,15246668
19375,11200,2021-02-22,0.054878048780487805,16400,17300,900,19417433
19376,11200,2021-02-17,0.046357615894039736,15100,15800,700,11989053
19377,11200,2021-02-15,0.05862068965517241,14500,15350,850,14405862
19378,11200,2021-01-19,0.06405693950177936,14050,14950,900,6550934
19379,11200,2021-01-18,0.05067567567567568,14800,14050,-750,6546762
19380,11200,2021-01-04,0.1863799283154122,13950,16550,2600,38614102
19381,11200,2020-12-29,0.06589147286821706,12900,13750,850,9298354
19382,11200,2020-12-22,0.04411764705882353,13600,13000,-600,5611117
19383,11200,2020-12-17,0.05904059040590406,13550,14350,800,18063126
19384,11200,2020-12-10,0.07364341085271318,12900,13850,950,16972906
19385,11200,2020-11-23,0.050980392156862744,12750,13400,650,11988135
19386,11200,2020-11-19,0.045627376425855515,13150,12550,-600,11909306
19387,11200,2020-11-17,0.08156028368794327,14100,12950,-1150,22165115
19388,11200,2020-11-12,0.10384615384615385,13000,14350,1350,45128507
19389,11200,2020-11-11,0.04838709677419355,12400,13000,600,17900430
19390,11200,2020-11-10,0.04201680672268908,11900,12400,500,16861581
19391,11200,2020-11-09,0.16097560975609757,10250,11900,1650,28455967
19392,11200,2020-11-05,0.07521186440677965,9440,10150,710,16941269
19393,11200,2020-10-30,0.0547945205479452,9490,8970,-520,12295144
19394,11200,2020-10-28,0.06659142212189616,8860,9450,590,15306046
19395,11200,2020-10-26,0.09293680297397769,8070,8820,750,23200669
19396,11200,2020-10-23,0.056282722513089,7640,8070,430,12431787
19397,11200,2020-10-21,0.07801418439716312,7050,7600,550,8678052
19398,11200,2020-09-28,0.061224489795918366,6860,7280,420,3172491
19399,11200,2020-09-22,0.04183535762483131,7410,7100,-310,5461917
19400,11200,2020-09-10,0.09090909090909091,6490,7080,590,24811048
19401,11200,2020-09-09,0.04340836012861737,6220,6490,270,5515664
19402,11200,2020-09-02,0.05110732538330494,5870,6170,300,3599181
19403,11200,2020-08-27,0.043010752688172046,5580,5340,-240,4604481
19404,11200,2020-08-20,0.051194539249146756,5860,5560,-300,5282570
19405,11200,2020-08-18,0.11232449297971919,6410,5690,-720,9674274
19406,11200,2020-08-13,0.04231974921630094,6380,6650,270,5754698
19407,11200,2020-08-12,0.061764705882352944,6800,6380,-420,7911865
19408,11200,2020-08-06,0.0628099173553719,6050,6430,380,12166054
19409,11200,2020-07-30,0.06557377049180328,5490,5850,360,6111882
19410,11200,2020-07-29,0.061895551257253385,5170,5490,320,5385525
19411,11200,2020-07-21,0.04504504504504504,4995,5220,225,4054260
19412,11200,2020-06-26,0.0787037037037037,4320,4660,340,3049102
19413,11200,2020-06-25,0.046357615894039736,4530,4320,-210,3123364
19414,11200,2020-06-15,0.07945736434108527,5160,4750,-410,6954895
19415,11200,2020-06-12,0.07360861759425494,5570,5160,-410,8613229
19416,11200,2020-06-04,0.099601593625498,5020,5520,500,16221001
19417,11200,2020-05-27,0.083986562150056,4465,4840,375,15837049
19418,11200,2020-05-26,0.07460890493381468,4155,4465,310,7337191
19419,11200,2020-05-25,0.04005006257822278,3995,4155,160,3007002
19420,11200,2020-05-22,0.044444444444444446,3825,3995,170,12795608
19421,11200,2020-04-13,0.05167173252279635,3290,3460,170,2574276
19422,11200,2020-03-31,0.1051693404634581,2805,3100,295,3365384
19423,11200,2020-03-30,0.0525328330206379,2665,2805,140,1631441
19424,11200,2020-03-25,0.1111111111111111,2340,2600,260,2671935
19425,11200,2020-03-24,0.0684931506849315,2190,2340,150,1740696
19426,11200,2020-03-23,0.09690721649484536,2425,2190,-235,2438506
19427,11200,2020-03-20,0.043010752688172046,2325,2425,100,3836779
19428,11200,2020-03-19,0.17699115044247787,2825,2325,-500,4066380
19429,11200,2020-03-18,0.058333333333333334,3000,2825,-175,1617712
19430,11200,2020-03-13,0.06564885496183206,3275,3060,-215,3964328
19431,11200,2020-03-12,0.04518950437317784,3430,3275,-155,1790039
19432,11200,2020-03-09,0.05994550408719346,3670,3450,-220,1951088
19433,11200,2020-03-05,0.05815602836879433,3525,3730,205,1721638
19434,11200,2020-02-24,0.04428571428571428,3500,3345,-155,1838543
19435,11200,2020-02-17,0.040522875816993466,3825,3980,155,2545266
19436,11200,2020-02-10,0.0524822695035461,3525,3710,185,1144368
19437,11200,2020-01-28,0.04401650618982118,3635,3475,-160,1518192
19438,11200,2020-01-02,0.056338028169014086,3550,3750,200,1799891
19439,11200,2019-11-19,0.059420289855072465,3450,3655,205,1855117
19440,11200,2019-08-08,0.060240963855421686,2905,3080,175,731369
19441,11200,2019-08-05,0.07395498392282958,3110,2880,-230,1699191
19442,11200,2019-07-05,0.04945054945054945,3640,3820,180,1458377
19443,11200,2019-06-21,0.040110650069156296,3615,3760,145,1529794
19444,11200,2019-04-24,0.047619047619047616,4200,4000,-200,2014615
19445,11200,2019-04-22,0.10991957104557641,3730,4140,410,9097091
19446,11200,2019-02-28,0.09297052154195011,4410,4000,-410,4179735
19447,11200,2019-02-07,0.049586776859504134,4235,4445,210,5705243
19448,11200,2019-02-01,0.05742821473158552,4005,4235,230,2831296
19449,11200,2018-11-28,0.0625,4000,3750,-250,4099719
19450,11200,2018-11-19,0.04625,4000,4185,185,1358652
19451,11200,2018-11-02,0.06955380577427822,3810,4075,265,1362193
19452,11200,2018-10-29,0.05699481865284974,3860,3640,-220,1764996
19453,11200,2018-10-26,0.051597051597051594,4070,3860,-210,2384896
19454,11200,2018-10-11,0.053763440860215055,4650,4400,-250,2130347
19455,11200,2018-09-19,0.06933911159263272,4615,4935,320,20780887
19456,11200,2018-08-27,0.046012269938650305,4890,4665,-225,1651224
19457,11200,2018-07-30,0.04912663755458515,4580,4805,225,2061287
19458,11200,2018-07-26,0.04081632653061224,4410,4590,180,1385551
19459,11200,2018-07-09,0.04756871035940803,4730,4505,-225,2153415
19460,11200,2018-07-02,0.055666003976143144,5030,4750,-280,1819063
19461,11200,2018-06-29,0.041407867494824016,4830,5030,200,1637367
19462,11200,2018-06-21,0.04267161410018553,5390,5160,-230,1653062
19463,11200,2018-06-20,0.044573643410852716,5160,5390,230,2357346
19464,11200,2018-06-19,0.05321100917431193,5450,5160,-290,3188721
19465,11200,2018-06-14,0.051601423487544484,5620,5330,-290,4592129
19466,11200,2018-06-01,0.04060913705583756,5910,5670,-240,5524909
19467,11200,2018-05-29,0.0696969696969697,6600,6140,-460,15179916
19468,11200,2018-05-28,0.22448979591836735,5390,6600,1210,46346415
19469,11200,2018-05-25,0.0817717206132879,5870,5390,-480,9794335
19470,11200,2018-05-16,0.06677018633540373,6440,6010,-430,16784297
19471,11200,2018-05-15,0.042071197411003236,6180,6440,260,23600217
19472,11200,2018-05-14,0.06920415224913495,5780,6180,400,21392613
19473,11200,2018-05-08,0.05752961082910321,5910,5570,-340,7503974
19474,11200,2018-05-03,0.04918032786885246,6100,5800,-300,11688589
19475,11200,2018-04-30,0.15399239543726237,5260,6070,810,69084199
19476,11200,2018-04-26,0.07755102040816327,4900,5280,380,17980456
19477,11200,2018-04-23,0.0602655771195097,4895,5190,295,28778966
19478,11200,2018-04-18,0.05245901639344262,4575,4815,240,9082223
19479,11200,2018-04-09,0.05888030888030888,5180,4875,-305,9478692
19480,11200,2018-04-05,0.14827201783723523,4485,5150,665,71697983
19481,11200,2018-02-05,0.06041666666666667,4800,4510,-290,4672756
19482,11200,2018-01-03,0.043912175648702596,5010,4790,-220,9789137
19483,11200,2017-12-27,0.04411764705882353,4760,4970,210,4053766
19484,11200,2017-12-21,0.04158215010141988,4930,4725,-205,1705382
19485,11200,2017-12-01,0.0547008547008547,5850,5530,-320,2380521
19486,11200,2017-11-30,0.0893854748603352,5370,5850,480,5753422
19487,11200,2017-11-21,0.07432432432432433,5920,5480,-440,4146677
19488,11200,2017-10-27,0.04934687953555878,6890,7230,340,1362922
19489,11200,2017-10-16,0.14427860696517414,8040,6880,-1160,4302237
19490,11200,2017-07-26,0.04142011834319527,8450,8100,-350,2288568
19491,11200,2017-01-17,0.044270833333333336,7680,8020,340,3727756
19492,11200,2017-01-12,0.10661268556005399,7410,8200,790,13654100
19493,11200,2017-01-04,0.08005822416302766,6870,7420,550,4620366
19494,11200,2016-12-09,0.05858310626702997,7340,6910,-430,3737504
19495,11200,2016-12-07,0.05401459854014599,6850,7220,370,1445749
19496,11200,2016-12-01,0.05555555555555555,7200,6800,-400,6780951
19497,11200,2016-11-21,0.053735255570117955,7630,7220,-410,1391735
19498,11200,2016-11-10,0.043859649122807015,7980,8330,350,1573394
19499,11200,2016-11-09,0.054502369668246446,8440,7980,-460,3945399
19500,11200,2016-10-17,0.05200433369447454,9230,8750,-480,4395880
19501,11200,2016-10-14,0.10538922155688622,8350,9230,880,14914079
19502,11200,2016-09-26,0.05968331303288672,8210,8700,490,6447382
19503,11200,2016-09-21,0.08288770053475936,7480,8100,620,9659520
19504,11200,2016-09-19,0.040993788819875775,8050,7720,-330,2744034
19505,11200,2016-09-12,0.06868451688009314,8590,8000,-590,4192507
19506,11200,2016-09-07,0.07953216374269007,8550,9230,680,16856732
19507,11200,2016-09-06,0.06043956043956044,9100,8550,-550,10742393
19508,11200,2016-08-31,0.2557200538358008,7430,9330,1900,51168100
19509,11200,2016-08-30,0.07525325615050651,6910,7430,520,12888443
19510,11200,2016-08-04,0.07068062827225131,7640,7100,-540,14197313
19511,11200,2016-08-03,0.2792452830188679,10600,7640,-2960,27047568
19512,18880,2021-04-21,0.04143646408839779,18100,17350,-750,1793444
19513,18880,2021-03-29,0.04,18750,18000,-750,1638484
19514,18880,2021-03-26,0.06837606837606838,17550,18750,1200,6069802
19515,18880,2021-03-22,0.05714285714285714,17500,18500,1000,9910868
19516,18880,2021-03-11,0.06461538461538462,16250,17300,1050,1959396
19517,18880,2021-03-02,0.11974110032362459,15450,17300,1850,7906802
19518,18880,2021-02-26,0.040372670807453416,16100,15450,-650,1746909
19519,18880,2021-02-24,0.042682926829268296,16400,15700,-700,1907399
19520,18880,2021-02-03,0.05307262569832402,17900,18850,950,2654476
19521,18880,2021-02-01,0.05389221556886228,16700,17600,900,1346258
19522,18880,2021-01-29,0.0670391061452514,17900,16700,-1200,1891019
19523,18880,2021-01-11,0.04607046070460705,18450,17600,-850,5087049
19524,18880,2021-01-08,0.12844036697247707,16350,18450,2100,14542365
19525,18880,2020-12-23,0.05555555555555555,15300,16150,850,6344971
19526,18880,2020-12-09,0.04472843450479233,15650,16350,700,1449354
19527,18880,2020-12-04,0.04833836858006042,16550,15750,-800,2453853
19528,18880,2020-12-01,0.09302325581395349,15050,16450,1400,6908505
19529,18880,2020-11-19,0.14391143911439114,13550,15500,1950,14470064
19530,18880,2020-11-11,0.07171314741035857,12550,13450,900,3400160
19531,18880,2020-10-30,0.04680851063829787,11750,11200,-550,985190
19532,18880,2020-10-05,0.04048582995951417,12350,12850,500,1961813
19533,18880,2020-09-22,0.07196969696969698,13200,12250,-950,2444827
19534,18880,2020-09-21,0.043478260869565216,12650,13200,550,4218262
19535,18880,2020-09-18,0.05947955390334572,13450,12650,-800,2688406
19536,18880,2020-09-17,0.06746031746031746,12600,13450,850,6616191
19537,18880,2020-08-24,0.07194244604316546,13900,12900,-1000,2691768
19538,18880,2020-08-21,0.10317460317460317,12600,13900,1300,5206182
19539,18880,2020-08-19,0.04819277108433735,12450,13050,600,2656469
19540,18880,2020-08-18,0.04230769230769231,13000,12450,-550,2234228
19541,18880,2020-08-13,0.0625,12000,12750,750,16273756
19542,18880,2020-08-12,0.10091743119266056,10900,12000,1100,22226342
19543,18880,2020-08-10,0.04265402843601896,10550,11000,450,2420751
19544,18880,2020-07-30,0.056782334384858045,9510,10050,540,2627301
19545,18880,2020-07-27,0.040525739320920046,9130,9500,370,1641089
19546,18880,2020-07-10,0.04477611940298507,10050,9600,-450,1087812
19547,18880,2020-06-16,0.06687898089171974,9420,10050,630,1141655
19548,18880,2020-06-15,0.07647058823529412,10200,9420,-780,1325247
19549,18880,2020-06-12,0.04672897196261682,10700,10200,-500,1653938
19550,18880,2020-05-29,0.06915477497255763,9110,9740,630,3099166
19551,18880,2020-04-07,0.04908675799086758,8760,9190,430,1545811
19552,18880,2020-04-06,0.06181818181818182,8250,8760,510,1155301
19553,18880,2020-04-01,0.040586245772266064,8870,8510,-360,1577583
19554,18880,2020-03-26,0.04220779220779221,9240,8850,-390,1775609
19555,18880,2020-03-24,0.04423748544819558,8590,8970,380,1465510
19556,18880,2020-03-23,0.07832618025751073,9320,8590,-730,1377405
19557,18880,2020-03-18,0.06309148264984227,9510,8910,-600,1534667
19558,18880,2020-03-16,0.04021739130434782,9200,9570,370,1550192
19559,18880,2020-03-12,0.09142857142857143,10500,9540,-960,2159971
19560,18880,2020-02-24,0.045871559633027525,10900,10400,-500,935132
19561,18880,2020-02-11,0.046511627906976744,10750,11250,500,1721541
19562,18880,2019-07-17,0.056768558951965066,11450,12100,650,2067404
19563,18880,2019-06-26,0.04081632653061224,12250,11750,-500,950888
19564,18880,2019-06-10,0.04329004329004329,11550,12050,500,683434
19565,18880,2019-05-27,0.04405286343612335,11350,11850,500,821774
19566,18880,2019-05-21,0.04405286343612335,11350,10850,-500,1348362
19567,18880,2019-05-09,0.04132231404958678,12100,11600,-500,1074428
19568,18880,2019-04-29,0.04526748971193416,12150,12700,550,1005969
19569,18880,2019-04-17,0.046218487394957986,11900,12450,550,1598418
19570,18880,2019-01-23,0.040983606557377046,12200,12700,500,1531311
19571,18880,2019-01-18,0.06276150627615062,11950,12700,750,3209379
19572,18880,2019-01-15,0.048672566371681415,11300,11850,550,1911623
19573,18880,2019-01-09,0.05238095238095238,10500,11050,550,1843464
19574,18880,2019-01-08,0.049773755656108594,11050,10500,-550,981257
19575,18880,2019-01-04,0.04716981132075472,10600,11100,500,1193747
19576,18880,2018-12-21,0.04484304932735426,11150,10650,-500,1541442
19577,18880,2018-12-19,0.04672897196261682,10700,11200,500,2087257
19578,18880,2018-12-12,0.045081967213114756,9760,10200,440,1381726
19579,18880,2018-12-05,0.06666666666666667,10650,9940,-710,3719500
19580,18880,2018-11-22,0.05092592592592592,10800,10250,-550,1310932
19581,18880,2018-11-13,0.05365853658536585,10250,10800,550,2424092
19582,18880,2018-11-12,0.05092592592592592,10800,10250,-550,962540
19583,18880,2018-10-29,0.04205607476635514,10700,10250,-450,1032145
19584,18880,2018-10-23,0.06779661016949153,11800,11000,-800,1478116
19585,18880,2018-10-10,0.04417670682730924,12450,11900,-550,1867244
19586,18880,2018-09-27,0.06037735849056604,13250,12450,-800,2204708
19587,18880,2018-09-21,0.04743083003952569,12650,13250,600,4909947
19588,18880,2018-09-18,0.059574468085106386,11750,12450,700,1038622
19589,18880,2018-08-10,0.05405405405405406,11100,11700,600,1839634
19590,18880,2018-07-13,0.05825242718446602,10300,10900,600,1079626
19591,18880,2018-07-05,0.050204918032786885,9760,10250,490,1800109
19592,18880,2018-07-04,0.057004830917874394,10350,9760,-590,2538915
19593,18880,2018-06-04,0.09852216748768473,10150,11150,1000,2186728
19594,18880,2018-05-23,0.06912442396313365,10850,10100,-750,3284937
19595,18880,2018-05-17,0.05429864253393665,11050,11650,600,1360776
19596,18880,2018-04-25,0.05150214592274678,11650,11050,-600,1139547
19597,18880,2018-04-06,0.05172413793103448,11600,11000,-600,1446068
19598,18880,2018-03-07,0.056910569105691054,12300,11600,-700,1447896
19599,18880,2018-02-23,0.040983606557377046,12200,12700,500,783586
19600,18880,2018-02-12,0.0546875,12800,12100,-700,1944076
19601,18880,2018-01-16,0.044897959183673466,12250,12800,550,1300719
19602,18880,2017-12-19,0.05734767025089606,13950,13150,-800,1641619
19603,18880,2017-12-18,0.0449438202247191,13350,13950,600,1308877
19604,18880,2017-12-01,0.041666666666666664,13200,13750,550,1189243
19605,18880,2017-11-24,0.055970149253731345,13400,14150,750,1969513
19606,18880,2017-11-22,0.04669260700389105,12850,13450,600,1819482
19607,18880,2017-11-09,0.052,12500,13150,650,2084467
19608,18880,2017-10-24,0.0859106529209622,14550,13300,-1250,3940166
19609,18880,2017-10-23,0.06985294117647059,13600,14550,950,3329782
19610,18880,2017-10-18,0.05905511811023622,12700,13450,750,2086732
19611,18880,2017-10-11,0.057034220532319393,13150,12400,-750,2542884
19612,18880,2017-10-10,0.04365079365079365,12600,13150,550,1902485
19613,18880,2017-09-25,0.05761316872427984,12150,12850,700,2587056
19614,18880,2017-09-15,0.044897959183673466,12250,12800,550,2499102
19615,18880,2017-09-12,0.04782608695652174,11500,12050,550,2586020
19616,18880,2017-09-11,0.0502283105022831,10950,11500,550,2645258
19617,18880,2017-08-24,0.05194805194805195,11550,12150,600,4638415
19618,18880,2017-08-18,0.09174311926605505,10900,11900,1000,5134820
19619,18880,2017-08-07,0.05829596412556054,11150,10500,-650,1659050
19620,18880,2017-08-03,0.046948356807511735,10650,11150,500,2478188
19621,18880,2017-08-02,0.054455445544554455,10100,10650,550,1270831
19622,18880,2017-07-31,0.04205607476635514,10700,10250,-450,1047737
19623,18880,2017-07-03,0.05339805825242718,10300,10850,550,1051927
19624,18880,2017-06-20,0.05240174672489083,11450,10850,-600,1657624
19625,18880,2017-06-16,0.041474654377880185,10850,11300,450,3390142
19626,18880,2017-06-08,0.05853658536585366,10250,10850,600,1511723
19627,18880,2017-05-22,0.04209445585215606,9740,10150,410,2009344
19628,18880,2017-05-11,0.041666666666666664,9120,9500,380,1996788
19629,18880,2017-05-08,0.04572098475967175,8530,8920,390,1500732
19630,18880,2017-03-17,0.04291845493562232,9320,9720,400,2964673
19631,18880,2017-03-14,0.08108108108108109,8510,9200,690,3810584
19632,18880,2017-03-03,0.05281285878300804,8710,8250,-460,2796654
19633,18880,2017-03-02,0.04912663755458515,9160,8710,-450,1935673
19634,18880,2017-02-15,0.05393743257820928,9270,8770,-500,2746441
19635,18880,2017-01-31,0.0431578947368421,9500,9090,-410,1747981
19636,18880,2017-01-13,0.040372670807453416,9660,10050,390,1656368
19637,18880,2017-01-10,0.050746268656716415,10050,9540,-510,3311399
19638,18880,2016-12-29,0.04568527918781726,9850,10300,450,1248764
19639,18880,2016-12-08,0.04700854700854701,9360,9800,440,1286112
19640,18880,2016-11-10,0.04186046511627907,10750,10300,-450,4638720
19641,18880,2016-11-09,0.048672566371681415,11300,10750,-550,1610859
19642,18880,2016-11-07,0.04128440366972477,10900,11350,450,1148169
19643,18880,2016-10-26,0.0425531914893617,11750,11250,-500,807317
19644,18880,2016-10-13,0.041666666666666664,12000,11500,-500,1560055
19645,18880,2016-10-10,0.046413502109704644,11850,12400,550,829214
19646,18880,2016-09-27,0.07661290322580645,12400,13350,950,2115158
19647,18880,2016-09-09,0.04365079365079365,12600,12050,-550,1118881
19648,18880,2016-09-07,0.049586776859504134,12100,12700,600,2881557
19649,18880,2016-08-30,0.04035874439461883,11150,11600,450,880921
19650,18880,2016-08-10,0.044444444444444446,11250,11750,500,1736901
19651,18880,2016-08-05,0.04,11250,11700,450,1447004
19652,47040,2021-06-02,0.06227544910179641,8350,8870,520,27759396
19653,47040,2021-05-31,0.042606516290726815,7980,8320,340,13553906
19654,47040,2021-05-18,0.05714285714285714,7350,7770,420,10224705
19655,47040,2021-04-29,0.06954102920723226,7190,7690,500,27493195
19656,47040,2021-04-20,0.05102040816326531,6860,7210,350,15109308
19657,47040,2021-04-08,0.07858243451463791,6490,7000,510,25827417
19658,47040,2021-03-29,0.04636785162287481,6470,6770,300,10592458
19659,47040,2021-03-22,0.04590163934426229,6100,6380,280,6503952
19660,47040,2021-03-15,0.05704697986577181,5960,6300,340,15376092
19661,47040,2021-03-12,0.04195804195804196,5720,5960,240,10629289
19662,47040,2021-02-04,0.05061349693251534,6520,6190,-330,11256306
19663,47040,2021-02-01,0.09491525423728814,5900,6460,560,12801447
19664,47040,2021-01-29,0.06645569620253164,6320,5900,-420,11265125
19665,47040,2021-01-28,0.04118616144975288,6070,6320,250,18960759
19666,47040,2021-01-18,0.05733558178752108,5930,6270,340,23957542
19667,47040,2021-01-14,0.0595446584938704,5710,6050,340,11516315
19668,47040,2021-01-05,0.12427184466019417,5150,5790,640,63694731
19669,47040,2020-12-30,0.06974248927038626,4660,4985,325,22854653
19670,47040,2020-12-18,0.06466512702078522,4330,4610,280,8850284
19671,47040,2020-12-14,0.046610169491525424,4720,4500,-220,5419254
19672,47040,2020-12-10,0.0872093023255814,4300,4675,375,33951737
19673,47040,2020-12-09,0.08040201005025126,3980,4300,320,8524837
19674,47040,2020-12-04,0.06964520367936924,3805,4070,265,14254782
19675,47040,2020-12-03,0.07334273624823695,3545,3805,260,11263948
19676,47040,2020-11-19,0.04644808743169399,3660,3490,-170,4364138
19677,47040,2020-11-11,0.040345821325648415,3470,3610,140,7035574
19678,47040,2020-11-10,0.0547112462006079,3290,3470,180,7730072
19679,47040,2020-11-09,0.051118210862619806,3130,3290,160,5387105
19680,47040,2020-10-23,0.05454545454545454,3025,3190,165,5085754
19681,47040,2020-08-31,0.04383116883116883,3080,2945,-135,20806884
19682,47040,2020-08-20,0.050445103857566766,3370,3200,-170,2141779
19683,47040,2020-08-18,0.04397163120567376,3525,3370,-155,1720632
19684,47040,2020-08-04,0.05028735632183908,3480,3655,175,4655043
19685,47040,2020-07-28,0.07132667617689016,3505,3755,250,5826855
19686,47040,2020-06-16,0.05747126436781609,3480,3680,200,1116764
19687,47040,2020-06-15,0.056910569105691054,3690,3480,-210,1414033
19688,47040,2020-06-05,0.043256997455470736,3930,4100,170,1715900
19689,47040,2020-05-29,0.047879616963064295,3655,3830,175,2547093
19690,47040,2020-04-27,0.04242424242424243,3300,3440,140,911273
19691,47040,2020-04-22,0.04078549848942598,3310,3445,135,2014014
19692,47040,2020-04-14,0.05071315372424723,3155,3315,160,2427988
19693,47040,2020-04-02,0.05253623188405797,2760,2905,145,1379518
19694,47040,2020-04-01,0.061224489795918366,2940,2760,-180,1814015
19695,47040,2020-03-31,0.0481283422459893,2805,2940,135,2285175
19696,47040,2020-03-25,0.13078470824949698,2485,2810,325,3340166
19697,47040,2020-03-24,0.09230769230769231,2275,2485,210,2317386
19698,47040,2020-03-23,0.1007905138339921,2530,2275,-255,2216825
19699,47040,2020-03-20,0.06751054852320675,2370,2530,160,3331959
19700,47040,2020-03-19,0.1520572450805009,2795,2370,-425,4389516
19701,47040,2020-03-18,0.0940032414910859,3085,2795,-290,2749166
19702,47040,2020-03-17,0.05657492354740061,3270,3085,-185,2440175
19703,47040,2020-03-13,0.06818181818181818,3520,3280,-240,3513467
19704,47040,2020-03-12,0.0712401055408971,3790,3520,-270,2831225
19705,47040,2020-03-09,0.06432038834951456,4120,3855,-265,2693924
19706,47040,2020-03-06,0.04074505238649592,4295,4120,-175,1284056
19707,47040,2020-03-05,0.0644361833952912,4035,4295,260,2277299
19708,47040,2020-02-24,0.04529616724738676,4305,4110,-195,2081759
19709,47040,2020-02-06,0.08700564971751412,4425,4810,385,2744930
19710,47040,2020-01-09,0.041617122473246136,4205,4380,175,1805007
19711,47040,2020-01-08,0.04971751412429379,4425,4205,-220,2788299
19712,47040,2020-01-06,0.04153354632587859,4695,4500,-195,1287069
19713,47040,2019-12-12,0.04658721560130011,4615,4830,215,2128026
19714,47040,2019-11-05,0.04061470911086718,4555,4740,185,1661776
19715,47040,2019-11-04,0.04953917050691244,4340,4555,215,1169977
19716,47040,2019-09-16,0.11986301369863013,4380,4905,525,6281206
19717,47040,2019-08-05,0.040690505548705305,4055,3890,-165,1262235
19718,47040,2019-07-25,0.04462242562929062,4370,4175,-195,1873386
19719,47040,2019-03-14,0.04311251314405889,4755,4960,205,1355240
19720,47040,2019-01-30,0.06761565836298933,5620,5240,-380,9250936
19721,47040,2019-01-29,0.049069373942470386,5910,5620,-290,3412149
19722,47040,2019-01-23,0.06560283687943262,5640,6010,370,2289355
19723,47040,2019-01-09,0.04036697247706422,5450,5670,220,1242213
19724,47040,2018-12-27,0.04046242774566474,5190,5400,210,1078547
19725,47040,2018-12-19,0.04203152364273205,5710,5470,-240,1568225
19726,47040,2018-12-14,0.05232558139534884,5160,5430,270,2784203
19727,47040,2018-12-12,0.04365904365904366,4810,5020,210,1369919
19728,47040,2018-11-28,0.06079664570230608,4770,5060,290,1778085
19729,47040,2018-11-02,0.04585152838427948,4580,4790,210,1057123
19730,47040,2018-10-30,0.05625717566016074,4355,4600,245,2238419
19731,47040,2018-10-29,0.05428881650380022,4605,4355,-250,3221589
19732,47040,2018-10-26,0.07250755287009064,4965,4605,-360,3434976
19733,47040,2018-10-11,0.05786618444846293,5530,5210,-320,2375429
19734,47040,2018-10-10,0.04325259515570934,5780,5530,-250,2098033
19735,47040,2018-09-21,0.05565217391304348,5750,6070,320,3549469
19736,47040,2018-09-10,0.075,5200,5590,390,4435077
19737,47040,2018-08-06,0.043859649122807015,5700,5450,-250,1873014
19738,47040,2018-07-02,0.06132879045996593,5870,5510,-360,2788902
19739,47040,2018-06-14,0.045925925925925926,6750,6440,-310,4014882
19740,47040,2018-06-11,0.06426332288401254,6380,6790,410,4214171
19741,47040,2018-06-05,0.05663430420711974,6180,6530,350,3463619
19742,47040,2018-05-29,0.05459770114942529,6960,6580,-380,4024110
19743,47040,2018-05-28,0.14473684210526316,6080,6960,880,13248700
19744,47040,2018-05-25,0.06748466257668712,6520,6080,-440,8480778
19745,47040,2018-05-21,0.04943502824858757,7080,6730,-350,3923502
19746,47040,2018-05-14,0.07620528771384137,6430,6920,490,9223127
19747,47040,2018-05-08,0.04236006051437216,6610,6330,-280,4274532
19748,47040,2018-04-30,0.06722689075630252,5950,6350,400,9798465
19749,47040,2018-04-19,0.05509181969949917,5990,6320,330,7978654
19750,47040,2018-04-18,0.05457746478873239,5680,5990,310,4398386
19751,47040,2018-04-09,0.04887218045112782,5320,5580,260,4703256
19752,47040,2018-03-12,0.042105263157894736,5700,5940,240,3408070
19753,47040,2018-03-09,0.05166051660516605,5420,5700,280,3881470
19754,47040,2018-03-06,0.07677165354330709,5080,5470,390,4692440
19755,47040,2018-02-19,0.05918367346938776,4900,5190,290,3682367
19756,47040,2018-02-08,0.0880281690140845,5680,5180,-500,11719649
19757,47040,2018-02-06,0.044850498338870434,6020,5750,-270,4198424
19758,47040,2018-01-19,0.04013961605584642,5730,5960,230,4679922
19759,47040,2017-12-15,0.07414104882459313,5530,5940,410,3307940
19760,47040,2017-12-14,0.044905008635578586,5790,5530,-260,2871682
19761,47040,2017-12-07,0.043706293706293704,5720,5470,-250,3151425
19762,47040,2017-11-21,0.05853658536585366,6150,5790,-360,7143712
19763,47040,2017-11-13,0.05925925925925926,6750,6350,-400,7286856
19764,47040,2017-11-09,0.0421875,6400,6670,270,12015690
19765,47040,2017-11-07,0.04552129221732746,6810,6500,-310,26215099
19766,47040,2017-11-02,0.0681198910081744,7340,6840,-500,7026872
19767,47040,2017-10-24,0.042796005706134094,7010,7310,300,1785514
19768,47040,2017-09-04,0.04441453566621804,7430,7100,-330,2128558
19769,47040,2017-09-01,0.05689900426742532,7030,7430,400,6159334
19770,47040,2017-08-03,0.061274509803921566,8160,7660,-500,2854513
19771,47040,2017-06-29,0.04892086330935252,6950,7290,340,1867266
19772,47040,2017-05-24,0.06280788177339902,8120,7610,-510,36770279
19773,47040,2017-04-13,0.046413502109704644,7110,6780,-330,10426634
19774,47040,2017-03-28,0.0442225392296719,7010,7320,310,1388249
19775,47040,2017-03-23,0.04899135446685879,6940,7280,340,2109328
19776,47040,2017-03-07,0.04597701149425287,6090,6370,280,1464485
19777,47040,2017-02-09,0.09158878504672897,5350,5840,490,4746627
19778,47040,2016-11-18,0.04021937842778794,5470,5250,-220,2423166
19779,47040,2016-11-16,0.055077452667814115,5810,5490,-320,7375151
19780,47040,2016-11-15,0.13670133729569092,6730,5810,-920,8759304
19781,47040,2016-11-10,0.051036682615629984,6270,6590,320,1990332
19782,950210,2021-05-26,0.054770318021201414,28300,29850,1550,835849
19783,950210,2021-05-04,0.054858934169279,31900,30150,-1750,664558
19784,950210,2021-05-03,0.05760709010339734,33850,31900,-1950,564073
19785,950210,2021-04-28,0.07088989441930618,33150,35500,2350,4133708
19786,950210,2021-04-26,0.10810810810810811,37000,33000,-4000,1623467
19787,950210,2021-04-22,0.0819423368740516,32950,35650,2700,7643291
19788,950210,2021-04-16,0.041935483870967745,31000,32300,1300,5614650
19789,950210,2021-04-15,0.05263157894736842,29450,31000,1550,2446476
19790,950210,2021-04-09,0.07806691449814127,26900,29000,2100,1817501
19791,950210,2021-04-06,0.040892193308550186,26900,25800,-1100,761757
19792,950210,2021-04-05,0.047787610619469026,28250,26900,-1350,584687
19793,950210,2021-03-09,0.11604095563139932,29300,32700,3400,9155017
19794,950210,2021-03-08,0.0624,31250,29300,-1950,1565709
19795,950210,2021-03-05,0.05446293494704992,33050,31250,-1800,2016202
19796,950210,2021-03-04,0.044797687861271675,34600,33050,-1550,1384889
19797,950210,2021-03-03,0.052054794520547946,36500,34600,-1900,1721501
19798,950210,2021-03-02,0.059278350515463915,38800,36500,-2300,2681476
19799,950210,2021-02-25,0.13088235294117648,34000,38450,4450,10523135
19800,950210,2021-02-24,0.08108108108108109,37000,34000,-3000,4947810
19801,950210,2021-02-22,0.055408970976253295,37900,35800,-2100,3437054
19802,950210,2021-02-18,0.15410573678290213,44450,37600,-6850,4516835
19803,950210,2021-02-17,0.08161157024793389,48400,44450,-3950,3173071
19804,950210,2021-02-09,0.17370892018779344,42600,50000,7400,27039598
19805,950210,2021-02-08,0.29878048780487804,32800,42600,9800,22798386
19806,950210,2021-02-05,0.12195121951219512,32800,32800,0,41481126
19807,950210,2021-02-05,0.12195121951219512,32800,32800,0,41481126
19808,950210,2021-02-05,0.12195121951219512,32800,32800,0,41481126
19809,950210,2021-02-05,0.12195121951219512,32800,32800,0,41481126
19810,950210,2021-02-05,0.12195121951219512,32800,32800,0,41481126
19811,950210,2021-02-05,0.12195121951219512,32800,32800,0,41481126
19812,950210,2021-02-05,0.12195121951219512,32800,32800,0,41481126
19813,950210,2021-02-05,0.12195121951219512,32800,32800,0,41481126
19814,950210,2021-02-05,0.12195121951219512,32800,32800,0,41481126
19815,950210,2021-02-05,0.12195121951219512,32800,32800,0,41481126
19816,950210,2021-02-05,0.12195121951219512,32800,32800,0,41481126
19817,950210,2021-02-05,0.12195121951219512,32800,32800,0,41481126
19818,950210,2021-02-05,0.12195121951219512,32800,32800,0,41481126
19819,950210,2021-02-05,0.12195121951219512,32800,32800,0,41481126
19820,950210,2021-02-05,0.12195121951219512,32800,32800,0,41481126
19821,950210,2021-02-05,0.12195121951219512,32800,32800,0,41481126
19822,950210,2021-02-05,0.12195121951219512,32800,32800,0,41481126
19823,950210,2021-02-05,0.12195121951219512,32800,32800,0,41481126
19824,950210,2021-02-05,0.12195121951219512,32800,32800,0,41481126
19825,950210,2021-02-05,0.12195121951219512,32800,32800,0,41481126
19826,950210,2021-02-05,0.12195121951219512,32800,32800,0,41481126
19827,950210,2021-02-05,0.12195121951219512,32800,32800,0,41481126
19828,950210,2021-02-05,0.12195121951219512,32800,32800,0,41481126
19829,950210,2021-02-05,0.12195121951219512,32800,32800,0,41481126
19830,950210,2021-02-05,0.12195121951219512,32800,32800,0,41481126
19831,950210,2021-02-05,0.12195121951219512,32800,32800,0,41481126
19832,950210,2021-02-05,0.12195121951219512,32800,32800,0,41481126
19833,950210,2021-02-05,0.12195121951219512,32800,32800,0,41481126
19834,950210,2021-02-05,0.12195121951219512,32800,32800,0,41481126
19835,950210,2021-02-05,0.12195121951219512,32800,32800,0,41481126
19836,950210,2021-02-05,0.12195121951219512,32800,32800,0,41481126
19837,950210,2021-02-05,0.12195121951219512,32800,32800,0,41481126
19838,950210,2021-02-05,0.12195121951219512,32800,32800,0,41481126
19839,950210,2021-02-05,0.12195121951219512,32800,32800,0,41481126
19840,950210,2021-02-05,0.12195121951219512,32800,32800,0,41481126
19841,950210,2021-02-05,0.12195121951219512,32800,32800,0,41481126
19842,950210,2021-02-05,0.12195121951219512,32800,32800,0,41481126
19843,950210,2021-02-05,0.12195121951219512,32800,32800,0,41481126
19844,950210,2021-02-05,0.12195121951219512,32800,32800,0,41481126
19845,950210,2021-02-05,0.12195121951219512,32800,32800,0,41481126
19846,950210,2021-02-05,0.12195121951219512,32800,32800,0,41481126
19847,950210,2021-02-05,0.12195121951219512,32800,32800,0,41481126
19848,950210,2021-02-05,0.12195121951219512,32800,32800,0,41481126
19849,950210,2021-02-05,0.12195121951219512,32800,32800,0,41481126
19850,950210,2021-02-05,0.12195121951219512,32800,32800,0,41481126
19851,950210,2021-02-05,0.12195121951219512,32800,32800,0,41481126
19852,950210,2021-02-05,0.12195121951219512,32800,32800,0,41481126
19853,950210,2021-02-05,0.12195121951219512,32800,32800,0,41481126
19854,950210,2021-02-05,0.12195121951219512,32800,32800,0,41481126
19855,950210,2021-02-05,0.12195121951219512,32800,32800,0,41481126
19856,950210,2021-02-05,0.12195121951219512,32800,32800,0,41481126
19857,950210,2021-02-05,0.12195121951219512,32800,32800,0,41481126
19858,950210,2021-02-05,0.12195121951219512,32800,32800,0,41481126
19859,950210,2021-02-05,0.12195121951219512,32800,32800,0,41481126
19860,950210,2021-02-05,0.12195121951219512,32800,32800,0,41481126
19861,950210,2021-02-05,0.12195121951219512,32800,32800,0,41481126
19862,950210,2021-02-05,0.12195121951219512,32800,32800,0,41481126
19863,950210,2021-02-05,0.12195121951219512,32800,32800,0,41481126
19864,950210,2021-02-05,0.12195121951219512,32800,32800,0,41481126
19865,950210,2021-02-05,0.12195121951219512,32800,32800,0,41481126
19866,950210,2021-02-05,0.12195121951219512,32800,32800,0,41481126
19867,950210,2021-02-05,0.12195121951219512,32800,32800,0,41481126
19868,950210,2021-02-05,0.12195121951219512,32800,32800,0,41481126
19869,950210,2021-02-05,0.12195121951219512,32800,32800,0,41481126
19870,950210,2021-02-05,0.12195121951219512,32800,32800,0,41481126
19871,950210,2021-02-05,0.12195121951219512,32800,32800,0,41481126
19872,950210,2021-02-05,0.12195121951219512,32800,32800,0,41481126
19873,950210,2021-02-05,0.12195121951219512,32800,32800,0,41481126
19874,950210,2021-02-05,0.12195121951219512,32800,32800,0,41481126
19875,950210,2021-02-05,0.12195121951219512,32800,32800,0,41481126
19876,950210,2021-02-05,0.12195121951219512,32800,32800,0,41481126
19877,950210,2021-02-05,0.12195121951219512,32800,32800,0,41481126
19878,950210,2021-02-05,0.12195121951219512,32800,32800,0,41481126
19879,950210,2021-02-05,0.12195121951219512,32800,32800,0,41481126
19880,950210,2021-02-05,0.12195121951219512,32800,32800,0,41481126
19881,950210,2021-02-05,0.12195121951219512,32800,32800,0,41481126
19882,950210,2021-02-05,0.12195121951219512,32800,32800,0,41481126
19883,950210,2021-02-05,0.12195121951219512,32800,32800,0,41481126
19884,950210,2021-02-05,0.12195121951219512,32800,32800,0,41481126
19885,950210,2021-02-05,0.12195121951219512,32800,32800,0,41481126
19886,950210,2021-02-05,0.12195121951219512,32800,32800,0,41481126
19887,950210,2021-02-05,0.12195121951219512,32800,32800,0,41481126
19888,950210,2021-02-05,0.12195121951219512,32800,32800,0,41481126
19889,950210,2021-02-05,0.12195121951219512,32800,32800,0,41481126
19890,950210,2021-02-05,0.12195121951219512,32800,32800,0,41481126
19891,950210,2021-02-05,0.12195121951219512,32800,32800,0,41481126
19892,950210,2021-02-05,0.12195121951219512,32800,32800,0,41481126
19893,950210,2021-02-05,0.12195121951219512,32800,32800,0,41481126
19894,950210,2021-02-05,0.12195121951219512,32800,32800,0,41481126
19895,950210,2021-02-05,0.12195121951219512,32800,32800,0,41481126
19896,950210,2021-02-05,0.12195121951219512,32800,32800,0,41481126
19897,950210,2021-02-05,0.12195121951219512,32800,32800,0,41481126
19898,950210,2021-02-05,0.12195121951219512,32800,32800,0,41481126
19899,950210,2021-02-05,0.12195121951219512,32800,32800,0,41481126
19900,950210,2021-02-05,0.12195121951219512,32800,32800,0,41481126
19901,950210,2021-02-05,0.12195121951219512,32800,32800,0,41481126
19902,950210,2021-02-05,0.12195121951219512,32800,32800,0,41481126
19903,950210,2021-02-05,0.12195121951219512,32800,32800,0,41481126
19904,950210,2021-02-05,0.12195121951219512,32800,32800,0,41481126
19905,950210,2021-02-05,0.12195121951219512,32800,32800,0,41481126
19906,950210,2021-02-05,0.12195121951219512,32800,32800,0,41481126
19907,950210,2021-02-05,0.12195121951219512,32800,32800,0,41481126
19908,950210,2021-02-05,0.12195121951219512,32800,32800,0,41481126
19909,950210,2021-02-05,0.12195121951219512,32800,32800,0,41481126
19910,950210,2021-02-05,0.12195121951219512,32800,32800,0,41481126
19911,950210,2021-02-05,0.12195121951219512,32800,32800,0,41481126
19912,950210,2021-02-05,0.12195121951219512,32800,32800,0,41481126
19913,950210,2021-02-05,0.12195121951219512,32800,32800,0,41481126
19914,950210,2021-02-05,0.12195121951219512,32800,32800,0,41481126
19915,950210,2021-02-05,0.12195121951219512,32800,32800,0,41481126
19916,285130,2021-05-28,0.043209876543209874,243000,253500,10500,125704
19917,285130,2021-05-11,0.04570383912248629,273500,261000,-12500,179179
19918,285130,2021-05-10,0.07045009784735812,255500,273500,18000,235802
19919,285130,2021-05-03,0.043151969981238276,266500,255000,-11500,123618
19920,285130,2021-04-29,0.05799648506151142,284500,268000,-16500,208925
19921,285130,2021-04-13,0.04743833017077799,263500,276000,12500,259622
19922,285130,2021-03-29,0.04259259259259259,270000,258500,-11500,200517
19923,285130,2021-03-22,0.05172413793103448,290000,275000,-15000,230856
19924,285130,2021-03-18,0.05345911949685535,318000,301000,-17000,790297
19925,285130,2021-03-17,0.06354515050167224,299000,318000,19000,483452
19926,285130,2021-03-12,0.10766423357664233,274000,303500,29500,732942
19927,285130,2021-03-08,0.06349206349206349,315000,295000,-20000,401971
19928,285130,2021-03-04,0.09077809798270893,347000,315500,-31500,612052
19929,285130,2021-03-03,0.0506155950752394,365500,347000,-18500,357299
19930,285130,2021-02-24,0.0504774897680764,366500,385000,18500,404266
19931,285130,2021-02-05,0.045146726862302484,443000,423000,-20000,434042
19932,285130,2021-02-04,0.04216216216216216,462500,443000,-19500,450130
19933,285130,2021-02-03,0.06199770378874857,435500,462500,27000,728044
19934,285130,2021-02-01,0.043942992874109264,421000,439500,18500,448340
19935,285130,2021-01-27,0.06143344709897611,439500,412500,-27000,655780
19936,285130,2021-01-26,0.06159420289855073,414000,439500,25500,899309
19937,285130,2021-01-21,0.062103929024081114,394500,419000,24500,888682
19938,285130,2021-01-19,0.0425531914893617,376000,392000,16000,417839
19939,285130,2021-01-18,0.07582260371959942,349500,376000,26500,427722
19940,285130,2021-01-11,0.049738219895287955,382000,363000,-19000,384141
19941,285130,2020-12-29,0.062169312169312166,378000,401500,23500,467380
19942,285130,2020-12-22,0.04466501240694789,403000,385000,-18000,266611
19943,285130,2020-12-21,0.04404145077720207,386000,403000,17000,392881
19944,285130,2020-11-27,0.04326923076923077,416000,434000,18000,594712
19945,285130,2020-11-24,0.0467706013363029,449000,428000,-21000,754292
19946,285130,2020-11-17,0.06,400000,424000,24000,664607
19947,285130,2020-11-11,0.1118421052631579,456000,405000,-51000,1069027
19948,285130,2020-11-09,0.09902200488997555,409000,449500,40500,1174964
19949,285130,2020-11-06,0.05006418485237484,389500,409000,19500,761451
19950,285130,2020-11-04,0.06666666666666667,367500,392000,24500,1426522
19951,285130,2020-11-03,0.05755395683453238,347500,367500,20000,619658
19952,285130,2020-10-30,0.046831955922865015,363000,346000,-17000,471613
19953,285130,2020-10-29,0.049132947976878616,346000,363000,17000,669231
19954,285130,2020-10-26,0.06200317965023847,314500,334000,19500,354130
19955,285130,2020-10-22,0.04984423676012461,321000,305000,-16000,357574
19956,285130,2020-10-20,0.05014749262536873,339000,322000,-17000,425894
19957,285130,2020-10-08,0.10969793322734499,314500,349000,34500,1014851
19958,285130,2020-10-06,0.051839464882943144,299000,314500,15500,486515
19959,285130,2020-09-25,0.09454545454545454,275000,301000,26000,1411032
19960,285130,2020-09-24,0.09688013136288999,304500,275000,-29500,486279
19961,285130,2020-09-21,0.06083086053412463,337000,316500,-20500,462444
19962,285130,2020-09-16,0.04264099037138927,363500,348000,-15500,415796
19963,285130,2020-09-15,0.05057803468208093,346000,363500,17500,580159
19964,285130,2020-09-10,0.0880503144654088,318000,346000,28000,1292176
19965,285130,2020-09-09,0.1417004048582996,370500,318000,-52500,2385330
19966,285130,2020-09-08,0.05964467005076142,394000,370500,-23500,623076
19967,285130,2020-09-01,0.054637865311308764,393500,415000,21500,817082
19968,285130,2020-08-25,0.04125,400000,416500,16500,669755
19969,285130,2020-08-19,0.0870712401055409,379000,412000,33000,803137
19970,285130,2020-08-14,0.11467889908256881,436000,386000,-50000,1935908
19971,285130,2020-08-13,0.09,400000,436000,36000,1138610
19972,285130,2020-08-10,0.18436578171091444,339000,401500,62500,1815181
19973,285130,2020-08-07,0.06103286384976526,319500,339000,19500,734159
19974,285130,2020-08-06,0.047540983606557376,305000,319500,14500,540379
19975,285130,2020-08-04,0.11317254174397032,269500,300000,30500,1078123
19976,285130,2020-07-29,0.08205128205128205,292500,268500,-24000,1080186
19977,285130,2020-07-28,0.056451612903225805,310000,292500,-17500,1216222
19978,285130,2020-07-27,0.1051693404634581,280500,310000,29500,4637109
19979,285130,2020-07-24,0.1761006289308176,238500,280500,42000,6873909
19980,285130,2020-07-22,0.29971988795518206,178500,232000,53500,1309454
19981,285130,2020-07-20,0.08536585365853659,164000,178000,14000,922880
19982,285130,2020-07-16,0.07333333333333333,150000,161000,11000,975817
19983,285130,2020-07-14,0.10676156583629894,140500,155500,15000,1177114
19984,285130,2020-07-08,0.09765625,128000,140500,12500,1878961
19985,285130,2020-07-06,0.043478260869565216,126500,132000,5500,1137795
19986,285130,2020-07-02,0.0959409594095941,135500,122500,-13000,2187130
19987,285130,2020-07-01,0.054474708171206226,128500,135500,7000,3010097
19988,285130,2020-06-30,0.04460966542750929,134500,128500,-6000,2028840
19989,285130,2020-06-29,0.21171171171171171,111000,134500,23500,5360032
19990,285130,2020-06-25,0.11219512195121951,102500,114000,11500,3681847
19991,285130,2020-06-24,0.041666666666666664,98400,102500,4100,610400
19992,285130,2020-06-09,0.044538706256627786,94300,98500,4200,1086667
19993,285130,2020-05-19,0.08446601941747572,103000,94300,-8700,2199858
19994,285130,2020-05-18,0.05641025641025641,97500,103000,5500,2254397
19995,285130,2020-05-14,0.1791044776119403,80400,94800,14400,3158161
19996,285130,2020-05-11,0.04150943396226415,79500,82800,3300,552022
19997,285130,2020-03-30,0.13671875,76800,87300,10500,2335832
19998,285130,2020-03-27,0.07262569832402235,71600,76800,5200,2278529
19999,285130,2020-03-26,0.10493827160493827,64800,71600,6800,1866931
20000,285130,2020-03-20,0.10758377425044091,56700,62800,6100,424212
20001,285130,2020-03-19,0.1181959564541213,64300,56700,-7600,1574817
20002,285130,2020-03-18,0.054098360655737705,61000,64300,3300,1223796
20003,285130,2020-03-17,0.12338858195211787,54300,61000,6700,550501
20004,285130,2020-03-13,0.07894736842105263,57000,52500,-4500,218260
20005,285130,2020-03-12,0.048414023372287146,59900,57000,-2900,159829
20006,285130,2020-03-09,0.057755775577557754,60600,64100,3500,431940
20007,285130,2020-03-02,0.043478260869565216,57500,60000,2500,116300
20008,285130,2020-02-28,0.04326123128119801,60100,57500,-2600,161829
20009,285130,2020-02-24,0.05216095380029806,67100,63600,-3500,137040
20010,285130,2020-02-06,0.04640718562874251,66800,69900,3100,446990
20011,285130,2020-02-05,0.11705685618729098,59800,66800,7000,1942745
20012,285130,2020-01-31,0.04455445544554455,60600,57900,-2700,211945
20013,285130,2020-01-10,0.059907834101382486,65100,69000,3900,1292254
20014,285130,2020-01-08,0.041033434650455926,65800,63100,-2700,312351
20015,285130,2020-01-02,0.0421875,64000,66700,2700,450033
20016,285130,2019-12-02,0.04843304843304843,70200,66800,-3400,1883645
20017,285130,2019-11-29,0.09067357512953368,77200,70200,-7000,1593104
20018,285130,2019-11-28,0.051771117166212535,73400,77200,3800,5391611
20019,285130,2019-11-27,0.2991150442477876,56500,73400,16900,1392774
20020,285130,2019-11-25,0.04963235294117647,54400,57100,2700,422223
20021,285130,2019-11-22,0.044145873320537425,52100,54400,2300,975850
20022,285130,2019-11-04,0.06932773109243698,47600,50900,3300,91704
20023,285130,2019-09-16,0.046789989118607184,45950,48100,2150,54625
20024,285130,2019-09-10,0.05057471264367816,43500,45700,2200,40872
20025,285130,2019-07-08,0.04114490161001789,55900,53600,-2300,50199
20026,285130,2019-03-04,0.048846675712347354,73700,77300,3600,79816
20027,285130,2019-02-08,0.059880239520958084,66800,70800,4000,143940
20028,285130,2018-12-12,0.045779685264663805,69900,73100,3200,47003
20029,285130,2018-11-21,0.06868131868131869,72800,77800,5000,151742
20030,285130,2018-11-08,0.08359133126934984,64600,70000,5400,138227
20031,285130,2018-11-02,0.06085526315789474,60800,64500,3700,55085
20032,285130,2018-10-29,0.08661417322834646,63500,58000,-5500,135853
20033,285130,2018-10-10,0.05670103092783505,77600,73200,-4400,114986
20034,285130,2018-06-19,0.046236559139784944,93000,88700,-4300,91730
20035,285130,2018-06-15,0.0570801317233809,91100,96300,5200,212308
20036,285130,2018-05-29,0.041128084606345476,85100,88600,3500,155374
20037,285130,2018-03-23,0.049773755656108594,110500,105000,-5500,89177
20038,285130,2018-02-19,0.04285714285714286,105000,109500,4500,118500
20039,285130,2018-02-05,0.05963302752293578,109000,102500,-6500,135075
20040,285130,2018-01-17,0.0625,120000,112500,-7500,226037
20041,285130,2018-01-09,0.1485148514851485,101000,116000,15000,782363
20042,285130,2018-01-08,0.06046511627906977,107500,101000,-6500,533640
20043,285130,2018-01-17,0.0625,120000,112500,-7500,226037
20044,285130,2018-01-09,0.1485148514851485,101000,116000,15000,782363
20045,285130,2018-01-08,0.06046511627906977,107500,101000,-6500,533640
20046,285130,2018-01-17,0.0625,120000,112500,-7500,226037
20047,285130,2018-01-09,0.1485148514851485,101000,116000,15000,782363
20048,285130,2018-01-08,0.06046511627906977,107500,101000,-6500,533640
20049,285130,2018-01-17,0.0625,120000,112500,-7500,226037
20050,285130,2018-01-09,0.1485148514851485,101000,116000,15000,782363
20051,285130,2018-01-08,0.06046511627906977,107500,101000,-6500,533640
20052,285130,2018-01-17,0.0625,120000,112500,-7500,226037
20053,285130,2018-01-09,0.1485148514851485,101000,116000,15000,782363
20054,285130,2018-01-08,0.06046511627906977,107500,101000,-6500,533640
20055,285130,2018-01-17,0.0625,120000,112500,-7500,226037
20056,285130,2018-01-09,0.1485148514851485,101000,116000,15000,782363
20057,285130,2018-01-08,0.06046511627906977,107500,101000,-6500,533640
20058,285130,2018-01-17,0.0625,120000,112500,-7500,226037
20059,285130,2018-01-09,0.1485148514851485,101000,116000,15000,782363
20060,285130,2018-01-08,0.06046511627906977,107500,101000,-6500,533640
20061,285130,2018-01-17,0.0625,120000,112500,-7500,226037
20062,285130,2018-01-09,0.1485148514851485,101000,116000,15000,782363
20063,285130,2018-01-08,0.06046511627906977,107500,101000,-6500,533640
20064,285130,2018-01-17,0.0625,120000,112500,-7500,226037
20065,285130,2018-01-09,0.1485148514851485,101000,116000,15000,782363
20066,285130,2018-01-08,0.06046511627906977,107500,101000,-6500,533640
20067,285130,2018-01-17,0.0625,120000,112500,-7500,226037
20068,285130,2018-01-09,0.1485148514851485,101000,116000,15000,782363
20069,285130,2018-01-08,0.06046511627906977,107500,101000,-6500,533640
20070,285130,2018-01-17,0.0625,120000,112500,-7500,226037
20071,285130,2018-01-09,0.1485148514851485,101000,116000,15000,782363
20072,285130,2018-01-08,0.06046511627906977,107500,101000,-6500,533640
20073,285130,2018-01-17,0.0625,120000,112500,-7500,226037
20074,285130,2018-01-09,0.1485148514851485,101000,116000,15000,782363
20075,285130,2018-01-08,0.06046511627906977,107500,101000,-6500,533640
20076,285130,2018-01-17,0.0625,120000,112500,-7500,226037
20077,285130,2018-01-09,0.1485148514851485,101000,116000,15000,782363
20078,285130,2018-01-08,0.06046511627906977,107500,101000,-6500,533640
20079,285130,2018-01-17,0.0625,120000,112500,-7500,226037
20080,285130,2018-01-09,0.1485148514851485,101000,116000,15000,782363
20081,285130,2018-01-08,0.06046511627906977,107500,101000,-6500,533640
20082,285130,2018-01-17,0.0625,120000,112500,-7500,226037
20083,285130,2018-01-09,0.1485148514851485,101000,116000,15000,782363
20084,285130,2018-01-08,0.06046511627906977,107500,101000,-6500,533640
20085,285130,2018-01-17,0.0625,120000,112500,-7500,226037
20086,285130,2018-01-09,0.1485148514851485,101000,116000,15000,782363
20087,285130,2018-01-08,0.06046511627906977,107500,101000,-6500,533640
20088,285130,2018-01-17,0.0625,120000,112500,-7500,226037
20089,285130,2018-01-09,0.1485148514851485,101000,116000,15000,782363
20090,285130,2018-01-08,0.06046511627906977,107500,101000,-6500,533640
20091,285130,2018-01-17,0.0625,120000,112500,-7500,226037
20092,285130,2018-01-09,0.1485148514851485,101000,116000,15000,782363
20093,285130,2018-01-08,0.06046511627906977,107500,101000,-6500,533640
20094,285130,2018-01-17,0.0625,120000,112500,-7500,226037
20095,285130,2018-01-09,0.1485148514851485,101000,116000,15000,782363
20096,285130,2018-01-08,0.06046511627906977,107500,101000,-6500,533640
20097,285130,2018-01-17,0.0625,120000,112500,-7500,226037
20098,285130,2018-01-09,0.1485148514851485,101000,116000,15000,782363
20099,285130,2018-01-08,0.06046511627906977,107500,101000,-6500,533640
20100,285130,2018-01-17,0.0625,120000,112500,-7500,226037
20101,285130,2018-01-09,0.1485148514851485,101000,116000,15000,782363
20102,285130,2018-01-08,0.06046511627906977,107500,101000,-6500,533640
20103,285130,2018-01-17,0.0625,120000,112500,-7500,226037
20104,285130,2018-01-09,0.1485148514851485,101000,116000,15000,782363
20105,285130,2018-01-08,0.06046511627906977,107500,101000,-6500,533640
20106,285130,2018-01-17,0.0625,120000,112500,-7500,226037
20107,285130,2018-01-09,0.1485148514851485,101000,116000,15000,782363
20108,285130,2018-01-08,0.06046511627906977,107500,101000,-6500,533640
20109,285130,2018-01-17,0.0625,120000,112500,-7500,226037
20110,285130,2018-01-09,0.1485148514851485,101000,116000,15000,782363
20111,285130,2018-01-08,0.06046511627906977,107500,101000,-6500,533640
20112,285130,2018-01-17,0.0625,120000,112500,-7500,226037
20113,285130,2018-01-09,0.1485148514851485,101000,116000,15000,782363
20114,285130,2018-01-08,0.06046511627906977,107500,101000,-6500,533640
20115,285130,2018-01-17,0.0625,120000,112500,-7500,226037
20116,285130,2018-01-09,0.1485148514851485,101000,116000,15000,782363
20117,285130,2018-01-08,0.06046511627906977,107500,101000,-6500,533640
20118,285130,2018-01-17,0.0625,120000,112500,-7500,226037
20119,285130,2018-01-09,0.1485148514851485,101000,116000,15000,782363
20120,285130,2018-01-08,0.06046511627906977,107500,101000,-6500,533640
20121,285130,2018-01-17,0.0625,120000,112500,-7500,226037
20122,285130,2018-01-09,0.1485148514851485,101000,116000,15000,782363
20123,285130,2018-01-08,0.06046511627906977,107500,101000,-6500,533640
20124,285130,2018-01-17,0.0625,120000,112500,-7500,226037
20125,285130,2018-01-09,0.1485148514851485,101000,116000,15000,782363
20126,285130,2018-01-08,0.06046511627906977,107500,101000,-6500,533640
20127,285130,2018-01-17,0.0625,120000,112500,-7500,226037
20128,285130,2018-01-09,0.1485148514851485,101000,116000,15000,782363
20129,285130,2018-01-08,0.06046511627906977,107500,101000,-6500,533640
20130,285130,2018-01-17,0.0625,120000,112500,-7500,226037
20131,285130,2018-01-09,0.1485148514851485,101000,116000,15000,782363
20132,285130,2018-01-08,0.06046511627906977,107500,101000,-6500,533640
20133,285130,2018-01-17,0.0625,120000,112500,-7500,226037
20134,285130,2018-01-09,0.1485148514851485,101000,116000,15000,782363
20135,285130,2018-01-08,0.06046511627906977,107500,101000,-6500,533640
20136,285130,2018-01-17,0.0625,120000,112500,-7500,226037
20137,285130,2018-01-09,0.1485148514851485,101000,116000,15000,782363
20138,285130,2018-01-08,0.06046511627906977,107500,101000,-6500,533640
20139,285130,2018-01-17,0.0625,120000,112500,-7500,226037
20140,285130,2018-01-09,0.1485148514851485,101000,116000,15000,782363
20141,285130,2018-01-08,0.06046511627906977,107500,101000,-6500,533640
20142,285130,2018-01-17,0.0625,120000,112500,-7500,226037
20143,285130,2018-01-09,0.1485148514851485,101000,116000,15000,782363
20144,285130,2018-01-08,0.06046511627906977,107500,101000,-6500,533640
20145,285130,2018-01-17,0.0625,120000,112500,-7500,226037
20146,285130,2018-01-09,0.1485148514851485,101000,116000,15000,782363
20147,285130,2018-01-08,0.06046511627906977,107500,101000,-6500,533640
20148,47050,2021-05-18,0.04883720930232558,21500,22550,1050,1007439
20149,47050,2021-05-12,0.04565217391304348,23000,21950,-1050,1879688
20150,47050,2021-05-04,0.04066985645933014,20900,21750,850,1481012
20151,47050,2021-04-30,0.056179775280898875,22250,21000,-1250,1644079
20152,47050,2021-04-27,0.06190476190476191,21000,22300,1300,3844090
20153,47050,2021-04-26,0.06060606060606061,19800,21000,1200,5735896
20154,47050,2021-03-30,0.0425,20000,20850,850,1114536
20155,47050,2021-03-25,0.05012531328320802,19950,20950,1000,1788181
20156,47050,2021-03-23,0.09492273730684327,22650,20500,-2150,4229806
20157,47050,2021-03-18,0.0659090909090909,22000,23450,1450,3250047
20158,47050,2021-02-25,0.056338028169014086,21300,22500,1200,1850466
20159,47050,2021-02-24,0.07592190889370933,23050,21300,-1750,2750876
20160,47050,2021-02-17,0.050808314087759814,21650,22750,1100,6991364
20161,47050,2021-02-15,0.04072398190045249,22100,21200,-900,1997078
20162,47050,2021-02-09,0.04319654427645788,23150,22150,-1000,3435084
20163,47050,2021-02-08,0.049886621315192746,22050,23150,1100,7315347
20164,47050,2021-02-04,0.17098445595854922,19300,22600,3300,18348535
20165,47050,2021-02-01,0.10909090909090909,16500,18300,1800,14003744
20166,47050,2021-01-22,0.05813953488372093,17200,16200,-1000,2655699
20167,47050,2021-01-21,0.12786885245901639,15250,17200,1950,6494009
20168,47050,2021-01-11,0.04416403785488959,15850,15150,-700,1790563
20169,47050,2021-01-07,0.08305647840531562,15050,16300,1250,3461515
20170,47050,2020-12-29,0.04276315789473684,15200,14550,-650,957680
20171,47050,2020-12-11,0.054982817869415807,14550,15350,800,1877299
20172,47050,2020-10-26,0.04452054794520548,14600,13950,-650,400683
20173,47050,2020-10-21,0.07342657342657342,14300,15350,1050,1048983
20174,47050,2020-06-16,0.11678832116788321,13700,15300,1600,726010
20175,47050,2020-06-15,0.04529616724738676,14350,13700,-650,409164
20176,47050,2020-06-12,0.06514657980456026,15350,14350,-1000,592461
20177,47050,2020-05-29,0.06312292358803986,15050,16000,950,977981
20178,47050,2020-05-22,0.052980132450331126,15100,14300,-800,428478
20179,47050,2020-05-18,0.0683453237410072,13900,14850,950,696451
20180,47050,2020-04-13,0.04,13750,13200,-550,359188
20181,47050,2020-04-09,0.04887218045112782,13300,13950,650,537208
20182,47050,2020-04-07,0.046153846153846156,13000,13600,600,775056
20183,47050,2020-04-06,0.12554112554112554,11550,13000,1450,997539
20184,47050,2020-04-02,0.09345794392523364,10700,11700,1000,584551
20185,47050,2020-04-01,0.05726872246696035,11350,10700,-650,450457
20186,47050,2020-03-25,0.09508547008547008,9360,10250,890,843342
20187,47050,2020-03-24,0.07586206896551724,8700,9360,660,616264
20188,47050,2020-03-23,0.10585817060637205,9730,8700,-1030,659090
20189,47050,2020-03-20,0.0704070407040704,9090,9730,640,657286
20190,47050,2020-03-19,0.10443349753694581,10150,9090,-1060,1009767
20191,47050,2020-03-18,0.06451612903225806,10850,10150,-700,599194
20192,47050,2020-03-16,0.05063291139240506,11850,11250,-600,405830
20193,47050,2020-03-13,0.06324110671936758,12650,11850,-800,894262
20194,47050,2020-03-12,0.06985294117647059,13600,12650,-950,986916
20195,47050,2020-03-09,0.08333333333333333,15000,13750,-1250,856008
20196,47050,2020-02-28,0.04472843450479233,15650,14950,-700,970470
20197,47050,2020-02-07,0.06489675516224189,16950,18050,1100,915139
20198,47050,2019-09-16,0.042440318302387266,18850,19650,800,605522
20199,47050,2019-06-18,0.0463768115942029,17250,18050,800,402520
20200,47050,2019-01-09,0.058666666666666666,18750,19850,1100,536000
20201,47050,2019-01-07,0.05042016806722689,17850,18750,900,487843
20202,47050,2018-12-26,0.040214477211796246,18650,17900,-750,336645
20203,47050,2018-11-14,0.06905370843989769,19550,18200,-1350,897186
20204,47050,2018-11-06,0.06353591160220995,18100,19250,1150,561827
20205,47050,2018-11-02,0.05459770114942529,17400,18350,950,319421
20206,47050,2018-09-27,0.045,20000,20900,900,849797
20207,47050,2018-09-13,0.04450261780104712,19100,19950,850,795263
20208,47050,2018-09-07,0.044444444444444446,18000,18800,800,598896
20209,47050,2018-07-24,0.105,20000,17900,-2100,2471710
20210,47050,2018-07-02,0.0514018691588785,21400,20300,-1100,685133
20211,47050,2018-06-28,0.04714640198511166,20150,21100,950,879236
20212,47050,2018-06-19,0.041189931350114416,21850,20950,-900,764222
20213,47050,2018-06-18,0.056155507559395246,23150,21850,-1300,736666
20214,47050,2018-05-28,0.045454545454545456,23100,24150,1050,1197751
20215,47050,2018-05-25,0.043478260869565216,24150,23100,-1050,784200
20216,47050,2018-05-18,0.05122950819672131,24400,25650,1250,807603
20217,47050,2018-05-16,0.064453125,25600,23950,-1650,1100707
20218,47050,2018-05-14,0.09071274298056156,23150,25250,2100,2414406
20219,47050,2018-05-10,0.07482993197278912,22050,23700,1650,1129475
20220,47050,2018-04-25,0.058212058212058215,24050,22650,-1400,1003700
20221,47050,2018-04-10,0.060674157303370786,22250,23600,1350,770151
20222,47050,2018-03-26,0.04484304932735426,22300,23300,1000,974438
20223,47050,2018-03-22,0.05647058823529412,21250,22450,1200,1511605
20224,47050,2018-03-15,0.05764411027568922,19950,21100,1150,834715
20225,47050,2018-02-27,0.04225352112676056,21300,20400,-900,696773
20226,47050,2018-02-07,0.04139433551198257,22950,22000,-950,622208
20227,47050,2018-02-06,0.04375,24000,22950,-1050,907296
20228,47050,2018-01-25,0.12412177985948478,21350,24000,2650,3536944
20229,47050,2018-01-24,0.041463414634146344,20500,21350,850,623513
20230,47050,2018-01-12,0.04116222760290557,20650,21500,850,1050815
20231,47050,2018-01-11,0.04176334106728538,21550,20650,-900,863020
20232,47050,2018-01-10,0.06683168316831684,20200,21550,1350,1949546
20233,47050,2018-01-03,0.04,18750,19500,750,1116006
20234,47050,2017-11-15,0.041025641025641026,19500,18700,-800,1134941
20235,47050,2017-11-07,0.06565656565656566,19800,21100,1300,1558400
20236,47050,2017-10-25,0.04177545691906005,19150,19950,800,433052
20237,47050,2017-09-22,0.04156479217603912,20450,19600,-850,561648
20238,47050,2017-08-01,0.05531914893617021,23500,24800,1300,848933
20239,47050,2017-05-26,0.043824701195219126,25100,24000,-1100,978943
20240,47050,2017-05-25,0.08189655172413793,23200,25100,1900,1174217
20241,47050,2017-04-07,0.04121475054229935,23050,24000,950,496751
20242,47050,2017-03-31,0.05066079295154185,22700,23850,1150,665447
20243,47050,2017-01-31,0.048598130841121495,26750,25450,-1300,382895
20244,47050,2017-01-19,0.047619047619047616,28350,27000,-1350,504928
20245,47050,2017-01-11,0.04220183486238532,27250,28400,1150,250675
20246,47050,2016-12-12,0.04918032786885246,27450,28800,1350,434195
20247,47050,2016-12-08,0.07074569789674952,26150,28000,1850,398191
20248,47050,2016-11-24,0.040968342644320296,26850,25750,-1100,218115
20249,47050,2016-11-16,0.06679764243614932,25450,27150,1700,655391
20250,47050,2016-11-10,0.0502092050209205,23900,25100,1200,439405
20251,47050,2016-11-07,0.04883227176220807,23550,24700,1150,233641
20252,47050,2016-11-01,0.052104208416833664,24950,23650,-1300,351705
20253,47050,2016-10-27,0.04174573055028463,26350,25250,-1100,508162
20254,47050,2016-10-11,0.04930966469428008,25350,26600,1250,557650
20255,47050,2016-09-29,0.1261061946902655,22600,25450,2850,1391762
20256,47050,2016-09-12,0.04439746300211417,23650,22600,-1050,164367
20257,47050,2016-08-19,0.04956896551724138,23200,24350,1150,528889
20258,47050,2016-08-03,0.051224944320712694,22450,21300,-1150,529312
20259,11210,2021-05-28,0.08443271767810026,75800,82200,6400,1229949
20260,11210,2021-05-21,0.06258148631029987,76700,81500,4800,969352
20261,11210,2021-05-12,0.06429548563611491,73100,77800,4700,1559659
20262,11210,2021-05-10,0.04341736694677871,71400,74500,3100,468638
20263,11210,2021-04-02,0.06443298969072164,77600,82600,5000,849489
20264,11210,2021-02-24,0.06432038834951456,82400,77100,-5300,586168
20265,11210,2021-02-22,0.04252873563218391,87000,83300,-3700,426649
20266,11210,2021-02-10,0.057208237986270026,87400,92400,5000,709467
20267,11210,2021-02-08,0.1190233977619532,98300,86600,-11700,1495947
20268,11210,2021-02-04,0.056485355648535567,95600,101000,5400,1605112
20269,11210,2021-02-03,0.043668122270742356,91600,95600,4000,1780767
20270,11210,2021-01-27,0.04904904904904905,99900,95000,-4900,1428676
20271,11210,2021-01-26,0.05308056872037915,105500,99900,-5600,1101172
20272,11210,2021-01-21,0.1780673181324647,92100,108500,16400,3863251
20273,11210,2021-01-19,0.05601907032181168,83900,88600,4700,3599250
20274,11210,2021-01-18,0.11420982735723771,75300,83900,8600,5609212
20275,11210,2021-01-15,0.04924242424242424,79200,75300,-3900,848657
20276,11210,2021-01-14,0.04116222760290557,82600,79200,-3400,898883
20277,11210,2021-01-08,0.2132768361581921,70800,85900,15100,8843690
20278,11210,2021-01-06,0.040446304044630406,71700,68800,-2900,1318030
20279,11210,2021-01-04,0.29906542056074764,53500,69500,16000,4951540
20280,11210,2020-12-30,0.1192468619246862,47800,53500,5700,1727577
20281,11210,2020-10-30,0.05649717514124294,44250,41750,-2500,374747
20282,11210,2020-10-28,0.04423748544819558,42950,44850,1900,598313
20283,11210,2020-10-05,0.06666666666666667,40500,43200,2700,337815
20284,11210,2020-09-24,0.045949214026602174,41350,39450,-1900,216719
20285,11210,2020-09-14,0.05555555555555555,40500,42750,2250,344917
20286,11210,2020-08-20,0.06451612903225806,41850,39150,-2700,388556
20287,11210,2020-08-18,0.08426966292134831,44500,40750,-3750,495363
20288,11210,2020-08-12,0.06864988558352403,43700,46700,3000,1877843
20289,11210,2020-08-10,0.09242618741976893,38950,42550,3600,1214628
20290,11210,2020-08-06,0.042105263157894736,38000,39600,1600,520257
20291,11210,2020-07-13,0.12885154061624648,35700,40300,4600,670976
20292,11210,2020-07-06,0.06502890173410404,34600,36850,2250,189470
20293,11210,2020-06-16,0.07894736842105263,34200,36900,2700,153133
20294,11210,2020-06-15,0.08921438082556592,37550,34200,-3350,261868
20295,11210,2020-06-05,0.046094750320102434,39050,40850,1800,321145
20296,11210,2020-05-22,0.04217687074829932,36750,35200,-1550,223346
20297,11210,2020-05-19,0.14596273291925466,32200,36900,4700,1058186
20298,11210,2020-05-08,0.06729264475743349,31950,34100,2150,341473
20299,11210,2020-04-13,0.055873925501432664,34900,32950,-1950,266801
20300,11210,2020-04-09,0.13934426229508196,30500,34750,4250,644704
20301,11210,2020-04-07,0.06806282722513089,28650,30600,1950,344802
20302,11210,2020-04-06,0.08522727272727272,26400,28650,2250,330070
20303,11210,2020-03-31,0.046875,25600,26800,1200,239403
20304,11210,2020-03-25,0.13260869565217392,23000,26050,3050,414878
20305,11210,2020-03-24,0.12195121951219512,20500,23000,2500,252348
20306,11210,2020-03-23,0.1276595744680851,23500,20500,-3000,264304
20307,11210,2020-03-20,0.1491442542787286,20450,23500,3050,369544
20308,11210,2020-03-19,0.1670061099796334,24550,20450,-4100,461642
20309,11210,2020-03-18,0.09074074074074075,27000,24550,-2450,306466
20310,11210,2020-03-13,0.051580698835274545,30050,28500,-1550,407060
20311,11210,2020-03-12,0.07109737248840804,32350,30050,-2300,347983
20312,11210,2020-03-09,0.06164383561643835,36500,34250,-2250,283430
20313,11210,2020-03-06,0.054404145077720206,38600,36500,-2100,290861
20314,11210,2020-02-28,0.043532338308457715,40200,38450,-1750,167769
20315,11210,2020-02-24,0.043942992874109264,42100,40250,-1850,144100
20316,11210,2020-02-06,0.04806565064478312,42650,44700,2050,230071
20317,11210,2020-01-31,0.06030701754385965,45600,42850,-2750,540621
20318,11210,2020-01-30,0.06843718079673136,48950,45600,-3350,470032
20319,11210,2020-01-29,0.07815442561205273,53100,48950,-4150,699813
20320,11210,2020-01-22,0.07581967213114754,48800,52500,3700,360963
20321,11210,2020-01-17,0.044466403162055336,50600,48350,-2250,187344
20322,11210,2020-01-16,0.06079664570230608,47700,50600,2900,220929
20323,11210,2020-01-09,0.0670391061452514,44750,47750,3000,180348
20324,11210,2019-12-30,0.04041450777202073,48250,50200,1950,79304
20325,11210,2019-11-12,0.060665362035225046,51100,54200,3100,274654
20326,11210,2019-10-28,0.040923399790136414,47650,49600,1950,355658
20327,11210,2019-10-25,0.08049886621315193,44100,47650,3550,329451
20328,11210,2019-10-04,0.07091469681397738,48650,45200,-3450,286761
20329,11210,2019-09-04,0.0625,44000,46750,2750,289095
20330,11210,2019-08-28,0.05030674846625767,40750,42800,2050,258610
20331,11210,2019-07-29,0.09071949947862357,47950,43600,-4350,460556
20332,11210,2019-07-26,0.05610236220472441,50800,47950,-2850,450016
20333,11210,2019-07-04,0.05844155844155844,46200,48900,2700,213303
20334,11210,2019-06-27,0.04180064308681672,46650,48600,1950,141567
20335,11210,2019-06-18,0.0400890868596882,44900,46700,1800,124014
20336,11210,2019-06-10,0.059788980070339975,42650,45200,2550,258965
20337,11210,2019-06-07,0.044063647490820076,40850,42650,1800,202504
20338,11210,2019-05-31,0.06777645659928656,42050,39200,-2850,400535
20339,11210,2019-05-03,0.05220883534136546,49800,47200,-2600,275719
20340,11210,2019-04-29,0.08836206896551724,46400,50500,4100,399501
20341,11210,2019-04-26,0.04329896907216495,48500,46400,-2100,425750
20342,11210,2019-04-08,0.060175054704595186,45700,48450,2750,471588
20343,11210,2019-04-05,0.05909617612977984,43150,45700,2550,273889
20344,11210,2019-04-01,0.04691358024691358,40500,42400,1900,120629
20345,11210,2019-03-18,0.0471584038694075,41350,43300,1950,123561
20346,11210,2019-02-25,0.07965686274509803,40800,44050,3250,705201
20347,11210,2019-01-23,0.0488997555012225,40900,42900,2000,223871
20348,11210,2019-01-18,0.04955527318932656,39350,41300,1950,214611
20349,11210,2019-01-04,0.05702364394993046,35950,38000,2050,180810
20350,11210,2018-12-12,0.07963246554364471,32650,35250,2600,492897
20351,11210,2018-11-27,0.06482982171799027,30850,32850,2000,271786
20352,11210,2018-11-22,0.06790123456790123,32400,30200,-2200,221256
20353,11210,2018-11-07,0.06948640483383686,33100,30800,-2300,341745
20354,11210,2018-11-06,0.08881578947368421,30400,33100,2700,506172
20355,11210,2018-10-29,0.11127819548872181,33250,29550,-3700,550028
20356,11210,2018-10-25,0.07222222222222222,36000,33400,-2600,345702
20357,11210,2018-10-18,0.056074766355140186,37450,35350,-2100,266428
20358,11210,2018-10-11,0.047619047619047616,38850,37000,-1850,244864
20359,11210,2018-10-04,0.04886769964243146,41950,39900,-2050,248910
20360,11210,2018-08-28,0.06315789473684211,42750,45450,2700,426402
20361,11210,2018-08-21,0.040169133192389,47300,45400,-1900,192849
20362,11210,2018-08-06,0.04065934065934066,45500,47350,1850,251287
20363,11210,2018-07-31,0.06200676437429538,44350,47100,2750,415738
20364,11210,2018-07-30,0.05344418052256532,42100,44350,2250,241654
20365,11210,2018-07-27,0.04318181818181818,44000,42100,-1900,608880
20366,11210,2018-07-26,0.06796116504854369,41200,44000,2800,376082
20367,11210,2018-07-17,0.05060240963855422,41500,43600,2100,241039
20368,11210,2018-07-06,0.06510416666666667,38400,40900,2500,334491
20369,11210,2018-07-04,0.041561712846347604,39700,38050,-1650,236391
20370,11210,2018-05-03,0.04158790170132325,52900,55100,2200,541668
20371,11210,2018-04-04,0.04371584699453552,54900,57300,2400,327710
20372,11210,2018-03-29,0.05172413793103448,58000,55000,-3000,294472
20373,11210,2018-03-02,0.043029259896729774,58100,55600,-2500,208786
20374,11210,2018-01-26,0.061933534743202415,66200,62100,-4100,786447
20375,11210,2017-12-11,0.04608294930875576,65100,62100,-3000,301452
20376,11210,2017-11-13,0.06018518518518518,64800,68700,3900,483317
20377,11210,2017-10-30,0.07971014492753623,69000,63500,-5500,601536
20378,11210,2017-10-26,0.06069802731411229,65900,69900,4000,413445
20379,11210,2017-09-28,0.04054054054054054,66600,63900,-2700,330006
20380,11210,2017-09-26,0.07590759075907591,60600,65200,4600,326166
20381,11210,2017-09-15,0.047058823529411764,59500,62300,2800,336226
20382,11210,2017-09-08,0.07088989441930618,66300,61600,-4700,742237
20383,11210,2017-08-04,0.04178272980501393,71800,74800,3000,502071
20384,11210,2017-06-14,0.051094890510948905,68500,72000,3500,803395
20385,11210,2017-03-22,0.043010752688172046,74400,71200,-3200,396980
20386,11210,2017-03-21,0.09251101321585903,68100,74400,6300,736913
20387,11210,2017-02-14,0.042993630573248405,62800,65500,2700,390283
20388,11210,2017-01-31,0.06782106782106782,69300,64600,-4700,619221
20389,11210,2017-01-18,0.05548216644649934,75700,79900,4200,374969
20390,11210,2017-01-03,0.05121293800539083,74200,78000,3800,299328
20391,11210,2016-12-08,0.0689149560117302,68200,72900,4700,242455
20392,11210,2016-11-10,0.04825737265415549,74600,71000,-3600,395801
20393,11210,2016-11-09,0.04358974358974359,78000,74600,-3400,255223
20394,11210,2016-10-31,0.05748502994011976,83500,78700,-4800,339527
20395,11210,2016-08-30,0.04664391353811149,87900,92000,4100,267965
20396,11210,2016-08-24,0.04316546762589928,83400,87000,3600,171561
20397,12750,2020-08-20,0.043,100000,95700,-4300,67150
20398,12750,2020-08-18,0.05102040816326531,98000,103000,5000,74043
20399,12750,2020-08-11,0.05771365149833518,90100,95300,5200,76888
20400,12750,2020-07-29,0.07692307692307693,85800,92400,6600,172587
20401,12750,2020-06-25,0.04509582863585118,88700,84700,-4000,68787
20402,12750,2020-06-16,0.06610576923076923,83200,88700,5500,51894
20403,12750,2020-06-15,0.05131128848346636,87700,83200,-4500,58438
20404,12750,2020-05-29,0.06029579067121729,87900,93200,5300,111196
20405,12750,2020-05-13,0.050808314087759814,86600,91000,4400,82898
20406,12750,2020-04-06,0.06615776081424936,78600,83800,5200,85470
20407,12750,2020-04-01,0.05375,80000,75700,-4300,85399
20408,12750,2020-03-25,0.06701708278580815,76100,81200,5100,123635
20409,12750,2020-03-23,0.12559241706161137,84400,73800,-10600,103901
20410,12750,2019-05-07,0.04004004004004004,99900,95900,-4000,127517
20411,12750,2018-10-31,0.04777415852334419,92100,96500,4400,116126
20412,12750,2018-10-11,0.0435244161358811,94200,90100,-4100,104368
20413,12750,2018-07-27,0.10412371134020619,97000,86900,-10100,234287
20414,12750,2018-06-18,0.06559139784946237,93000,99100,6100,127672
20415,12750,2018-06-01,0.04072398190045249,88400,92000,3600,56267
20416,12750,2018-03-09,0.04008667388949079,92300,96000,3700,99571
20417,12750,2018-01-03,0.04225352112676056,106500,102000,-4500,83000
20418,12750,2017-12-28,0.0594059405940594,101000,107000,6000,126130
20419,12750,2017-12-27,0.051643192488262914,106500,101000,-5500,96767
20420,12750,2017-12-15,0.04,100000,104000,4000,88272
20421,12750,2017-11-28,0.046632124352331605,96500,101000,4500,176688
20422,12750,2017-11-20,0.04855371900826446,96800,101500,4700,157325
20423,12750,2017-11-03,0.05043859649122807,91200,95800,4600,148107
20424,12750,2017-07-31,0.06585612968591692,98700,92200,-6500,134899
20425,12750,2017-05-12,0.0430622009569378,104500,100000,-4500,68536
20426,12750,2017-02-10,0.054958183990442055,83700,88300,4600,149383
20427,12750,2016-09-27,0.05130784708249497,99400,104500,5100,64831
20428,181710,2020-09-04,0.06225165562913907,75500,80200,4700,683908
20429,181710,2020-08-20,0.06201550387596899,77400,72600,-4800,265370
20430,181710,2020-08-07,0.05942857142857143,87500,82300,-5200,436108
20431,181710,2020-07-07,0.04196642685851319,83400,86900,3500,216417
20432,181710,2020-06-25,0.045146726862302484,88600,84600,-4000,143789
20433,181710,2020-06-23,0.05411764705882353,85000,89600,4600,330077
20434,181710,2020-06-15,0.06141367323290846,86300,81000,-5300,139999
20435,181710,2020-05-20,0.04929577464788732,85200,89400,4200,287855
20436,181710,2020-05-19,0.04054054054054054,88800,85200,-3600,498364
20437,181710,2020-05-18,0.04,92500,88800,-3700,232136
20438,181710,2020-05-11,0.06265060240963856,83000,88200,5200,355552
20439,181710,2020-04-16,0.06169296987087518,69700,74000,4300,173208
20440,181710,2020-03-31,0.0770440251572327,63600,68500,4900,200132
20441,181710,2020-03-30,0.046052631578947366,60800,63600,2800,104766
20442,181710,2020-03-25,0.044481054365733116,60700,63400,2700,84185
20443,181710,2020-03-24,0.10564663023679417,54900,60700,5800,133344
20444,181710,2020-03-23,0.08193979933110368,59800,54900,-4900,98169
20445,181710,2020-03-20,0.08727272727272728,55000,59800,4800,125559
20446,181710,2020-03-19,0.0802675585284281,59800,55000,-4800,212311
20447,181710,2020-03-18,0.07430340557275542,64600,59800,-4800,100630
20448,181710,2020-03-12,0.056338028169014086,71000,67000,-4000,144787
20449,181710,2020-03-11,0.0456989247311828,74400,71000,-3400,97870
20450,181710,2020-03-04,0.04564315352697095,72300,75600,3300,96428
20451,181710,2020-03-02,0.054519368723098996,69700,73500,3800,128605
20452,181710,2020-02-28,0.04911323328785812,73300,69700,-3600,104986
20453,181710,2020-02-04,0.04249667994687915,75300,78500,3200,85336
20454,181710,2020-01-29,0.044654939106901215,73900,77200,3300,134959
20455,181710,2020-01-10,0.08272859216255443,68900,74600,5700,307556
20456,181710,2020-01-09,0.0487062404870624,65700,68900,3200,148280
20457,181710,2019-11-27,0.05705229793977813,63100,66700,3600,187687
20458,181710,2019-08-08,0.053156146179401995,60200,63400,3200,114026
20459,181710,2019-08-05,0.04411764705882353,61200,58500,-2700,136014
20460,181710,2019-07-19,0.04094488188976378,63500,66100,2600,131433
20461,181710,2019-07-08,0.04217687074829932,73500,70400,-3100,158812
20462,181710,2019-07-05,0.05,70000,73500,3500,281666
20463,181710,2019-07-01,0.0646830530401035,77300,72300,-5000,224584
20464,181710,2019-06-27,0.04040404040404041,79200,76000,-3200,157201
20465,181710,2019-06-26,0.04463208685162847,82900,79200,-3700,152135
20466,181710,2019-06-18,0.05296343001261034,79300,83500,4200,185623
20467,181710,2019-06-10,0.04946524064171123,74800,78500,3700,91579
20468,181710,2019-05-02,0.0988095238095238,84000,75700,-8300,410580
20469,181710,2019-04-16,0.057432432432432436,88800,83700,-5100,192340
20470,181710,2019-03-26,0.04101326899879373,82900,86300,3400,155682
20471,181710,2019-03-19,0.04022346368715084,89500,85900,-3600,190585
20472,181710,2019-03-18,0.040697674418604654,86000,89500,3500,164144
20473,181710,2019-03-11,0.0580964153275649,80900,85600,4700,352597
20474,181710,2019-03-04,0.05405405405405406,74000,78000,4000,127176
20475,181710,2019-02-14,0.11956521739130435,64400,72100,7700,673236
20476,181710,2019-02-11,0.05029585798816568,67600,64200,-3400,122927
20477,181710,2019-02-01,0.1440677966101695,59000,67500,8500,624458
20478,181710,2019-01-07,0.05457746478873239,56800,59900,3100,110672
20479,181710,2018-11-21,0.05137614678899083,54500,57300,2800,66142
20480,181710,2018-11-12,0.04154002026342452,49350,51400,2050,130321
20481,181710,2018-11-08,0.04715969989281887,46650,48850,2200,52162
20482,181710,2018-10-30,0.054245283018867926,42400,44700,2300,140085
20483,181710,2018-10-29,0.06813186813186813,45500,42400,-3100,127985
20484,181710,2018-10-26,0.05405405405405406,48100,45500,-2600,146405
20485,181710,2018-10-11,0.05565217391304348,57500,54300,-3200,162203
20486,181710,2018-08-13,0.04141104294478527,65200,62500,-2700,84062
20487,181710,2018-08-09,0.06825396825396825,63000,67300,4300,145946
20488,181710,2018-06-15,0.05202312138728324,69200,65600,-3600,125908
20489,181710,2018-05-11,0.06666666666666667,60000,64000,4000,476267
20490,181710,2018-03-16,0.04090267983074753,70900,68000,-2900,269443
20491,181710,2018-03-07,0.04648074369189907,75300,71800,-3500,174626
20492,181710,2018-01-25,0.043256997455470736,78600,82000,3400,227971
20493,181710,2018-01-16,0.052269601100412656,72700,76500,3800,259758
20494,181710,2018-01-11,0.05934718100890208,67400,71400,4000,240956
20495,181710,2017-12-27,0.08823529411764706,64600,70300,5700,185816
20496,181710,2017-12-06,0.04437869822485207,67600,64600,-3000,121353
20497,181710,2017-11-14,0.07352941176470588,68000,73000,5000,352324
20498,181710,2017-10-12,0.055232558139534885,68800,65000,-3800,252120
20499,181710,2017-09-26,0.04154302670623145,67400,70200,2800,132857
20500,181710,2017-09-20,0.052702702702702706,74000,70100,-3900,191417
20501,181710,2017-08-16,0.042071197411003236,61800,64400,2600,271793
20502,181710,2017-08-11,0.14498644986449866,73800,63100,-10700,599641
20503,181710,2017-08-04,0.046357615894039736,75500,72000,-3500,135731
20504,181710,2017-07-26,0.049019607843137254,81600,77600,-4000,217113
20505,181710,2017-07-07,0.044063647490820076,81700,78100,-3600,115640
20506,181710,2017-06-19,0.056555269922879174,77800,82200,4400,349134
20507,181710,2017-05-15,0.05238095238095238,63000,66300,3300,188772
20508,181710,2017-03-21,0.04695652173913043,57500,60200,2700,160221
20509,181710,2017-02-22,0.05851063829787234,56400,59700,3300,208384
20510,181710,2017-02-13,0.04,57500,55200,-2300,249431
20511,181710,2017-01-31,0.0536779324055666,50300,53000,2700,168895
20512,181710,2016-12-28,0.04771784232365145,48200,50500,2300,83323
20513,181710,2016-10-17,0.04835924006908463,57900,55100,-2800,148878
20514,52690,2021-06-01,0.04475043029259897,58100,55500,-2600,1178800
20515,52690,2021-05-28,0.04107142857142857,56000,58300,2300,2747426
20516,52690,2021-05-26,0.16224814422057265,47150,54800,7650,3485082
20517,52690,2021-05-25,0.04069175991861648,49150,47150,-2000,998548
20518,52690,2021-05-21,0.05534351145038168,52400,49500,-2900,4542660
20519,52690,2021-05-20,0.13665943600867678,46100,52400,6300,2694663
20520,52690,2021-05-18,0.09892729439809297,41950,46100,4150,1592174
20521,52690,2021-05-17,0.046134663341645885,40100,41950,1850,745137
20522,52690,2021-05-13,0.05283505154639175,38800,40850,2050,2347306
20523,52690,2021-05-11,0.07832167832167833,35750,38550,2800,818610
20524,52690,2021-05-07,0.05143721633888049,33050,34750,1700,512133
20525,52690,2021-05-04,0.0743801652892562,36300,33600,-2700,893385
20526,52690,2021-05-03,0.0546875,38400,36300,-2100,360046
20527,52690,2021-04-30,0.04206241519674356,36850,38400,1550,798119
20528,52690,2021-04-29,0.061146496815286625,39250,36850,-2400,402421
20529,52690,2021-04-27,0.04933333333333333,37500,39350,1850,669837
20530,52690,2021-04-26,0.07178217821782178,40400,37500,-2900,1178889
20531,52690,2021-04-23,0.17551020408163265,49000,40400,-8600,1808859
20532,52690,2021-04-22,0.12,43750,49000,5250,4052860
20533,52690,2021-04-20,0.15086782376502003,37450,43100,5650,2409652
20534,52690,2021-04-15,0.05233380480905234,35350,37200,1850,1960098
20535,52690,2021-04-14,0.12939297124600638,31300,35350,4050,1719288
20536,52690,2021-04-12,0.09666080843585237,28450,31200,2750,1173641
20537,52690,2021-04-07,0.045454545454545456,28600,27300,-1300,607917
20538,52690,2021-04-06,0.06716417910447761,26800,28600,1800,1269264
20539,52690,2021-04-02,0.12608695652173912,23000,25900,2900,1933704
20540,52690,2021-03-31,0.04176334106728538,21550,22450,900,257164
20541,52690,2021-03-17,0.053268765133171914,20650,21750,1100,724468
20542,52690,2021-03-04,0.07605633802816901,17750,19100,1350,973605
20543,52690,2020-12-22,0.05013927576601671,17950,17050,-900,273057
20544,52690,2020-12-18,0.06376811594202898,17250,18350,1100,1537208
20545,52690,2020-09-04,0.08923076923076922,16250,17700,1450,888322
20546,52690,2020-08-20,0.050746268656716415,16750,15900,-850,121824
20547,52690,2020-08-18,0.046242774566473986,17300,16500,-800,119581
20548,52690,2020-08-06,0.042042042042042045,16650,17350,700,352112
20549,52690,2020-08-04,0.043343653250773995,16150,16850,700,258210
20550,52690,2020-07-21,0.049689440993788817,16100,16900,800,224365
20551,52690,2020-06-16,0.04220779220779221,15400,16050,650,66569
20552,52690,2020-06-15,0.04643962848297214,16150,15400,-750,145004
20553,52690,2020-04-16,0.056338028169014086,17750,16750,-1000,262008
20554,52690,2020-04-07,0.07255520504731862,15850,17000,1150,240575
20555,52690,2020-04-06,0.04966887417218543,15100,15850,750,154002
20556,52690,2020-03-25,0.04332129963898917,13850,14450,600,179738
20557,52690,2020-03-24,0.05725190839694656,13100,13850,750,116364
20558,52690,2020-03-23,0.06428571428571428,14000,13100,-900,108968
20559,52690,2020-03-20,0.08108108108108109,12950,14000,1050,149530
20560,52690,2020-03-19,0.040740740740740744,13500,12950,-550,215863
20561,52690,2020-03-18,0.045936395759717315,14150,13500,-650,119831
20562,52690,2020-03-16,0.040268456375838924,14900,14300,-600,161160
20563,52690,2020-03-13,0.08307692307692308,16250,14900,-1350,373874
20564,52690,2020-03-12,0.055232558139534885,17200,16250,-950,228552
20565,52690,2020-01-29,0.04941176470588235,21250,20200,-1050,217083
20566,52690,2020-01-23,0.044444444444444446,20250,21150,900,230562
20567,52690,2020-01-22,0.060209424083769635,19100,20250,1150,237922
20568,52690,2019-12-19,0.08831168831168831,19250,20950,1700,622611
20569,52690,2019-10-02,0.040268456375838924,22350,21450,-900,139961
20570,52690,2019-09-25,0.06339468302658487,24450,22900,-1550,255292
20571,52690,2019-09-23,0.08425720620842572,22550,24450,1900,566630
20572,52690,2019-09-18,0.11519607843137254,20400,22750,2350,759696
20573,52690,2019-09-17,0.08222811671087533,18850,20400,1550,900784
20574,52690,2019-08-05,0.051771117166212535,18350,17400,-950,90671
20575,52690,2019-07-19,0.04509283819628647,18850,19700,850,72699
20576,52690,2019-06-25,0.08096280087527352,22850,21000,-1850,183168
20577,52690,2019-05-31,0.04645476772616137,20450,21400,950,131195
20578,52690,2019-04-29,0.05707762557077625,21900,23150,1250,171854
20579,52690,2019-03-05,0.048736462093862815,27700,29050,1350,261328
20580,52690,2019-03-04,0.04924242424242424,26400,27700,1300,157081
20581,52690,2019-02-28,0.04693140794223827,27700,26400,-1300,149469
20582,52690,2019-02-22,0.054409005628517824,26650,28100,1450,206895
20583,52690,2019-01-30,0.06289308176100629,23850,25350,1500,193891
20584,52690,2019-01-28,0.04251012145748988,24700,23650,-1050,167498
20585,52690,2019-01-14,0.12980769230769232,20800,23500,2700,534257
20586,52690,2018-12-21,0.04954954954954955,22200,21100,-1100,77561
20587,52690,2018-12-13,0.04738154613466334,20050,21000,950,110640
20588,52690,2018-11-26,0.0671462829736211,20850,22250,1400,257018
20589,52690,2018-11-21,0.041666666666666664,20400,21250,850,96653
20590,52690,2018-11-15,0.047244094488188976,19050,19950,900,68086
20591,52690,2018-10-23,0.0703883495145631,20600,19150,-1450,118985
20592,52690,2018-10-15,0.05405405405405406,18500,19500,1000,115089
20593,52690,2018-10-11,0.0794044665012407,20150,18550,-1600,161920
20594,52690,2018-10-10,0.04047619047619048,21000,20150,-850,76514
20595,52690,2018-10-01,0.04047619047619048,21000,21850,850,149867
20596,52690,2018-08-23,0.04047619047619048,21000,21850,850,168809
20597,52690,2018-08-01,0.04225352112676056,21300,20400,-900,434655
20598,52690,2018-07-27,0.043478260869565216,23000,22000,-1000,230723
20599,52690,2018-07-24,0.05580357142857143,22400,23650,1250,191795
20600,52690,2018-07-06,0.06221198156682028,21700,23050,1350,148103
20601,52690,2018-07-02,0.1509433962264151,26500,22500,-4000,801439
20602,52690,2018-06-27,0.06017699115044248,28250,26550,-1700,132787
20603,52690,2018-06-19,0.06498194945848375,27700,25900,-1800,178241
20604,52690,2018-06-14,0.08681672025723473,31100,28400,-2700,304241
20605,52690,2018-06-11,0.05723905723905724,29700,31400,1700,183872
20606,52690,2018-05-29,0.08771929824561403,34200,31200,-3000,508899
20607,52690,2018-05-28,0.044274809160305344,32750,34200,1450,354785
20608,52690,2018-05-14,0.0898876404494382,35600,38800,3200,400530
20609,52690,2018-05-09,0.046511627906976744,36550,34850,-1700,288637
20610,52690,2018-05-03,0.06291834002677377,37350,35000,-2350,495269
20611,52690,2018-04-30,0.04539007092198582,35250,36850,1600,704426
20612,52690,2018-04-24,0.05570652173913043,36800,34750,-2050,397006
20613,52690,2018-04-20,0.06083086053412463,33700,35750,2050,531110
20614,52690,2018-04-19,0.06141732283464567,31750,33700,1950,473901
20615,52690,2018-04-16,0.1195079086115993,28450,31850,3400,563659
20616,52690,2018-04-13,0.04981549815498155,27100,28450,1350,170823
20617,52690,2018-04-04,0.048013245033112585,30200,28750,-1450,245940
20618,52690,2018-04-02,0.0624,31250,29300,-1950,262646
20619,52690,2018-03-29,0.07167832167832168,28600,30650,2050,624726
20620,52690,2018-03-27,0.049910873440285206,28050,29450,1400,230669
20621,52690,2018-03-19,0.04308797127468582,27850,29050,1200,795207
20622,52690,2018-03-15,0.0975609756097561,24600,27000,2400,841755
20623,52690,2018-03-09,0.07021276595744681,23500,25150,1650,280417
20624,52690,2018-03-08,0.049107142857142856,22400,23500,1100,89883
20625,52690,2018-02-05,0.04158004158004158,24050,23050,-1000,94270
20626,52690,2018-01-23,0.042735042735042736,23400,24400,1000,194262
20627,52690,2018-01-09,0.045662100456621,21900,22900,1000,187798
20628,52690,2017-12-21,0.05588822355289421,25050,23650,-1400,277378
20629,52690,2017-12-15,0.04132231404958678,24200,25200,1000,175198
20630,52690,2017-12-08,0.04375,24000,22950,-1050,774067
20631,52690,2017-12-05,0.14974619289340102,19700,22650,2950,1107938
20632,52690,2017-12-04,0.08241758241758242,18200,19700,1500,412884
20633,52690,2017-11-24,0.059490084985835696,17650,18700,1050,291508
20634,52690,2017-10-23,0.09324009324009325,21450,19450,-2000,822119
20635,52690,2017-10-13,0.06976744186046512,19350,20700,1350,443231
20636,52690,2017-10-11,0.07608695652173914,18400,19800,1400,352000
20637,52690,2017-09-25,0.05013927576601671,17950,17050,-900,131048
20638,52690,2017-09-20,0.05865921787709497,17900,18950,1050,326898
20639,52690,2017-07-31,0.04773869346733668,19900,18950,-950,191978
20640,52690,2017-07-26,0.05789473684210526,19000,20100,1100,351535
20641,52690,2017-07-14,0.05063291139240506,19750,18750,-1000,307731
20642,52690,2017-06-28,0.0675,20000,18650,-1350,569777
20643,52690,2017-06-20,0.04,21250,20400,-850,792640
20644,52690,2017-06-19,0.1090146750524109,23850,21250,-2600,921175
20645,52690,2017-06-01,0.040169133192389,23650,24600,950,701640
20646,52690,2017-05-02,0.047619047619047616,25200,24000,-1200,317302
20647,52690,2017-04-12,0.0423572744014733,27150,26000,-1150,201649
20648,52690,2017-03-23,0.07128712871287128,25250,27050,1800,417373
20649,52690,2017-03-08,0.0705244122965642,27650,25700,-1950,284543
20650,52690,2017-03-07,0.06756756756756757,25900,27650,1750,186554
20651,52690,2017-02-24,0.0410958904109589,25550,26600,1050,194781
20652,52690,2017-02-09,0.09110169491525423,23600,25750,2150,529464
20653,52690,2016-11-10,0.047516198704103674,23150,24250,1100,107660
20654,52690,2016-11-02,0.04056795131845842,24650,23650,-1000,189707
20655,52690,2016-10-31,0.040152963671128104,26150,25100,-1050,165049
20656,52690,2016-10-28,0.06440071556350627,27950,26150,-1800,516150
20657,52690,2016-10-20,0.05755395683453238,27800,29400,1600,172884
20658,52690,2016-08-18,0.05409582689335394,32350,34100,1750,288254
20659,294870,2021-05-27,0.0427807486631016,28050,29250,1200,911567
20660,294870,2021-05-07,0.0481283422459893,28050,29400,1350,1681510
20661,294870,2021-03-15,0.040145985401459854,27400,28500,1100,924491
20662,294870,2021-03-09,0.05242718446601942,25750,27100,1350,721616
20663,294870,2021-02-04,0.0467741935483871,31000,29550,-1450,3014989
20664,294870,2021-02-03,0.06164383561643835,29200,31000,1800,2087987
20665,294870,2021-02-01,0.056672760511883,27350,28900,1550,1041627
20666,294870,2021-01-29,0.058519793459552494,29050,27350,-1700,1430998
20667,294870,2021-01-26,0.0449438202247191,31150,29750,-1400,1265372
20668,294870,2021-01-19,0.08896797153024912,28100,30600,2500,2965987
20669,294870,2021-01-12,0.040740740740740744,27000,28100,1100,2472988
20670,294870,2021-01-05,0.06653992395437262,26300,28050,1750,3748502
20671,294870,2020-12-30,0.04609218436873747,24950,26100,1150,1286693
20672,294870,2020-12-22,0.05084745762711865,26550,25200,-1350,1205277
20673,294870,2020-12-09,0.06263048016701461,23950,25450,1500,3509690
20674,294870,2020-12-07,0.08144796380090498,22100,23900,1800,5426863
20675,294870,2020-12-04,0.07021791767554479,20650,22100,1450,3072959
20676,294870,2020-09-24,0.046189376443418015,21650,20650,-1000,802645
20677,294870,2020-09-22,0.04054054054054054,22200,21300,-900,795343
20678,294870,2020-09-21,0.04103671706263499,23150,22200,-950,938719
20679,294870,2020-09-11,0.048728813559322036,23600,24750,1150,2123573
20680,294870,2020-09-01,0.1108695652173913,23000,25550,2550,3992617
20681,294870,2020-08-31,0.05263157894736842,21850,23000,1150,1983951
20682,294870,2020-08-28,0.05048076923076923,20800,21850,1050,1245024
20683,294870,2020-08-27,0.0502283105022831,21900,20800,-1100,951466
20684,294870,2020-08-26,0.057971014492753624,20700,21900,1200,1539552
20685,294870,2020-08-18,0.06912442396313365,21700,20200,-1500,1228206
20686,294870,2020-08-10,0.04201680672268908,23800,22800,-1000,1354615
20687,294870,2020-08-05,0.06904231625835189,22450,24000,1550,3131193
20688,294870,2020-08-04,0.044186046511627906,21500,22450,950,2642411
20689,294870,2020-07-30,0.053864168618266976,21350,22500,1150,3161481
20690,294870,2020-07-13,0.042606516290726815,19950,20800,850,480449
20691,294870,2020-06-26,0.04081632653061224,22050,21150,-900,1253308
20692,294870,2020-06-24,0.04830917874396135,20700,21700,1000,1533477
20693,294870,2020-06-15,0.05121951219512195,20500,19450,-1050,1164699
20694,294870,2020-06-09,0.06132075471698113,21200,22500,1300,6309331
20695,294870,2020-05-29,0.05673758865248227,21150,19950,-1200,5528278
20696,294870,2020-05-26,0.04291845493562232,23300,22300,-1000,2387049
20697,294870,2020-05-22,0.06018518518518518,21600,22900,1300,2902756
20698,294870,2020-05-20,0.0675,20000,21350,1350,3483217
20699,294870,2020-05-15,0.08333333333333333,18600,20150,1550,3702843
20700,294870,2020-05-11,0.05053191489361702,18800,19750,950,1344418
20701,294870,2020-04-29,0.07102272727272728,17600,18850,1250,1808606
20702,294870,2020-04-24,0.05913978494623656,18600,17500,-1100,941691
20703,294870,2020-04-14,0.06515580736543909,17650,18800,1150,923303
20704,294870,2020-04-07,0.06267806267806268,17550,18650,1100,3049443
20705,294870,2020-04-02,0.09554140127388536,15700,17200,1500,2207031
20706,294870,2020-03-25,0.07719298245614035,14250,15350,1100,1235641
20707,294870,2020-03-23,0.125,16000,14000,-2000,692331
20708,294870,2020-03-20,0.2698412698412698,12600,16000,3400,702553
20709,294870,2020-03-19,0.07692307692307693,13650,12600,-1050,990604
20710,294870,2020-03-12,0.05750798722044728,15650,14750,-900,1094286
20711,294870,2020-03-09,0.045180722891566265,16600,15850,-750,628672
20712,294870,2020-03-02,0.04986149584487535,18050,17150,-900,1030649
20713,294870,2020-02-27,0.051490514905149054,18450,17500,-950,1175906
20714,294870,2020-02-21,0.042606516290726815,19950,19100,-850,786306
20715,294870,2020-02-06,0.062034739454094295,20150,21400,1250,645633
20716,294870,2020-01-14,0.0420353982300885,22600,23550,950,651685
20717,294870,2020-01-13,0.046413502109704644,23700,22600,-1100,791179
20718,294870,2020-01-08,0.05942622950819672,24400,22950,-1450,468828
20719,294870,2019-12-11,0.056179775280898875,26700,25200,-1500,915672
20720,294870,2019-11-14,0.05472636815920398,30150,28500,-1650,1136035
20721,294870,2019-11-08,0.07313432835820896,33500,31050,-2450,1201428
20722,294870,2019-09-03,0.09431345353675451,36050,32650,-3400,1002380
20723,294870,2019-08-08,0.04881656804733728,33800,35450,1650,174508
20724,294870,2019-08-07,0.04788732394366197,35500,33800,-1700,184629
20725,294870,2019-07-09,0.0644361833952912,40350,37750,-2600,359413
20726,294870,2019-07-08,0.04383886255924171,42200,40350,-1850,119689
20727,294870,2019-06-10,0.04988399071925754,43100,45250,2150,173531
20728,294870,2019-05-28,0.04065040650406504,43050,41300,-1750,351287
20729,294870,2019-04-26,0.048368953880764905,44450,46600,2150,262320
20730,294870,2019-03-19,0.04934541792547835,49650,52100,2450,250607
20731,294870,2019-02-28,0.06866537717601548,51700,48150,-3550,288763
20732,294870,2019-02-12,0.06971904266389178,48050,51400,3350,319240
20733,294870,2019-01-30,0.0811965811965812,46800,50600,3800,657452
20734,294870,2019-01-29,0.04581005586592179,44750,46800,2050,306328
20735,294870,2019-01-09,0.06320541760722348,44300,47100,2800,175557
20736,294870,2018-12-20,0.05303030303030303,46200,48650,2450,316298
20737,294870,2018-12-18,0.0892018779342723,42600,46400,3800,569233
20738,294870,2018-12-17,0.040293040293040296,40950,42600,1650,212440
20739,294870,2018-11-14,0.043373493975903614,41500,39700,-1800,227489
20740,294870,2018-11-05,0.047830923248053395,44950,42800,-2150,229241
20741,294870,2018-10-30,0.04221954161640531,41450,43200,1750,151800
20742,294870,2018-10-26,0.0732519422863485,45050,41750,-3300,233121
20743,294870,2018-10-11,0.060133630289532294,44900,42200,-2700,352729
20744,294870,2018-10-10,0.0836734693877551,49000,44900,-4100,726638
20745,294870,2018-10-01,0.04518664047151277,50900,53200,2300,316865
20746,294870,2018-09-27,0.05045045045045045,55500,52700,-2800,509693
20747,294870,2018-09-20,0.040280210157618214,57100,54800,-2300,686079
20748,294870,2018-09-19,0.04194630872483222,59600,57100,-2500,432356
20749,294870,2018-09-18,0.040257648953301126,62100,59600,-2500,366042
20750,294870,2018-09-10,0.12056737588652482,56400,63200,6800,858884
20751,294870,2018-07-31,0.05271828665568369,60700,57500,-3200,286973
20752,294870,2018-07-25,0.06725663716814159,56500,60300,3800,519777
20753,294870,2018-07-24,0.06805293005671077,52900,56500,3600,525366
20754,294870,2018-07-20,0.06626506024096386,49800,53100,3300,315253
20755,294870,2018-07-19,0.04046242774566474,51900,49800,-2100,245698
20756,294870,2018-07-16,0.045936395759717315,56600,54000,-2600,247299
20757,294870,2018-07-03,0.055865921787709494,53700,56700,3000,634945
20758,294870,2018-06-29,0.07584830339321358,50100,53900,3800,464182
20759,294870,2018-06-28,0.045714285714285714,52500,50100,-2400,379801
20760,294870,2018-06-26,0.04424778761061947,56500,54000,-2500,372448
20761,294870,2018-06-19,0.09836065573770492,61000,55000,-6000,968919
20762,294870,2018-06-18,0.07993966817496229,66300,61000,-5300,854098
20763,294870,2018-06-15,0.059574468085106386,70500,66300,-4200,573753
20764,294870,2018-06-14,0.06746031746031746,75600,70500,-5100,1164317
20765,294870,2018-06-19,0.09836065573770492,61000,55000,-6000,968919
20766,294870,2018-06-18,0.07993966817496229,66300,61000,-5300,854098
20767,294870,2018-06-15,0.059574468085106386,70500,66300,-4200,573753
20768,294870,2018-06-14,0.06746031746031746,75600,70500,-5100,1164317
20769,294870,2018-06-19,0.09836065573770492,61000,55000,-6000,968919
20770,294870,2018-06-18,0.07993966817496229,66300,61000,-5300,854098
20771,294870,2018-06-15,0.059574468085106386,70500,66300,-4200,573753
20772,294870,2018-06-14,0.06746031746031746,75600,70500,-5100,1164317
20773,294870,2018-06-19,0.09836065573770492,61000,55000,-6000,968919
20774,294870,2018-06-18,0.07993966817496229,66300,61000,-5300,854098
20775,294870,2018-06-15,0.059574468085106386,70500,66300,-4200,573753
20776,294870,2018-06-14,0.06746031746031746,75600,70500,-5100,1164317
20777,294870,2018-06-19,0.09836065573770492,61000,55000,-6000,968919
20778,294870,2018-06-18,0.07993966817496229,66300,61000,-5300,854098
20779,294870,2018-06-15,0.059574468085106386,70500,66300,-4200,573753
20780,294870,2018-06-14,0.06746031746031746,75600,70500,-5100,1164317
20781,294870,2018-06-19,0.09836065573770492,61000,55000,-6000,968919
20782,294870,2018-06-18,0.07993966817496229,66300,61000,-5300,854098
20783,294870,2018-06-15,0.059574468085106386,70500,66300,-4200,573753
20784,294870,2018-06-14,0.06746031746031746,75600,70500,-5100,1164317
20785,294870,2018-06-19,0.09836065573770492,61000,55000,-6000,968919
20786,294870,2018-06-18,0.07993966817496229,66300,61000,-5300,854098
20787,294870,2018-06-15,0.059574468085106386,70500,66300,-4200,573753
20788,294870,2018-06-14,0.06746031746031746,75600,70500,-5100,1164317
20789,294870,2018-06-19,0.09836065573770492,61000,55000,-6000,968919
20790,294870,2018-06-18,0.07993966817496229,66300,61000,-5300,854098
20791,294870,2018-06-15,0.059574468085106386,70500,66300,-4200,573753
20792,294870,2018-06-14,0.06746031746031746,75600,70500,-5100,1164317
20793,294870,2018-06-19,0.09836065573770492,61000,55000,-6000,968919
20794,294870,2018-06-18,0.07993966817496229,66300,61000,-5300,854098
20795,294870,2018-06-15,0.059574468085106386,70500,66300,-4200,573753
20796,294870,2018-06-14,0.06746031746031746,75600,70500,-5100,1164317
20797,294870,2018-06-19,0.09836065573770492,61000,55000,-6000,968919
20798,294870,2018-06-18,0.07993966817496229,66300,61000,-5300,854098
20799,294870,2018-06-15,0.059574468085106386,70500,66300,-4200,573753
20800,294870,2018-06-14,0.06746031746031746,75600,70500,-5100,1164317
20801,294870,2018-06-19,0.09836065573770492,61000,55000,-6000,968919
20802,294870,2018-06-18,0.07993966817496229,66300,61000,-5300,854098
20803,294870,2018-06-15,0.059574468085106386,70500,66300,-4200,573753
20804,294870,2018-06-14,0.06746031746031746,75600,70500,-5100,1164317
20805,294870,2018-06-19,0.09836065573770492,61000,55000,-6000,968919
20806,294870,2018-06-18,0.07993966817496229,66300,61000,-5300,854098
20807,294870,2018-06-15,0.059574468085106386,70500,66300,-4200,573753
20808,294870,2018-06-14,0.06746031746031746,75600,70500,-5100,1164317
20809,294870,2018-06-19,0.09836065573770492,61000,55000,-6000,968919
20810,294870,2018-06-18,0.07993966817496229,66300,61000,-5300,854098
20811,294870,2018-06-15,0.059574468085106386,70500,66300,-4200,573753
20812,294870,2018-06-14,0.06746031746031746,75600,70500,-5100,1164317
20813,294870,2018-06-19,0.09836065573770492,61000,55000,-6000,968919
20814,294870,2018-06-18,0.07993966817496229,66300,61000,-5300,854098
20815,294870,2018-06-15,0.059574468085106386,70500,66300,-4200,573753
20816,294870,2018-06-14,0.06746031746031746,75600,70500,-5100,1164317
20817,294870,2018-06-19,0.09836065573770492,61000,55000,-6000,968919
20818,294870,2018-06-18,0.07993966817496229,66300,61000,-5300,854098
20819,294870,2018-06-15,0.059574468085106386,70500,66300,-4200,573753
20820,294870,2018-06-14,0.06746031746031746,75600,70500,-5100,1164317
20821,294870,2018-06-19,0.09836065573770492,61000,55000,-6000,968919
20822,294870,2018-06-18,0.07993966817496229,66300,61000,-5300,854098
20823,294870,2018-06-15,0.059574468085106386,70500,66300,-4200,573753
20824,294870,2018-06-14,0.06746031746031746,75600,70500,-5100,1164317
20825,294870,2018-06-19,0.09836065573770492,61000,55000,-6000,968919
20826,294870,2018-06-18,0.07993966817496229,66300,61000,-5300,854098
20827,294870,2018-06-15,0.059574468085106386,70500,66300,-4200,573753
20828,294870,2018-06-14,0.06746031746031746,75600,70500,-5100,1164317
20829,294870,2018-06-19,0.09836065573770492,61000,55000,-6000,968919
20830,294870,2018-06-18,0.07993966817496229,66300,61000,-5300,854098
20831,294870,2018-06-15,0.059574468085106386,70500,66300,-4200,573753
20832,294870,2018-06-14,0.06746031746031746,75600,70500,-5100,1164317
20833,294870,2018-06-19,0.09836065573770492,61000,55000,-6000,968919
20834,294870,2018-06-18,0.07993966817496229,66300,61000,-5300,854098
20835,294870,2018-06-15,0.059574468085106386,70500,66300,-4200,573753
20836,294870,2018-06-14,0.06746031746031746,75600,70500,-5100,1164317
20837,294870,2018-06-19,0.09836065573770492,61000,55000,-6000,968919
20838,294870,2018-06-18,0.07993966817496229,66300,61000,-5300,854098
20839,294870,2018-06-15,0.059574468085106386,70500,66300,-4200,573753
20840,294870,2018-06-14,0.06746031746031746,75600,70500,-5100,1164317
20841,294870,2018-06-19,0.09836065573770492,61000,55000,-6000,968919
20842,294870,2018-06-18,0.07993966817496229,66300,61000,-5300,854098
20843,294870,2018-06-15,0.059574468085106386,70500,66300,-4200,573753
20844,294870,2018-06-14,0.06746031746031746,75600,70500,-5100,1164317
20845,294870,2018-06-19,0.09836065573770492,61000,55000,-6000,968919
20846,294870,2018-06-18,0.07993966817496229,66300,61000,-5300,854098
20847,294870,2018-06-15,0.059574468085106386,70500,66300,-4200,573753
20848,294870,2018-06-14,0.06746031746031746,75600,70500,-5100,1164317
20849,294870,2018-06-19,0.09836065573770492,61000,55000,-6000,968919
20850,294870,2018-06-18,0.07993966817496229,66300,61000,-5300,854098
20851,294870,2018-06-15,0.059574468085106386,70500,66300,-4200,573753
20852,294870,2018-06-14,0.06746031746031746,75600,70500,-5100,1164317
20853,294870,2018-06-19,0.09836065573770492,61000,55000,-6000,968919
20854,294870,2018-06-18,0.07993966817496229,66300,61000,-5300,854098
20855,294870,2018-06-15,0.059574468085106386,70500,66300,-4200,573753
20856,294870,2018-06-14,0.06746031746031746,75600,70500,-5100,1164317
20857,294870,2018-06-19,0.09836065573770492,61000,55000,-6000,968919
20858,294870,2018-06-18,0.07993966817496229,66300,61000,-5300,854098
20859,294870,2018-06-15,0.059574468085106386,70500,66300,-4200,573753
20860,294870,2018-06-14,0.06746031746031746,75600,70500,-5100,1164317
20861,294870,2018-06-19,0.09836065573770492,61000,55000,-6000,968919
20862,294870,2018-06-18,0.07993966817496229,66300,61000,-5300,854098
20863,294870,2018-06-15,0.059574468085106386,70500,66300,-4200,573753
20864,294870,2018-06-14,0.06746031746031746,75600,70500,-5100,1164317
20865,294870,2018-06-19,0.09836065573770492,61000,55000,-6000,968919
20866,294870,2018-06-18,0.07993966817496229,66300,61000,-5300,854098
20867,294870,2018-06-15,0.059574468085106386,70500,66300,-4200,573753
20868,294870,2018-06-14,0.06746031746031746,75600,70500,-5100,1164317
20869,294870,2018-06-19,0.09836065573770492,61000,55000,-6000,968919
20870,294870,2018-06-18,0.07993966817496229,66300,61000,-5300,854098
20871,294870,2018-06-15,0.059574468085106386,70500,66300,-4200,573753
20872,294870,2018-06-14,0.06746031746031746,75600,70500,-5100,1164317
20873,294870,2018-06-19,0.09836065573770492,61000,55000,-6000,968919
20874,294870,2018-06-18,0.07993966817496229,66300,61000,-5300,854098
20875,294870,2018-06-15,0.059574468085106386,70500,66300,-4200,573753
20876,294870,2018-06-14,0.06746031746031746,75600,70500,-5100,1164317
20877,294870,2018-06-19,0.09836065573770492,61000,55000,-6000,968919
20878,294870,2018-06-18,0.07993966817496229,66300,61000,-5300,854098
20879,294870,2018-06-15,0.059574468085106386,70500,66300,-4200,573753
20880,294870,2018-06-14,0.06746031746031746,75600,70500,-5100,1164317
20881,294870,2018-06-19,0.09836065573770492,61000,55000,-6000,968919
20882,294870,2018-06-18,0.07993966817496229,66300,61000,-5300,854098
20883,294870,2018-06-15,0.059574468085106386,70500,66300,-4200,573753
20884,294870,2018-06-14,0.06746031746031746,75600,70500,-5100,1164317
20885,294870,2018-06-19,0.09836065573770492,61000,55000,-6000,968919
20886,294870,2018-06-18,0.07993966817496229,66300,61000,-5300,854098
20887,294870,2018-06-15,0.059574468085106386,70500,66300,-4200,573753
20888,294870,2018-06-14,0.06746031746031746,75600,70500,-5100,1164317
20889,294870,2018-06-19,0.09836065573770492,61000,55000,-6000,968919
20890,294870,2018-06-18,0.07993966817496229,66300,61000,-5300,854098
20891,294870,2018-06-15,0.059574468085106386,70500,66300,-4200,573753
20892,294870,2018-06-14,0.06746031746031746,75600,70500,-5100,1164317
20893,294870,2018-06-19,0.09836065573770492,61000,55000,-6000,968919
20894,294870,2018-06-18,0.07993966817496229,66300,61000,-5300,854098
20895,294870,2018-06-15,0.059574468085106386,70500,66300,-4200,573753
20896,294870,2018-06-14,0.06746031746031746,75600,70500,-5100,1164317
20897,294870,2018-06-19,0.09836065573770492,61000,55000,-6000,968919
20898,294870,2018-06-18,0.07993966817496229,66300,61000,-5300,854098
20899,294870,2018-06-15,0.059574468085106386,70500,66300,-4200,573753
20900,294870,2018-06-14,0.06746031746031746,75600,70500,-5100,1164317
20901,294870,2018-06-19,0.09836065573770492,61000,55000,-6000,968919
20902,294870,2018-06-18,0.07993966817496229,66300,61000,-5300,854098
20903,294870,2018-06-15,0.059574468085106386,70500,66300,-4200,573753
20904,294870,2018-06-14,0.06746031746031746,75600,70500,-5100,1164317
20905,294870,2018-06-19,0.09836065573770492,61000,55000,-6000,968919
20906,294870,2018-06-18,0.07993966817496229,66300,61000,-5300,854098
20907,294870,2018-06-15,0.059574468085106386,70500,66300,-4200,573753
20908,294870,2018-06-14,0.06746031746031746,75600,70500,-5100,1164317
20909,294870,2018-06-19,0.09836065573770492,61000,55000,-6000,968919
20910,294870,2018-06-18,0.07993966817496229,66300,61000,-5300,854098
20911,294870,2018-06-15,0.059574468085106386,70500,66300,-4200,573753
20912,294870,2018-06-14,0.06746031746031746,75600,70500,-5100,1164317
20913,294870,2018-06-19,0.09836065573770492,61000,55000,-6000,968919
20914,294870,2018-06-18,0.07993966817496229,66300,61000,-5300,854098
20915,294870,2018-06-15,0.059574468085106386,70500,66300,-4200,573753
20916,294870,2018-06-14,0.06746031746031746,75600,70500,-5100,1164317
20917,294870,2018-06-19,0.09836065573770492,61000,55000,-6000,968919
20918,294870,2018-06-18,0.07993966817496229,66300,61000,-5300,854098
20919,294870,2018-06-15,0.059574468085106386,70500,66300,-4200,573753
20920,294870,2018-06-14,0.06746031746031746,75600,70500,-5100,1164317
20921,294870,2018-06-19,0.09836065573770492,61000,55000,-6000,968919
20922,294870,2018-06-18,0.07993966817496229,66300,61000,-5300,854098
20923,294870,2018-06-15,0.059574468085106386,70500,66300,-4200,573753
20924,294870,2018-06-14,0.06746031746031746,75600,70500,-5100,1164317
20925,294870,2018-06-19,0.09836065573770492,61000,55000,-6000,968919
20926,294870,2018-06-18,0.07993966817496229,66300,61000,-5300,854098
20927,294870,2018-06-15,0.059574468085106386,70500,66300,-4200,573753
20928,294870,2018-06-14,0.06746031746031746,75600,70500,-5100,1164317
20929,294870,2018-06-19,0.09836065573770492,61000,55000,-6000,968919
20930,294870,2018-06-18,0.07993966817496229,66300,61000,-5300,854098
20931,294870,2018-06-15,0.059574468085106386,70500,66300,-4200,573753
20932,294870,2018-06-14,0.06746031746031746,75600,70500,-5100,1164317
20933,294870,2018-06-19,0.09836065573770492,61000,55000,-6000,968919
20934,294870,2018-06-18,0.07993966817496229,66300,61000,-5300,854098
20935,294870,2018-06-15,0.059574468085106386,70500,66300,-4200,573753
20936,294870,2018-06-14,0.06746031746031746,75600,70500,-5100,1164317
20937,294870,2018-06-19,0.09836065573770492,61000,55000,-6000,968919
20938,294870,2018-06-18,0.07993966817496229,66300,61000,-5300,854098
20939,294870,2018-06-15,0.059574468085106386,70500,66300,-4200,573753
20940,294870,2018-06-14,0.06746031746031746,75600,70500,-5100,1164317
20941,294870,2018-06-19,0.09836065573770492,61000,55000,-6000,968919
20942,294870,2018-06-18,0.07993966817496229,66300,61000,-5300,854098
20943,294870,2018-06-15,0.059574468085106386,70500,66300,-4200,573753
20944,294870,2018-06-14,0.06746031746031746,75600,70500,-5100,1164317
20945,3550,2021-05-31,0.056074766355140186,107000,101000,-6000,1061671
20946,3550,2021-05-27,0.08695652173913043,126500,108500,-18000,1781390
20947,3550,2021-04-28,0.06751054852320675,118500,126500,8000,1380617
20948,3550,2021-04-27,0.04435483870967742,124000,118500,-5500,1011527
20949,3550,2021-04-26,0.08296943231441048,114500,124000,9500,1416097
20950,3550,2021-04-23,0.05045871559633028,109000,114500,5500,639572
20951,3550,2021-04-15,0.07881773399014778,101500,109500,8000,1925401
20952,3550,2021-04-14,0.058394160583941604,95900,101500,5600,784271
20953,3550,2021-04-12,0.047409040793825796,90700,95000,4300,618231
20954,3550,2021-02-22,0.04116465863453815,99600,95500,-4100,672404
20955,3550,2021-02-18,0.04265402843601896,105500,101000,-4500,560427
20956,3550,2021-02-17,0.053811659192825115,111500,105500,-6000,596989
20957,3550,2021-02-10,0.047619047619047616,105000,110000,5000,700702
20958,3550,2021-01-29,0.04251207729468599,103500,99100,-4400,748985
20959,3550,2021-01-26,0.05429864253393665,110500,104500,-6000,863557
20960,3550,2021-01-22,0.0735930735930736,115500,107000,-8500,1249988
20961,3550,2021-01-21,0.06451612903225806,108500,115500,7000,1853456
20962,3550,2021-01-20,0.05339805825242718,103000,108500,5500,807210
20963,3550,2021-01-14,0.04830917874396135,103500,108500,5000,1006769
20964,3550,2021-01-07,0.10483042137718397,97300,107500,10200,3425106
20965,3550,2021-01-04,0.10742857142857143,87500,96900,9400,2269706
20966,3550,2020-12-23,0.10344827586206896,78300,86400,8100,7758366
20967,3550,2020-11-30,0.061170212765957445,75200,70600,-4600,1176464
20968,3550,2020-08-21,0.08470290771175727,79100,85800,6700,548515
20969,3550,2020-08-20,0.04353083434099154,82700,79100,-3600,475768
20970,3550,2020-08-18,0.040697674418604654,86000,82500,-3500,396942
20971,3550,2020-08-14,0.044444444444444446,90000,86000,-4000,438723
20972,3550,2020-08-10,0.046511627906976744,86000,90000,4000,546654
20973,3550,2020-08-07,0.04116222760290557,82600,86000,3400,487203
20974,3550,2020-08-05,0.052429667519181586,78200,82300,4100,469770
20975,3550,2020-08-04,0.045454545454545456,74800,78200,3400,550498
20976,3550,2020-06-17,0.08653846153846154,72800,79100,6300,838913
20977,3550,2020-06-16,0.05660377358490566,68900,72800,3900,322346
20978,3550,2020-06-15,0.043055555555555555,72000,68900,-3100,408844
20979,3550,2020-06-04,0.05154639175257732,67900,71400,3500,616827
20980,3550,2020-05-19,0.050488599348534204,61400,64500,3100,375551
20981,3550,2020-04-16,0.04152823920265781,60200,62700,2500,594662
20982,3550,2020-04-06,0.09107142857142857,56000,61100,5100,283092
20983,3550,2020-04-01,0.059322033898305086,59000,55500,-3500,354857
20984,3550,2020-03-27,0.04440497335701599,56300,58800,2500,421212
20985,3550,2020-03-26,0.047377326565143825,59100,56300,-2800,418017
20986,3550,2020-03-25,0.14313346228239845,51700,59100,7400,494572
20987,3550,2020-03-24,0.11783783783783784,46250,51700,5450,412014
20988,3550,2020-03-23,0.04639175257731959,48500,46250,-2250,423348
20989,3550,2020-03-19,0.05511811023622047,50800,48000,-2800,544107
20990,3550,2020-03-18,0.0695970695970696,54600,50800,-3800,497779
20991,3550,2020-03-17,0.0634648370497427,58300,54600,-3700,430706
20992,3550,2020-03-16,0.04111842105263158,60800,58300,-2500,346457
20993,3550,2020-03-12,0.0444104134762634,65300,62400,-2900,537896
20994,3550,2020-02-12,0.05952380952380952,75600,80100,4500,576513
20995,3550,2019-03-25,0.04597701149425287,78300,74700,-3600,150144
20996,3550,2019-01-15,0.045714285714285714,70000,73200,3200,204124
20997,3550,2018-12-12,0.056296296296296296,67500,71300,3800,230477
20998,3550,2018-10-31,0.04574132492113565,63400,66300,2900,278055
20999,3550,2018-10-11,0.06398809523809523,67200,62900,-4300,514140
21000,3550,2018-06-21,0.04076086956521739,73600,70600,-3000,378677
21001,3550,2018-05-10,0.045103092783505154,77600,81100,3500,443695
21002,3550,2018-01-09,0.044642857142857144,89600,93600,4000,419749
21003,3550,2017-11-13,0.048368953880764905,88900,84600,-4300,597891
21004,3550,2017-08-30,0.061957868649318466,80700,85700,5000,622956
21005,3550,2017-06-12,0.040983606557377046,85400,81900,-3500,383009
21006,3550,2017-06-09,0.04528763769889841,81700,85400,3700,710929
21007,3550,2017-05-24,0.049868766404199474,76200,80000,3800,652389
21008,3550,2017-05-08,0.049635036496350364,68500,71900,3400,446813
21009,3550,2017-02-01,0.052364864864864864,59200,62300,3100,549859
21010,3550,2016-12-26,0.0423728813559322,59000,61500,2500,577508
21011,990,2021-06-03,0.05204460966542751,53800,56600,2800,2568573
21012,990,2021-05-24,0.053604436229205174,54100,51200,-2900,1336146
21013,990,2021-05-17,0.05956678700361011,55400,52100,-3300,2242140
21014,990,2021-05-11,0.05423728813559322,59000,55800,-3200,1276832
21015,990,2021-05-10,0.059245960502693,55700,59000,3300,1094299
21016,990,2021-04-28,0.04745762711864407,59000,56200,-2800,946771
21017,990,2021-04-20,0.046632124352331605,57900,60600,2700,3228457
21018,990,2021-04-19,0.07024029574861368,54100,57900,3800,2330919
21019,990,2021-03-30,0.04963235294117647,54400,57100,2700,1088829
21020,990,2021-03-23,0.040280210157618214,57100,54800,-2300,946415
21021,990,2021-03-16,0.08206106870229007,52400,56700,4300,1950497
21022,990,2021-03-08,0.04477611940298507,53600,51200,-2400,899757
21023,990,2021-03-04,0.044326241134751775,56400,53900,-2500,992206
21024,990,2021-02-18,0.04791344667697063,64700,61600,-3100,1427067
21025,990,2021-02-15,0.05186385737439222,61700,64900,3200,2344050
21026,990,2021-01-29,0.08071748878923767,66900,61500,-5400,3539007
21027,990,2021-01-26,0.04267425320056899,70300,67300,-3000,1724188
21028,990,2021-01-20,0.0914826498422713,63400,69200,5800,6388832
21029,990,2021-01-18,0.06010016694490818,59900,63500,3600,4551888
21030,990,2021-01-12,0.10142348754448399,56200,61900,5700,7038777
21031,990,2021-01-06,0.07414829659318638,49900,53600,3700,5895650
21032,990,2020-12-29,0.0627027027027027,46250,49150,2900,5805330
21033,990,2020-12-28,0.07683352735739232,42950,46250,3300,9571591
21034,990,2020-12-24,0.07107231920199501,40100,42950,2850,14750858
21035,990,2020-12-22,0.0684931506849315,36500,39000,2500,6964980
21036,990,2020-12-17,0.04005722460658083,34950,36350,1400,2032343
21037,990,2020-11-25,0.05475504322766571,34700,36600,1900,2938399
21038,990,2020-11-04,0.0790273556231003,32900,35500,2600,1636970
21039,990,2020-10-30,0.04341317365269461,33400,31950,-1450,447549
21040,990,2020-10-26,0.04314329738058552,32450,31050,-1400,859457
21041,990,2020-10-22,0.04005722460658083,34950,33550,-1400,519839
21042,990,2020-09-28,0.08895265423242468,34850,37950,3100,1552455
21043,990,2020-09-11,0.045576407506702415,37300,39000,1700,1857124
21044,990,2020-09-07,0.07204610951008646,34700,37200,2500,2890169
21045,990,2020-08-20,0.05181347150259067,38600,36600,-2000,2762922
21046,990,2020-08-19,0.11884057971014493,34500,38600,4100,3642264
21047,990,2020-08-18,0.06504065040650407,36900,34500,-2400,2177311
21048,990,2020-08-13,0.06340057636887608,34700,36900,2200,3359443
21049,990,2020-07-30,0.05082212257100149,33450,35150,1700,2990949
21050,990,2020-07-28,0.07246376811594203,31050,33300,2250,5179315
21051,990,2020-07-10,0.04639175257731959,29100,30450,1350,2477812
21052,990,2020-07-06,0.06293706293706294,28600,30400,1800,1614199
21053,990,2020-06-25,0.04067796610169491,29500,28300,-1200,1160238
21054,990,2020-06-19,0.04659498207885305,27900,29200,1300,1344338
21055,990,2020-06-15,0.06412478336221837,28850,27000,-1850,1371735
21056,990,2020-06-01,0.07342657342657342,28600,30700,2100,1688404
21057,990,2020-05-28,0.042483660130718956,30600,29300,-1300,2222420
21058,990,2020-05-27,0.06422018348623854,32700,30600,-2100,2513763
21059,990,2020-05-25,0.17765567765567766,27300,32150,4850,5169727
21060,990,2020-05-06,0.04518664047151277,25450,26600,1150,741881
21061,990,2020-05-04,0.048598130841121495,26750,25450,-1300,1249717
21062,990,2020-04-22,0.04938271604938271,24300,25500,1200,1474327
21063,990,2020-04-16,0.04157549234135667,22850,23800,950,1107354
21064,990,2020-04-13,0.06329113924050633,23700,22200,-1500,1079063
21065,990,2020-04-07,0.05869074492099323,22150,23450,1300,2210126
21066,990,2020-04-06,0.05980861244019139,20900,22150,1250,1222679
21067,990,2020-03-24,0.16056338028169015,17750,20600,2850,2189418
21068,990,2020-03-20,0.15333333333333332,15000,17300,2300,2049125
21069,990,2020-03-19,0.09365558912386707,16550,15000,-1550,2057984
21070,990,2020-03-18,0.1196808510638298,18800,16550,-2250,1431346
21071,990,2020-03-16,0.0954653937947494,20950,18950,-2000,1395047
21072,990,2020-03-13,0.05417607223476298,22150,20950,-1200,1802753
21073,990,2020-03-11,0.0708502024291498,24700,22950,-1750,969978
21074,990,2020-03-09,0.05731225296442688,25300,23850,-1450,686153
21075,990,2020-03-02,0.07773109243697479,23800,25650,1850,1068640
21076,990,2020-02-28,0.07392996108949416,25700,23800,-1900,1465275
21077,990,2020-02-27,0.05860805860805861,27300,25700,-1600,934839
21078,990,2020-02-13,0.04006968641114982,28700,29850,1150,1597930
21079,990,2020-02-03,0.05301645338208409,27350,28800,1450,948732
21080,990,2020-01-31,0.05199306759098787,28850,27350,-1500,1042212
21081,990,2020-01-22,0.07560137457044673,29100,31300,2200,2208977
21082,990,2020-01-15,0.04477611940298507,30150,28800,-1350,801305
21083,990,2020-01-14,0.046875,28800,30150,1350,1095972
21084,990,2019-12-27,0.05628517823639775,26650,28150,1500,1105626
21085,990,2019-12-17,0.1072961373390558,23300,25800,2500,3165986
21086,990,2019-12-16,0.04484304932735426,22300,23300,1000,1172081
21087,990,2019-12-06,0.04859335038363171,19550,20500,950,997612
21088,990,2019-11-22,0.04,17500,18200,700,413806
21089,990,2019-11-15,0.05113636363636364,17600,18500,900,1193531
21090,990,2019-11-08,0.04411764705882353,17000,17750,750,553566
21091,990,2019-10-11,0.059006211180124224,16100,17050,950,1070930
21092,990,2019-09-17,0.04262295081967213,15250,15900,650,930217
21093,990,2019-08-09,0.07196969696969698,13200,14150,950,1326060
21094,990,2019-08-05,0.05660377358490566,13250,12500,-750,633966
21095,990,2019-07-29,0.040145985401459854,13700,13150,-550,447346
21096,990,2019-07-15,0.040293040293040296,13650,14200,550,1695873
21097,990,2019-07-08,0.13071895424836602,15300,13300,-2000,1962498
21098,990,2019-07-02,0.06711409395973154,14900,15900,1000,1647526
21099,990,2019-06-18,0.05263157894736842,16150,15300,-850,1564559
21100,990,2019-06-17,0.045307443365695796,15450,16150,700,1407383
21101,990,2019-06-12,0.0472972972972973,14800,15500,700,1312870
21102,990,2019-05-21,0.05102040816326531,14700,15450,750,879616
21103,990,2019-05-17,0.042704626334519574,14050,14650,600,2103088
21104,990,2019-05-09,0.07540983606557378,15250,14100,-1150,1156451
21105,990,2019-05-07,0.040123456790123455,16200,15550,-650,643953
21106,990,2019-04-30,0.0457516339869281,15300,16000,700,948780
21107,990,2019-04-19,0.09225092250922509,13550,14800,1250,2393462
21108,990,2019-04-18,0.04240282685512368,14150,13550,-600,427069
21109,990,2019-04-17,0.05204460966542751,13450,14150,700,590731
21110,990,2019-04-03,0.08139534883720931,12900,13950,1050,1094513
21111,990,2019-04-01,0.04,12500,13000,500,469412
21112,990,2019-03-12,0.060085836909871244,11650,12350,700,298882
21113,990,2019-02-15,0.04477611940298507,13400,12800,-600,417805
21114,990,2019-02-14,0.05928853754940711,12650,13400,750,1193800
21115,990,2019-01-31,0.051470588235294115,13600,12900,-700,840384
21116,990,2019-01-30,0.07936507936507936,12600,13600,1000,1363435
21117,990,2019-01-29,0.05,12000,12600,600,695071
21118,990,2019-01-25,0.1050228310502283,10950,12100,1150,888300
21119,990,2019-01-21,0.08450704225352113,10650,11550,900,514170
21120,990,2018-12-14,0.04329004329004329,11550,11050,-500,205340
21121,990,2018-12-06,0.04310344827586207,11600,11100,-500,284946
21122,990,2018-12-03,0.0425531914893617,11750,12250,500,244661
21123,990,2018-11-02,0.08771929824561403,11400,12400,1000,692479
21124,990,2018-10-30,0.06763285024154589,10350,11050,700,753733
21125,990,2018-10-29,0.08,11250,10350,-900,574121
21126,990,2018-10-25,0.06995884773662552,12150,11300,-850,907332
21127,990,2018-10-23,0.0622568093385214,12850,12050,-800,657153
21128,990,2018-10-22,0.06204379562043796,13700,12850,-850,529913
21129,990,2018-10-12,0.049429657794676805,13150,13800,650,306748
21130,990,2018-10-11,0.0539568345323741,13900,13150,-750,528154
21131,990,2018-08-21,0.046296296296296294,16200,16950,750,432716
21132,990,2018-08-14,0.04180064308681672,15550,16200,650,678975
21133,990,2018-08-09,0.05309734513274336,16950,16050,-900,564644
21134,990,2018-08-08,0.052795031055900624,16100,16950,850,732463
21135,990,2018-07-30,0.045584045584045586,17550,16750,-800,427182
21136,990,2018-07-27,0.06363636363636363,16500,17550,1050,531542
21137,990,2018-07-26,0.04899135446685879,17350,16500,-850,781913
21138,990,2018-07-23,0.06318681318681318,18200,17050,-1150,624655
21139,990,2018-06-28,0.051597051597051594,20350,19300,-1050,730835
21140,990,2018-06-25,0.050724637681159424,20700,19650,-1050,1086546
21141,990,2018-06-22,0.07253886010362694,19300,20700,1400,926976
21142,990,2018-06-05,0.08163265306122448,17150,18550,1400,2225637
21143,990,2018-05-30,0.050314465408805034,15900,16700,800,1279355
21144,990,2018-04-23,0.06206896551724138,14500,13600,-900,738609
21145,990,2018-04-12,0.06273062730627306,13550,14400,850,560782
21146,990,2018-04-05,0.04460966542750929,13450,14050,600,558470
21147,990,2018-04-04,0.04609929078014184,14100,13450,-650,498210
21148,990,2018-04-02,0.04067796610169491,14750,14150,-600,1074305
21149,990,2018-03-23,0.0701219512195122,16400,15250,-1150,683507
21150,990,2018-03-16,0.08090614886731391,15450,16700,1250,1330921
21151,990,2018-02-01,0.057432432432432436,14800,15650,850,1857832
21152,990,2018-01-31,0.08823529411764706,13600,14800,1200,2730565
21153,990,2018-01-23,0.058365758754863814,12850,13600,750,1003121
21154,990,2018-01-18,0.13247863247863248,11700,13250,1550,1799188
21155,990,2017-12-21,0.05439330543933055,11950,11300,-650,563731
21156,990,2017-11-24,0.06367041198501873,13350,14200,850,1208696
21157,990,2017-11-21,0.06115107913669065,13900,13050,-850,1644134
21158,990,2017-10-20,0.04498269896193772,14450,15100,650,902653
21159,990,2017-10-17,0.07194244604316546,13900,14900,1000,947880
21160,990,2017-09-11,0.05263157894736842,14250,15000,750,1118955
21161,990,2017-09-07,0.0949367088607595,15800,14300,-1500,2184753
21162,990,2017-08-17,0.06441717791411043,16300,17350,1050,1071862
21163,990,2017-08-03,0.05235602094240838,19100,18100,-1000,754563
21164,990,2017-07-26,0.06280193236714976,20700,19400,-1300,1364097
21165,990,2017-06-19,0.06060606060606061,21450,22750,1300,1680968
21166,990,2017-06-09,0.10194174757281553,20600,22700,2100,2786053
21167,990,2017-05-22,0.04455445544554455,20200,21100,900,855244
21168,990,2017-04-25,0.0405727923627685,20950,21800,850,670268
21169,990,2017-04-07,0.050761421319796954,19700,20700,1000,7750420
21170,990,2017-04-03,0.06544502617801047,19100,20350,1250,1202298
21171,990,2017-02-15,0.04143646408839779,18100,18850,750,969711
21172,990,2017-02-14,0.05847953216374269,17100,18100,1000,923137
21173,990,2017-02-09,0.05405405405405406,16650,17550,900,530383
21174,990,2017-01-03,0.05828220858895705,16300,17250,950,945384
21175,990,2016-12-13,0.04777070063694268,15700,16450,750,263343
21176,990,2016-11-16,0.04819277108433735,16600,17400,800,426849
21177,990,2016-11-07,0.05642633228840126,15950,16850,900,281813
21178,990,2016-11-01,0.04105571847507331,17050,16350,-700,494228
21179,990,2016-10-18,0.05084745762711865,17700,18600,900,584672
21180,990,2016-09-29,0.058823529411764705,17000,18000,1000,684701
21181,990,2016-08-29,0.05042016806722689,17850,16950,-900,682161
21182,990,2016-08-16,0.04950495049504951,20200,19200,-1000,876910
21183,990,2016-08-08,0.0549738219895288,19100,20150,1050,1558441
21184,990,2016-08-04,0.0443213296398892,18050,18850,800,781678
21185,112610,2021-06-01,0.05006587615283267,75900,79700,3800,753942
21186,112610,2021-05-25,0.07142857142857142,70000,75000,5000,737267
21187,112610,2021-05-13,0.04027777777777778,72000,69100,-2900,476834
21188,112610,2021-05-11,0.040106951871657755,74800,71800,-3000,542896
21189,112610,2021-05-06,0.06392045454545454,70400,74900,4500,865694
21190,112610,2021-05-03,0.06623376623376623,77000,71900,-5100,614733
21191,112610,2021-04-30,0.0504774897680764,73300,77000,3700,627250
21192,112610,2021-04-28,0.05141388174807198,77800,73800,-4000,853737
21193,112610,2021-04-27,0.04656862745098039,81600,77800,-3800,985287
21194,112610,2021-04-16,0.05334987593052109,80600,84900,4300,1176190
21195,112610,2021-04-09,0.041719342604298354,79100,82400,3300,1341612
21196,112610,2021-04-08,0.04768211920529802,75500,79100,3600,1134930
21197,112610,2021-03-26,0.047685834502103785,71300,74700,3400,956513
21198,112610,2021-03-24,0.05319148936170213,65800,69300,3500,743186
21199,112610,2021-03-12,0.10077519379844961,64500,71000,6500,1900314
21200,112610,2021-03-10,0.057283142389525366,61100,64600,3500,2328499
21201,112610,2021-03-09,0.042662116040955635,58600,61100,2500,2165447
21202,112610,2021-03-08,0.09428129829984544,64700,58600,-6100,1797469
21203,112610,2021-03-04,0.05397727272727273,70400,66600,-3800,552757
21204,112610,2021-02-25,0.041428571428571426,70000,72900,2900,415519
21205,112610,2021-02-24,0.047619047619047616,73500,70000,-3500,419634
21206,112610,2021-02-23,0.045454545454545456,77000,73500,-3500,680172
21207,112610,2021-02-22,0.06097560975609756,82000,77000,-5000,749154
21208,112610,2021-02-01,0.075,160000,172000,12000,239608
21209,112610,2021-01-29,0.050445103857566766,168500,160000,-8500,307406
21210,112610,2021-01-20,0.0463768115942029,172500,180500,8000,559117
21211,112610,2021-01-19,0.08490566037735849,159000,172500,13500,333102
21212,112610,2020-12-30,0.05357142857142857,168000,177000,9000,323826
21213,112610,2020-12-22,0.06017191977077364,174500,155000,-19500,561087
21214,112610,2020-12-17,0.05970149253731343,167500,177500,10000,492802
21215,112610,2020-12-16,0.09836065573770492,152500,167500,15000,492773
21216,112610,2020-12-09,0.11290322580645161,124000,138000,14000,1170385
21217,112610,2020-11-18,0.0759493670886076,118500,127500,9000,686100
21218,112610,2020-11-11,0.0648854961832061,131000,122500,-8500,548285
21219,112610,2020-11-09,0.15486725663716813,113000,130500,17500,1067142
21220,112610,2020-11-06,0.06103286384976526,106500,113000,6500,834012
21221,112610,2020-11-05,0.0790273556231003,98700,106500,7800,993812
21222,112610,2020-11-04,0.09863013698630137,109500,98700,-10800,1726951
21223,112610,2020-11-02,0.06820461384152457,99700,106500,6800,319396
21224,112610,2020-10-30,0.054976303317535544,105500,99700,-5800,220953
21225,112610,2020-10-28,0.07995846313603323,96300,104000,7700,424320
21226,112610,2020-10-26,0.07192118226600985,101500,94200,-7300,365825
21227,112610,2020-10-20,0.054490413723511606,99100,104500,5400,408417
21228,112610,2020-10-19,0.04251207729468599,103500,99100,-4400,298149
21229,112610,2020-10-16,0.04608294930875576,108500,103500,-5000,381871
21230,112610,2020-10-13,0.058091286307053944,120500,113500,-7000,405525
21231,112610,2020-10-06,0.07009345794392523,107000,114500,7500,457751
21232,112610,2020-10-05,0.07971745711402624,99100,107000,7900,707469
21233,112610,2020-09-28,0.0881104033970276,94200,102500,8300,293477
21234,112610,2020-09-22,0.08597285067873303,110500,101000,-9500,516436
21235,112610,2020-09-08,0.07053941908713693,120500,112000,-8500,825035
21236,112610,2020-09-04,0.12857142857142856,105000,118500,13500,1729769
21237,112610,2020-09-03,0.07692307692307693,97500,105000,7500,539146
21238,112610,2020-09-01,0.04390243902439024,102500,98000,-4500,357416
21239,112610,2020-08-31,0.08350951374207188,94600,102500,7900,548152
21240,112610,2020-08-28,0.08486238532110092,87200,94600,7400,675080
21241,112610,2020-08-24,0.06025641025641026,78000,82700,4700,422881
21242,112610,2020-08-14,0.0492379835873388,85300,81100,-4200,365726
21243,112610,2020-08-12,0.04523227383863081,81800,85500,3700,605360
21244,112610,2020-08-07,0.04066985645933014,83600,80200,-3400,473483
21245,112610,2020-08-05,0.043037974683544304,79000,82400,3400,351599
21246,112610,2020-07-30,0.15879828326180256,69900,81000,11100,1459297
21247,112610,2020-07-28,0.051094890510948905,68500,72000,3500,474131
21248,112610,2020-07-24,0.04630969609261939,69100,65900,-3200,467848
21249,112610,2020-07-21,0.14832535885167464,62700,72000,9300,2247669
21250,112610,2020-07-20,0.06271186440677966,59000,62700,3700,947742
21251,112610,2020-07-16,0.07992565055762081,53800,58100,4300,768400
21252,112610,2020-07-07,0.09574468085106383,47000,51500,4500,1455532
21253,112610,2020-07-06,0.056179775280898875,44500,47000,2500,497132
21254,112610,2020-07-03,0.05952380952380952,42000,44500,2500,347933
21255,112610,2020-06-26,0.05044136191677175,39650,41650,2000,1111487
21256,112610,2020-06-19,0.06784260515603799,36850,39350,2500,126311
21257,112610,2020-06-16,0.04,35000,36400,1400,51786
21258,112610,2020-06-15,0.0944372574385511,38650,35000,-3650,115495
21259,112610,2020-05-26,0.04539559014267185,38550,40300,1750,261549
21260,112610,2020-05-25,0.0649171270718232,36200,38550,2350,122169
21261,112610,2020-05-22,0.0461133069828722,37950,36200,-1750,144884
21262,112610,2020-05-21,0.06153846153846154,35750,37950,2200,705392
21263,112610,2020-05-11,0.04671532846715328,34250,35850,1600,67680
21264,112610,2020-04-27,0.06271186440677966,29500,31350,1850,64533
21265,112610,2020-04-02,0.056074766355140186,26750,28250,1500,43456
21266,112610,2020-03-26,0.08571428571428572,24500,26600,2100,99275
21267,112610,2020-03-25,0.07929515418502203,22700,24500,1800,73997
21268,112610,2020-03-20,0.1649746192893401,19700,22950,3250,101788
21269,112610,2020-03-19,0.14161220043572983,22950,19700,-3250,359823
21270,112610,2020-03-18,0.0874751491053678,25150,22950,-2200,73623
21271,112610,2020-03-17,0.043726235741444866,26300,25150,-1150,108511
21272,112610,2020-03-16,0.09621993127147767,29100,26300,-2800,71750
21273,112610,2020-03-12,0.07790143084260731,31450,29000,-2450,104597
21274,112610,2020-03-11,0.041158536585365856,32800,31450,-1350,71406
21275,112610,2020-03-09,0.08209959623149395,37150,34100,-3050,72392
21276,112610,2020-02-24,0.04319371727748691,38200,36550,-1650,49189
21277,112610,2020-02-05,0.04907161803713528,37700,39550,1850,112510
21278,112610,2020-01-16,0.04057591623036649,38200,39750,1550,61836
21279,112610,2019-11-13,0.04625850340136054,36750,38450,1700,123026
21280,112610,2019-11-12,0.041720990873533245,38350,36750,-1600,163411
21281,112610,2019-11-08,0.0993006993006993,35750,39300,3550,381084
21282,112610,2019-11-07,0.05457227138643068,33900,35750,1850,161149
21283,112610,2019-11-01,0.05206738131699847,32650,34350,1700,97601
21284,112610,2019-08-26,0.051118210862619806,31300,29700,-1600,44963
21285,112610,2019-08-07,0.0931098696461825,26850,29350,2500,219432
21286,112610,2019-08-06,0.105,30000,26850,-3150,284810
21287,112610,2019-08-05,0.05362776025236593,31700,30000,-1700,102439
21288,112610,2019-07-26,0.04488078541374474,35650,34050,-1600,99838
21289,112610,2019-07-17,0.07317073170731707,38950,36100,-2850,268914
21290,112610,2019-07-05,0.04964539007092199,42300,40200,-2100,206812
21291,112610,2019-06-13,0.06002554278416347,39150,41500,2350,105860
21292,112610,2019-06-05,0.04285714285714286,38500,40150,1650,127429
21293,112610,2019-06-04,0.04904632152588556,36700,38500,1800,82519
21294,112610,2019-06-03,0.045584045584045586,35100,36700,1600,55689
21295,112610,2019-05-29,0.04935064935064935,38500,36600,-1900,82570
21296,112610,2019-05-02,0.06561679790026247,38100,40600,2500,162474
21297,112610,2019-04-19,0.04773869346733668,39800,37900,-1900,156717
21298,112610,2019-04-17,0.06727037516170763,38650,41250,2600,450965
21299,112610,2019-04-12,0.04068241469816273,38100,39650,1550,143766
21300,112610,2019-03-20,0.06588579795021962,34150,36400,2250,317490
21301,112610,2019-03-19,0.04915514592933948,32550,34150,1600,247006
21302,112610,2019-03-05,0.06035889070146819,30650,32500,1850,122901
21303,112610,2018-12-27,0.04431599229287091,25950,27100,1150,71483
21304,112610,2018-12-03,0.05410122164048865,28650,30200,1550,85511
21305,112610,2018-11-27,0.0430622009569378,31350,30000,-1350,142183
21306,112610,2018-10-31,0.04679376083188908,28850,30200,1350,87828
21307,112610,2018-10-30,0.04528985507246377,27600,28850,1250,82387
21308,112610,2018-10-29,0.061224489795918366,29400,27600,-1800,91335
21309,112610,2018-10-24,0.06230031948881789,31300,29350,-1950,44917
21310,112610,2018-10-11,0.0563165905631659,32850,31000,-1850,145778
21311,112610,2018-10-08,0.052478134110787174,34300,32500,-1800,58970
21312,112610,2018-09-21,0.0572289156626506,33200,35100,1900,304317
21313,112610,2018-09-07,0.05378151260504202,29750,31350,1600,192729
21314,112610,2018-09-06,0.05309734513274336,28250,29750,1500,86900
21315,112610,2018-08-17,0.051056338028169015,28400,29850,1450,212196
21316,112610,2018-08-16,0.08812260536398467,26100,28400,2300,135345
21317,112610,2018-08-13,0.05263157894736842,27550,26100,-1450,46639
21318,112610,2018-07-24,0.06841046277665996,24850,26550,1700,91949
21319,112610,2018-07-02,0.0641025641025641,27300,25550,-1750,119454
21320,112610,2018-06-25,0.04930966469428008,25350,26600,1250,68639
21321,112610,2018-06-19,0.08487084870848709,27100,24800,-2300,257175
21322,112610,2018-06-18,0.04912280701754386,28500,27100,-1400,165774
21323,112610,2018-06-05,0.05169340463458111,28050,26600,-1450,416651
21324,112610,2018-05-29,0.08742331288343558,32600,29750,-2850,1868423
21325,112610,2018-05-16,0.06406685236768803,35900,33600,-2300,134112
21326,112610,2018-05-10,0.08035714285714286,33600,36300,2700,216618
21327,112610,2018-05-08,0.056179775280898875,35600,33600,-2000,99666
21328,112610,2018-05-02,0.08108108108108109,33300,36000,2700,152301
21329,112610,2018-04-25,0.046686746987951805,33200,31650,-1550,42706
21330,112610,2018-04-09,0.04252199413489736,34100,32650,-1450,61035
21331,112610,2018-03-21,0.04491017964071856,33400,31900,-1500,90037
21332,112610,2018-03-12,0.0641399416909621,34300,36500,2200,74075
21333,112610,2018-03-05,0.059743954480796585,35150,33050,-2100,61836
21334,112610,2018-02-21,0.07124681933842239,39300,36500,-2800,149564
21335,112610,2018-02-19,0.06301369863013699,36500,38800,2300,154491
21336,112610,2018-02-12,0.048295454545454544,35200,36900,1700,73860
21337,112610,2018-01-29,0.05370101596516691,34450,36300,1850,172909
21338,112610,2018-01-23,0.08018867924528301,31800,34350,2550,234313
21339,112610,2018-01-10,0.04208754208754209,29700,30950,1250,126887
21340,112610,2018-01-04,0.05166051660516605,27100,28500,1400,164921
21341,112610,2018-01-02,0.04198473282442748,26200,27300,1100,100639
21342,112610,2017-12-20,0.04961832061068702,26200,24900,-1300,139323
21343,112610,2017-12-13,0.07770961145194274,24450,26350,1900,215091
21344,112610,2017-12-07,0.04106776180698152,24350,25350,1000,194717
21345,112610,2017-12-05,0.04421052631578947,23750,24800,1050,107428
21346,112610,2017-11-27,0.051181102362204724,25400,24100,-1300,77627
21347,112610,2017-11-02,0.04339622641509434,26500,25350,-1150,77664
21348,112610,2017-10-25,0.055449330783938815,26150,27600,1450,223089
21349,112610,2017-09-21,0.06336633663366337,25250,23650,-1600,55173
21350,112610,2017-09-12,0.0718562874251497,25050,26850,1800,210663
21351,112610,2017-09-04,0.043478260869565216,27600,26400,-1200,78833
21352,112610,2017-08-22,0.05027932960893855,26850,28200,1350,61709
21353,112610,2017-08-09,0.05460750853242321,29300,27700,-1600,72653
21354,112610,2017-08-01,0.08022388059701492,26800,28950,2150,139739
21355,112610,2017-07-28,0.041666666666666664,28800,27600,-1200,67007
21356,112610,2017-07-20,0.10877192982456141,28500,31600,3100,448927
21357,112610,2017-07-03,0.05989110707803993,27550,25900,-1650,85270
21358,112610,2017-06-26,0.08269230769230769,26000,28150,2150,149549
21359,112610,2017-06-19,0.05371900826446281,24200,25500,1300,121891
21360,112610,2017-05-23,0.049145299145299144,23400,24550,1150,77385
21361,112610,2017-05-18,0.0515695067264574,22300,23450,1150,104087
21362,112610,2017-05-10,0.04714640198511166,20150,21100,950,55404
21363,112610,2017-03-16,0.04142011834319527,16900,17600,700,85077
21364,112610,2016-11-09,0.18237704918032788,24400,19950,-4450,412256
21365,112610,2016-11-07,0.06739130434782609,23000,24550,1550,182293
21366,112610,2016-11-02,0.06910569105691057,24600,22900,-1700,100912
21367,112610,2016-10-31,0.0425531914893617,25850,24750,-1100,105669
21368,112610,2016-10-24,0.0513347022587269,24350,25600,1250,112132
21369,112610,2016-08-26,0.062264150943396226,26500,24850,-1650,197627
21370,112610,2016-08-10,0.046296296296296294,27000,25750,-1250,203110
21371,112610,2016-08-08,0.04580152671755725,26200,27400,1200,258048
21372,112610,2016-08-02,0.04819277108433735,24900,26100,1200,369093
21373,16360,2021-05-10,0.067816091954023,43500,46450,2950,1975873
21374,16360,2021-01-29,0.050314465408805034,39750,37750,-2000,908488
21375,16360,2020-12-29,0.056778679026651215,43150,40700,-2450,1383425
21376,16360,2020-11-23,0.040522875816993466,38250,39800,1550,874201
21377,16360,2020-11-16,0.0851063829787234,35250,38250,3000,1591487
21378,16360,2020-11-11,0.053019145802650956,33950,35750,1800,1014117
21379,16360,2020-09-02,0.04361873990306947,30950,32300,1350,1407330
21380,16360,2020-08-25,0.05714285714285714,29750,31450,1700,735176
21381,16360,2020-08-18,0.051643192488262914,31950,30300,-1650,1017382
21382,16360,2020-08-10,0.06109324758842444,31100,33000,1900,1479089
21383,16360,2020-07-13,0.04119850187265917,26700,27800,1100,524846
21384,16360,2020-06-16,0.051094890510948905,27400,28800,1400,532143
21385,16360,2020-06-15,0.04861111111111111,28800,27400,-1400,807920
21386,16360,2020-06-03,0.06070826306913996,29650,31450,1800,2022916
21387,16360,2020-06-02,0.0421792618629174,28450,29650,1200,1489653
21388,16360,2020-04-29,0.05985915492957746,28400,30100,1700,1420001
21389,16360,2020-04-17,0.051001821493624776,27450,28850,1400,1078805
21390,16360,2020-04-06,0.05128205128205128,27300,28700,1400,611532
21391,16360,2020-04-01,0.07155025553662692,29350,27250,-2100,676657
21392,16360,2020-03-25,0.1734475374732334,23350,27400,4050,1109536
21393,16360,2020-03-24,0.12259615384615384,20800,23350,2550,1006296
21394,16360,2020-03-23,0.1297071129707113,23900,20800,-3100,1010313
21395,16360,2020-03-19,0.14385964912280702,28500,24400,-4100,789228
21396,16360,2020-03-16,0.042993630573248405,31400,30050,-1350,563171
21397,16360,2020-01-28,0.045931758530183726,38100,36350,-1750,390860
21398,16360,2019-08-08,0.04227405247813411,34300,35750,1450,387890
21399,16360,2019-07-03,0.04219948849104859,39100,37450,-1650,358240
21400,16360,2019-01-24,0.045454545454545456,33000,34500,1500,641456
21401,16360,2018-11-02,0.08113207547169811,26500,28650,2150,651365
21402,16360,2018-10-11,0.0594059405940594,30300,28500,-1800,734021
21403,16360,2018-04-10,0.04435483870967742,37200,35550,-1650,3379449
21404,16360,2018-03-23,0.06016847172081829,41550,39050,-2500,651041
21405,16360,2018-03-12,0.04239401496259352,40100,41800,1700,424952
21406,16360,2018-02-12,0.04,40000,41600,1600,453043
21407,16360,2018-01-23,0.05493133583021224,40050,42250,2200,1195687
21408,16360,2018-01-12,0.04111405835543767,37700,39250,1550,933490
21409,16360,2017-10-12,0.05722460658082976,34950,36950,2000,841801
21410,16360,2017-01-26,0.050473186119873815,31700,33300,1600,509266
21411,16360,2016-12-21,0.049107142857142856,33600,31950,-1650,1103709
21412,23530,2021-05-11,0.06563706563706563,129500,121000,-8500,667395
21413,23530,2021-03-23,0.04296875,128000,122500,-5500,266529
21414,23530,2021-03-10,0.04182509505703422,131500,126000,-5500,192339
21415,23530,2021-03-03,0.05761316872427984,121500,128500,7000,422277
21416,23530,2021-02-24,0.04417670682730924,124500,119000,-5500,282217
21417,23530,2021-02-08,0.049773755656108594,110500,116000,5500,236573
21418,23530,2021-01-18,0.06276150627615062,119500,112000,-7500,260063
21419,23530,2021-01-12,0.091324200913242,109500,119500,10000,717104
21420,23530,2021-01-08,0.06572769953051644,106500,113500,7000,511602
21421,23530,2020-11-20,0.04446742502585315,96700,101000,4300,304035
21422,23530,2020-11-10,0.04,90000,93600,3600,367877
21423,23530,2020-11-09,0.04895104895104895,85800,90000,4200,322993
21424,23530,2020-10-19,0.06942889137737962,89300,95500,6200,588516
21425,23530,2020-10-13,0.041237113402061855,87300,90900,3600,380493
21426,23530,2020-10-12,0.05818181818181818,82500,87300,4800,453748
21427,23530,2020-08-18,0.06413301662707839,84200,78800,-5400,239963
21428,23530,2020-08-12,0.043532338308457715,80400,83900,3500,363305
21429,23530,2020-06-30,0.04467805519053877,76100,79500,3400,204835
21430,23530,2020-06-16,0.04868913857677903,80100,84000,3900,87295
21431,23530,2020-06-15,0.05985915492957746,85200,80100,-5100,163098
21432,23530,2020-06-12,0.051224944320712694,89800,85200,-4600,211358
21433,23530,2020-04-29,0.04038461538461539,104000,99800,-4200,327951
21434,23530,2020-04-28,0.07660455486542443,96600,104000,7400,660292
21435,23530,2020-04-27,0.14049586776859505,84700,96600,11900,496867
21436,23530,2020-04-08,0.09414758269720101,78600,86000,7400,364161
21437,23530,2020-04-02,0.05056179775280899,71200,74800,3600,137747
21438,23530,2020-04-01,0.050666666666666665,75000,71200,-3800,115342
21439,23530,2020-03-25,0.1338709677419355,62000,70300,8300,542774
21440,23530,2020-03-24,0.0634648370497427,58300,62000,3700,228180
21441,23530,2020-03-23,0.0804416403785489,63400,58300,-5100,188896
21442,23530,2020-03-20,0.047933884297520664,60500,63400,2900,255489
21443,23530,2020-03-19,0.1357142857142857,70000,60500,-9500,321396
21444,23530,2020-03-18,0.05913978494623656,74400,70000,-4400,176478
21445,23530,2020-03-13,0.05121951219512195,82000,77800,-4200,331997
21446,23530,2020-03-12,0.08277404921700224,89400,82000,-7400,377755
21447,23530,2020-03-06,0.043478260869565216,98900,94600,-4300,192281
21448,23530,2020-02-24,0.05167464114832536,104500,99100,-5400,268506
21449,23530,2020-02-20,0.044642857142857144,112000,107000,-5000,193999
21450,23530,2020-02-14,0.0411522633744856,121500,116500,-5000,224033
21451,23530,2020-01-28,0.07307692307692308,130000,120500,-9500,243214
21452,23530,2020-01-13,0.05058365758754864,128500,135000,6500,169220
21453,23530,2019-11-28,0.04633204633204633,129500,135500,6000,144894
21454,23530,2019-11-06,0.04597701149425287,130500,136500,6000,189803
21455,23530,2019-11-04,0.061224489795918366,122500,130000,7500,178989
21456,23530,2019-09-27,0.05128205128205128,136500,129500,-7000,161883
21457,23530,2019-08-28,0.041666666666666664,132000,137500,5500,140746
21458,23530,2019-08-19,0.04564315352697095,120500,126000,5500,90160
21459,23530,2019-08-05,0.041353383458646614,133000,127500,-5500,177101
21460,23530,2019-07-15,0.047619047619047616,147000,140000,-7000,224319
21461,23530,2019-07-09,0.04126984126984127,157500,151000,-6500,148883
21462,23530,2019-01-02,0.04028436018957346,211000,202500,-8500,96043
21463,23530,2018-11-19,0.04128440366972477,218000,227000,9000,139499
21464,23530,2018-09-20,0.04030226700251889,198500,206500,8000,189262
21465,23530,2018-09-13,0.06149732620320856,187000,198500,11500,291810
21466,23530,2018-08-16,0.04712041884816754,191000,182000,-9000,213952
21467,23530,2018-08-13,0.07090464547677261,204500,190000,-14500,303251
21468,23530,2018-07-06,0.046341463414634146,205000,214500,9500,105502
21469,23530,2018-05-03,0.051181102362204724,254000,241000,-13000,119180
21470,23530,2018-04-02,0.06609808102345416,234500,250000,15500,347397
21471,23530,2018-03-09,0.07092198581560284,211500,226500,15000,333207
21472,23530,2018-03-08,0.06281407035175879,199000,211500,12500,170712
21473,23530,2018-02-13,0.04157549234135667,228500,219000,-9500,151094
21474,23530,2018-02-09,0.078,250000,230500,-19500,333896
21475,23530,2018-02-08,0.041666666666666664,240000,250000,10000,152505
21476,23530,2018-02-07,0.060665362035225046,255500,240000,-15500,196133
21477,23530,2018-01-26,0.05506607929515418,227000,239500,12500,246252
21478,23530,2018-01-04,0.061124694376528114,204500,217000,12500,367139
21479,23530,2017-11-22,0.044444444444444446,225000,215000,-10000,659011
21480,23530,2017-11-20,0.040268456375838924,223500,232500,9000,157374
21481,23530,2017-11-03,0.043478260869565216,218500,228000,9500,133209
21482,23530,2017-10-31,0.07142857142857142,210000,225000,15000,608422
21483,23530,2017-10-30,0.06490872210953347,246500,210000,-36500,860328
21484,23530,2017-09-26,0.0835214446952596,221500,240000,18500,321780
21485,23530,2017-09-20,0.045454545454545456,231000,220500,-10500,227991
21486,23530,2017-09-15,0.08409090909090909,220000,238500,18500,542868
21487,23530,2017-09-01,0.05252918287937743,257000,243500,-13500,260659
21488,23530,2017-08-30,0.042435424354243544,271000,259500,-11500,141980
21489,23530,2017-08-21,0.04299065420560748,267500,256000,-11500,92616
21490,23530,2017-08-17,0.09202453987730061,244500,267000,22500,200423
21491,23530,2017-08-14,0.04061895551257253,258500,248000,-10500,115619
21492,23530,2017-07-31,0.08521739130434783,287500,263000,-24500,315387
21493,23530,2017-06-27,0.054514480408858604,293500,309500,16000,107378
21494,23530,2017-06-08,0.04222972972972973,296000,308500,12500,191370
21495,23530,2017-06-02,0.04363001745200698,286500,299000,12500,135212
21496,23530,2017-05-15,0.04961832061068702,262000,275000,13000,229290
21497,23530,2017-04-27,0.05304518664047151,254500,268000,13500,580374
21498,23530,2017-04-21,0.04477611940298507,234500,245000,10500,366929
21499,23530,2017-04-20,0.044543429844097995,224500,234500,10000,204953
21500,23530,2017-03-02,0.0735930735930736,231000,214000,-17000,407547
21501,23530,2017-02-17,0.0610236220472441,254000,238500,-15500,2679038
21502,23530,2017-02-10,0.06073752711496746,230500,244500,14000,165488
21503,23530,2017-01-20,0.050808314087759814,216500,227500,11000,253840
21504,23530,2016-12-15,0.04100227790432802,219500,228500,9000,75276
21505,23530,2016-11-07,0.05251141552511415,219000,230500,11500,116370
21506,23530,2016-08-16,0.05303030303030303,198000,208500,10500,206716
21507,267250,2021-06-01,0.06382978723404255,70500,75000,4500,615920
21508,267250,2021-05-06,0.09784172661870504,69500,76300,6800,877025
21509,267250,2021-04-26,0.08517887563884156,58700,63700,5000,1146567
21510,267250,2021-03-26,0.07380073800738007,271000,291000,20000,189015
21511,267250,2021-02-23,0.07293666026871401,260500,279500,19000,174483
21512,267250,2020-12-29,0.08791208791208792,318500,290500,-28000,211631
21513,267250,2020-12-11,0.06082289803220036,279500,296500,17000,129829
21514,267250,2020-11-24,0.043151969981238276,266500,278000,11500,111471
21515,267250,2020-11-10,0.06652360515021459,233000,248500,15500,184771
21516,267250,2020-11-09,0.04954954954954955,222000,233000,11000,100959
21517,267250,2020-09-24,0.04018912529550828,211500,203000,-8500,64132
21518,267250,2020-09-11,0.049217002237136466,223500,234500,11000,143819
21519,267250,2020-08-20,0.05788423153692615,250500,236000,-14500,54402
21520,267250,2020-08-18,0.04961832061068702,262000,249000,-13000,64495
21521,267250,2020-08-12,0.0465587044534413,247000,258500,11500,99252
21522,267250,2020-08-11,0.06465517241379311,232000,247000,15000,125277
21523,267250,2020-06-16,0.05858585858585859,247500,262000,14500,48173
21524,267250,2020-06-15,0.07649253731343283,268000,247500,-20500,69515
21525,267250,2020-06-12,0.056338028169014086,284000,268000,-16000,59806
21526,267250,2020-05-06,0.05319148936170213,235000,247500,12500,76150
21527,267250,2020-04-29,0.05194805194805195,231000,243000,12000,94372
21528,267250,2020-04-06,0.08254716981132075,212000,229500,17500,85548
21529,267250,2020-04-02,0.06683804627249357,194500,207500,13000,67324
21530,267250,2020-03-25,0.150997150997151,175500,202000,26500,94644
21531,267250,2020-03-24,0.09345794392523364,160500,175500,15000,82377
21532,267250,2020-03-23,0.12295081967213115,183000,160500,-22500,75290
21533,267250,2020-03-20,0.04871060171919771,174500,183000,8500,118677
21534,267250,2020-03-19,0.14039408866995073,203000,174500,-28500,133794
21535,267250,2020-03-18,0.053613053613053616,214500,203000,-11500,75783
21536,267250,2020-03-13,0.06521739130434782,230000,215000,-15000,160753
21537,267250,2020-03-12,0.06504065040650407,246000,230000,-16000,96272
21538,267250,2020-03-09,0.05649717514124294,265500,250500,-15000,66760
21539,267250,2020-03-06,0.05178571428571429,280000,265500,-14500,99221
21540,267250,2020-02-24,0.051601423487544484,281000,266500,-14500,49783
21541,267250,2020-02-21,0.04584040747028863,294500,281000,-13500,60200
21542,267250,2020-02-06,0.15849056603773584,265000,307000,42000,172533
21543,267250,2020-01-28,0.04785478547854786,303000,288500,-14500,53520
21544,267250,2019-12-27,0.04722222222222222,360000,343000,-17000,67719
21545,267250,2019-08-19,0.04340567612687813,299500,312500,13000,27872
21546,267250,2019-07-25,0.04302670623145401,337000,322500,-14500,52695
21547,267250,2019-07-04,0.046583850931677016,322000,337000,15000,42022
21548,267250,2019-01-31,0.043941411451398134,375500,359000,-16500,224522
21549,267250,2018-11-06,0.043010752688172046,372000,388000,16000,39876
21550,267250,2018-11-02,0.06204906204906205,346500,368000,21500,44295
21551,267250,2018-10-26,0.04709141274238227,361000,344000,-17000,38872
21552,267250,2018-10-11,0.05063291139240506,395000,375000,-20000,54965
21553,267250,2018-10-08,0.04600484261501211,413000,394000,-19000,44915
21554,267250,2018-08-03,0.060294117647058824,340000,360500,20500,100101
21555,267250,2018-08-01,0.040238450074515646,335500,349000,13500,48443
21556,267250,2018-07-26,0.05164992826398852,348500,330500,-18000,138093
21557,267250,2018-07-02,0.04101838755304102,353500,339000,-14500,51785
21558,267250,2018-06-19,0.04336043360433604,369000,353000,-16000,61749
21559,267250,2018-06-14,0.05188067444876784,385500,365500,-20000,170418
21560,267250,2018-05-30,0.042821158690176324,397000,380000,-17000,74150
21561,267250,2018-05-10,0.05997552019583843,408500,433000,24500,74068
21562,267250,2018-04-26,0.04596273291925466,402500,421000,18500,43114
21563,267250,2018-03-13,0.043673012318029114,446500,427000,-19500,68734
21564,267250,2018-03-06,0.05575326215895611,421500,445000,23500,57857
21565,267250,2018-02-13,0.07647058823529412,425000,392500,-32500,224453
21566,267250,2018-02-09,0.05327413984461709,450500,426500,-24000,87509
21567,267250,2018-01-29,0.044967880085653104,467000,488000,21000,110533
21568,267250,2018-01-23,0.04398148148148148,432000,451000,19000,73811
21569,267250,2018-01-04,0.04196642685851319,417000,434500,17500,217691
21570,267250,2018-01-02,0.08792650918635171,381000,414500,33500,145399
21571,267250,2017-12-28,0.056865464632454926,360500,381000,20500,84750
21572,267250,2017-12-06,0.04819277108433735,415000,395000,-20000,86022
21573,267250,2017-11-15,0.045454545454545456,396000,378000,-18000,124684
21574,267250,2017-10-16,0.042045454545454546,440000,458500,18500,102533
21575,267250,2017-09-12,0.04294478527607362,407500,425000,17500,66607
21576,267250,2017-08-07,0.05246913580246913,486000,460500,-25500,146894
21577,267250,2017-08-01,0.05221339387060159,440500,463500,23000,301709
21578,267250,2017-06-22,0.052429667519181586,391000,370500,-20500,1359752
21579,267250,2017-06-14,0.08450704225352113,390500,423500,33000,209336
21580,267250,2017-06-13,0.05218446601941747,412000,390500,-21500,169733
21581,267250,2017-06-08,0.04738154613466334,401000,420000,19000,93344
21582,267250,2017-05-24,0.04534005037783375,397000,415000,18000,203838
21583,267250,2017-05-23,0.06008010680907877,374500,397000,22500,156818
21584,267250,2017-05-19,0.041428571428571426,350000,364500,14500,156722
21585,267250,2017-05-15,0.05006587615283267,379500,360500,-19000,159155
21586,267250,2017-05-10,0.05512820512820513,390000,390000,0,756348
21587,267250,2017-05-10,0.05512820512820513,390000,390000,0,756348
21588,267250,2017-05-10,0.05512820512820513,390000,390000,0,756348
21589,267250,2017-05-10,0.05512820512820513,390000,390000,0,756348
21590,267250,2017-05-10,0.05512820512820513,390000,390000,0,756348
21591,267250,2017-05-10,0.05512820512820513,390000,390000,0,756348
21592,267250,2017-05-10,0.05512820512820513,390000,390000,0,756348
21593,267250,2017-05-10,0.05512820512820513,390000,390000,0,756348
21594,267250,2017-05-10,0.05512820512820513,390000,390000,0,756348
21595,267250,2017-05-10,0.05512820512820513,390000,390000,0,756348
21596,267250,2017-05-10,0.05512820512820513,390000,390000,0,756348
21597,267250,2017-05-10,0.05512820512820513,390000,390000,0,756348
21598,267250,2017-05-10,0.05512820512820513,390000,390000,0,756348
21599,267250,2017-05-10,0.05512820512820513,390000,390000,0,756348
21600,267250,2017-05-10,0.05512820512820513,390000,390000,0,756348
21601,267250,2017-05-10,0.05512820512820513,390000,390000,0,756348
21602,267250,2017-05-10,0.05512820512820513,390000,390000,0,756348
21603,267250,2017-05-10,0.05512820512820513,390000,390000,0,756348
21604,336370,2021-05-13,0.04681647940074907,53400,50900,-2500,546573
21605,336370,2021-05-10,0.05572441742654509,49350,52100,2750,917706
21606,336370,2021-04-26,0.048582995951417005,49400,51800,2400,1181172
21607,336370,2021-04-22,0.06961325966850829,45250,48400,3150,1059291
21608,336370,2021-04-13,0.049494949494949494,49500,47050,-2450,843062
21609,336370,2021-04-12,0.06223175965665236,46600,49500,2900,919797
21610,336370,2021-03-16,0.09175377468060394,43050,47000,3950,761719
21611,336370,2021-03-04,0.041304347826086954,46000,44100,-1900,374126
21612,336370,2021-02-24,0.05567010309278351,48500,45800,-2700,319018
21613,336370,2021-02-09,0.05343511450381679,52400,49600,-2800,1162492
21614,336370,2021-02-05,0.051759834368530024,48300,50800,2500,534013
21615,336370,2021-01-29,0.05241935483870968,49600,47000,-2600,956372
21616,336370,2021-01-28,0.05343511450381679,52400,49600,-2800,863761
21617,336370,2021-01-25,0.04452690166975881,53900,56300,2400,1844348
21618,336370,2020-12-29,0.043933054393305436,47800,49900,2100,692453
21619,336370,2020-12-24,0.09323583180987204,54700,49600,-5100,3129896
21620,336370,2020-12-23,0.06627680311890838,51300,54700,3400,1321889
21621,336370,2020-12-22,0.06557377049180328,54900,51300,-3600,1060499
21622,336370,2020-12-18,0.05847953216374269,51300,54300,3000,2248616
21623,336370,2020-12-17,0.0577319587628866,48500,51300,2800,1729112
21624,336370,2020-12-14,0.04007633587786259,52400,50300,-2100,482392
21625,336370,2020-12-08,0.050682261208576995,51300,53900,2600,1246135
21626,336370,2020-11-27,0.06695464362850972,46300,49400,3100,6437149
21627,336370,2020-11-26,0.049886621315192746,44100,46300,2200,1040951
21628,336370,2020-11-25,0.05755395683453238,41700,44100,2400,1358915
21629,336370,2020-11-12,0.04832214765100671,37250,39050,1800,489107
21630,336370,2020-11-02,0.04754358161648178,31550,33050,1500,95283
21631,336370,2020-10-26,0.06596701649175413,33350,31150,-2200,204346
21632,336370,2020-10-15,0.04716981132075472,37100,35350,-1750,342577
21633,336370,2020-09-22,0.06598984771573604,39400,42000,2600,546560
21634,336370,2020-09-07,0.06755126658624849,41450,44250,2800,8992049
21635,336370,2020-08-20,0.06127167630057803,43250,40600,-2650,697548
21636,336370,2020-08-18,0.07221006564551423,45700,42400,-3300,740491
21637,336370,2020-08-10,0.12219451371571072,40100,45000,4900,2568385
21638,336370,2020-07-28,0.04807692307692308,36400,38150,1750,1764085
21639,336370,2020-07-09,0.05952380952380952,33600,35600,2000,765443
21640,336370,2020-07-03,0.079155672823219,37900,34900,-3000,894777
21641,336370,2020-07-02,0.14501510574018128,33100,37900,4800,2405717
21642,336370,2020-06-29,0.04267425320056899,35150,33650,-1500,393358
21643,336370,2020-06-16,0.05215123859191656,38350,40350,2000,1022612
21644,336370,2020-06-15,0.09230769230769231,42250,38350,-3900,1492268
21645,336370,2020-06-12,0.05099502487562189,40200,42250,2050,4397496
21646,336370,2020-06-05,0.05412371134020619,38800,40900,2100,850374
21647,336370,2020-06-04,0.049019607843137254,40800,38800,-2000,1015088
21648,336370,2020-06-03,0.06529209621993128,43650,40800,-2850,1634283
21649,336370,2020-05-29,0.048162230671736375,39450,41350,1900,1017130
21650,336370,2020-05-26,0.056282722513089,38200,40350,2150,3735712
21651,336370,2020-05-25,0.05379310344827586,36250,38200,1950,2504079
21652,336370,2020-05-20,0.045655375552282766,33950,35500,1550,1271124
21653,336370,2020-05-12,0.042492917847025496,35300,33800,-1500,1452514
21654,336370,2020-05-11,0.0745814307458143,32850,35300,2450,6801580
21655,336370,2020-04-27,0.05601317957166392,30350,32050,1700,1407401
21656,336370,2020-04-24,0.06327160493827161,32400,30350,-2050,1086862
21657,336370,2020-04-20,0.04953560371517028,32300,33900,1600,2789412
21658,336370,2020-04-14,0.13652482269503546,28200,32050,3850,5595812
21659,336370,2020-04-10,0.2020497803806735,34150,27250,-6900,6002221
21660,336370,2020-04-09,0.22841726618705036,27800,34150,6350,7397073
21661,336370,2020-04-08,0.15113871635610765,24150,27800,3650,4068815
21662,336370,2020-04-06,0.05603448275862069,23200,24500,1300,970922
21663,336370,2020-04-03,0.13170731707317074,20500,23200,2700,1380113
21664,336370,2020-04-02,0.05398457583547558,19450,20500,1050,505322
21665,336370,2020-04-01,0.05420054200542006,18450,19450,1000,1348879
21666,336370,2020-03-25,0.15522388059701492,16750,19350,2600,1324510
21667,336370,2020-03-24,0.07717041800643087,15550,16750,1200,730743
21668,336370,2020-03-23,0.046012269938650305,16300,15550,-750,448821
21669,336370,2020-03-20,0.13194444444444445,14400,16300,1900,999099
21670,336370,2020-03-19,0.17478510028653296,17450,14400,-3050,883442
21671,336370,2020-03-18,0.06933333333333333,18750,17450,-1300,347516
21672,336370,2020-03-16,0.06201550387596899,19350,18150,-1200,476042
21673,336370,2020-03-13,0.04207920792079208,20200,19350,-850,832845
21674,336370,2020-03-12,0.12554112554112554,23100,20200,-2900,1208060
21675,336370,2020-03-11,0.11494252873563218,26100,23100,-3000,1003763
21676,336370,2020-03-09,0.08318264014466546,27650,25350,-2300,612049
21677,336370,2020-03-04,0.06741573033707865,26700,28500,1800,678230
21678,336370,2020-03-02,0.05454545454545454,24750,26100,1350,330442
21679,336370,2020-02-28,0.04807692307692308,26000,24750,-1250,423934
21680,336370,2020-02-27,0.04411764705882353,27200,26000,-1200,319978
21681,336370,2020-02-25,0.046065259117082535,26050,27250,1200,454823
21682,336370,2020-02-24,0.04927007299270073,27400,26050,-1350,686249
21683,336370,2020-02-12,0.040998217468805706,28050,26900,-1150,717940
21684,336370,2020-02-11,0.08932038834951456,25750,28050,2300,1078780
21685,336370,2020-02-04,0.08971962616822429,26750,29150,2400,1010998
21686,336370,2020-01-31,0.09217391304347826,28750,26100,-2650,702609
21687,336370,2020-01-28,0.04562043795620438,27400,28650,1250,617284
21688,336370,2020-01-22,0.13704496788008566,23350,26550,3200,1399465
21689,336370,2020-01-17,0.042682926829268296,24600,23550,-1050,227285
21690,336370,2020-01-16,0.0603448275862069,23200,24600,1400,406257
21691,336370,2020-01-13,0.06827309236947791,24900,23200,-1700,520084
21692,336370,2020-01-09,0.06451612903225806,23250,24750,1500,479258
21693,336370,2020-01-03,0.10411622276029056,20650,22800,2150,1052337
21694,336370,2019-12-27,0.06036745406824147,19050,20200,1150,486922
21695,336370,2019-12-26,0.058333333333333334,18000,19050,1050,390355
21696,336370,2019-12-17,0.049738219895287955,19100,18150,-950,633690
21697,336370,2019-12-04,0.04060913705583756,19700,18900,-800,186359
21698,336370,2019-11-29,0.04522613065326633,19900,19000,-900,439911
21699,336370,2019-11-19,0.045023696682464455,21100,22050,950,771050
21700,336370,2019-11-15,0.04987531172069826,20050,21050,1000,2051376
21701,336370,2019-11-14,0.044270833333333336,19200,20050,850,669800
21702,336370,2019-11-06,0.07988165680473373,16900,18250,1350,931287
21703,336370,2019-11-01,0.0702247191011236,17800,16550,-1250,974913
21704,336370,2019-10-30,0.0701219512195122,16400,17550,1150,2537841
21705,336370,2019-10-24,0.2987551867219917,12050,15650,3600,579507
21706,336370,2019-10-23,0.2956989247311828,9300,12050,2750,154363
21707,336370,2019-10-22,0.2988826815642458,7160,9300,2140,45023
21708,336370,2019-10-21,0.29945553539019965,5510,7160,1650,27340
21709,336370,2019-10-18,0.1053941908713693,12050,5510,-6540,43470
21710,336370,2019-10-23,0.2956989247311828,9300,12050,2750,154363
21711,336370,2019-10-22,0.2988826815642458,7160,9300,2140,45023
21712,336370,2019-10-21,0.29945553539019965,5510,7160,1650,27340
21713,336370,2019-10-18,0.1053941908713693,12050,5510,-6540,43470
21714,336370,2019-10-23,0.2956989247311828,9300,12050,2750,154363
21715,336370,2019-10-22,0.2988826815642458,7160,9300,2140,45023
21716,336370,2019-10-21,0.29945553539019965,5510,7160,1650,27340
21717,336370,2019-10-18,0.1053941908713693,12050,5510,-6540,43470
21718,336370,2019-10-23,0.2956989247311828,9300,12050,2750,154363
21719,336370,2019-10-22,0.2988826815642458,7160,9300,2140,45023
21720,336370,2019-10-21,0.29945553539019965,5510,7160,1650,27340
21721,336370,2019-10-18,0.1053941908713693,12050,5510,-6540,43470
21722,336370,2019-10-23,0.2956989247311828,9300,12050,2750,154363
21723,336370,2019-10-22,0.2988826815642458,7160,9300,2140,45023
21724,336370,2019-10-21,0.29945553539019965,5510,7160,1650,27340
21725,336370,2019-10-18,0.1053941908713693,12050,5510,-6540,43470
21726,336370,2019-10-23,0.2956989247311828,9300,12050,2750,154363
21727,336370,2019-10-22,0.2988826815642458,7160,9300,2140,45023
21728,336370,2019-10-21,0.29945553539019965,5510,7160,1650,27340
21729,336370,2019-10-18,0.1053941908713693,12050,5510,-6540,43470
21730,336370,2019-10-23,0.2956989247311828,9300,12050,2750,154363
21731,336370,2019-10-22,0.2988826815642458,7160,9300,2140,45023
21732,336370,2019-10-21,0.29945553539019965,5510,7160,1650,27340
21733,336370,2019-10-18,0.1053941908713693,12050,5510,-6540,43470
21734,336370,2019-10-23,0.2956989247311828,9300,12050,2750,154363
21735,336370,2019-10-22,0.2988826815642458,7160,9300,2140,45023
21736,336370,2019-10-21,0.29945553539019965,5510,7160,1650,27340
21737,336370,2019-10-18,0.1053941908713693,12050,5510,-6540,43470
21738,336370,2019-10-23,0.2956989247311828,9300,12050,2750,154363
21739,336370,2019-10-22,0.2988826815642458,7160,9300,2140,45023
21740,336370,2019-10-21,0.29945553539019965,5510,7160,1650,27340
21741,336370,2019-10-18,0.1053941908713693,12050,5510,-6540,43470
21742,336370,2019-10-23,0.2956989247311828,9300,12050,2750,154363
21743,336370,2019-10-22,0.2988826815642458,7160,9300,2140,45023
21744,336370,2019-10-21,0.29945553539019965,5510,7160,1650,27340
21745,336370,2019-10-18,0.1053941908713693,12050,5510,-6540,43470
21746,336370,2019-10-23,0.2956989247311828,9300,12050,2750,154363
21747,336370,2019-10-22,0.2988826815642458,7160,9300,2140,45023
21748,336370,2019-10-21,0.29945553539019965,5510,7160,1650,27340
21749,336370,2019-10-18,0.1053941908713693,12050,5510,-6540,43470
21750,336370,2019-10-23,0.2956989247311828,9300,12050,2750,154363
21751,336370,2019-10-22,0.2988826815642458,7160,9300,2140,45023
21752,336370,2019-10-21,0.29945553539019965,5510,7160,1650,27340
21753,336370,2019-10-18,0.1053941908713693,12050,5510,-6540,43470
21754,336370,2019-10-23,0.2956989247311828,9300,12050,2750,154363
21755,336370,2019-10-22,0.2988826815642458,7160,9300,2140,45023
21756,336370,2019-10-21,0.29945553539019965,5510,7160,1650,27340
21757,336370,2019-10-18,0.1053941908713693,12050,5510,-6540,43470
21758,336370,2019-10-23,0.2956989247311828,9300,12050,2750,154363
21759,336370,2019-10-22,0.2988826815642458,7160,9300,2140,45023
21760,336370,2019-10-21,0.29945553539019965,5510,7160,1650,27340
21761,336370,2019-10-18,0.1053941908713693,12050,5510,-6540,43470
21762,336370,2019-10-23,0.2956989247311828,9300,12050,2750,154363
21763,336370,2019-10-22,0.2988826815642458,7160,9300,2140,45023
21764,336370,2019-10-21,0.29945553539019965,5510,7160,1650,27340
21765,336370,2019-10-18,0.1053941908713693,12050,5510,-6540,43470
21766,336370,2019-10-23,0.2956989247311828,9300,12050,2750,154363
21767,336370,2019-10-22,0.2988826815642458,7160,9300,2140,45023
21768,336370,2019-10-21,0.29945553539019965,5510,7160,1650,27340
21769,336370,2019-10-18,0.1053941908713693,12050,5510,-6540,43470
21770,336370,2019-10-23,0.2956989247311828,9300,12050,2750,154363
21771,336370,2019-10-22,0.2988826815642458,7160,9300,2140,45023
21772,336370,2019-10-21,0.29945553539019965,5510,7160,1650,27340
21773,336370,2019-10-18,0.1053941908713693,12050,5510,-6540,43470
21774,336370,2019-10-23,0.2956989247311828,9300,12050,2750,154363
21775,336370,2019-10-22,0.2988826815642458,7160,9300,2140,45023
21776,336370,2019-10-21,0.29945553539019965,5510,7160,1650,27340
21777,336370,2019-10-18,0.1053941908713693,12050,5510,-6540,43470
21778,336370,2019-10-23,0.2956989247311828,9300,12050,2750,154363
21779,336370,2019-10-22,0.2988826815642458,7160,9300,2140,45023
21780,336370,2019-10-21,0.29945553539019965,5510,7160,1650,27340
21781,336370,2019-10-18,0.1053941908713693,12050,5510,-6540,43470
21782,336370,2019-10-23,0.2956989247311828,9300,12050,2750,154363
21783,336370,2019-10-22,0.2988826815642458,7160,9300,2140,45023
21784,336370,2019-10-21,0.29945553539019965,5510,7160,1650,27340
21785,336370,2019-10-18,0.1053941908713693,12050,5510,-6540,43470
21786,336370,2019-10-23,0.2956989247311828,9300,12050,2750,154363
21787,336370,2019-10-22,0.2988826815642458,7160,9300,2140,45023
21788,336370,2019-10-21,0.29945553539019965,5510,7160,1650,27340
21789,336370,2019-10-18,0.1053941908713693,12050,5510,-6540,43470
21790,336370,2019-10-23,0.2956989247311828,9300,12050,2750,154363
21791,336370,2019-10-22,0.2988826815642458,7160,9300,2140,45023
21792,336370,2019-10-21,0.29945553539019965,5510,7160,1650,27340
21793,336370,2019-10-18,0.1053941908713693,12050,5510,-6540,43470
21794,336370,2019-10-23,0.2956989247311828,9300,12050,2750,154363
21795,336370,2019-10-22,0.2988826815642458,7160,9300,2140,45023
21796,336370,2019-10-21,0.29945553539019965,5510,7160,1650,27340
21797,336370,2019-10-18,0.1053941908713693,12050,5510,-6540,43470
21798,336370,2019-10-23,0.2956989247311828,9300,12050,2750,154363
21799,336370,2019-10-22,0.2988826815642458,7160,9300,2140,45023
21800,336370,2019-10-21,0.29945553539019965,5510,7160,1650,27340
21801,336370,2019-10-18,0.1053941908713693,12050,5510,-6540,43470
21802,336370,2019-10-23,0.2956989247311828,9300,12050,2750,154363
21803,336370,2019-10-22,0.2988826815642458,7160,9300,2140,45023
21804,336370,2019-10-21,0.29945553539019965,5510,7160,1650,27340
21805,336370,2019-10-18,0.1053941908713693,12050,5510,-6540,43470
21806,336370,2019-10-23,0.2956989247311828,9300,12050,2750,154363
21807,336370,2019-10-22,0.2988826815642458,7160,9300,2140,45023
21808,336370,2019-10-21,0.29945553539019965,5510,7160,1650,27340
21809,336370,2019-10-18,0.1053941908713693,12050,5510,-6540,43470
21810,336370,2019-10-23,0.2956989247311828,9300,12050,2750,154363
21811,336370,2019-10-22,0.2988826815642458,7160,9300,2140,45023
21812,336370,2019-10-21,0.29945553539019965,5510,7160,1650,27340
21813,336370,2019-10-18,0.1053941908713693,12050,5510,-6540,43470
21814,336370,2019-10-23,0.2956989247311828,9300,12050,2750,154363
21815,336370,2019-10-22,0.2988826815642458,7160,9300,2140,45023
21816,336370,2019-10-21,0.29945553539019965,5510,7160,1650,27340
21817,336370,2019-10-18,0.1053941908713693,12050,5510,-6540,43470
21818,336370,2019-10-23,0.2956989247311828,9300,12050,2750,154363
21819,336370,2019-10-22,0.2988826815642458,7160,9300,2140,45023
21820,336370,2019-10-21,0.29945553539019965,5510,7160,1650,27340
21821,336370,2019-10-18,0.1053941908713693,12050,5510,-6540,43470
21822,336370,2019-10-23,0.2956989247311828,9300,12050,2750,154363
21823,336370,2019-10-22,0.2988826815642458,7160,9300,2140,45023
21824,336370,2019-10-21,0.29945553539019965,5510,7160,1650,27340
21825,336370,2019-10-18,0.1053941908713693,12050,5510,-6540,43470
21826,336370,2019-10-23,0.2956989247311828,9300,12050,2750,154363
21827,336370,2019-10-22,0.2988826815642458,7160,9300,2140,45023
21828,336370,2019-10-21,0.29945553539019965,5510,7160,1650,27340
21829,336370,2019-10-18,0.1053941908713693,12050,5510,-6540,43470
21830,336370,2019-10-23,0.2956989247311828,9300,12050,2750,154363
21831,336370,2019-10-22,0.2988826815642458,7160,9300,2140,45023
21832,336370,2019-10-21,0.29945553539019965,5510,7160,1650,27340
21833,336370,2019-10-18,0.1053941908713693,12050,5510,-6540,43470
21834,336370,2019-10-23,0.2956989247311828,9300,12050,2750,154363
21835,336370,2019-10-22,0.2988826815642458,7160,9300,2140,45023
21836,336370,2019-10-21,0.29945553539019965,5510,7160,1650,27340
21837,336370,2019-10-18,0.1053941908713693,12050,5510,-6540,43470
21838,336370,2019-10-23,0.2956989247311828,9300,12050,2750,154363
21839,336370,2019-10-22,0.2988826815642458,7160,9300,2140,45023
21840,336370,2019-10-21,0.29945553539019965,5510,7160,1650,27340
21841,336370,2019-10-18,0.1053941908713693,12050,5510,-6540,43470
21842,336370,2019-10-23,0.2956989247311828,9300,12050,2750,154363
21843,336370,2019-10-22,0.2988826815642458,7160,9300,2140,45023
21844,336370,2019-10-21,0.29945553539019965,5510,7160,1650,27340
21845,336370,2019-10-18,0.1053941908713693,12050,5510,-6540,43470
21846,336370,2019-10-23,0.2956989247311828,9300,12050,2750,154363
21847,336370,2019-10-22,0.2988826815642458,7160,9300,2140,45023
21848,336370,2019-10-21,0.29945553539019965,5510,7160,1650,27340
21849,336370,2019-10-18,0.1053941908713693,12050,5510,-6540,43470
21850,336370,2019-10-23,0.2956989247311828,9300,12050,2750,154363
21851,336370,2019-10-22,0.2988826815642458,7160,9300,2140,45023
21852,336370,2019-10-21,0.29945553539019965,5510,7160,1650,27340
21853,336370,2019-10-18,0.1053941908713693,12050,5510,-6540,43470
21854,336370,2019-10-23,0.2956989247311828,9300,12050,2750,154363
21855,336370,2019-10-22,0.2988826815642458,7160,9300,2140,45023
21856,336370,2019-10-21,0.29945553539019965,5510,7160,1650,27340
21857,336370,2019-10-18,0.1053941908713693,12050,5510,-6540,43470
21858,336370,2019-10-23,0.2956989247311828,9300,12050,2750,154363
21859,336370,2019-10-22,0.2988826815642458,7160,9300,2140,45023
21860,336370,2019-10-21,0.29945553539019965,5510,7160,1650,27340
21861,336370,2019-10-18,0.1053941908713693,12050,5510,-6540,43470
21862,336370,2019-10-23,0.2956989247311828,9300,12050,2750,154363
21863,336370,2019-10-22,0.2988826815642458,7160,9300,2140,45023
21864,336370,2019-10-21,0.29945553539019965,5510,7160,1650,27340
21865,336370,2019-10-18,0.1053941908713693,12050,5510,-6540,43470
21866,336370,2019-10-23,0.2956989247311828,9300,12050,2750,154363
21867,336370,2019-10-22,0.2988826815642458,7160,9300,2140,45023
21868,336370,2019-10-21,0.29945553539019965,5510,7160,1650,27340
21869,336370,2019-10-18,0.1053941908713693,12050,5510,-6540,43470
21870,336370,2019-10-23,0.2956989247311828,9300,12050,2750,154363
21871,336370,2019-10-22,0.2988826815642458,7160,9300,2140,45023
21872,336370,2019-10-21,0.29945553539019965,5510,7160,1650,27340
21873,336370,2019-10-18,0.1053941908713693,12050,5510,-6540,43470
21874,336370,2019-10-23,0.2956989247311828,9300,12050,2750,154363
21875,336370,2019-10-22,0.2988826815642458,7160,9300,2140,45023
21876,336370,2019-10-21,0.29945553539019965,5510,7160,1650,27340
21877,336370,2019-10-18,0.1053941908713693,12050,5510,-6540,43470
21878,336370,2019-10-23,0.2956989247311828,9300,12050,2750,154363
21879,336370,2019-10-22,0.2988826815642458,7160,9300,2140,45023
21880,336370,2019-10-21,0.29945553539019965,5510,7160,1650,27340
21881,336370,2019-10-18,0.1053941908713693,12050,5510,-6540,43470
21882,336370,2019-10-23,0.2956989247311828,9300,12050,2750,154363
21883,336370,2019-10-22,0.2988826815642458,7160,9300,2140,45023
21884,336370,2019-10-21,0.29945553539019965,5510,7160,1650,27340
21885,336370,2019-10-18,0.1053941908713693,12050,5510,-6540,43470
21886,336370,2019-10-23,0.2956989247311828,9300,12050,2750,154363
21887,336370,2019-10-22,0.2988826815642458,7160,9300,2140,45023
21888,336370,2019-10-21,0.29945553539019965,5510,7160,1650,27340
21889,336370,2019-10-18,0.1053941908713693,12050,5510,-6540,43470
21890,336370,2019-10-23,0.2956989247311828,9300,12050,2750,154363
21891,336370,2019-10-22,0.2988826815642458,7160,9300,2140,45023
21892,336370,2019-10-21,0.29945553539019965,5510,7160,1650,27340
21893,336370,2019-10-18,0.1053941908713693,12050,5510,-6540,43470
21894,336370,2019-10-23,0.2956989247311828,9300,12050,2750,154363
21895,336370,2019-10-22,0.2988826815642458,7160,9300,2140,45023
21896,336370,2019-10-21,0.29945553539019965,5510,7160,1650,27340
21897,336370,2019-10-18,0.1053941908713693,12050,5510,-6540,43470
21898,336370,2019-10-23,0.2956989247311828,9300,12050,2750,154363
21899,336370,2019-10-22,0.2988826815642458,7160,9300,2140,45023
21900,336370,2019-10-21,0.29945553539019965,5510,7160,1650,27340
21901,336370,2019-10-18,0.1053941908713693,12050,5510,-6540,43470
21902,336370,2019-10-23,0.2956989247311828,9300,12050,2750,154363
21903,336370,2019-10-22,0.2988826815642458,7160,9300,2140,45023
21904,336370,2019-10-21,0.29945553539019965,5510,7160,1650,27340
21905,336370,2019-10-18,0.1053941908713693,12050,5510,-6540,43470
21906,336370,2019-10-23,0.2956989247311828,9300,12050,2750,154363
21907,336370,2019-10-22,0.2988826815642458,7160,9300,2140,45023
21908,336370,2019-10-21,0.29945553539019965,5510,7160,1650,27340
21909,336370,2019-10-18,0.1053941908713693,12050,5510,-6540,43470
21910,336370,2019-10-23,0.2956989247311828,9300,12050,2750,154363
21911,336370,2019-10-22,0.2988826815642458,7160,9300,2140,45023
21912,336370,2019-10-21,0.29945553539019965,5510,7160,1650,27340
21913,336370,2019-10-18,0.1053941908713693,12050,5510,-6540,43470
21914,336370,2019-10-23,0.2956989247311828,9300,12050,2750,154363
21915,336370,2019-10-22,0.2988826815642458,7160,9300,2140,45023
21916,336370,2019-10-21,0.29945553539019965,5510,7160,1650,27340
21917,336370,2019-10-18,0.1053941908713693,12050,5510,-6540,43470
21918,336370,2019-10-23,0.2956989247311828,9300,12050,2750,154363
21919,336370,2019-10-22,0.2988826815642458,7160,9300,2140,45023
21920,336370,2019-10-21,0.29945553539019965,5510,7160,1650,27340
21921,336370,2019-10-18,0.1053941908713693,12050,5510,-6540,43470
21922,336370,2019-10-23,0.2956989247311828,9300,12050,2750,154363
21923,336370,2019-10-22,0.2988826815642458,7160,9300,2140,45023
21924,336370,2019-10-21,0.29945553539019965,5510,7160,1650,27340
21925,336370,2019-10-18,0.1053941908713693,12050,5510,-6540,43470
21926,336370,2019-10-23,0.2956989247311828,9300,12050,2750,154363
21927,336370,2019-10-22,0.2988826815642458,7160,9300,2140,45023
21928,336370,2019-10-21,0.29945553539019965,5510,7160,1650,27340
21929,336370,2019-10-18,0.1053941908713693,12050,5510,-6540,43470
21930,336370,2019-10-23,0.2956989247311828,9300,12050,2750,154363
21931,336370,2019-10-22,0.2988826815642458,7160,9300,2140,45023
21932,336370,2019-10-21,0.29945553539019965,5510,7160,1650,27340
21933,336370,2019-10-18,0.1053941908713693,12050,5510,-6540,43470
21934,336370,2019-10-23,0.2956989247311828,9300,12050,2750,154363
21935,336370,2019-10-22,0.2988826815642458,7160,9300,2140,45023
21936,336370,2019-10-21,0.29945553539019965,5510,7160,1650,27340
21937,336370,2019-10-18,0.1053941908713693,12050,5510,-6540,43470
21938,336370,2019-10-23,0.2956989247311828,9300,12050,2750,154363
21939,336370,2019-10-22,0.2988826815642458,7160,9300,2140,45023
21940,336370,2019-10-21,0.29945553539019965,5510,7160,1650,27340
21941,336370,2019-10-18,0.1053941908713693,12050,5510,-6540,43470
21942,336370,2019-10-23,0.2956989247311828,9300,12050,2750,154363
21943,336370,2019-10-22,0.2988826815642458,7160,9300,2140,45023
21944,336370,2019-10-21,0.29945553539019965,5510,7160,1650,27340
21945,336370,2019-10-18,0.1053941908713693,12050,5510,-6540,43470
21946,336370,2019-10-23,0.2956989247311828,9300,12050,2750,154363
21947,336370,2019-10-22,0.2988826815642458,7160,9300,2140,45023
21948,336370,2019-10-21,0.29945553539019965,5510,7160,1650,27340
21949,336370,2019-10-18,0.1053941908713693,12050,5510,-6540,43470
21950,336370,2019-10-23,0.2956989247311828,9300,12050,2750,154363
21951,336370,2019-10-22,0.2988826815642458,7160,9300,2140,45023
21952,336370,2019-10-21,0.29945553539019965,5510,7160,1650,27340
21953,336370,2019-10-18,0.1053941908713693,12050,5510,-6540,43470
21954,336370,2019-10-23,0.2956989247311828,9300,12050,2750,154363
21955,336370,2019-10-22,0.2988826815642458,7160,9300,2140,45023
21956,336370,2019-10-21,0.29945553539019965,5510,7160,1650,27340
21957,336370,2019-10-18,0.1053941908713693,12050,5510,-6540,43470
21958,336370,2019-10-23,0.2956989247311828,9300,12050,2750,154363
21959,336370,2019-10-22,0.2988826815642458,7160,9300,2140,45023
21960,336370,2019-10-21,0.29945553539019965,5510,7160,1650,27340
21961,336370,2019-10-18,0.1053941908713693,12050,5510,-6540,43470
21962,336370,2019-10-23,0.2956989247311828,9300,12050,2750,154363
21963,336370,2019-10-22,0.2988826815642458,7160,9300,2140,45023
21964,336370,2019-10-21,0.29945553539019965,5510,7160,1650,27340
21965,336370,2019-10-18,0.1053941908713693,12050,5510,-6540,43470
21966,336370,2019-10-23,0.2956989247311828,9300,12050,2750,154363
21967,336370,2019-10-22,0.2988826815642458,7160,9300,2140,45023
21968,336370,2019-10-21,0.29945553539019965,5510,7160,1650,27340
21969,336370,2019-10-18,0.1053941908713693,12050,5510,-6540,43470
21970,336370,2019-10-23,0.2956989247311828,9300,12050,2750,154363
21971,336370,2019-10-22,0.2988826815642458,7160,9300,2140,45023
21972,336370,2019-10-21,0.29945553539019965,5510,7160,1650,27340
21973,336370,2019-10-18,0.1053941908713693,12050,5510,-6540,43470
21974,336370,2019-10-23,0.2956989247311828,9300,12050,2750,154363
21975,336370,2019-10-22,0.2988826815642458,7160,9300,2140,45023
21976,336370,2019-10-21,0.29945553539019965,5510,7160,1650,27340
21977,336370,2019-10-18,0.1053941908713693,12050,5510,-6540,43470
21978,336370,2019-10-23,0.2956989247311828,9300,12050,2750,154363
21979,336370,2019-10-22,0.2988826815642458,7160,9300,2140,45023
21980,336370,2019-10-21,0.29945553539019965,5510,7160,1650,27340
21981,336370,2019-10-18,0.1053941908713693,12050,5510,-6540,43470
21982,336370,2019-10-23,0.2956989247311828,9300,12050,2750,154363
21983,336370,2019-10-22,0.2988826815642458,7160,9300,2140,45023
21984,336370,2019-10-21,0.29945553539019965,5510,7160,1650,27340
21985,336370,2019-10-18,0.1053941908713693,12050,5510,-6540,43470
21986,336370,2019-10-23,0.2956989247311828,9300,12050,2750,154363
21987,336370,2019-10-22,0.2988826815642458,7160,9300,2140,45023
21988,336370,2019-10-21,0.29945553539019965,5510,7160,1650,27340
21989,336370,2019-10-18,0.1053941908713693,12050,5510,-6540,43470
21990,336370,2019-10-23,0.2956989247311828,9300,12050,2750,154363
21991,336370,2019-10-22,0.2988826815642458,7160,9300,2140,45023
21992,336370,2019-10-21,0.29945553539019965,5510,7160,1650,27340
21993,336370,2019-10-18,0.1053941908713693,12050,5510,-6540,43470
21994,336370,2019-10-23,0.2956989247311828,9300,12050,2750,154363
21995,336370,2019-10-22,0.2988826815642458,7160,9300,2140,45023
21996,336370,2019-10-21,0.29945553539019965,5510,7160,1650,27340
21997,336370,2019-10-18,0.1053941908713693,12050,5510,-6540,43470
21998,336370,2019-10-23,0.2956989247311828,9300,12050,2750,154363
21999,336370,2019-10-22,0.2988826815642458,7160,9300,2140,45023
22000,336370,2019-10-21,0.29945553539019965,5510,7160,1650,27340
22001,336370,2019-10-18,0.1053941908713693,12050,5510,-6540,43470
22002,336370,2019-10-23,0.2956989247311828,9300,12050,2750,154363
22003,336370,2019-10-22,0.2988826815642458,7160,9300,2140,45023
22004,336370,2019-10-21,0.29945553539019965,5510,7160,1650,27340
22005,336370,2019-10-18,0.1053941908713693,12050,5510,-6540,43470
22006,336370,2019-10-23,0.2956989247311828,9300,12050,2750,154363
22007,336370,2019-10-22,0.2988826815642458,7160,9300,2140,45023
22008,336370,2019-10-21,0.29945553539019965,5510,7160,1650,27340
22009,336370,2019-10-18,0.1053941908713693,12050,5510,-6540,43470
22010,336370,2019-10-23,0.2956989247311828,9300,12050,2750,154363
22011,336370,2019-10-22,0.2988826815642458,7160,9300,2140,45023
22012,336370,2019-10-21,0.29945553539019965,5510,7160,1650,27340
22013,336370,2019-10-18,0.1053941908713693,12050,5510,-6540,43470
22014,336370,2019-10-23,0.2956989247311828,9300,12050,2750,154363
22015,336370,2019-10-22,0.2988826815642458,7160,9300,2140,45023
22016,336370,2019-10-21,0.29945553539019965,5510,7160,1650,27340
22017,336370,2019-10-18,0.1053941908713693,12050,5510,-6540,43470
22018,336370,2019-10-23,0.2956989247311828,9300,12050,2750,154363
22019,336370,2019-10-22,0.2988826815642458,7160,9300,2140,45023
22020,336370,2019-10-21,0.29945553539019965,5510,7160,1650,27340
22021,33780,2020-12-29,0.05981941309255079,88600,83300,-5300,1503342
22022,33780,2020-08-06,0.07365792759051186,80100,86000,5900,1395915
22023,33780,2020-06-16,0.0416141235813367,79300,82600,3300,435544
22024,33780,2020-06-15,0.046875,83200,79300,-3900,542656
22025,33780,2020-05-25,0.045012165450121655,82200,85900,3700,938074
22026,33780,2020-05-22,0.04580152671755725,78600,82200,3600,1531549
22027,33780,2020-04-03,0.05049088359046283,71300,74900,3600,606101
22028,33780,2020-04-01,0.049531459170013385,74700,71000,-3700,487326
22029,33780,2020-03-25,0.06499261447562776,67700,72100,4400,657557
22030,33780,2020-03-24,0.06446540880503145,63600,67700,4100,705417
22031,33780,2020-03-23,0.06332842415316642,67900,63600,-4300,600618
22032,33780,2020-03-19,0.0847682119205298,75500,69100,-6400,881642
22033,33780,2020-03-04,0.04004711425206125,84900,81500,-3400,2017991
22034,33780,2018-05-10,0.045785639958376693,96100,100500,4400,522158
22035,33780,2017-09-15,0.04433497536945813,101500,106000,4500,526725
22036,33780,2017-07-31,0.04602510460251046,119500,114000,-5500,481578
22037,33780,2017-03-16,0.04433497536945813,101500,97000,-4500,1348685
22038,33780,2016-11-11,0.05504587155963303,109000,103000,-6000,741271
22039,33780,2016-10-25,0.04405286343612335,113500,108500,-5000,590313
22040,69620,2021-05-18,0.07586206896551724,145000,156000,11000,284230
22041,69620,2021-05-10,0.04878048780487805,143500,150500,7000,163718
22042,69620,2021-05-07,0.05514705882352941,136000,143500,7500,336066
22043,69620,2021-05-04,0.05928853754940711,126500,134000,7500,102813
22044,69620,2021-05-03,0.052434456928838954,133500,126500,-7000,62429
22045,69620,2021-04-30,0.0498220640569395,140500,133500,-7000,125749
22046,69620,2021-03-17,0.051587301587301584,126000,132500,6500,242044
22047,69620,2021-03-04,0.04044117647058824,136000,130500,-5500,108826
22048,69620,2021-02-24,0.04878048780487805,143500,136500,-7000,144610
22049,69620,2021-02-23,0.07717041800643087,155500,143500,-12000,235270
22050,69620,2021-02-22,0.14338235294117646,136000,155500,19500,1150456
22051,69620,2021-02-16,0.04406779661016949,147500,141000,-6500,319703
22052,69620,2021-02-04,0.05642633228840126,159500,150500,-9000,199368
22053,69620,2021-01-18,0.04597701149425287,174000,166000,-8000,250259
22054,69620,2021-01-11,0.042735042735042736,175500,168000,-7500,330545
22055,69620,2021-01-05,0.10755813953488372,172000,190500,18500,2903141
22056,69620,2021-01-04,0.04242424242424243,165000,172000,7000,787288
22057,69620,2020-12-29,0.06472491909385113,154500,164500,10000,541837
22058,69620,2020-12-24,0.059880239520958084,167000,157000,-10000,1855893
22059,69620,2020-12-23,0.29979035639413,238500,167000,-71500,612231
22060,69620,2020-12-22,0.13430127041742287,275500,238500,-37000,633248
22061,69620,2020-12-21,0.29952830188679247,212000,275500,63500,314609
22062,69620,2020-12-18,0.20797720797720798,175500,212000,36500,5918965
22063,69620,2020-12-17,0.3,135000,175500,40500,6454045
22064,69620,2020-12-14,0.06315789473684211,142500,133500,-9000,1616439
22065,69620,2020-12-10,0.18803418803418803,117000,139000,22000,4850359
22066,69620,2020-12-09,0.05405405405405406,111000,117000,6000,696234
22067,69620,2020-12-08,0.06722689075630252,119000,111000,-8000,211472
22068,69620,2020-12-04,0.04405286343612335,113500,118500,5000,835147
22069,69620,2020-12-01,0.07246376811594203,103500,111000,7500,2574960
22070,69620,2020-11-25,0.05344295991778006,97300,102500,5200,753229
22071,69620,2020-10-26,0.081,100000,91900,-8100,170724
22072,69620,2020-09-24,0.0647887323943662,106500,99600,-6900,131310
22073,69620,2020-08-18,0.05555555555555555,117000,110500,-6500,167645
22074,69620,2020-08-07,0.13333333333333333,135000,117000,-18000,1135774
22075,69620,2020-08-06,0.19469026548672566,113000,135000,22000,3434964
22076,69620,2020-07-07,0.17228464419475656,133500,110500,-23000,1522642
22077,69620,2020-07-06,0.06374501992031872,125500,133500,8000,698865
22078,69620,2020-07-01,0.052830188679245285,132500,125500,-7000,142610
22079,69620,2020-06-30,0.046762589928057555,139000,132500,-6500,181349
22080,69620,2020-06-16,0.040145985401459854,137000,142500,5500,206033
22081,69620,2020-06-15,0.0711864406779661,147500,137000,-10500,459438
22082,69620,2020-06-10,0.04377104377104377,148500,142000,-6500,989282
22083,69620,2020-06-09,0.1,135000,148500,13500,2893201
22084,69620,2020-06-08,0.055944055944055944,143000,135000,-8000,1061157
22085,69620,2020-06-05,0.3,110000,143000,33000,2887016
22086,69620,2020-05-29,0.05092592592592592,108000,102500,-5500,201878
22087,69620,2020-05-15,0.04854368932038835,103000,108000,5000,469229
22088,69620,2020-04-22,0.08411214953271028,107000,116000,9000,1405651
22089,69620,2020-04-21,0.05726872246696035,113500,107000,-6500,251208
22090,69620,2020-04-20,0.0861244019138756,104500,113500,9000,661028
22091,69620,2020-04-14,0.11461619348054679,95100,106000,10900,1515356
22092,69620,2020-04-07,0.05321507760532151,90200,95000,4800,97760
22093,69620,2020-04-06,0.04883720930232558,86000,90200,4200,94122
22094,69620,2020-03-25,0.06938775510204082,73500,78600,5100,356719
22095,69620,2020-03-24,0.08247422680412371,67900,73500,5600,597131
22096,69620,2020-03-20,0.040625,64000,66600,2600,186584
22097,69620,2020-03-19,0.12806539509536785,73400,64000,-9400,205635
22098,69620,2020-03-17,0.0525,80000,75800,-4200,229001
22099,69620,2020-03-16,0.09502262443438914,88400,80000,-8400,613322
22100,69620,2020-03-13,0.05238095238095238,84000,88400,4400,1429800
22101,69620,2020-03-12,0.08496732026143791,91800,84000,-7800,136618
22102,69620,2020-03-11,0.05165289256198347,96800,91800,-5000,71574
22103,69620,2020-03-04,0.0990990990990991,111000,100000,-11000,655362
22104,69620,2020-03-02,0.09523809523809523,105000,115000,10000,81021
22105,69620,2020-02-24,0.06382978723404255,117500,110000,-7500,35045
22106,69620,2020-01-21,0.08823529411764706,136000,124000,-12000,225484
22107,69620,2020-01-10,0.06513409961685823,130500,139000,8500,105691
22108,69620,2019-10-01,0.053691275167785234,149000,157000,8000,52957
22109,69620,2019-09-26,0.041666666666666664,156000,149500,-6500,169364
22110,69620,2019-09-25,0.060240963855421686,166000,156000,-10000,96925
22111,69620,2019-08-30,0.06349206349206349,157500,167500,10000,212942
22112,69620,2019-08-12,0.05501618122977346,154500,163000,8500,42931
22113,69620,2019-08-08,0.06993006993006994,143000,153000,10000,55206
22114,69620,2019-08-05,0.06430868167202572,155500,145500,-10000,49747
22115,69620,2019-07-19,0.040498442367601244,160500,167000,6500,57500
22116,69620,2019-07-11,0.046511627906976744,150500,157500,7000,61974
22117,69620,2019-07-08,0.04113924050632911,158000,151500,-6500,29753
22118,69620,2019-06-25,0.04100946372239748,158500,152000,-6500,45592
22119,69620,2019-05-29,0.04807692307692308,156000,148500,-7500,91372
22120,69620,2019-05-21,0.04487179487179487,156000,163000,7000,64714
22121,69620,2019-05-20,0.045871559633027525,163500,156000,-7500,79919
22122,69620,2019-05-13,0.07936507936507936,189000,174000,-15000,181013
22123,69620,2019-03-21,0.04381443298969072,194000,185500,-8500,76739
22124,69620,2019-02-07,0.05699481865284974,193000,204000,11000,401670
22125,69620,2019-01-31,0.04594594594594595,185000,193500,8500,123091
22126,69620,2019-01-08,0.043596730245231606,183500,191500,8000,82656
22127,69620,2018-12-27,0.05965909090909091,176000,186500,10500,75120
22128,69620,2018-11-08,0.042042042042042045,166500,173500,7000,66279
22129,69620,2018-11-06,0.06583072100313479,159500,170000,10500,99055
22130,69620,2018-11-02,0.0763888888888889,144000,155000,11000,72982
22131,69620,2018-10-30,0.043478260869565216,138000,144000,6000,82352
22132,69620,2018-10-26,0.047619047619047616,147000,140000,-7000,68017
22133,69620,2018-10-23,0.050955414012738856,157000,149000,-8000,66209
22134,69620,2018-10-15,0.05167173252279635,164500,156000,-8500,88871
22135,69620,2018-10-11,0.05621301775147929,169000,159500,-9500,67473
22136,69620,2018-10-05,0.056451612903225805,186000,175500,-10500,96522
22137,69620,2018-08-03,0.07202216066481995,180500,193500,13000,181616
22138,69620,2018-07-03,0.04314720812182741,197000,205500,8500,77869
22139,69620,2018-06-22,0.07291666666666667,192000,206000,14000,91305
22140,69620,2018-06-20,0.055865921787709494,179000,189000,10000,55799
22141,69620,2018-06-19,0.05291005291005291,189000,179000,-10000,68832
22142,69620,2018-05-21,0.06753246753246753,192500,205500,13000,186544
22143,69620,2018-05-17,0.07213930348258707,201000,186500,-14500,390265
22144,69620,2018-05-16,0.06068601583113457,189500,201000,11500,168667
22145,69620,2018-05-11,0.056910569105691054,184500,195000,10500,104370
22146,69620,2018-05-04,0.040983606557377046,183000,175500,-7500,62099
22147,69620,2018-04-30,0.043010752688172046,186000,178000,-8000,106004
22148,69620,2018-04-19,0.05343511450381679,196500,186000,-10500,125119
22149,69620,2018-04-12,0.06164383561643835,219000,205500,-13500,136025
22150,69620,2018-04-06,0.04830917874396135,207000,217000,10000,93636
22151,69620,2018-04-04,0.04785894206549118,198500,208000,9500,122407
22152,69620,2018-03-23,0.04702970297029703,202000,192500,-9500,104439
22153,69620,2018-03-21,0.05194805194805195,192500,202500,10000,118612
22154,69620,2018-02-28,0.041884816753926704,191000,183000,-8000,120228
22155,69620,2018-02-27,0.04657534246575343,182500,191000,8500,158928
22156,69620,2018-02-19,0.047337278106508875,169000,177000,8000,116082
22157,69620,2018-02-08,0.04361370716510903,160500,167500,7000,89874
22158,69620,2018-02-07,0.05309734513274336,169500,160500,-9000,114133
22159,69620,2018-02-01,0.04155124653739612,180500,173000,-7500,143065
22160,69620,2018-01-30,0.07871720116618076,171500,185000,13500,446027
22161,69620,2018-01-24,0.11197916666666667,192000,170500,-21500,1136644
22162,69620,2018-01-19,0.04081632653061224,196000,188000,-8000,108498
22163,69620,2018-01-17,0.055825242718446605,206000,194500,-11500,140081
22164,69620,2018-01-12,0.14804469273743018,179000,205500,26500,599894
22165,69620,2018-01-10,0.07272727272727272,165000,177000,12000,152420
22166,69620,2018-01-04,0.047337278106508875,169000,161000,-8000,142318
22167,69620,2017-12-27,0.09210526315789473,152000,166000,14000,162279
22168,69620,2017-12-15,0.06690140845070422,142000,151500,9500,163147
22169,69620,2017-12-13,0.04428044280442804,135500,141500,6000,75029
22170,69620,2017-12-11,0.0625,128000,136000,8000,88662
22171,69620,2017-11-22,0.04240282685512368,141500,135500,-6000,132795
22172,69620,2017-11-20,0.04797047970479705,135500,142000,6500,79176
22173,69620,2017-11-08,0.06882591093117409,123500,132000,8500,115868
22174,69620,2017-11-03,0.0641025641025641,117000,124500,7500,151756
22175,69620,2017-10-13,0.1,115000,126500,11500,478177
22176,69620,2017-10-11,0.08173076923076923,104000,112500,8500,230674
22177,69620,2017-09-26,0.047619047619047616,105000,110000,5000,83811
22178,69620,2017-09-25,0.045454545454545456,110000,105000,-5000,94315
22179,69620,2017-09-22,0.047619047619047616,115500,110000,-5500,127727
22180,69620,2017-09-21,0.05,110000,115500,5500,164593
22181,69620,2017-09-19,0.07317073170731707,102500,110000,7500,231554
22182,69620,2017-07-26,0.0550561797752809,89000,93900,4900,231800
22183,69620,2017-07-20,0.05938242280285035,84200,89200,5000,161173
22184,69620,2017-06-16,0.06666666666666667,93000,86800,-6200,382445
22185,69620,2017-06-15,0.07,100000,93000,-7000,448827
22186,69620,2017-06-05,0.0639412997903564,95400,101500,6100,217637
22187,69620,2017-05-08,0.05452562704471101,91700,96700,5000,148374
22188,69620,2017-04-03,0.052318668252080855,84100,88500,4400,115620
22189,69620,2017-03-27,0.07332490518331226,79100,84900,5800,144816
22190,69620,2017-02-10,0.04150943396226415,79500,82800,3300,113027
22191,69620,2017-02-07,0.047435897435897434,78000,81700,3700,154725
22192,69620,2017-02-03,0.045454545454545456,72600,75900,3300,136745
22193,69620,2017-02-01,0.07331378299120235,68200,73200,5000,106238
22194,69620,2017-01-05,0.05847953216374269,68400,72400,4000,143234
22195,69620,2016-12-13,0.04185351270553064,66900,69700,2800,68406
22196,69620,2016-12-12,0.048589341692789965,63800,66900,3100,76104
22197,69620,2016-11-18,0.04780876494023904,75300,71700,-3600,54396
22198,69620,2016-11-10,0.08379888268156424,71600,77600,6000,107898
22199,69620,2016-11-04,0.041193181818181816,70400,73300,2900,71763
22200,69620,2016-10-28,0.040927694406548434,73300,70300,-3000,59717
22201,69620,2016-10-06,0.04438964241676942,81100,77500,-3600,112312
22202,69620,2016-09-30,0.06025492468134415,86300,81100,-5200,157527
22203,69620,2016-09-23,0.05459057071960298,80600,85000,4400,180994
22204,69620,2016-09-20,0.06417112299465241,74800,79600,4800,169427
22205,69620,2016-08-22,0.04114713216957606,80200,76900,-3300,132162
22206,69620,2016-08-18,0.04389086595492289,84300,80600,-3700,207073
22207,69620,2016-08-17,0.06747787610619468,90400,84300,-6100,212473
22208,30200,2021-05-24,0.04823151125401929,31100,32600,1500,2261161
22209,30200,2021-02-16,0.07489878542510121,24700,26550,1850,8410853
22210,30200,2021-01-25,0.04430379746835443,23700,24750,1050,4000922
22211,30200,2020-12-29,0.050980392156862744,25500,24200,-1300,3596616
22212,30200,2020-06-16,0.04185022026431718,22700,23650,950,851098
22213,30200,2020-06-15,0.046218487394957986,23800,22700,-1100,1178814
22214,30200,2020-04-20,0.04772727272727273,22000,23050,1050,1904121
22215,30200,2020-04-06,0.07537688442211055,19900,21400,1500,2008413
22216,30200,2020-03-25,0.051490514905149054,18450,19400,950,1365226
22217,30200,2020-03-24,0.0453257790368272,17650,18450,800,1619980
22218,30200,2020-03-23,0.06613756613756613,18900,17650,-1250,1376171
22219,30200,2020-03-20,0.06179775280898876,17800,18900,1100,1472194
22220,30200,2020-03-19,0.06315789473684211,19000,17800,-1200,2038799
22221,30200,2020-03-18,0.05707196029776675,20150,19000,-1150,1342355
22222,30200,2020-03-13,0.045454545454545456,22000,21000,-1000,2435169
22223,30200,2017-07-03,0.04294478527607362,32600,34000,1400,1940688
22224,6650,2021-05-11,0.06351791530944625,307000,287500,-19500,172626
22225,6650,2021-05-03,0.05714285714285714,315000,297000,-18000,128742
22226,6650,2021-04-29,0.06240713224368499,336500,315500,-21000,226488
22227,6650,2021-04-28,0.07300275482093664,363000,336500,-26500,182941
22228,6650,2021-04-27,0.04011461318051576,349000,363000,14000,199664
22229,6650,2021-04-26,0.05597579425113464,330500,349000,18500,148858
22230,6650,2021-04-22,0.06270096463022508,311000,330500,19500,185080
22231,6650,2021-04-05,0.05132192846034215,321500,305000,-16500,130733
22232,6650,2021-03-10,0.05247376311844078,333500,316000,-17500,105339
22233,6650,2021-02-25,0.04956268221574344,343000,360000,17000,119676
22234,6650,2021-02-24,0.06412005457025921,366500,343000,-23500,100733
22235,6650,2021-02-16,0.07366984993178717,366500,393500,27000,185997
22236,6650,2021-02-10,0.21859706362153344,306500,373500,67000,587686
22237,6650,2021-02-02,0.07652173913043478,287500,309500,22000,247394
22238,6650,2021-01-29,0.048576214405360134,298500,284000,-14500,180529
22239,6650,2021-01-27,0.05474452554744526,274000,289000,15000,274423
22240,6650,2021-01-07,0.048736462093862815,277000,290500,13500,251334
22241,6650,2021-01-06,0.17872340425531916,235000,277000,42000,621523
22242,6650,2020-12-30,0.045454545454545456,220000,230000,10000,150308
22243,6650,2020-11-18,0.05652173913043478,230000,243000,13000,109989
22244,6650,2020-11-09,0.04716981132075472,212000,222000,10000,99454
22245,6650,2020-11-05,0.04030226700251889,198500,206500,8000,134061
22246,6650,2020-10-27,0.043478260869565216,195500,187000,-8500,72394
22247,6650,2020-10-20,0.058011049723756904,181000,191500,10500,94594
22248,6650,2020-10-08,0.0431266846361186,185500,193500,8000,190787
22249,6650,2020-10-05,0.13213213213213212,166500,188500,22000,242004
22250,6650,2020-09-23,0.04697986577181208,149000,156000,7000,81377
22251,6650,2020-09-22,0.050955414012738856,157000,149000,-8000,75646
22252,6650,2020-09-09,0.06840390879478828,153500,164000,10500,485086
22253,6650,2020-09-08,0.05862068965517241,145000,153500,8500,690399
22254,6650,2020-09-07,0.2554112554112554,115500,145000,29500,915584
22255,6650,2020-08-20,0.059322033898305086,118000,111000,-7000,56636
22256,6650,2020-07-29,0.0694980694980695,129500,120500,-9000,231753
22257,6650,2020-07-28,0.040160642570281124,124500,129500,5000,87545
22258,6650,2020-07-15,0.053061224489795916,122500,129000,6500,109855
22259,6650,2020-07-13,0.08296943231441048,114500,124000,9500,92819
22260,6650,2020-06-19,0.08260869565217391,115000,124500,9500,148175
22261,6650,2020-06-16,0.107981220657277,106500,118000,11500,94733
22262,6650,2020-06-15,0.07792207792207792,115500,106500,-9000,55901
22263,6650,2020-06-12,0.04938271604938271,121500,115500,-6000,70103
22264,6650,2020-05-28,0.04150943396226415,132500,127000,-5500,62284
22265,6650,2020-05-22,0.04924242424242424,132000,125500,-6500,94367
22266,6650,2020-05-19,0.05019305019305019,129500,136000,6500,119927
22267,6650,2020-05-07,0.04,125000,130000,5000,91677
22268,6650,2020-05-04,0.13167259786476868,140500,122000,-18500,186289
22269,6650,2020-04-24,0.04779411764705882,136000,142500,6500,197210
22270,6650,2020-04-23,0.07086614173228346,127000,136000,9000,183691
22271,6650,2020-04-22,0.058333333333333334,120000,127000,7000,155520
22272,6650,2020-04-20,0.09345794392523364,107000,117000,10000,106525
22273,6650,2020-04-16,0.04265402843601896,105500,110000,4500,94558
22274,6650,2020-04-14,0.14798694232861806,91900,105500,13600,213404
22275,6650,2020-03-31,0.06985294117647059,81600,87300,5700,69006
22276,6650,2020-03-25,0.11468531468531469,71500,79700,8200,79469
22277,6650,2020-03-24,0.08006042296072508,66200,71500,5300,38473
22278,6650,2020-03-23,0.04057971014492753,69000,66200,-2800,51051
22279,6650,2020-03-20,0.12195121951219512,61500,69000,7500,108370
22280,6650,2020-03-19,0.12142857142857143,70000,61500,-8500,77868
22281,6650,2020-03-18,0.0410958904109589,73000,70000,-3000,51065
22282,6650,2020-03-16,0.06896551724137931,81200,75600,-5600,38570
22283,6650,2020-03-13,0.05581395348837209,86000,81200,-4800,106083
22284,6650,2020-03-12,0.07427341227125941,92900,86000,-6900,75134
22285,6650,2020-03-10,0.05136986301369863,87600,92100,4500,100848
22286,6650,2020-03-04,0.043528064146620846,87300,91100,3800,39332
22287,6650,2020-02-28,0.05622932745314223,90700,85600,-5100,60681
22288,6650,2020-02-06,0.059190031152647975,96300,102000,5700,48128
22289,6650,2020-01-31,0.04004106776180698,97400,93500,-3900,46173
22290,6650,2020-01-28,0.06944444444444445,108000,100500,-7500,67869
22291,6650,2020-01-14,0.041666666666666664,108000,112500,4500,36570
22292,6650,2020-01-08,0.04186046511627907,107500,103000,-4500,63318
22293,6650,2020-01-06,0.043859649122807015,114000,109000,-5000,57109
22294,6650,2019-10-11,0.040983606557377046,122000,127000,5000,42764
22295,6650,2019-09-11,0.042801556420233464,128500,134000,5500,55388
22296,6650,2019-08-26,0.05194805194805195,115500,109500,-6000,48772
22297,6650,2019-08-19,0.04484304932735426,111500,116500,5000,19498
22298,6650,2019-08-05,0.07112970711297072,119500,111000,-8500,59846
22299,6650,2019-07-30,0.042735042735042736,117000,122000,5000,33595
22300,6650,2019-07-19,0.040983606557377046,122000,127000,5000,37706
22301,6650,2019-05-29,0.043478260869565216,138000,132000,-6000,47543
22302,6650,2019-05-09,0.0462046204620462,151500,144500,-7000,36046
22303,6650,2019-02-28,0.04632152588555858,183500,175000,-8500,69168
22304,6650,2019-02-18,0.05014749262536873,169500,178000,8500,64778
22305,6650,2019-02-08,0.05202312138728324,173000,164000,-9000,54838
22306,6650,2019-01-25,0.04953560371517028,161500,169500,8000,76068
22307,6650,2019-01-09,0.04861111111111111,144000,151000,7000,49035
22308,6650,2019-01-07,0.08823529411764706,136000,148000,12000,101700
22309,6650,2019-01-03,0.05423728813559322,147500,139500,-8000,71169
22310,6650,2018-12-10,0.04746835443037975,158000,150500,-7500,88810
22311,6650,2018-12-03,0.0625,160000,170000,10000,110410
22312,6650,2018-11-26,0.06172839506172839,162000,172000,10000,72676
22313,6650,2018-11-07,0.05029585798816568,169000,160500,-8500,91158
22314,6650,2018-11-02,0.0732484076433121,157000,168500,11500,118323
22315,6650,2018-10-29,0.06031746031746032,157500,148000,-9500,76094
22316,6650,2018-10-26,0.08430232558139535,172000,157500,-14500,91826
22317,6650,2018-10-24,0.10526315789473684,152000,168000,16000,218876
22318,6650,2018-10-23,0.047021943573667714,159500,152000,-7500,78327
22319,6650,2018-10-11,0.05202312138728324,173000,164000,-9000,63573
22320,6650,2018-10-04,0.052924791086350974,179500,170000,-9500,107764
22321,6650,2018-09-11,0.07692307692307693,208000,192000,-16000,170768
22322,6650,2018-08-22,0.07707910750507099,246500,227500,-19000,219134
22323,6650,2018-08-01,0.06813627254509018,249500,232500,-17000,133022
22324,6650,2018-07-26,0.08189655172413793,232000,251000,19000,106208
22325,6650,2018-07-12,0.0511727078891258,234500,246500,12000,83903
22326,6650,2018-07-02,0.041916167664670656,250500,240000,-10500,30608
22327,6650,2018-06-27,0.04892367906066536,255500,243000,-12500,68844
22328,6650,2018-06-14,0.04779411764705882,272000,259000,-13000,60523
22329,6650,2018-06-08,0.05458089668615984,256500,270500,14000,104663
22330,6650,2018-06-04,0.046464646464646465,247500,259000,11500,56716
22331,6650,2018-05-28,0.05578512396694215,242000,255500,13500,90437
22332,6650,2018-05-04,0.05663716814159292,282500,266500,-16000,55743
22333,6650,2018-05-03,0.046296296296296294,270000,282500,12500,78917
22334,6650,2018-04-16,0.05391304347826087,287500,272000,-15500,90328
22335,6650,2018-03-05,0.06635071090047394,316500,295500,-21000,71240
22336,6650,2018-02-21,0.041604754829123326,336500,322500,-14000,75486
22337,6650,2018-02-19,0.04128440366972477,327000,340500,13500,41142
22338,6650,2018-02-08,0.04146730462519936,313500,326500,13000,50130
22339,6650,2018-02-07,0.07658321060382917,339500,313500,-26000,50914
22340,6650,2018-01-29,0.06782334384858044,317000,338500,21500,70471
22341,6650,2018-01-22,0.05756578947368421,304000,321500,17500,90354
22342,6650,2018-01-12,0.06563039723661486,289500,308500,19000,147129
22343,6650,2018-01-08,0.10211946050096339,259500,286000,26500,208590
22344,6650,2017-11-15,0.04216867469879518,249000,238500,-10500,96820
22345,6650,2017-11-02,0.06986027944111776,250500,268000,17500,179964
22346,6650,2017-10-30,0.0421455938697318,261000,250000,-11000,86492
22347,6650,2017-09-11,0.04339622641509434,265000,276500,11500,54766
22348,6650,2017-08-14,0.050980392156862744,255000,268000,13000,115349
22349,6650,2017-07-31,0.05725971370143149,244500,258500,14000,85748
22350,6650,2017-07-14,0.042105263157894736,237500,247500,10000,79173
22351,6650,2017-05-25,0.10159362549800798,251000,276500,25500,139177
22352,6650,2017-05-22,0.09188034188034189,234000,255500,21500,156452
22353,6650,2017-02-01,0.04814814814814815,270000,283000,13000,48790
22354,6650,2017-01-31,0.0425531914893617,282000,270000,-12000,46073
22355,6650,2017-01-18,0.04878048780487805,287000,273000,-14000,52092
22356,6650,2017-01-09,0.04036697247706422,272500,283500,11000,37546
22357,6650,2016-12-15,0.06854838709677419,248000,265000,17000,54498
22358,6650,2016-12-08,0.052313883299798795,248500,261500,13000,66313
22359,6650,2016-12-06,0.05708245243128964,236500,250000,13500,95823
22360,6650,2016-11-14,0.10024449877750612,204500,225000,20500,106862
22361,6650,2016-11-10,0.043037974683544304,197500,206000,8500,54260
22362,6650,2016-10-18,0.06569343065693431,205500,219000,13500,76385
22363,6650,2016-08-29,0.04784688995215311,209000,199000,-10000,58793
22364,16380,2021-05-27,0.04864864864864865,18500,19400,900,659996
22365,16380,2021-05-26,0.05612244897959184,19600,18500,-1100,651499
22366,16380,2021-05-21,0.04433497536945813,20300,19400,-900,1028843
22367,16380,2021-05-20,0.06018518518518518,21600,20300,-1300,746918
22368,16380,2021-05-18,0.051094890510948905,20550,21600,1050,900791
22369,16380,2021-05-14,0.06531531531531531,22200,20750,-1450,1310458
22370,16380,2021-05-13,0.07692307692307693,24050,22200,-1850,1284523
22371,16380,2021-05-11,0.11666666666666667,21000,23450,2450,4568010
22372,16380,2021-05-06,0.04392764857881137,19350,20200,850,830167
22373,16380,2021-05-03,0.0525,20000,18950,-1050,1008541
22374,16380,2021-04-30,0.0430622009569378,20900,20000,-900,1377732
22375,16380,2021-04-27,0.17032967032967034,18200,21300,3100,8046407
22376,16380,2021-04-23,0.09036144578313253,16600,18100,1500,4260267
22377,16380,2021-04-22,0.11784511784511785,14850,16600,1750,2381169
22378,16380,2021-04-07,0.09722222222222222,14400,15800,1400,1226570
22379,16380,2021-04-01,0.049019607843137254,15300,14550,-750,1040368
22380,16380,2021-03-30,0.04861111111111111,14400,15100,700,2286494
22381,16380,2021-03-29,0.10344827586206896,13050,14400,1350,7043929
22382,16380,2021-03-10,0.04669260700389105,12850,12250,-600,340117
22383,16380,2021-02-24,0.044534412955465584,12350,11800,-550,544861
22384,16380,2021-02-01,0.04245283018867924,10600,11050,450,199511
22385,16380,2021-01-29,0.04072398190045249,11050,10600,-450,255148
22386,16380,2021-01-11,0.06719367588932806,12650,11800,-850,694118
22387,16380,2021-01-05,0.06584362139917696,12150,12950,800,1654864
22388,16380,2021-01-04,0.04741379310344827,11600,12150,550,607266
22389,16380,2020-12-24,0.056338028169014086,10650,11250,600,293499
22390,16380,2020-12-22,0.0611353711790393,11450,10750,-700,307638
22391,16380,2020-12-15,0.041666666666666664,12000,11500,-500,358059
22392,16380,2020-12-14,0.04,12500,12000,-500,463608
22393,16380,2020-12-10,0.046610169491525424,11800,12350,550,854048
22394,16380,2020-12-09,0.05357142857142857,11200,11800,600,567694
22395,16380,2020-12-08,0.04680851063829787,11750,11200,-550,460951
22396,16380,2020-12-04,0.07488986784140969,11350,12200,850,1664221
22397,16380,2020-12-03,0.05092592592592592,10800,11350,550,2046023
22398,16380,2020-12-02,0.048458149779735685,11350,10800,-550,1895772
22399,16380,2020-12-01,0.29714285714285715,8750,11350,2600,6219710
22400,16380,2020-11-13,0.05094130675526024,9030,8570,-460,207883
22401,16380,2020-10-16,0.04391891891891892,8880,8490,-390,330965
22402,16380,2020-10-14,0.06064356435643564,8080,8570,490,671004
22403,16380,2020-09-25,0.07599118942731277,9080,8390,-690,339736
22404,16380,2020-09-24,0.092,10000,9080,-920,331518
22405,16380,2020-09-23,0.1031390134529148,11150,10000,-1150,322021
22406,16380,2020-09-22,0.07851239669421488,12100,11150,-950,323009
22407,16380,2020-09-21,0.09701492537313433,13400,12100,-1300,295707
22408,16380,2020-09-14,0.06451612903225806,12400,13200,800,116169
22409,16380,2020-09-10,0.06722689075630252,11900,12700,800,280295
22410,16380,2020-09-01,0.04583333333333333,12000,12550,550,72028
22411,16380,2020-08-20,0.045283018867924525,13250,12650,-600,120148
22412,16380,2020-08-14,0.07534246575342465,14600,13500,-1100,113781
22413,16380,2020-08-11,0.14615384615384616,13000,14900,1900,1103577
22414,16380,2020-08-10,0.04411764705882353,13600,13000,-600,94277
22415,16380,2020-08-07,0.08366533864541832,12550,13600,1050,131741
22416,16380,2020-07-10,0.05405405405405406,12950,12250,-700,86106
22417,16380,2020-07-03,0.08786610878661087,11950,13000,1050,270032
22418,16380,2020-06-25,0.05384615384615385,13000,12300,-700,94253
22419,16380,2020-06-22,0.04411764705882353,13600,13000,-600,90263
22420,16380,2020-06-15,0.15151515151515152,16500,14000,-2500,301587
22421,16380,2020-06-12,0.15601023017902813,19550,16500,-3050,696213
22422,16380,2020-06-11,0.045454545454545456,18700,19550,850,1024388
22423,16380,2020-06-10,0.12650602409638553,16600,18700,2100,1281804
22424,16380,2020-06-03,0.07987220447284345,15650,16900,1250,616074
22425,16380,2020-05-29,0.2076923076923077,13000,15700,2700,1165423
22426,16380,2020-05-28,0.1016949152542373,11800,13000,1200,2037610
22427,16380,2020-05-15,0.045454545454545456,12100,12650,550,80251
22428,16380,2020-05-14,0.043478260869565216,12650,12100,-550,66450
22429,16380,2020-05-06,0.0995850622406639,12050,13250,1200,496879
22430,16380,2020-05-04,0.04782608695652174,11500,12050,550,235089
22431,16380,2020-04-28,0.08163265306122448,12250,11250,-1000,308527
22432,16380,2020-04-27,0.13120567375886524,14100,12250,-1850,478916
22433,16380,2020-04-24,0.04406779661016949,14750,14100,-650,114031
22434,16380,2020-04-22,0.13432835820895522,16750,14500,-2250,180125
22435,16380,2020-04-21,0.046875,16000,16750,750,216332
22436,16380,2020-04-20,0.21212121212121213,13200,16000,2800,187109
22437,16380,2020-04-17,0.0954356846473029,12050,13200,1150,148599
22438,16380,2020-04-16,0.08558558558558559,11100,12050,950,674462
22439,16380,2020-04-14,0.23333333333333334,9000,11100,2100,864304
22440,16380,2020-04-13,0.1111111111111111,8100,9000,900,202121
22441,16380,2020-04-07,0.047142857142857146,7000,7330,330,33258
22442,16380,2020-03-30,0.0576,6250,6610,360,15417
22443,16380,2020-03-25,0.07719298245614035,5700,6140,440,21201
22444,16380,2020-03-23,0.05414551607445008,5910,5590,-320,7471
22445,16380,2020-03-20,0.11090225563909774,5320,5910,590,12571
22446,16380,2020-03-19,0.16875,6400,5320,-1080,41302
22447,16380,2020-03-13,0.058394160583941604,6850,6450,-400,17159
22448,16380,2019-12-30,0.0684931506849315,7300,7800,500,384404
22449,16380,2019-11-25,0.06963788300835655,7180,7680,500,79158
22450,16380,2019-10-02,0.046948356807511735,10650,10150,-500,26146
22451,16380,2019-09-30,0.0752212389380531,11300,10450,-850,55296
22452,16380,2019-09-27,0.05439330543933055,11950,11300,-650,33574
22453,16380,2019-09-25,0.06896551724137931,13050,12150,-900,89440
22454,16380,2019-09-24,0.10616438356164383,14600,13050,-1550,307604
22455,16380,2019-09-23,0.10606060606060606,13200,14600,1400,863940
22456,16380,2019-09-20,0.20481927710843373,16600,13200,-3400,216936
22457,16380,2019-09-19,0.5666666666666667,6000,16600,10600,68869
22458,16380,2019-08-12,0.04,6000,6240,240,24957
22459,16380,2019-08-05,0.08461538461538462,6500,5950,-550,18571
22460,16380,2019-07-11,0.12649164677804295,8380,7320,-1060,454187
22461,16380,2019-07-10,0.2992248062015504,6450,8380,1930,235824
22462,16380,2019-06-07,0.04477611940298507,8040,7680,-360,64331
22463,16380,2019-05-29,0.07210401891252956,8460,7850,-610,108372
22464,16380,2019-05-28,0.154,10000,8460,-1540,176884
22465,16380,2019-05-27,0.047619047619047616,10500,10000,-500,43013
22466,16380,2019-05-16,0.059907834101382486,10850,10200,-650,467087
22467,16380,2019-05-15,0.04830917874396135,10350,10850,500,1190141
22468,16380,2019-05-09,0.059907834101382486,10850,10200,-650,43318
22469,16380,2019-05-08,0.05853658536585366,10250,10850,600,181300
22470,16380,2019-04-29,0.047619047619047616,10500,10000,-500,86904
22471,16380,2019-04-26,0.05527638190954774,9950,10500,550,125890
22472,16380,2019-04-24,0.06103286384976526,10650,10000,-650,86869
22473,16380,2019-04-22,0.10383064516129033,9920,10950,1030,511766
22474,16380,2019-04-17,0.04113924050632911,9480,9870,390,690242
22475,16380,2019-04-09,0.09392898052691867,8730,9550,820,352517
22476,16380,2019-04-08,0.04381161007667032,9130,8730,-400,54613
22477,16380,2019-04-05,0.087,10000,9130,-870,160920
22478,16380,2019-04-03,0.20613496932515338,8150,9830,1680,760123
22479,16380,2019-04-02,0.04086845466155811,7830,8150,320,49903
22480,16380,2019-03-29,0.14447592067988668,7060,8080,1020,602619
22481,16380,2019-03-28,0.07105263157894737,7600,7060,-540,143159
22482,16380,2019-03-25,0.042416452442159386,7780,7450,-330,40069
22483,16380,2019-03-19,0.07276736493936053,9070,8410,-660,131651
22484,16380,2019-03-13,0.06220095693779904,10450,9800,-650,182715
22485,16380,2019-03-04,0.04926108374384237,10150,10650,500,124352
22486,16380,2019-02-28,0.07727272727272727,11000,10150,-850,121264
22487,16380,2019-02-27,0.14464099895941726,9610,11000,1390,695829
22488,16380,2019-02-11,0.1,12000,10800,-1200,618676
22489,16380,2019-02-08,0.2958963282937365,9260,12000,2740,343162
22490,16380,2019-01-29,0.04885654885654886,9620,9150,-470,73639
22491,16380,2019-01-28,0.042786069651741296,10050,9620,-430,74118
22492,16380,2019-01-23,0.09049773755656108,11050,10050,-1000,225499
22493,16380,2019-01-21,0.07511737089201878,10650,11450,800,346690
22494,16380,2019-01-18,0.06578947368421052,11400,10650,-750,243141
22495,16380,2019-01-17,0.05555555555555555,10800,11400,600,208849
22496,16380,2019-01-11,0.04583333333333333,12000,11450,-550,392000
22497,16380,2019-01-10,0.08396946564885496,13100,12000,-1100,710290
22498,16380,2019-01-08,0.2990936555891239,9930,12900,2970,99896
22499,16380,2019-01-07,0.299738219895288,7640,9930,2290,59375
22500,16380,2019-01-04,0.14029850746268657,6700,7640,940,76558
22501,16380,2018-12-18,0.041990668740279936,6430,6700,270,36914
22502,16380,2018-10-31,0.045588235294117645,6800,7110,310,3696
22503,16380,2018-10-25,0.08333333333333333,7800,7150,-650,24127
22504,16380,2018-10-24,0.05569007263922518,8260,7800,-460,7670
22505,16380,2018-09-13,0.09259259259259259,8100,8850,750,117285
22506,16380,2018-09-06,0.042682926829268296,8200,7850,-350,15356
22507,16380,2018-07-02,0.04060913705583756,7880,7560,-320,10097
22508,16380,2018-06-19,0.04771784232365145,9640,9180,-460,6229
22509,16380,2018-05-28,0.06811145510835913,9690,10350,660,24656
22510,16380,2018-05-24,0.041346153846153845,10400,9970,-430,34600
22511,16380,2018-05-23,0.041474654377880185,10850,10400,-450,22582
22512,16380,2018-05-08,0.051643192488262914,10650,11200,550,287441
22513,16380,2018-04-18,0.1,12000,10800,-1200,67180
22514,16380,2018-04-13,0.05333333333333334,11250,11850,600,59618
22515,16380,2018-04-11,0.041474654377880185,10850,11300,450,179192
22516,16380,2018-04-10,0.05339805825242718,10300,10850,550,40882
22517,16380,2018-03-28,0.05240174672489083,11450,10850,-600,47065
22518,16380,2018-03-26,0.06944444444444445,10800,11550,750,277312
22519,16380,2018-03-23,0.06086956521739131,11500,10800,-700,657750
22520,16380,2018-03-22,0.06882591093117409,12350,11500,-850,122685
22521,16380,2018-03-21,0.08518518518518518,13500,12350,-1150,553394
22522,16380,2018-03-20,0.2980769230769231,10400,13500,3100,410957
22523,16380,2018-03-19,0.059063136456211814,9820,10400,580,29876
22524,16380,2018-01-31,0.04932735426008968,11150,10600,-550,53252
22525,16380,2018-01-18,0.04932735426008968,11150,10600,-550,66146
22526,16380,2018-01-17,0.0825242718446602,10300,11150,850,330674
22527,16380,2018-01-11,0.07017543859649122,11400,10600,-800,68579
22528,16380,2018-01-09,0.04132231404958678,12100,11600,-500,81600
22529,16380,2018-01-03,0.2966804979253112,9640,12500,2860,576528
22530,16380,2018-01-02,0.2991913746630728,7420,9640,2220,73816
22531,16380,2017-12-26,0.05695364238410596,7550,7120,-430,59010
22532,16380,2017-12-22,0.0644361833952912,8070,7550,-520,64664
22533,16380,2017-12-21,0.0846774193548387,7440,8070,630,238256
22534,16380,2017-12-20,0.04980842911877394,7830,7440,-390,59402
22535,16380,2017-12-18,0.04239401496259352,8020,7680,-340,58379
22536,16380,2017-12-15,0.04699738903394256,7660,8020,360,199718
22537,16380,2017-12-13,0.07995365005793743,8630,7940,-690,191682
22538,16380,2017-12-12,0.0537280701754386,9120,8630,-490,684792
22539,16380,2017-12-11,0.29914529914529914,7020,9120,2100,939412
22540,16380,2017-12-08,0.17411764705882352,8500,7020,-1480,180439
22541,16380,2017-12-07,0.178743961352657,10350,8500,-1850,411299
22542,16380,2017-12-06,0.29699248120300753,7980,10350,2370,425365
22543,16380,2017-12-05,0.2996742671009772,6140,7980,1840,450215
22544,16380,2017-11-17,0.04276315789473684,6080,6340,260,12006
22545,16380,2017-11-15,0.055639097744360905,6650,6280,-370,39396
22546,16380,2017-09-29,0.05218617771509168,7090,7460,370,13915
22547,16380,2017-09-22,0.06385696040868455,7830,7330,-500,20976
22548,16380,2017-09-19,0.041025641025641026,7800,8120,320,11564
22549,16380,2017-09-15,0.07766990291262135,8240,7600,-640,67839
22550,16380,2017-09-12,0.08503767491926803,9290,8500,-790,93129
22551,16380,2017-09-04,0.05402843601895735,10550,9980,-570,35139
22552,16380,2017-08-28,0.043859649122807015,11400,10900,-500,30568
22553,16380,2017-07-20,0.0423728813559322,11800,12300,500,14207
22554,16380,2017-06-08,0.056666666666666664,15000,14150,-850,94448
22555,16380,2017-05-23,0.0410958904109589,14600,15200,600,47655
22556,16380,2017-04-24,0.0599250936329588,13350,14150,800,71029
22557,16380,2017-01-10,0.07987220447284345,15650,14400,-1250,62882
22558,16380,2016-11-09,0.04887218045112782,13300,13950,650,18223
22559,16380,2016-11-07,0.08267716535433071,12700,13750,1050,61919
22560,16380,2016-11-04,0.058333333333333334,12000,12700,700,14925
22561,16380,2016-11-02,0.047244094488188976,12700,12100,-600,13009
22562,16380,2016-10-31,0.04477611940298507,13400,12800,-600,10895
22563,16380,2016-10-07,0.04778156996587031,14650,13950,-700,10009
22564,16380,2016-09-19,0.0673076923076923,15600,14550,-1050,41512
22565,16380,2016-08-25,0.05263157894736842,16150,17000,850,208411
22566,16380,2016-08-12,0.048859934853420196,15350,16100,750,13611
22567,28670,2021-05-25,0.05794947994056464,6730,7120,390,8899890
22568,28670,2021-05-14,0.04583333333333333,7200,6870,-330,13412185
22569,28670,2021-05-06,0.07541899441340782,7160,7700,540,17992669
22570,28670,2021-05-03,0.043596730245231606,7340,7020,-320,12069658
22571,28670,2021-04-26,0.06142857142857143,7000,7430,430,36006283
22572,28670,2021-04-22,0.10987261146496816,6280,6970,690,38969920
22573,28670,2021-04-16,0.06197654941373534,5970,6340,370,18422951
22574,28670,2021-03-29,0.05417276720351391,6830,6460,-370,16221937
22575,28670,2021-03-26,0.041158536585365856,6560,6830,270,28542317
22576,28670,2021-03-22,0.1045958795562599,6310,6970,660,46661593
22577,28670,2021-03-12,0.04241435562805873,6130,6390,260,14127850
22578,28670,2021-03-10,0.043029259896729774,5810,6060,250,15506261
22579,28670,2021-03-09,0.10339506172839506,6480,5810,-670,62881613
22580,28670,2021-03-05,0.09540034071550256,5870,6430,560,82365221
22581,28670,2021-03-03,0.06039076376554174,5630,5970,340,17122253
22582,28670,2021-02-22,0.07721280602636535,5310,5720,410,39269272
22583,28670,2021-02-19,0.059880239520958084,5010,5310,300,13747214
22584,28670,2021-02-16,0.044715447154471545,4920,5140,220,5957883
22585,28670,2021-01-26,0.041586073500967116,5170,4955,-215,3831840
22586,28670,2021-01-21,0.08559498956158663,4790,5200,410,14724150
22587,28670,2021-01-19,0.04891304347826087,4600,4825,225,3558090
22588,28670,2021-01-15,0.043259557344064385,4970,4755,-215,3423194
22589,28670,2021-01-06,0.0570902394106814,5430,5120,-310,8510216
22590,28670,2021-01-04,0.0697211155378486,5020,5370,350,12120901
22591,28670,2020-12-24,0.04194260485651214,4530,4720,190,16312399
22592,28670,2020-12-18,0.04918032786885246,4270,4480,210,15654713
22593,28670,2020-11-23,0.06049382716049383,4050,4295,245,19395948
22594,28670,2020-11-13,0.06319290465631928,4510,4225,-285,13104956
22595,28670,2020-11-12,0.06745562130177515,4225,4510,285,72851138
22596,28670,2020-11-09,0.2109038737446198,3485,4220,735,64203949
22597,28670,2020-10-16,0.04,3750,3600,-150,2083578
22598,28670,2020-10-14,0.04846938775510204,3920,3730,-190,3301215
22599,28670,2020-10-05,0.11695906432748537,3420,3820,400,10765337
22600,28670,2020-08-20,0.05471956224350205,3655,3455,-200,2463083
22601,28670,2020-08-18,0.051181102362204724,3810,3615,-195,2591779
22602,28670,2020-07-10,0.04865556978233035,3905,3715,-190,3630422
22603,28670,2020-07-07,0.04198473282442748,3930,4095,165,5286821
22604,28670,2020-06-29,0.0525,4000,3790,-210,3177143
22605,28670,2020-06-26,0.0610079575596817,3770,4000,230,15478400
22606,28670,2020-06-18,0.07582260371959942,3495,3760,265,4204989
22607,28670,2020-06-16,0.06083086053412463,3370,3575,205,1323947
22608,28670,2020-06-15,0.0703448275862069,3625,3370,-255,2137855
22609,28670,2020-06-05,0.05466666666666667,3750,3955,205,5099984
22610,28670,2020-06-03,0.06482758620689655,3625,3860,235,14668938
22611,28670,2020-05-29,0.04227405247813411,3430,3575,145,2419546
22612,28670,2020-05-28,0.04055944055944056,3575,3430,-145,2327394
22613,28670,2020-05-22,0.05263157894736842,3610,3420,-190,2095658
22614,28670,2020-05-19,0.0637329286798179,3295,3505,210,7211281
22615,28670,2020-05-04,0.05370101596516691,3445,3260,-185,2550541
22616,28670,2020-04-23,0.07020280811232449,3205,3430,225,2883022
22617,28670,2020-04-17,0.04153354632587859,3130,3260,130,2417820
22618,28670,2020-04-14,0.04084967320261438,3060,3185,125,1422268
22619,28670,2020-04-06,0.07939189189189189,2960,3195,235,2338816
22620,28670,2020-04-03,0.045936395759717315,2830,2960,130,1730221
22621,28670,2020-04-01,0.05583756345177665,2955,2790,-165,2148438
22622,28670,2020-03-25,0.05576923076923077,2600,2745,145,2614664
22623,28670,2020-03-24,0.05263157894736842,2470,2600,130,2494947
22624,28670,2020-03-23,0.07835820895522388,2680,2470,-210,3154139
22625,28670,2020-03-20,0.2853717026378897,2085,2680,595,5822590
22626,28670,2020-03-19,0.26970227670753066,2855,2085,-770,4853706
22627,28670,2020-03-18,0.05306799336650083,3015,2855,-160,1639843
22628,28670,2020-03-17,0.04133545310015898,3145,3015,-130,1895019
22629,28670,2020-03-13,0.11357340720221606,3610,3200,-410,3802691
22630,28670,2020-03-12,0.041168658698539175,3765,3610,-155,2428023
22631,28670,2020-02-27,0.04240766073871409,3655,3810,155,2634592
22632,28670,2020-02-24,0.06143790849673202,3825,3590,-235,2087505
22633,28670,2020-02-06,0.05605095541401274,3925,4145,220,1554940
22634,28670,2020-01-28,0.0608187134502924,4275,4015,-260,1865123
22635,28670,2019-11-08,0.04431818181818182,4400,4595,195,2880661
22636,28670,2019-10-14,0.0715909090909091,4400,4715,315,2857466
22637,28670,2019-08-30,0.04967602591792657,4630,4860,230,2509767
22638,28670,2019-08-14,0.040137614678899085,4360,4535,175,2848260
22639,28670,2019-08-05,0.04838709677419355,4650,4425,-225,1911900
22640,28670,2019-07-17,0.04365904365904366,4810,5020,210,4466672
22641,28670,2019-05-15,0.04274465691788527,4445,4635,190,1268584
22642,28670,2019-05-09,0.05194805194805195,4620,4380,-240,2486426
22643,28670,2018-12-27,0.056558363417569195,4155,4390,235,1261107
22644,28670,2018-11-26,0.05070754716981132,4240,4455,215,1898557
22645,28670,2018-11-12,0.07684210526315789,4750,4385,-365,4393477
22646,28670,2018-11-02,0.05217391304347826,4600,4840,240,1429291
22647,28670,2018-10-26,0.043523316062176166,4825,4615,-210,1389993
22648,28670,2018-10-11,0.0425531914893617,4935,4725,-210,1930906
22649,28670,2018-09-21,0.04120603015075377,4975,5180,205,2176899
22650,28670,2018-08-20,0.04296875,5120,5340,220,3563209
22651,28670,2018-08-14,0.04383282364933741,4905,5120,215,2016323
22652,28670,2018-07-23,0.04583333333333333,4800,5020,220,3778810
22653,28670,2018-07-06,0.04343220338983051,4720,4925,205,3440835
22654,28670,2018-07-02,0.05424769703172978,4885,4620,-265,2042678
22655,28670,2018-05-10,0.06627680311890838,5130,5470,340,6315630
22656,28670,2018-05-02,0.045454545454545456,5500,5250,-250,3115165
22657,28670,2018-04-04,0.08617424242424243,5280,4825,-455,9154847
22658,28670,2018-03-26,0.04330708661417323,5080,5300,220,2196103
22659,28670,2018-02-14,0.051188299817184646,5470,5750,280,2835096
22660,28670,2018-01-25,0.04946996466431095,5660,5940,280,6421414
22661,28670,2018-01-15,0.05226480836236934,5740,5440,-300,5446612
22662,28670,2018-01-10,0.05328596802841918,5630,5930,300,7032718
22663,28670,2018-01-04,0.06261859582542695,5270,5600,330,5099980
22664,28670,2017-12-27,0.05595116988809766,4915,5190,275,3518686
22665,28670,2017-12-22,0.052581261950286805,5230,4955,-275,8626040
22666,28670,2017-12-18,0.04513888888888889,5760,5500,-260,4926909
22667,28670,2017-12-15,0.04,6000,5760,-240,3890961
22668,28670,2017-12-04,0.06842105263157895,5700,6090,390,10654391
22669,28670,2017-11-24,0.05970149253731343,5360,5680,320,7137342
22670,28670,2017-11-17,0.06212424849699399,4990,5300,310,7062032
22671,28670,2017-11-14,0.06461538461538462,4875,5190,315,6494241
22672,28670,2017-10-26,0.06,5500,5170,-330,7981274
22673,28670,2017-10-23,0.04195804195804196,5720,5480,-240,3719868
22674,28670,2017-10-17,0.062157221206581355,5470,5810,340,6646126
22675,28670,2017-09-25,0.05075187969924812,5320,5590,270,6065381
22676,28670,2017-09-22,0.06502636203866433,5690,5320,-370,8983494
22677,28670,2017-09-21,0.057947019867549666,6040,5690,-350,9491101
22678,28670,2017-09-14,0.0806697108066971,6570,6040,-530,45913072
22679,28670,2017-08-18,0.05392156862745098,6120,6450,330,6293224
22680,28670,2017-08-14,0.04819277108433735,5810,6090,280,4579387
22681,28670,2017-07-25,0.06290322580645161,6200,5810,-390,7063183
22682,28670,2017-07-24,0.040268456375838924,5960,6200,240,5221779
22683,28670,2017-07-18,0.05982905982905983,5850,6200,350,8779797
22684,28670,2017-07-12,0.04007285974499089,5490,5710,220,11984483
22685,28670,2017-06-08,0.04570383912248629,5470,5220,-250,14011890
22686,28670,2017-05-31,0.04364326375711575,5270,5500,230,21127467
22687,28670,2017-05-12,0.06418219461697723,4830,5140,310,5534979
22688,28670,2017-04-19,0.0449438202247191,5340,5100,-240,8221523
22689,28670,2017-04-12,0.0546875,5120,5400,280,5454399
22690,28670,2017-04-03,0.08363636363636363,5500,5040,-460,8580849
22691,28670,2017-03-16,0.08823529411764706,5100,5550,450,8292798
22692,28670,2017-02-28,0.07484407484407485,4810,5170,360,11504136
22693,28670,2017-02-23,0.049578059071729956,4740,4975,235,5423099
22694,28670,2017-02-21,0.06175514626218852,4615,4900,285,8845181
22695,28670,2016-11-15,0.04294478527607362,4075,3900,-175,2491616
22696,28670,2016-11-10,0.10241820768136557,3515,3875,360,2928373
22697,28670,2016-11-09,0.04353741496598639,3675,3515,-160,4271499
22698,28670,2016-11-02,0.04264099037138927,3635,3480,-155,1878264
22699,28670,2016-10-11,0.0517464424320828,3865,4065,200,3245369
22700,28670,2016-09-30,0.04697156983930779,4045,3855,-190,3614846
22701,28670,2016-09-26,0.04050925925925926,4320,4145,-175,3429729
22702,28670,2016-09-22,0.07537688442211055,3980,4280,300,13596412
22703,28670,2016-09-07,0.061813186813186816,3640,3865,225,4785881
22704,28670,2016-09-06,0.053315994798439535,3845,3640,-205,3683760
22705,28670,2016-09-02,0.04539385847797063,3745,3915,170,15511290
22706,28670,2016-08-31,0.04551920341394026,3515,3675,160,6205096
