,code,date,rate,pre_close,close,diff,volume,단축코드,한글 종목명
0,60,2021-05-24,0.0434782608695652,17250,18000,750,708415,60.0,메리츠화재해상보험보통주
1,60,2021-05-17,0.1678486997635933,21150,17600,-3550,3428940,60.0,메리츠화재해상보험보통주
2,60,2021-05-06,0.0461538461538461,19500,20400,900,512610,60.0,메리츠화재해상보험보통주
3,60,2021-03-31,0.0516304347826086,18400,19350,950,955676,60.0,메리츠화재해상보험보통주
4,60,2021-02-22,0.0466666666666666,15000,15700,700,1271128,60.0,메리츠화재해상보험보통주
5,60,2021-02-01,0.0599369085173501,15850,14900,-950,1152343,60.0,메리츠화재해상보험보통주
6,60,2021-01-25,0.0427631578947368,15200,15850,650,978548,60.0,메리츠화재해상보험보통주
7,60,2021-01-14,0.0415224913494809,14450,15050,600,743867,60.0,메리츠화재해상보험보통주
8,60,2020-12-29,0.0823170731707317,16400,15050,-1350,917229,60.0,메리츠화재해상보험보통주
9,60,2020-11-10,0.0422535211267605,14200,14800,600,330623,60.0,메리츠화재해상보험보통주
10,60,2020-11-02,0.0469314079422382,13850,14500,650,214543,60.0,메리츠화재해상보험보통주
11,60,2020-10-30,0.0448275862068965,14500,13850,-650,316946,60.0,메리츠화재해상보험보통주
12,60,2020-10-22,0.0410958904109589,14600,15200,600,894578,60.0,메리츠화재해상보험보통주
13,60,2020-10-19,0.0441176470588235,13600,14200,600,532316,60.0,메리츠화재해상보험보통주
14,60,2020-10-08,0.0411985018726591,13350,13900,550,438858,60.0,메리츠화재해상보험보통주
15,60,2020-08-18,0.0410447761194029,13400,12850,-550,255530,60.0,메리츠화재해상보험보통주
16,60,2020-06-16,0.0636704119850187,13350,14200,850,190591,60.0,메리츠화재해상보험보통주
17,60,2020-06-15,0.0664335664335664,14300,13350,-950,185654,60.0,메리츠화재해상보험보통주
18,60,2020-05-15,0.0422535211267605,14200,14800,600,646630,60.0,메리츠화재해상보험보통주
19,60,2020-04-10,0.0967741935483871,12400,13600,1200,863824,60.0,메리츠화재해상보험보통주
20,60,2020-04-02,0.0416666666666666,12000,12500,500,177522,60.0,메리츠화재해상보험보통주
21,60,2020-03-31,0.0517241379310344,11600,12200,600,203185,60.0,메리츠화재해상보험보통주
22,60,2020-03-27,0.0401785714285714,11200,11650,450,206366,60.0,메리츠화재해상보험보통주
23,60,2020-03-26,0.087378640776699,10300,11200,900,370283,60.0,메리츠화재해상보험보통주
24,60,2020-03-25,0.0618556701030927,9700,10300,600,307937,60.0,메리츠화재해상보험보통주
25,60,2020-03-23,0.0454545454545454,9900,9450,-450,397366,60.0,메리츠화재해상보험보통주
26,60,2020-03-20,0.0784313725490196,9180,9900,720,596347,60.0,메리츠화재해상보험보통주
27,60,2020-03-19,0.2086206896551724,11600,9180,-2420,780973,60.0,메리츠화재해상보험보통주
28,60,2020-03-17,0.0551181102362204,12700,12000,-700,319127,60.0,메리츠화재해상보험보통주
29,60,2019-09-10,0.0469613259668508,18100,18950,850,317077,60.0,메리츠화재해상보험보통주
30,60,2019-08-23,0.0415584415584415,19250,18450,-800,147312,60.0,메리츠화재해상보험보통주
31,60,2019-08-22,0.0405405405405405,18500,19250,750,197748,60.0,메리츠화재해상보험보통주
32,60,2019-06-07,0.0476190476190476,22050,21000,-1050,264930,60.0,메리츠화재해상보험보통주
33,60,2019-05-13,0.0402542372881355,23600,22650,-950,416851,60.0,메리츠화재해상보험보통주
34,60,2019-04-01,0.0452674897119341,24300,25400,1100,480325,60.0,메리츠화재해상보험보통주
35,60,2018-12-05,0.0448113207547169,21200,22150,950,285701,60.0,메리츠화재해상보험보통주
36,60,2018-11-20,0.0457831325301204,20750,21700,950,356371,60.0,메리츠화재해상보험보통주
37,60,2018-11-12,0.0989304812834224,18700,20550,1850,1190128,60.0,메리츠화재해상보험보통주
38,60,2018-09-27,0.0566037735849056,18550,19600,1050,580989,60.0,메리츠화재해상보험보통주
39,60,2018-06-21,0.0483091787439613,20700,19700,-1000,386376,60.0,메리츠화재해상보험보통주
40,60,2018-03-23,0.0409090909090909,22000,21100,-900,191091,60.0,메리츠화재해상보험보통주
41,60,2017-12-20,0.0412573673870334,25450,24400,-1050,163624,60.0,메리츠화재해상보험보통주
42,60,2017-12-19,0.0451745379876796,24350,25450,1100,518201,60.0,메리츠화재해상보험보통주
43,60,2017-12-18,0.0428265524625267,23350,24350,1000,294976,60.0,메리츠화재해상보험보통주
44,60,2017-12-01,0.046692607003891,25700,24500,-1200,164887,60.0,메리츠화재해상보험보통주
45,60,2017-10-30,0.0509090909090909,27500,26100,-1400,250591,60.0,메리츠화재해상보험보통주
46,60,2017-10-20,0.0464646464646464,24750,25900,1150,527204,60.0,메리츠화재해상보험보통주
47,60,2017-07-11,0.0406698564593301,20900,21750,850,409602,60.0,메리츠화재해상보험보통주
48,80,2021-05-31,0.0462351387054161,37850,39600,1750,1466409,80.0,하이트진로보통주
49,80,2021-05-26,0.0423497267759562,36600,38150,1550,2009431,80.0,하이트진로보통주
50,80,2021-02-05,0.0535987748851454,32650,34400,1750,993285,80.0,하이트진로보통주
51,80,2021-01-18,0.0489510489510489,35750,34000,-1750,783089,80.0,하이트진로보통주
52,80,2020-12-10,0.0526315789473684,31350,33000,1650,1520626,80.0,하이트진로보통주
53,80,2020-10-06,0.0653685674547983,35950,38300,2350,1047653,80.0,하이트진로보통주
54,80,2020-09-28,0.0779610194902548,33350,35950,2600,493071,80.0,하이트진로보통주
55,80,2020-08-18,0.0495767835550181,41350,39300,-2050,1327397,80.0,하이트진로보통주
56,80,2020-08-14,0.0623582766439909,44100,41350,-2750,1758970,80.0,하이트진로보통주
57,80,2020-08-06,0.0408602150537634,46500,44600,-1900,806005,80.0,하이트진로보통주
58,80,2020-08-05,0.0652920962199312,43650,46500,2850,1444373,80.0,하이트진로보통주
59,80,2020-08-03,0.0469314079422382,41550,43500,1950,769702,80.0,하이트진로보통주
60,80,2020-07-10,0.0437788018433179,43400,45300,1900,843773,80.0,하이트진로보통주
61,80,2020-07-07,0.0567786790266512,43150,45600,2450,712358,80.0,하이트진로보통주
62,80,2020-06-10,0.046979865771812,37250,39000,1750,1007368,80.0,하이트진로보통주
63,80,2020-06-01,0.0763888888888889,36000,38750,2750,1407345,80.0,하이트진로보통주
64,80,2020-05-14,0.0405797101449275,34500,35900,1400,596496,80.0,하이트진로보통주
65,80,2020-05-06,0.0439393939393939,33000,34450,1450,684259,80.0,하이트진로보통주
66,80,2020-04-24,0.0523648648648648,29600,31150,1550,906931,80.0,하이트진로보통주
67,80,2020-04-06,0.0516934046345811,28050,29500,1450,647069,80.0,하이트진로보통주
68,80,2020-04-03,0.0408163265306122,26950,28050,1100,484075,80.0,하이트진로보통주
69,80,2020-03-26,0.0430327868852459,24400,25450,1050,744386,80.0,하이트진로보통주
70,80,2020-03-25,0.0748898678414096,22700,24400,1700,794298,80.0,하이트진로보통주
71,80,2020-03-24,0.0460829493087557,21700,22700,1000,617814,80.0,하이트진로보통주
72,80,2020-03-23,0.1033057851239669,24200,21700,-2500,450741,80.0,하이트진로보통주
73,80,2020-03-20,0.1,22000,24200,2200,776466,80.0,하이트진로보통주
74,80,2020-03-19,0.1056910569105691,24600,22000,-2600,707613,80.0,하이트진로보통주
75,80,2020-03-13,0.0587121212121212,26400,24850,-1550,1080618,80.0,하이트진로보통주
76,80,2020-03-09,0.0427350427350427,29250,28000,-1250,677198,80.0,하이트진로보통주
77,80,2020-03-04,0.0727611940298507,26800,28750,1950,905779,80.0,하이트진로보통주
78,80,2020-02-24,0.0566666666666666,30000,28300,-1700,1048672,80.0,하이트진로보통주
79,80,2020-02-21,0.04,31250,30000,-1250,639772,80.0,하이트진로보통주
80,80,2020-02-19,0.0769230769230769,29250,31500,2250,1005051,80.0,하이트진로보통주
81,80,2020-01-31,0.0491283676703645,31550,30000,-1550,580766,80.0,하이트진로보통주
82,80,2020-01-15,0.0895008605851979,29050,31650,2600,1580120,80.0,하이트진로보통주
83,80,2020-01-14,0.0602189781021897,27400,29050,1650,472229,80.0,하이트진로보통주
84,80,2019-11-19,0.0537261698440207,28850,30400,1550,695372,80.0,하이트진로보통주
85,80,2019-10-14,0.0478821362799263,27150,25850,-1300,843360,80.0,하이트진로보통주
86,80,2019-09-04,0.0536082474226804,24250,25550,1300,1145478,80.0,하이트진로보통주
87,80,2019-09-02,0.0772727272727272,22000,23700,1700,1201975,80.0,하이트진로보통주
88,80,2019-08-14,0.0425531914893617,21150,22050,900,756679,80.0,하이트진로보통주
89,80,2019-06-05,0.0413625304136253,20550,21400,850,856217,80.0,하이트진로보통주
90,80,2019-05-15,0.0441176470588235,20400,21300,900,800910,80.0,하이트진로보통주
91,80,2019-04-24,0.053763440860215,18600,19600,1000,2091395,80.0,하이트진로보통주
92,80,2019-03-26,0.0473537604456824,17950,18800,850,395953,80.0,하이트진로보통주
93,80,2019-01-04,0.0401234567901234,16200,16850,650,243593,80.0,하이트진로보통주
94,80,2018-11-16,0.0625,16000,17000,1000,656628,80.0,하이트진로보통주
95,80,2018-08-16,0.06,17500,16450,-1050,760633,80.0,하이트진로보통주
96,80,2018-07-11,0.0547945205479452,18250,19250,1000,698006,80.0,하이트진로보통주
97,80,2018-07-03,0.05,19000,18050,-950,684359,80.0,하이트진로보통주
98,80,2018-03-26,0.0421545667447306,21350,22250,900,237307,80.0,하이트진로보통주
99,80,2018-03-20,0.0426540284360189,21100,22000,900,290165,80.0,하이트진로보통주
100,80,2018-01-15,0.0653061224489796,24500,22900,-1600,736486,80.0,하이트진로보통주
101,80,2017-10-16,0.0504672897196261,26750,25400,-1350,879409,80.0,하이트진로보통주
102,80,2017-09-07,0.0509164969450101,24550,25800,1250,399854,80.0,하이트진로보통주
103,80,2017-09-01,0.0478927203065134,26100,24850,-1250,391167,80.0,하이트진로보통주
104,80,2017-08-16,0.0745341614906832,24150,25950,1800,1326446,80.0,하이트진로보통주
105,80,2017-07-24,0.0402684563758389,22350,23250,900,241342,80.0,하이트진로보통주
106,80,2017-07-13,0.0486111111111111,21600,22650,1050,423798,80.0,하이트진로보통주
107,80,2017-07-10,0.0502183406113537,22900,21750,-1150,553806,80.0,하이트진로보통주
108,80,2017-05-19,0.0417582417582417,22750,23700,950,1715511,80.0,하이트진로보통주
109,80,2016-12-28,0.0491071428571428,22400,21300,-1100,485834,80.0,하이트진로보통주
110,80,2016-10-28,0.0409638554216867,20750,21600,850,1046962,80.0,하이트진로보통주
111,100,2021-04-12,0.0427892234548335,63100,65800,2700,645948,100.0,유한양행보통주
112,100,2021-01-18,0.055045871559633,76300,72100,-4200,2180383,100.0,유한양행보통주
113,100,2021-01-14,0.0414993306559571,74700,77800,3100,1001087,100.0,유한양행보통주
114,100,2021-01-11,0.044328552803129,76700,73300,-3400,902778,100.0,유한양행보통주
115,100,2021-01-04,0.0545938748335552,75100,79200,4100,1040202,100.0,유한양행보통주
116,100,2020-12-28,0.0421768707482993,73500,76600,3100,1034267,100.0,유한양행보통주
117,100,2020-12-22,0.0535031847133758,78500,74300,-4200,1377799,100.0,유한양행보통주
118,100,2020-12-21,0.0857538035961272,72300,78500,6200,5494070,100.0,유한양행보통주
119,100,2020-12-18,0.0601173020527859,68200,72300,4100,2276533,100.0,유한양행보통주
120,100,2020-12-08,0.0401146131805157,69800,67000,-2800,1153281,100.0,유한양행보통주
121,100,2020-12-07,0.0721966205837173,65100,69800,4700,2655829,100.0,유한양행보통주
122,100,2020-10-28,0.0449050086355785,57900,60500,2600,220972,100.0,유한양행보통주
123,100,2020-09-24,0.0462249614791987,64900,61900,-3000,726180,100.0,유한양행보통주
124,100,2020-09-22,0.0736111111111111,72000,66700,-5300,1891243,100.0,유한양행보통주
125,100,2020-09-21,0.081081081081081,66600,72000,5400,6284923,100.0,유한양행보통주
126,100,2020-09-15,0.045662100456621,65700,68700,3000,1481070,100.0,유한양행보통주
127,100,2020-08-19,0.0562700964630225,62200,65700,3500,960406,100.0,유한양행보통주
128,100,2020-08-05,0.1572649572649572,58500,67700,9200,12395002,100.0,유한양행보통주
129,100,2020-07-24,0.0600375234521576,53300,56500,3200,7266218,100.0,유한양행보통주
130,100,2020-06-16,0.0465116279069767,51600,54000,2400,660604,100.0,유한양행보통주
131,100,2020-06-15,0.0618181818181818,55000,51600,-3400,1326801,100.0,유한양행보통주
132,100,2020-06-08,0.1003861003861003,51800,57000,5200,5974675,100.0,유한양행보통주
133,100,2020-05-11,0.0579857578840284,49150,52000,2850,2914944,100.0,유한양행보통주
134,100,2020-05-08,0.0502136752136752,46800,49150,2350,824620,100.0,유한양행보통주
135,100,2020-04-09,0.0526315789473684,46550,49000,2450,1819258,100.0,유한양행보통주
136,100,2020-03-27,0.0985221674876847,203000,223000,20000,555567,100.0,유한양행보통주
137,100,2020-03-19,0.0626506024096385,207500,194500,-13000,88336,100.0,유한양행보통주
138,100,2020-03-12,0.0572687224669603,227000,214000,-13000,92620,100.0,유한양행보통주
139,100,2019-12-12,0.0419426048565121,226500,236000,9500,122853,100.0,유한양행보통주
140,100,2019-09-17,0.047945205479452,219000,229500,10500,89548,100.0,유한양행보통주
141,100,2019-09-10,0.0465631929046563,225500,215000,-10500,130168,100.0,유한양행보통주
142,100,2019-08-05,0.0427927927927927,222000,212500,-9500,57582,100.0,유한양행보통주
143,100,2019-04-10,0.042016806722689,238000,248000,10000,68382,100.0,유한양행보통주
144,100,2019-01-15,0.0447427293064877,223500,233500,10000,237950,100.0,유한양행보통주
145,100,2019-01-04,0.0705596107055961,205500,220000,14500,109594,100.0,유한양행보통주
146,100,2018-12-06,0.0565217391304347,230000,217000,-13000,150990,100.0,유한양행보통주
147,100,2018-11-19,0.0604166666666666,240000,254500,14500,471933,100.0,유한양행보통주
148,100,2018-11-07,0.05,250000,237500,-12500,637970,100.0,유한양행보통주
149,100,2018-11-06,0.0822510822510822,231000,250000,19000,2285194,100.0,유한양행보통주
150,100,2018-11-05,0.297752808988764,178000,231000,53000,530551,100.0,유한양행보통주
151,100,2018-11-02,0.0532544378698224,169000,178000,9000,90530,100.0,유한양행보통주
152,100,2018-10-31,0.1365979381443298,194000,167500,-26500,330484,100.0,유한양행보통주
153,100,2018-10-11,0.0417633410672853,215500,206500,-9000,43401,100.0,유한양행보통주
154,100,2018-08-31,0.0436681222707423,229000,239000,10000,72966,100.0,유한양행보통주
155,100,2018-06-19,0.0597345132743362,226000,212500,-13500,88004,100.0,유한양행보통주
156,100,2018-06-04,0.0509164969450101,245500,233000,-12500,75859,100.0,유한양행보통주
157,100,2018-04-18,0.0555555555555555,252000,238000,-14000,123947,100.0,유한양행보통주
158,100,2018-04-09,0.0852878464818763,234500,254500,20000,316194,100.0,유한양행보통주
159,100,2018-03-23,0.0411899313501144,218500,209500,-9000,69588,100.0,유한양행보통주
160,100,2018-03-20,0.0423529411764705,212500,221500,9000,36698,100.0,유한양행보통주
161,100,2018-02-05,0.0417582417582417,227500,218000,-9500,72233,100.0,유한양행보통주
162,100,2018-01-29,0.0429864253393665,221000,230500,9500,158000,100.0,유한양행보통주
163,100,2017-07-28,0.0633397312859884,260500,244000,-16500,132263,100.0,유한양행보통주
164,100,2017-04-03,0.047191011235955,222500,233000,10500,82508,100.0,유한양행보통주
165,100,2017-02-23,0.0547619047619047,210000,221500,11500,128490,100.0,유한양행보통주
166,100,2017-02-15,0.0687830687830687,189000,202000,13000,162523,100.0,유한양행보통주
167,100,2016-12-13,0.0583756345177665,197000,208500,11500,115676,100.0,유한양행보통주
168,100,2016-11-21,0.0404761904761904,210000,201500,-8500,74315,100.0,유한양행보통주
169,100,2016-11-10,0.0692124105011933,209500,224000,14500,96457,100.0,유한양행보통주
170,100,2016-10-28,0.1524752475247524,252500,214000,-38500,277694,100.0,유한양행보통주
171,100,2016-10-14,0.0400763358778625,262000,251500,-10500,52213,100.0,유한양행보통주
172,120,2021-02-03,0.0890804597701149,174000,189500,15500,469408,120.0,씨제이대한통운보통주
173,120,2021-01-18,0.044378698224852,169000,161500,-7500,124302,120.0,씨제이대한통운보통주
174,120,2021-01-05,0.0504451038575667,168500,177000,8500,275065,120.0,씨제이대한통운보통주
175,120,2020-11-18,0.0445859872611464,157000,164000,7000,151690,120.0,씨제이대한통운보통주
176,120,2020-11-10,0.0401234567901234,162000,155500,-6500,237909,120.0,씨제이대한통운보통주
177,120,2020-10-22,0.0502793296089385,179000,170000,-9000,114299,120.0,씨제이대한통운보통주
178,120,2020-09-22,0.0480225988700565,177000,168500,-8500,123811,120.0,씨제이대한통운보통주
179,120,2020-09-16,0.0923076923076923,162500,177500,15000,514853,120.0,씨제이대한통운보통주
180,120,2020-08-20,0.0427631578947368,152000,145500,-6500,92023,120.0,씨제이대한통운보통주
181,120,2020-07-22,0.0402476780185758,161500,155000,-6500,91319,120.0,씨제이대한통운보통주
182,120,2020-06-16,0.0482315112540192,155500,163000,7500,53450,120.0,씨제이대한통운보통주
183,120,2020-05-18,0.0437710437710437,148500,155000,6500,232708,120.0,씨제이대한통운보통주
184,120,2020-05-13,0.0531914893617021,141000,148500,7500,196654,120.0,씨제이대한통운보통주
185,120,2020-05-04,0.0439189189189189,148000,141500,-6500,86017,120.0,씨제이대한통운보통주
186,120,2020-04-16,0.0711610486891385,133500,143000,9500,168418,120.0,씨제이대한통운보통주
187,120,2020-04-01,0.0588235294117647,136000,128000,-8000,72016,120.0,씨제이대한통운보통주
188,120,2020-03-20,0.0511811023622047,127000,133500,6500,109678,120.0,씨제이대한통운보통주
189,120,2020-03-18,0.0590717299578059,118500,125500,7000,112702,120.0,씨제이대한통운보통주
190,120,2020-03-13,0.0757575757575757,132000,122000,-10000,145289,120.0,씨제이대한통운보통주
191,120,2020-03-04,0.0518518518518518,135000,142000,7000,71964,120.0,씨제이대한통운보통주
192,120,2020-01-28,0.0422535211267605,142000,136000,-6000,49609,120.0,씨제이대한통운보통주
193,120,2019-10-18,0.0436241610738255,149000,155500,6500,193462,120.0,씨제이대한통운보통주
194,120,2019-08-08,0.0458015267175572,131000,137000,6000,129505,120.0,씨제이대한통운보통주
195,120,2019-06-26,0.0795847750865051,144500,133000,-11500,320260,120.0,씨제이대한통운보통주
196,120,2019-06-25,0.0555555555555555,153000,144500,-8500,133333,120.0,씨제이대한통운보통주
197,120,2019-05-31,0.0598006644518272,150500,159500,9000,74130,120.0,씨제이대한통운보통주
198,120,2019-04-16,0.0453257790368272,176500,168500,-8000,192274,120.0,씨제이대한통운보통주
199,120,2019-04-15,0.0474777448071216,168500,176500,8000,205268,120.0,씨제이대한통운보통주
200,120,2019-02-08,0.0609756097560975,164000,174000,10000,173157,120.0,씨제이대한통운보통주
201,120,2018-11-29,0.0402684563758389,149000,155000,6000,64216,120.0,씨제이대한통운보통주
202,120,2018-11-12,0.0482315112540192,155500,148000,-7500,78325,120.0,씨제이대한통운보통주
203,120,2018-10-31,0.0427631578947368,152000,158500,6500,103777,120.0,씨제이대한통운보통주
204,120,2018-10-19,0.0622950819672131,152500,162000,9500,261489,120.0,씨제이대한통운보통주
205,120,2018-10-12,0.0535714285714285,140000,147500,7500,118772,120.0,씨제이대한통운보통주
206,120,2018-10-11,0.054054054054054,148000,140000,-8000,112513,120.0,씨제이대한통운보통주
207,120,2018-10-04,0.062111801242236,161000,151000,-10000,133334,120.0,씨제이대한통운보통주
208,120,2018-08-13,0.0465116279069767,150500,143500,-7000,115677,120.0,씨제이대한통운보통주
209,120,2018-07-20,0.0419354838709677,155000,161500,6500,64697,120.0,씨제이대한통운보통주
210,120,2018-07-19,0.0718562874251497,167000,155000,-12000,163439,120.0,씨제이대한통운보통주
211,120,2018-06-11,0.0487012987012987,154000,161500,7500,119811,120.0,씨제이대한통운보통주
212,120,2018-05-28,0.0431893687707641,150500,157000,6500,129638,120.0,씨제이대한통운보통주
213,120,2018-05-16,0.0408163265306122,171500,164500,-7000,123020,120.0,씨제이대한통운보통주
214,120,2018-05-11,0.0543806646525679,165500,174500,9000,251545,120.0,씨제이대한통운보통주
215,120,2018-05-10,0.0746753246753246,154000,165500,11500,279750,120.0,씨제이대한통운보통주
216,120,2018-04-13,0.0666666666666666,135000,144000,9000,247237,120.0,씨제이대한통운보통주
217,120,2018-03-29,0.053639846743295,130500,137500,7000,116257,120.0,씨제이대한통운보통주
218,120,2018-03-19,0.0421455938697318,130500,136000,5500,271858,120.0,씨제이대한통운보통주
219,120,2018-03-09,0.0491803278688524,122000,128000,6000,155426,120.0,씨제이대한통운보통주
220,120,2017-12-20,0.0466666666666666,150000,143000,-7000,91757,120.0,씨제이대한통운보통주
221,120,2017-08-08,0.0444444444444444,180000,172000,-8000,146438,120.0,씨제이대한통운보통주
222,120,2017-04-21,0.059375,160000,169500,9500,107319,120.0,씨제이대한통운보통주
223,120,2017-02-15,0.0798722044728434,156500,169000,12500,190723,120.0,씨제이대한통운보통주
224,120,2016-08-02,0.0493827160493827,202500,212500,10000,74667,120.0,씨제이대한통운보통주
225,150,2021-06-03,0.0455555555555555,90000,85900,-4100,258722,150.0,두산보통주
226,150,2021-06-02,0.0727056019070321,83900,90000,6100,403484,150.0,두산보통주
227,150,2021-06-01,0.040045766590389,87400,83900,-3500,263498,150.0,두산보통주
228,150,2021-05-27,0.048780487804878,82000,86000,4000,335102,150.0,두산보통주
229,150,2021-05-24,0.0496644295302013,74500,78200,3700,250163,150.0,두산보통주
230,150,2021-05-21,0.0411840411840411,77700,74500,-3200,302263,150.0,두산보통주
231,150,2021-05-20,0.0821727019498607,71800,77700,5900,273040,150.0,두산보통주
232,150,2021-05-12,0.0535211267605633,71000,67200,-3800,225187,150.0,두산보통주
233,150,2021-05-10,0.0735068912710566,65300,70100,4800,267434,150.0,두산보통주
234,150,2021-05-04,0.0485584218512898,65900,62700,-3200,178237,150.0,두산보통주
235,150,2021-05-03,0.0427215189873417,63200,65900,2700,354628,150.0,두산보통주
236,150,2021-04-29,0.0422077922077922,61600,64200,2600,412950,150.0,두산보통주
237,150,2021-04-28,0.096085409252669,56200,61600,5400,1076502,150.0,두산보통주
238,150,2021-01-29,0.0551470588235294,54400,51400,-3000,169712,150.0,두산보통주
239,150,2021-01-22,0.0636363636363636,55000,58500,3500,424348,150.0,두산보통주
240,150,2021-01-18,0.0576271186440678,59000,55600,-3400,288788,150.0,두산보통주
241,150,2021-01-15,0.0442477876106194,56500,59000,2500,1215883,150.0,두산보통주
242,150,2021-01-14,0.1254980079681275,50200,56500,6300,814103,150.0,두산보통주
243,150,2021-01-11,0.0576208178438661,53800,50700,-3100,328376,150.0,두산보통주
244,150,2020-12-29,0.0590339892665474,55900,52600,-3300,235421,150.0,두산보통주
245,150,2020-12-11,0.0642722117202268,52900,56300,3400,392376,150.0,두산보통주
246,150,2020-11-24,0.0735146022155085,49650,53300,3650,343948,150.0,두산보통주
247,150,2020-10-26,0.0425752855659397,48150,46100,-2050,62137,150.0,두산보통주
248,150,2020-10-12,0.0411255411255411,46200,48100,1900,106447,150.0,두산보통주
249,150,2020-09-28,0.0518018018018018,44400,46700,2300,84941,150.0,두산보통주
250,150,2020-09-09,0.048780487804878,53300,50700,-2600,285628,150.0,두산보통주
251,150,2020-09-08,0.0714285714285714,57400,53300,-4100,800664,150.0,두산보통주
252,150,2020-09-07,0.2685082872928176,45250,57400,12150,1651663,150.0,두산보통주
253,150,2020-08-31,0.0702764976958525,43400,46450,3050,326981,150.0,두산보통주
254,150,2020-08-20,0.0607424071991001,44450,41750,-2700,159795,150.0,두산보통주
255,150,2020-08-18,0.0424836601307189,45900,43950,-1950,106368,150.0,두산보통주
256,150,2020-07-30,0.0635964912280701,45600,48500,2900,333304,150.0,두산보통주
257,150,2020-07-29,0.076741440377804,42350,45600,3250,354438,150.0,두산보통주
258,150,2020-07-24,0.0403135498320268,44650,42850,-1800,152915,150.0,두산보통주
259,150,2020-07-23,0.055026455026455,47250,44650,-2600,218996,150.0,두산보통주
260,150,2020-07-21,0.1720818291215403,41550,48700,7150,1627475,150.0,두산보통주
261,150,2020-07-20,0.0806241872561768,38450,41550,3100,355258,150.0,두산보통주
262,150,2020-06-25,0.0444993819530284,40450,38650,-1800,76825,150.0,두산보통주
263,150,2020-06-17,0.0819848975188781,46350,42550,-3800,332994,150.0,두산보통주
264,150,2020-06-16,0.15875,40000,46350,6350,541916,150.0,두산보통주
265,150,2020-06-15,0.0610328638497652,42600,40000,-2600,145824,150.0,두산보통주
266,150,2020-06-11,0.0702127659574468,47000,43700,-3300,266832,150.0,두산보통주
267,150,2020-06-09,0.0406091370558375,49250,47250,-2000,328212,150.0,두산보통주
268,150,2020-06-08,0.1054994388327721,44550,49250,4700,684824,150.0,두산보통주
269,150,2020-06-05,0.1292775665399239,39450,44550,5100,1066872,150.0,두산보통주
270,150,2020-05-19,0.0439716312056737,35250,36800,1550,120304,150.0,두산보통주
271,150,2020-05-15,0.065359477124183,38250,35750,-2500,256963,150.0,두산보통주
272,150,2020-05-04,0.0458488228004956,40350,38500,-1850,125954,150.0,두산보통주
273,150,2020-04-28,0.0811170212765957,37600,40650,3050,267451,150.0,두산보통주
274,150,2020-04-16,0.0421455938697318,39150,37500,-1650,171479,150.0,두산보통주
275,150,2020-04-09,0.0863874345549738,38200,41500,3300,293091,150.0,두산보통주
276,150,2020-04-01,0.0479041916167664,33400,35000,1600,521830,150.0,두산보통주
277,150,2020-03-31,0.0591549295774647,35500,33400,-2100,347969,150.0,두산보통주
278,150,2020-03-30,0.0885750962772785,38950,35500,-3450,316367,150.0,두산보통주
279,150,2020-03-27,0.064207650273224,36600,38950,2350,294236,150.0,두산보통주
280,150,2020-03-25,0.0812883435582822,32600,35250,2650,228536,150.0,두산보통주
281,150,2020-03-24,0.2051756007393715,27050,32600,5550,129758,150.0,두산보통주
282,150,2020-03-20,0.072936660268714,26050,27950,1900,190652,150.0,두산보통주
283,150,2020-03-19,0.1959876543209876,32400,26050,-6350,286987,150.0,두산보통주
284,150,2020-03-18,0.0974930362116991,35900,32400,-3500,153797,150.0,두산보통주
285,150,2020-03-17,0.0439414114513981,37550,35900,-1650,181710,150.0,두산보통주
286,150,2020-03-13,0.1319857312722948,42050,36500,-5550,445066,150.0,두산보통주
287,150,2020-03-12,0.0927723840345199,46350,42050,-4300,367920,150.0,두산보통주
288,150,2020-03-11,0.1678635547576301,55700,46350,-9350,644998,150.0,두산보통주
289,150,2020-02-28,0.0510204081632653,58800,55800,-3000,105963,150.0,두산보통주
290,150,2019-12-10,0.0474732006125574,65300,68400,3100,107411,150.0,두산보통주
291,150,2019-09-26,0.0443349753694581,101500,106000,4500,353315,150.0,두산보통주
292,150,2019-09-25,0.0514018691588785,107000,101500,-5500,188041,150.0,두산보통주
293,150,2019-09-10,0.0434782608695652,103500,108000,4500,154248,150.0,두산보통주
294,150,2019-08-05,0.0522167487684729,101500,96200,-5300,100992,150.0,두산보통주
295,150,2019-07-26,0.0510204081632653,98000,103000,5000,256734,150.0,두산보통주
296,150,2019-06-14,0.0545645330535152,95300,100500,5200,119688,150.0,두산보통주
297,150,2019-05-28,0.051,100000,94900,-5100,996341,150.0,두산보통주
298,150,2019-04-16,0.0812182741116751,98500,106500,8000,369716,150.0,두산보통주
299,150,2019-03-28,0.0469728601252609,95800,91300,-4500,106508,150.0,두산보통주
300,150,2019-02-14,0.0746411483253588,104500,96700,-7800,508271,150.0,두산보통주
301,150,2019-02-13,0.0752212389380531,113000,104500,-8500,248996,150.0,두산보통주
302,150,2019-01-18,0.0727272727272727,110000,118000,8000,195112,150.0,두산보통주
303,150,2019-01-02,0.0627802690582959,111500,104500,-7000,67723,150.0,두산보통주
304,150,2018-12-17,0.0445344129554655,123500,118000,-5500,58919,150.0,두산보통주
305,150,2018-11-28,0.0401606425702811,124500,119500,-5000,157521,150.0,두산보통주
306,150,2018-11-02,0.0464135021097046,118500,124000,5500,64090,150.0,두산보통주
307,150,2018-09-11,0.0793650793650793,126000,136000,10000,316760,150.0,두산보통주
308,150,2018-08-28,0.0465116279069767,107500,112500,5000,96024,150.0,두산보통주
309,150,2018-08-03,0.048076923076923,104000,109000,5000,116887,150.0,두산보통주
310,150,2018-04-30,0.0521739130434782,115000,121000,6000,167540,150.0,두산보통주
311,150,2018-02-09,0.0509259259259259,108000,113500,5500,127934,150.0,두산보통주
312,150,2018-01-18,0.0450819672131147,122000,116500,-5500,87167,150.0,두산보통주
313,150,2018-01-10,0.0504201680672268,119000,125000,6000,146525,150.0,두산보통주
314,150,2017-12-27,0.072289156626506,124500,115500,-9000,136674,150.0,두산보통주
315,150,2017-12-20,0.051063829787234,117500,123500,6000,80053,150.0,두산보통주
316,150,2017-12-05,0.0772357723577235,123000,132500,9500,66423,150.0,두산보통주
317,150,2017-11-15,0.0485074626865671,134000,127500,-6500,83894,150.0,두산보통주
318,150,2017-09-15,0.0407407407407407,135000,140500,5500,51275,150.0,두산보통주
319,150,2017-09-13,0.0421455938697318,130500,136000,5500,120351,150.0,두산보통주
320,150,2017-08-17,0.0431372549019607,127500,133000,5500,59221,150.0,두산보통주
321,150,2017-08-01,0.097457627118644,118000,129500,11500,124508,150.0,두산보통주
322,150,2017-06-09,0.1066666666666666,112500,124500,12000,241801,150.0,두산보통주
323,150,2017-05-23,0.0467289719626168,107000,112000,5000,162638,150.0,두산보통주
324,150,2017-02-28,0.0524752475247524,101000,95700,-5300,233067,150.0,두산보통주
325,150,2016-12-28,0.0521739130434782,115000,109000,-6000,79495,150.0,두산보통주
326,150,2016-11-11,0.0654205607476635,107000,114000,7000,145031,150.0,두산보통주
327,150,2016-11-10,0.0753768844221105,99500,107000,7500,117412,150.0,두산보통주
328,150,2016-10-07,0.0518867924528301,106000,100500,-5500,140599,150.0,두산보통주
329,150,2016-08-22,0.0464135021097046,118500,113000,-5500,85111,150.0,두산보통주
330,150,2016-08-05,0.0560747663551401,107000,113000,6000,129277,150.0,두산보통주
331,210,2021-05-13,0.0537142857142857,87500,82800,-4700,795569,210.0,DL보통주
332,210,2021-05-12,0.1336633663366336,101000,87500,-13500,1815244,210.0,DL보통주
333,210,2021-05-06,0.0537974683544303,94800,99900,5100,350593,210.0,DL보통주
334,210,2021-04-28,0.0540284360189573,105500,99800,-5700,363799,210.0,DL보통주
335,210,2021-04-27,0.0603015075376884,99500,105500,6000,338801,210.0,DL보통주
336,210,2021-04-26,0.0440713536201469,95300,99500,4200,245148,210.0,DL보통주
337,210,2021-04-22,0.0506465517241379,92800,97500,4700,412194,210.0,DL보통주
338,210,2021-04-14,0.0516431924882629,85200,89600,4400,484546,210.0,DL보통주
339,210,2021-03-25,0.0923450789793438,82300,89900,7600,822376,210.0,DL보통주
340,210,2021-03-19,0.0451219512195121,82000,85700,3700,649238,210.0,DL보통주
341,210,2021-03-18,0.0512820512820512,78000,82000,4000,423729,210.0,DL보통주
342,210,2021-03-10,0.0461538461538461,78000,74400,-3600,321320,210.0,DL보통주
343,210,2021-03-02,0.0439306358381502,86500,82700,-3800,473172,210.0,DL보통주
344,210,2021-02-25,0.0416666666666666,84000,87500,3500,337803,210.0,DL보통주
345,210,2021-02-24,0.081967213114754,91500,84000,-7500,633359,210.0,DL보통주
346,210,2021-02-19,0.0968858131487889,86700,95100,8400,814206,210.0,DL보통주
347,210,2021-02-05,0.0515826494724501,85300,89700,4400,761503,210.0,DL보통주
348,210,2021-02-04,0.0893997445721583,78300,85300,7000,1543565,210.0,DL보통주
349,210,2021-02-03,0.0755494505494505,72800,78300,5500,1272508,210.0,DL보통주
350,210,2021-02-02,0.1234567901234567,64800,72800,8000,1246356,210.0,DL보통주
351,210,2021-02-01,0.0622950819672131,61000,64800,3800,450046,210.0,DL보통주
352,210,2021-01-29,0.0453834115805946,63900,61000,-2900,599000,210.0,DL보통주
353,210,2021-01-27,0.0527817403708987,70100,66400,-3700,721475,210.0,DL보통주
354,210,2021-01-26,0.0603217158176943,74600,70100,-4500,921840,210.0,DL보통주
355,210,2020-12-28,0.0610859728506787,88400,83000,-5400,3832744,210.0,DL보통주
356,210,2020-12-21,0.0423634336677814,89700,93500,3800,752190,210.0,DL보통주
357,210,2020-12-18,0.0565371024734982,84900,89700,4800,851731,210.0,DL보통주
358,210,2020-12-11,0.0491017964071856,83500,87600,4100,1473994,210.0,DL보통주
359,210,2020-12-04,0.0466830466830466,81400,85200,3800,956510,210.0,DL보통주
360,210,2020-11-30,0.0498812351543943,84200,80000,-4200,1051932,210.0,DL보통주
361,210,2020-10-30,0.0647482014388489,83400,78000,-5400,773767,210.0,DL보통주
362,210,2020-10-28,0.063960639606396,81300,86500,5200,831170,210.0,DL보통주
363,210,2020-10-15,0.0665796344647519,76600,81700,5100,511303,210.0,DL보통주
364,210,2020-10-05,0.0439276485788113,77400,80800,3400,342808,210.0,DL보통주
365,210,2020-09-11,0.0603448275862069,92800,87200,-5600,1487256,210.0,DL보통주
366,210,2020-09-07,0.0638063806380638,90900,96700,5800,730832,210.0,DL보통주
367,210,2020-09-01,0.0840046029919447,86900,94200,7300,790761,210.0,DL보통주
368,210,2020-08-28,0.1348600508905852,78600,89200,10600,910007,210.0,DL보통주
369,210,2020-08-20,0.0413122721749696,82300,78900,-3400,367866,210.0,DL보통주
370,210,2020-08-18,0.0516055045871559,87200,82700,-4500,384080,210.0,DL보통주
371,210,2020-08-04,0.0420673076923076,83200,86700,3500,807738,210.0,DL보통주
372,210,2020-06-19,0.0501193317422434,83800,88000,4200,279486,210.0,DL보통주
373,210,2020-06-16,0.0549313358302122,80100,84500,4400,193927,210.0,DL보통주
374,210,2020-06-15,0.0642523364485981,85600,80100,-5500,308770,210.0,DL보통주
375,210,2020-06-12,0.0446428571428571,89600,85600,-4000,311175,210.0,DL보통주
376,210,2020-06-02,0.0484391819160387,92900,97400,4500,678204,210.0,DL보통주
377,210,2020-05-29,0.0745052386495925,85900,92300,6400,1062582,210.0,DL보통주
378,210,2020-05-26,0.04630788485607,79900,83600,3700,623400,210.0,DL보통주
379,210,2020-05-04,0.061293984108967,88100,82700,-5400,515714,210.0,DL보통주
380,210,2020-04-28,0.0723926380368098,81500,87400,5900,457174,210.0,DL보통주
381,210,2020-04-22,0.0466830466830466,81400,85200,3800,524318,210.0,DL보통주
382,210,2020-04-17,0.047936085219707,75100,78700,3600,704930,210.0,DL보통주
383,210,2020-04-02,0.1556534508076358,68100,78700,10600,2034731,210.0,DL보통주
384,210,2020-04-01,0.0759837177747625,73700,68100,-5600,689291,210.0,DL보통주
385,210,2020-03-31,0.1032934131736526,66800,73700,6900,958005,210.0,DL보통주
386,210,2020-03-30,0.0897226753670473,61300,66800,5500,563525,210.0,DL보통주
387,210,2020-03-25,0.0535714285714285,56000,59000,3000,451382,210.0,DL보통주
388,210,2020-03-24,0.0666666666666666,52500,56000,3500,317211,210.0,DL보통주
389,210,2020-03-23,0.0724381625441696,56600,52500,-4100,239989,210.0,DL보통주
390,210,2020-03-20,0.1551020408163265,49000,56600,7600,305317,210.0,DL보통주
391,210,2020-03-19,0.1107078039927404,55100,49000,-6100,559253,210.0,DL보통주
392,210,2020-03-18,0.0581196581196581,58500,55100,-3400,322816,210.0,DL보통주
393,210,2020-03-16,0.050632911392405,63200,60000,-3200,237690,210.0,DL보통주
394,210,2020-03-13,0.0438729198184568,66100,63200,-2900,453473,210.0,DL보통주
395,210,2020-03-12,0.0447976878612716,69200,66100,-3100,388547,210.0,DL보통주
396,210,2020-03-09,0.0452054794520547,73000,69700,-3300,287194,210.0,DL보통주
397,210,2020-02-25,0.0452674897119341,72900,76200,3300,170857,210.0,DL보통주
398,210,2020-02-24,0.0495436766623207,76700,72900,-3800,196480,210.0,DL보통주
399,210,2020-01-06,0.0421412300683371,87800,84100,-3700,235620,210.0,DL보통주
400,210,2019-11-21,0.0466595970307529,94300,89900,-4400,228862,210.0,DL보통주
401,210,2019-10-23,0.0420081967213114,97600,93500,-4100,153037,210.0,DL보통주
402,210,2019-10-10,0.0411099691675231,97300,93300,-4000,272190,210.0,DL보통주
403,210,2019-08-22,0.048780487804878,102500,97500,-5000,167469,210.0,DL보통주
404,210,2019-08-21,0.0427263479145473,98300,102500,4200,239361,210.0,DL보통주
405,210,2019-08-13,0.0533199195171026,99400,94100,-5300,141569,210.0,DL보통주
406,210,2019-08-01,0.0521327014218009,105500,100000,-5500,264306,210.0,DL보통주
407,210,2019-06-04,0.0462962962962962,108000,113000,5000,201268,210.0,DL보통주
408,210,2019-06-03,0.0434782608695652,103500,108000,4500,143608,210.0,DL보통주
409,210,2019-05-15,0.0647181628392484,95800,102000,6200,166373,210.0,DL보통주
410,210,2019-01-30,0.0441176470588235,102000,106500,4500,227167,210.0,DL보통주
411,210,2019-01-24,0.044776119402985,100500,105000,4500,238453,210.0,DL보통주
412,210,2019-01-02,0.0595121951219512,102500,96400,-6100,353937,210.0,DL보통주
413,210,2018-12-13,0.0452261306532663,99500,104000,4500,334455,210.0,DL보통주
414,210,2018-11-28,0.0453539823008849,90400,94500,4100,365752,210.0,DL보통주
415,210,2018-11-02,0.0506666666666666,75000,78800,3800,274126,210.0,DL보통주
416,210,2018-10-11,0.0579881656804733,84500,79600,-4900,258435,210.0,DL보통주
417,210,2018-06-27,0.0582403965303593,80700,76000,-4700,424246,210.0,DL보통주
418,210,2018-06-14,0.0486935866983372,84200,80100,-4100,386767,210.0,DL보통주
419,210,2018-05-29,0.0434782608695652,89700,85800,-3900,313526,210.0,DL보통주
420,210,2018-05-28,0.0820265379975874,82900,89700,6800,1047957,210.0,DL보통주
421,210,2018-05-18,0.0464285714285714,84000,87900,3900,328564,210.0,DL보통주
422,210,2018-05-16,0.0514285714285714,87500,83000,-4500,356063,210.0,DL보통주
423,210,2018-05-14,0.0506024096385542,83000,87200,4200,657660,210.0,DL보통주
424,210,2018-05-08,0.0487528344671201,88200,83900,-4300,461949,210.0,DL보통주
425,210,2018-04-18,0.0434227330779054,78300,81700,3400,401387,210.0,DL보통주
426,210,2018-04-12,0.0526315789473684,76000,80000,4000,820424,210.0,DL보통주
427,210,2018-03-09,0.0479548660084626,70900,74300,3400,304109,210.0,DL보통주
428,210,2018-01-26,0.0917225950782997,89400,81200,-8200,1701345,210.0,DL보통주
429,210,2017-11-15,0.0512223515715948,85900,81500,-4400,448729,210.0,DL보통주
430,210,2017-11-02,0.0419161676646706,83500,87000,3500,383103,210.0,DL보통주
431,210,2017-05-25,0.0517647058823529,85000,89400,4400,608762,210.0,DL보통주
432,210,2016-12-29,0.053204353083434,82700,87100,4400,376919,210.0,DL보통주
433,210,2016-11-09,0.063231850117096,85400,80000,-5400,353359,210.0,DL보통주
434,210,2016-10-26,0.0414333706606942,89300,85600,-3700,265602,210.0,DL보통주
435,240,2021-04-27,0.0594594594594594,18500,19600,1100,3345401,240.0,한국앤컴퍼니보통주
436,240,2021-03-26,0.0445682451253481,17950,18750,800,428553,240.0,한국앤컴퍼니보통주
437,240,2021-03-19,0.0588235294117647,17000,18000,1000,2459874,240.0,한국앤컴퍼니보통주
438,240,2021-02-26,0.0416666666666666,18000,17250,-750,1320514,240.0,한국앤컴퍼니보통주
439,240,2021-02-24,0.1919642857142857,22400,18100,-4300,2891315,240.0,한국앤컴퍼니보통주
440,240,2021-02-15,0.0495495495495495,22200,21100,-1100,990430,240.0,한국앤컴퍼니보통주
441,240,2021-02-10,0.0962962962962963,20250,22200,1950,1184623,240.0,한국앤컴퍼니보통주
442,240,2021-02-09,0.0559440559440559,21450,20250,-1200,902609,240.0,한국앤컴퍼니보통주
443,240,2021-02-03,0.1318681318681318,18200,20600,2400,3852988,240.0,한국앤컴퍼니보통주
444,240,2021-02-02,0.0996978851963746,16550,18200,1650,3554617,240.0,한국앤컴퍼니보통주
445,240,2021-02-01,0.0441640378548895,15850,16550,700,386245,240.0,한국앤컴퍼니보통주
446,240,2021-01-28,0.0411764705882352,17000,16300,-700,592418,240.0,한국앤컴퍼니보통주
447,240,2021-01-27,0.0429447852760736,16300,17000,700,741550,240.0,한국앤컴퍼니보통주
448,240,2021-01-25,0.0527950310559006,16100,16950,850,813148,240.0,한국앤컴퍼니보통주
449,240,2021-01-21,0.0814332247557003,15350,16600,1250,1248618,240.0,한국앤컴퍼니보통주
450,240,2021-01-19,0.0404040404040404,14850,15450,600,421735,240.0,한국앤컴퍼니보통주
451,240,2020-12-22,0.0404040404040404,14850,14250,-600,431559,240.0,한국앤컴퍼니보통주
452,240,2020-11-27,0.0441640378548895,15850,16550,700,1789306,240.0,한국앤컴퍼니보통주
453,240,2020-10-30,0.0418006430868167,15550,14900,-650,388101,240.0,한국앤컴퍼니보통주
454,240,2020-10-26,0.0597014925373134,16750,15750,-1000,634487,240.0,한국앤컴퍼니보통주
455,240,2020-09-28,0.0608974358974358,15600,16550,950,2209295,240.0,한국앤컴퍼니보통주
456,240,2020-09-24,0.075075075075075,16650,15400,-1250,1220233,240.0,한국앤컴퍼니보통주
457,240,2020-09-23,0.0951086956521739,18400,16650,-1750,2505621,240.0,한국앤컴퍼니보통주
458,240,2020-09-22,0.1393188854489164,16150,18400,2250,4753505,240.0,한국앤컴퍼니보통주
459,240,2020-09-14,0.0453074433656957,15450,16150,700,944907,240.0,한국앤컴퍼니보통주
460,240,2020-09-11,0.0433436532507739,16150,15450,-700,791461,240.0,한국앤컴퍼니보통주
461,240,2020-09-08,0.0608974358974358,15600,16550,950,6159246,240.0,한국앤컴퍼니보통주
462,240,2020-08-26,0.0710227272727272,17600,16350,-1250,12566006,240.0,한국앤컴퍼니보통주
463,240,2020-08-25,0.2988929889298893,13550,17600,4050,16022141,240.0,한국앤컴퍼니보통주
464,240,2020-08-20,0.0539568345323741,13900,13150,-750,528773,240.0,한국앤컴퍼니보통주
465,240,2020-07-30,0.2995594713656387,11350,14750,3400,8100058,240.0,한국앤컴퍼니보통주
466,240,2020-07-09,0.0652173913043478,13800,12900,-900,938084,240.0,한국앤컴퍼니보통주
467,240,2020-07-06,0.0984251968503937,12700,13950,1250,2421577,240.0,한국앤컴퍼니보통주
468,240,2020-06-30,0.0571428571428571,12250,12950,700,13742119,240.0,한국앤컴퍼니보통주
469,240,2020-06-29,0.0986547085201793,11150,12250,1100,3217689,240.0,한국앤컴퍼니보통주
470,240,2020-06-19,0.0460251046025104,11950,11400,-550,214073,240.0,한국앤컴퍼니보통주
471,240,2020-06-18,0.0765765765765765,11100,11950,850,184543,240.0,한국앤컴퍼니보통주
472,240,2020-06-16,0.1,10000,11000,1000,123670,240.0,한국앤컴퍼니보통주
473,240,2020-06-15,0.0566037735849056,10600,10000,-600,96722,240.0,한국앤컴퍼니보통주
474,240,2020-05-19,0.0491299897645854,9770,10250,480,215074,240.0,한국앤컴퍼니보통주
475,240,2020-05-12,0.0524271844660194,10300,9760,-540,150464,240.0,한국앤컴퍼니보통주
476,240,2020-04-13,0.0473933649289099,10550,10050,-500,88632,240.0,한국앤컴퍼니보통주
477,240,2020-04-10,0.0776302349336057,9790,10550,760,220960,240.0,한국앤컴퍼니보통주
478,240,2020-03-25,0.1051314142678347,7990,8830,840,153595,240.0,한국앤컴퍼니보통주
479,240,2020-03-24,0.0667556742323097,7490,7990,500,157346,240.0,한국앤컴퍼니보통주
480,240,2020-03-23,0.1351039260969977,8660,7490,-1170,136101,240.0,한국앤컴퍼니보통주
481,240,2020-03-20,0.0825,8000,8660,660,117672,240.0,한국앤컴퍼니보통주
482,240,2020-03-19,0.1208791208791208,9100,8000,-1100,183967,240.0,한국앤컴퍼니보통주
483,240,2020-03-18,0.0872617853560682,9970,9100,-870,86713,240.0,한국앤컴퍼니보통주
484,240,2020-03-12,0.0601851851851851,10800,10150,-650,114961,240.0,한국앤컴퍼니보통주
485,240,2020-03-09,0.0521739130434782,11500,10900,-600,142983,240.0,한국앤컴퍼니보통주
486,240,2020-03-06,0.0534979423868312,12150,11500,-650,175030,240.0,한국앤컴퍼니보통주
487,240,2019-08-16,0.0484429065743944,14450,13750,-700,45906,240.0,한국앤컴퍼니보통주
488,240,2019-07-09,0.0638297872340425,16450,15400,-1050,122410,240.0,한국앤컴퍼니보통주
489,240,2018-11-07,0.0609756097560975,16400,15400,-1000,148118,240.0,한국앤컴퍼니보통주
490,240,2018-10-24,0.0415430267062314,16850,17550,700,50803,240.0,한국앤컴퍼니보통주
491,240,2017-07-31,0.047191011235955,22250,21200,-1050,177432,240.0,한국앤컴퍼니보통주
492,240,2017-01-10,0.0431654676258992,20850,21750,900,235745,240.0,한국앤컴퍼니보통주
493,240,2016-08-31,0.0541871921182266,20300,21400,1100,183709,240.0,한국앤컴퍼니보통주
494,240,2016-08-17,0.0962025316455696,19750,21650,1900,761724,240.0,한국앤컴퍼니보통주
495,270,2021-05-28,0.0482673267326732,80800,84700,3900,6187345,270.0,기아보통주
496,270,2021-05-03,0.0402597402597402,77000,80100,3100,3400379,270.0,기아보통주
497,270,2021-03-30,0.0407407407407407,81000,84300,3300,4249176,270.0,기아보통주
498,270,2021-02-24,0.0470139771283354,78700,75000,-3700,4740627,270.0,기아보통주
499,270,2021-02-08,0.1497536945812808,101500,86300,-15200,25297437,270.0,기아보통주
500,270,2021-02-03,0.0965207631874298,89100,97700,8600,31478502,270.0,기아보통주
501,270,2021-02-01,0.0909090909090909,82500,90000,7500,7948901,270.0,기아보통주
502,270,2021-01-29,0.064625850340136,88200,82500,-5700,9432805,270.0,기아보통주
503,270,2021-01-25,0.0626423690205011,87800,93300,5500,9905812,270.0,기아보통주
504,270,2021-01-20,0.0503597122302158,83400,87600,4200,26518838,270.0,기아보통주
505,270,2021-01-19,0.1664335664335664,71500,83400,11900,13378821,270.0,기아보통주
506,270,2021-01-08,0.0841269841269841,63000,68300,5300,25357804,270.0,기아보통주
507,270,2020-12-03,0.0641447368421052,60800,64700,3900,4152306,270.0,기아보통주
508,270,2020-11-11,0.0660550458715596,54500,58100,3600,4438993,270.0,기아보통주
509,270,2020-11-10,0.0420650095602294,52300,54500,2200,3155193,270.0,기아보통주
510,270,2020-10-30,0.0471698113207547,53000,50500,-2500,2559004,270.0,기아보통주
511,270,2020-10-27,0.1032325338894682,47950,52900,4950,9347585,270.0,기아보통주
512,270,2020-10-05,0.0767590618336887,46900,50500,3600,4185612,270.0,기아보통주
513,270,2020-09-22,0.04437564499484,48450,46300,-2150,2512697,270.0,기아보통주
514,270,2020-09-16,0.0470324748040313,44650,46750,2100,4289868,270.0,기아보통주
515,270,2020-09-14,0.0496453900709219,42300,44400,2100,2473674,270.0,기아보통주
516,270,2020-08-20,0.0484633569739952,42300,40250,-2050,2611942,270.0,기아보통주
517,270,2020-08-12,0.0413135593220339,47200,45250,-1950,2734266,270.0,기아보통주
518,270,2020-08-10,0.0970414201183432,42250,46350,4100,6774254,270.0,기아보통주
519,270,2020-07-29,0.0517241379310344,37700,39650,1950,3410420,270.0,기아보통주
520,270,2020-07-17,0.0424929178470254,35300,36800,1500,2720640,270.0,기아보통주
521,270,2020-07-13,0.0546021840873634,32050,33800,1750,1924926,270.0,기아보통주
522,270,2020-06-24,0.0465116279069767,32250,33750,1500,2345625,270.0,기아보통주
523,270,2020-06-16,0.0636645962732919,32200,34250,2050,1866950,270.0,기아보통주
524,270,2020-06-15,0.08,35000,32200,-2800,2407518,270.0,기아보통주
525,270,2020-06-02,0.0549132947976878,34600,36500,1900,3154171,270.0,기아보통주
526,270,2020-05-29,0.0669781931464174,32100,34250,2150,5053078,270.0,기아보통주
527,270,2020-05-19,0.080068143100511,29350,31700,2350,5443583,270.0,기아보통주
528,270,2020-05-08,0.0517241379310344,29000,30500,1500,2777232,270.0,기아보통주
529,270,2020-04-13,0.0483870967741935,31000,29500,-1500,2007475,270.0,기아보통주
530,270,2020-04-09,0.0672566371681415,28250,30150,1900,3167177,270.0,기아보통주
531,270,2020-04-07,0.0541044776119402,26800,28250,1450,2680220,270.0,기아보통주
532,270,2020-04-06,0.0551181102362204,25400,26800,1400,1721874,270.0,기아보통주
533,270,2020-03-31,0.0420841683366733,24950,26000,1050,2219339,270.0,기아보통주
534,270,2020-03-25,0.0887445887445887,23100,25150,2050,5010440,270.0,기아보통주
535,270,2020-03-24,0.0744186046511627,21500,23100,1600,2947942,270.0,기아보통주
536,270,2020-03-23,0.1097308488612836,24150,21500,-2650,2365341,270.0,기아보통주
537,270,2020-03-20,0.0709534368070953,22550,24150,1600,3015123,270.0,기아보통주
538,270,2020-03-19,0.108695652173913,25300,22550,-2750,2305074,270.0,기아보통주
539,270,2020-03-17,0.0645756457564575,27100,25350,-1750,2682844,270.0,기아보통주
540,270,2020-03-16,0.0606585788561525,28850,27100,-1750,1862674,270.0,기아보통주
541,270,2020-03-13,0.0540983606557377,30500,28850,-1650,2777060,270.0,기아보통주
542,270,2020-03-12,0.040880503144654,31800,30500,-1300,1872682,270.0,기아보통주
543,270,2020-03-09,0.0476190476190476,34650,33000,-1650,1316550,270.0,기아보통주
544,270,2020-03-02,0.0482758620689655,36250,34500,-1750,2981038,270.0,기아보통주
545,270,2020-02-06,0.0482233502538071,39400,41300,1900,1405887,270.0,기아보통주
546,270,2020-01-02,0.0406320541760722,44300,42500,-1800,1355029,270.0,기아보통주
547,270,2019-09-23,0.0545454545454545,44000,46400,2400,2951967,270.0,기아보통주
548,270,2019-06-10,0.0449574726609963,41150,43000,1850,1357541,270.0,기아보통주
549,270,2019-05-31,0.0449029126213592,41200,39350,-1850,2666239,270.0,기아보통주
550,270,2019-04-29,0.0535506402793946,42950,45250,2300,2828522,270.0,기아보통주
551,270,2019-01-04,0.060882800608828,32850,34850,2000,1573507,270.0,기아보통주
552,270,2018-11-22,0.0500863557858376,28950,27500,-1450,1219813,270.0,기아보통주
553,270,2018-11-20,0.0471380471380471,29700,28300,-1400,1109399,270.0,기아보통주
554,270,2018-11-05,0.0423011844331641,29550,28300,-1250,1176599,270.0,기아보통주
555,270,2018-10-25,0.0592334494773519,28700,27000,-1700,2557751,270.0,기아보통주
556,270,2018-10-15,0.0646616541353383,33250,31100,-2150,2038170,270.0,기아보통주
557,270,2018-09-06,0.0450310559006211,32200,33650,1450,2459792,270.0,기아보통주
558,270,2018-07-06,0.0454545454545454,29700,31050,1350,1366055,270.0,기아보통주
559,270,2018-07-04,0.0452342487883683,30950,29550,-1400,1614173,270.0,기아보통주
560,270,2018-06-04,0.0579937304075235,31900,33750,1850,2204733,270.0,기아보통주
561,270,2018-01-19,0.0412844036697247,32700,34050,1350,1814883,270.0,기아보통주
562,270,2017-10-18,0.046031746031746,31500,32950,1450,1667694,270.0,기아보통주
563,270,2017-08-08,0.0445344129554655,37050,35400,-1650,1904223,270.0,기아보통주
564,270,2016-11-10,0.0439146800501882,39850,38100,-1750,3223287,270.0,기아보통주
565,660,2021-05-11,0.0538461538461538,130000,123000,-7000,9882491,660.0,에스케이하이닉스보통주
566,660,2021-04-21,0.0433212996389891,138500,132500,-6000,5120577,660.0,에스케이하이닉스보통주
567,660,2021-04-01,0.060377358490566,132500,140500,8000,5833436,660.0,에스케이하이닉스보통주
568,660,2021-02-26,0.0471380471380471,148500,141500,-7000,10843268,660.0,에스케이하이닉스보통주
569,660,2021-02-25,0.0919117647058823,136000,148500,12500,9936495,660.0,에스케이하이닉스보통주
570,660,2021-02-19,0.0555555555555555,126000,133000,7000,6986526,660.0,에스케이하이닉스보통주
571,660,2021-02-15,0.0476190476190476,126000,132000,6000,5384526,660.0,에스케이하이닉스보통주
572,660,2021-02-02,0.04,125000,130000,5000,4880067,660.0,에스케이하이닉스보통주
573,660,2021-01-28,0.0428015564202334,128500,123000,-5500,6270829,660.0,에스케이하이닉스보통주
574,660,2021-01-26,0.0444444444444444,135000,129000,-6000,6270106,660.0,에스케이하이닉스보통주
575,660,2021-01-25,0.0505836575875486,128500,135000,6500,5061864,660.0,에스케이하이닉스보통주
576,660,2021-01-04,0.0632911392405063,118500,126000,7500,7995016,660.0,에스케이하이닉스보통주
577,660,2020-12-09,0.0478260869565217,115000,120500,5500,5490760,660.0,에스케이하이닉스보통주
578,660,2020-12-02,0.0845771144278607,100500,109000,8500,7488361,660.0,에스케이하이닉스보통주
579,660,2020-11-16,0.092530657748049,89700,98000,8300,9274278,660.0,에스케이하이닉스보통주
580,660,2020-09-03,0.0423841059602649,75500,78700,3200,7002529,660.0,에스케이하이닉스보통주
581,660,2020-08-20,0.0426666666666666,75000,71800,-3200,7260223,660.0,에스케이하이닉스보통주
582,660,2020-06-16,0.0414634146341463,82000,85400,3400,3518785,660.0,에스케이하이닉스보통주
583,660,2020-06-03,0.0648259303721488,83300,88700,5400,11642239,660.0,에스케이하이닉스보통주
584,660,2020-04-06,0.0439698492462311,79600,83100,3500,5784159,660.0,에스케이하이닉스보통주
585,660,2020-04-01,0.0588235294117647,83300,78400,-4900,6845675,660.0,에스케이하이닉스보통주
586,660,2020-03-26,0.0449704142011834,84500,80700,-3800,7895289,660.0,에스케이하이닉스보통주
587,660,2020-03-25,0.073697585768742,78700,84500,5800,8787217,660.0,에스케이하이닉스보통주
588,660,2020-03-24,0.1340057636887608,69400,78700,9300,7247345,660.0,에스케이하이닉스보통주
589,660,2020-03-23,0.0721925133689839,74800,69400,-5400,8192363,660.0,에스케이하이닉스보통주
590,660,2020-03-20,0.0840579710144927,69000,74800,5800,8750101,660.0,에스케이하이닉스보통주
591,660,2020-03-19,0.0560875512995896,73100,69000,-4100,11140367,660.0,에스케이하이닉스보통주
592,660,2020-03-18,0.0907960199004975,80400,73100,-7300,7949482,660.0,에스케이하이닉스보통주
593,660,2020-03-11,0.0404040404040404,89100,85500,-3600,5226251,660.0,에스케이하이닉스보통주
594,660,2020-03-09,0.0615550755939524,92600,86900,-5700,6196552,660.0,에스케이하이닉스보통주
595,660,2020-03-02,0.0477815699658703,87900,92100,4200,6382279,660.0,에스케이하이닉스보통주
596,660,2020-02-28,0.052801724137931,92800,87900,-4900,8171939,660.0,에스케이하이닉스보통주
597,660,2019-12-17,0.0474040632054176,88600,92800,4200,5070618,660.0,에스케이하이닉스보통주
598,660,2019-12-13,0.0539568345323741,83400,87900,4500,5831965,660.0,에스케이하이닉스보통주
599,660,2019-10-18,0.0444444444444444,81000,77400,-3600,13625664,660.0,에스케이하이닉스보통주
600,660,2019-08-30,0.0559345156889495,73300,77400,4100,3839246,660.0,에스케이하이닉스보통주
601,660,2019-08-06,0.0450928381962864,75400,72000,-3400,5008247,660.0,에스케이하이닉스보통주
602,660,2019-07-10,0.0444126074498567,69800,72900,3100,4346179,660.0,에스케이하이닉스보통주
603,660,2019-06-19,0.0599369085173501,63400,67200,3800,6230370,660.0,에스케이하이닉스보통주
604,660,2019-05-09,0.0535491905354919,80300,76000,-4300,5939278,660.0,에스케이하이닉스보통주
605,660,2019-04-03,0.0458115183246073,76400,79900,3500,4674142,660.0,에스케이하이닉스보통주
606,660,2019-03-25,0.0420499342969776,76100,72900,-3200,3752230,660.0,에스케이하이닉스보통주
607,660,2019-03-21,0.076595744680851,70500,75900,5400,10030131,660.0,에스케이하이닉스보통주
608,660,2019-02-28,0.0502035278154681,73700,70000,-3700,7869451,660.0,에스케이하이닉스보통주
609,660,2019-02-15,0.0465116279069767,77400,73800,-3600,4154616,660.0,에스케이하이닉스보통주
610,660,2019-02-08,0.0417209908735332,76700,73500,-3200,4012485,660.0,에스케이하이닉스보통주
611,660,2019-01-25,0.0581560283687943,70500,74600,4100,7163871,660.0,에스케이하이닉스보통주
612,660,2019-01-24,0.0553892215568862,66800,70500,3700,6914092,660.0,에스케이하이닉스보통주
613,660,2019-01-14,0.0460829493087557,65100,62100,-3000,3282892,660.0,에스케이하이닉스보통주
614,660,2019-01-09,0.0743243243243243,59200,63600,4400,4928656,660.0,에스케이하이닉스보통주
615,660,2019-01-03,0.0478547854785478,60600,57700,-2900,3337621,660.0,에스케이하이닉스보통주
616,660,2018-12-14,0.0564885496183206,65500,61800,-3700,5617675,660.0,에스케이하이닉스보통주
617,660,2018-11-02,0.0629575402635432,68300,72600,4300,5334082,660.0,에스케이하이닉스보통주
618,660,2018-10-12,0.0492753623188405,69000,72400,3400,4882184,660.0,에스케이하이닉스보통주
619,660,2018-09-14,0.0429530201342281,74500,77700,3200,4124842,660.0,에스케이하이닉스보통주
620,660,2018-08-21,0.0495314591700133,74700,78400,3700,5663191,660.0,에스케이하이닉스보통주
621,660,2018-08-06,0.0468187274909964,83300,79400,-3900,5910100,660.0,에스케이하이닉스보통주
622,660,2018-07-23,0.0705346985210466,87900,81700,-6200,7076375,660.0,에스케이하이닉스보통주
623,660,2018-06-25,0.0525139664804469,89500,84800,-4700,4420542,660.0,에스케이하이닉스보통주
624,660,2018-06-20,0.0439952437574316,84100,87800,3700,4183210,660.0,에스케이하이닉스보통주
625,660,2018-05-23,0.0695847362514029,89100,95300,6200,10378915,660.0,에스케이하이닉스보통주
626,660,2018-04-26,0.049757281553398,82400,86500,4100,7551747,660.0,에스케이하이닉스보통주
627,660,2018-03-23,0.0620767494356659,88600,83100,-5500,7310739,660.0,에스케이하이닉스보통주
628,660,2018-03-13,0.0600706713780918,84900,90000,5100,8775741,660.0,에스케이하이닉스보통주
629,660,2018-03-06,0.0523627075351213,78300,82400,4100,7588369,660.0,에스케이하이닉스보통주
630,660,2018-02-13,0.0429530201342281,74500,77700,3200,7814367,660.0,에스케이하이닉스보통주
631,660,2018-01-25,0.0469613259668508,72400,75800,3400,8758929,660.0,에스케이하이닉스보통주
632,660,2018-01-10,0.0520156046814044,76900,72900,-4000,9123901,660.0,에스케이하이닉스보통주
633,660,2017-11-30,0.0679611650485436,82400,76800,-5600,11213748,660.0,에스케이하이닉스보통주
634,660,2017-10-23,0.043103448275862,81200,84700,3500,5388391,660.0,에스케이하이닉스보통주
635,660,2017-10-10,0.0699638118214716,82900,88700,5800,7956055,660.0,에스케이하이닉스보통주
636,660,2017-09-26,0.048667439165701,86300,82100,-4200,11035272,660.0,에스케이하이닉스보통주
637,660,2017-08-14,0.0602605863192182,61400,65100,3700,5239246,660.0,에스케이하이닉스보통주
638,660,2017-08-11,0.046583850931677,64400,61400,-3000,6664578,660.0,에스케이하이닉스보통주
639,660,2017-07-28,0.0555555555555555,68400,64600,-3800,8093780,660.0,에스케이하이닉스보통주
640,660,2017-07-26,0.0511363636363636,70400,66800,-3600,9659618,660.0,에스케이하이닉스보통주
641,660,2017-03-17,0.0488301119023397,49150,46750,-2400,8098258,660.0,에스케이하이닉스보통주
642,660,2017-03-06,0.0477707006369426,47100,49350,2250,5045970,660.0,에스케이하이닉스보통주
643,660,2017-02-24,0.0537848605577689,50200,47500,-2700,7707747,660.0,에스케이하이닉스보통주
644,660,2017-02-14,0.044378698224852,50700,48450,-2250,8593878,660.0,에스케이하이닉스보통주
645,660,2017-02-10,0.0512333965844402,52700,50000,-2700,9120878,660.0,에스케이하이닉스보통주
646,660,2016-11-22,0.0478527607361963,40750,42700,1950,3306186,660.0,에스케이하이닉스보통주
647,660,2016-11-09,0.044578313253012,41500,39650,-1850,5779291,660.0,에스케이하이닉스보통주
648,660,2016-10-26,0.0450669914738124,41050,42900,1850,6364037,660.0,에스케이하이닉스보통주
649,660,2016-09-27,0.0417721518987341,39500,41150,1650,4001505,660.0,에스케이하이닉스보통주
650,660,2016-09-12,0.0500641848523748,38950,37000,-1950,4885896,660.0,에스케이하이닉스보통주
651,670,2021-05-13,0.0536912751677852,745000,705000,-40000,4940,670.0,영풍보통주
652,670,2021-05-10,0.0657142857142857,700000,746000,46000,4788,670.0,영풍보통주
653,670,2021-05-06,0.0461997019374068,671000,702000,31000,2789,670.0,영풍보통주
654,670,2021-04-30,0.0436619718309859,710000,679000,-31000,4398,670.0,영풍보통주
655,670,2021-04-27,0.0417956656346749,646000,673000,27000,4436,670.0,영풍보통주
656,670,2021-02-26,0.0432098765432098,648000,620000,-28000,3199,670.0,영풍보통주
657,670,2021-02-23,0.0462809917355371,605000,633000,28000,11072,670.0,영풍보통주
658,670,2021-02-22,0.0558464223385689,573000,605000,32000,8183,670.0,영풍보통주
659,670,2021-02-17,0.0452079566003616,553000,578000,25000,7512,670.0,영풍보통주
660,670,2021-01-11,0.0541012216404886,573000,542000,-31000,4899,670.0,영풍보통주
661,670,2021-01-05,0.0481481481481481,540000,566000,26000,4895,670.0,영풍보통주
662,670,2020-08-20,0.0577299412915851,511000,481500,-29500,4691,670.0,영풍보통주
663,670,2020-08-12,0.0448028673835125,558000,533000,-25000,4688,670.0,영풍보통주
664,670,2020-08-07,0.0677655677655677,546000,583000,37000,8873,670.0,영풍보통주
665,670,2020-07-31,0.0422018348623853,545000,522000,-23000,2449,670.0,영풍보통주
666,670,2020-07-27,0.0558882235528942,501000,529000,28000,4199,670.0,영풍보통주
667,670,2020-07-22,0.0491803278688524,488000,512000,24000,6933,670.0,영풍보통주
668,670,2020-06-15,0.0438247011952191,502000,480000,-22000,2696,670.0,영풍보통주
669,670,2020-05-14,0.0431519699812382,533000,510000,-23000,2473,670.0,영풍보통주
670,670,2020-05-11,0.0553435114503816,524000,553000,29000,3898,670.0,영풍보통주
671,670,2020-05-04,0.0412667946257197,521000,499500,-21500,2480,670.0,영풍보통주
672,670,2020-04-07,0.0607621009268795,485500,515000,29500,2607,670.0,영풍보통주
673,670,2020-03-25,0.0720288115246098,416500,446500,30000,3509,670.0,영풍보통주
674,670,2020-03-24,0.0846354166666666,384000,416500,32500,3555,670.0,영풍보통주
675,670,2020-03-23,0.1222857142857142,437500,384000,-53500,3109,670.0,영풍보통주
676,670,2020-03-20,0.0802469135802469,405000,437500,32500,5724,670.0,영풍보통주
677,670,2020-03-19,0.0989988876529477,449500,405000,-44500,3173,670.0,영풍보통주
678,670,2020-03-18,0.0693581780538302,483000,449500,-33500,2031,670.0,영풍보통주
679,670,2020-03-17,0.0510805500982318,509000,483000,-26000,2209,670.0,영풍보통주
680,670,2020-03-11,0.0475319926873857,547000,521000,-26000,2745,670.0,영풍보통주
681,670,2020-02-24,0.0482866043613707,642000,611000,-31000,1664,670.0,영풍보통주
682,670,2019-12-13,0.0455235204855842,659000,629000,-30000,3290,670.0,영풍보통주
683,670,2019-11-04,0.0573770491803278,610000,645000,35000,985,670.0,영풍보통주
684,670,2019-10-18,0.0490693739424703,591000,620000,29000,4161,670.0,영풍보통주
685,670,2019-06-13,0.0470262793914246,723000,757000,34000,2667,670.0,영풍보통주
686,670,2019-06-03,0.0767045454545454,704000,758000,54000,3810,670.0,영풍보통주
687,670,2019-05-07,0.0412234042553191,752000,721000,-31000,2791,670.0,영풍보통주
688,670,2019-04-05,0.0443349753694581,812000,848000,36000,2435,670.0,영풍보통주
689,670,2018-12-18,0.0586701434159061,767000,722000,-45000,3114,670.0,영풍보통주
690,670,2018-11-02,0.0421875,640000,667000,27000,2380,670.0,영풍보통주
691,670,2018-10-11,0.0541611624834874,757000,716000,-41000,1729,670.0,영풍보통주
692,670,2018-07-04,0.0455729166666666,768000,733000,-35000,3221,670.0,영풍보통주
693,670,2018-05-14,0.0429732868757259,861000,898000,37000,3372,670.0,영풍보통주
694,670,2018-01-22,0.0453686200378071,1058000,1010000,-48000,5540,670.0,영풍보통주
695,670,2018-01-09,0.0406278855032317,1083000,1127000,44000,3224,670.0,영풍보통주
696,670,2017-12-05,0.0624390243902439,1025000,1089000,64000,15485,670.0,영풍보통주
697,670,2017-12-04,0.1458333333333333,1200000,1025000,-175000,18257,670.0,영풍보통주
698,670,2017-11-15,0.0570599613152804,1034000,1093000,59000,5971,670.0,영풍보통주
699,670,2017-10-27,0.0532010820559062,1109000,1168000,59000,3103,670.0,영풍보통주
700,670,2017-06-26,0.0430308699719363,1069000,1115000,46000,3619,670.0,영풍보통주
701,670,2017-03-30,0.0690423162583518,898000,960000,62000,6715,670.0,영풍보통주
702,670,2016-09-05,0.0485074626865671,1072000,1124000,52000,1812,670.0,영풍보통주
703,720,2021-05-27,0.0642722117202268,52900,56300,3400,3790619,720.0,현대건설보통주
704,720,2021-04-30,0.0718232044198895,54300,50400,-3900,2564460,720.0,현대건설보통주
705,720,2021-03-12,0.050251256281407,39800,41800,2000,945381,720.0,현대건설보통주
706,720,2021-02-26,0.0421179302045728,41550,39800,-1750,1018432,720.0,현대건설보통주
707,720,2021-02-01,0.0807453416149068,40250,43500,3250,1510418,720.0,현대건설보통주
708,720,2021-01-29,0.0462085308056872,42200,40250,-1950,1721424,720.0,현대건설보통주
709,720,2021-01-19,0.048780487804878,43050,45150,2100,2158846,720.0,현대건설보통주
710,720,2021-01-15,0.0435754189944134,44750,42800,-1950,1874022,720.0,현대건설보통주
711,720,2021-01-11,0.0756097560975609,41000,44100,3100,6595915,720.0,현대건설보통주
712,720,2021-01-05,0.0483660130718954,38250,40100,1850,4010166,720.0,현대건설보통주
713,720,2020-12-10,0.0421195652173913,36800,38350,1550,4034397,720.0,현대건설보통주
714,720,2020-12-04,0.0472103004291845,34950,36600,1650,3229954,720.0,현대건설보통주
715,720,2020-11-30,0.0427350427350427,35100,33600,-1500,1448489,720.0,현대건설보통주
716,720,2020-08-20,0.0501474926253687,33900,32200,-1700,1503859,720.0,현대건설보통주
717,720,2020-08-18,0.0555555555555555,36000,34000,-2000,1387948,720.0,현대건설보통주
718,720,2020-08-11,0.058055152394775,34450,36450,2000,4053870,720.0,현대건설보통주
719,720,2020-06-23,0.0405027932960893,35800,34350,-1450,2579502,720.0,현대건설보통주
720,720,2020-06-22,0.075075075075075,33300,35800,2500,11307283,720.0,현대건설보통주
721,720,2020-06-16,0.0606060606060606,31350,33250,1900,753850,720.0,현대건설보통주
722,720,2020-06-15,0.0752212389380531,33900,31350,-2550,996594,720.0,현대건설보통주
723,720,2020-06-12,0.0450704225352112,35500,33900,-1600,945605,720.0,현대건설보통주
724,720,2020-06-03,0.0542082738944365,35050,36950,1900,2749367,720.0,현대건설보통주
725,720,2020-05-27,0.0429629629629629,33750,35200,1450,1613356,720.0,현대건설보통주
726,720,2020-05-26,0.0416666666666666,32400,33750,1350,1434923,720.0,현대건설보통주
727,720,2020-04-24,0.0503597122302158,34750,33000,-1750,1333616,720.0,현대건설보통주
728,720,2020-04-14,0.0420032310177706,30950,32250,1300,1095785,720.0,현대건설보통주
729,720,2020-04-09,0.0541012216404886,28650,30200,1550,1081463,720.0,현대건설보통주
730,720,2020-04-06,0.0408921933085501,26900,28000,1100,1015865,720.0,현대건설보통주
731,720,2020-04-02,0.063953488372093,25800,27450,1650,1270336,720.0,현대건설보통주
732,720,2020-04-01,0.0601092896174863,27450,25800,-1650,1102830,720.0,현대건설보통주
733,720,2020-03-31,0.0764705882352941,25500,27450,1950,2999864,720.0,현대건설보통주
734,720,2020-03-25,0.1207289293849658,21950,24600,2650,1902036,720.0,현대건설보통주
735,720,2020-03-24,0.1227621483375959,19550,21950,2400,1297187,720.0,현대건설보통주
736,720,2020-03-23,0.0778301886792452,21200,19550,-1650,1117661,720.0,현대건설보통주
737,720,2020-03-20,0.0984455958549222,19300,21200,1900,1887135,720.0,현대건설보통주
738,720,2020-03-19,0.1734475374732334,23350,19300,-4050,2750825,720.0,현대건설보통주
739,720,2020-03-18,0.1053639846743295,26100,23350,-2750,1681585,720.0,현대건설보통주
740,720,2020-03-16,0.0424778761061946,28250,27050,-1200,969795,720.0,현대건설보통주
741,720,2020-03-13,0.0488215488215488,29700,28250,-1450,1808030,720.0,현대건설보통주
742,720,2020-03-12,0.0645669291338582,31750,29700,-2050,1435817,720.0,현대건설보통주
743,720,2020-03-09,0.0679886685552408,35300,32900,-2400,1167994,720.0,현대건설보통주
744,720,2020-02-24,0.0545702592087312,36650,34650,-2000,921320,720.0,현대건설보통주
745,720,2020-02-06,0.0557717250324254,38550,40700,2150,786307,720.0,현대건설보통주
746,720,2020-01-28,0.045510455104551,40650,38800,-1850,616097,720.0,현대건설보통주
747,720,2020-01-13,0.0463917525773195,38800,40600,1800,890218,720.0,현대건설보통주
748,720,2020-01-08,0.0516372795969773,39700,37650,-2050,1269380,720.0,현대건설보통주
749,720,2019-10-07,0.0457516339869281,45900,43800,-2100,865675,720.0,현대건설보통주
750,720,2019-09-25,0.0425311203319502,48200,46150,-2050,714347,720.0,현대건설보통주
751,720,2019-09-16,0.0675526024363233,45150,48200,3050,1591498,720.0,현대건설보통주
752,720,2019-09-10,0.0582639714625445,42050,44500,2450,1260933,720.0,현대건설보통주
753,720,2019-08-05,0.0513126491646778,41900,39750,-2150,953283,720.0,현대건설보통주
754,720,2019-07-09,0.050595238095238,50400,47850,-2550,1035148,720.0,현대건설보통주
755,720,2019-07-03,0.0473588342440801,54900,52300,-2600,628663,720.0,현대건설보통주
756,720,2019-06-24,0.0407407407407407,54000,56200,2200,640543,720.0,현대건설보통주
757,720,2019-05-15,0.0615550755939524,46300,49150,2850,789859,720.0,현대건설보통주
758,720,2019-05-09,0.0512820512820512,50700,48100,-2600,953836,720.0,현대건설보통주
759,720,2019-04-26,0.0430528375733855,51100,53300,2200,912207,720.0,현대건설보통주
760,720,2019-03-29,0.0595238095238095,50400,53400,3000,1320678,720.0,현대건설보통주
761,720,2019-03-04,0.0506993006993006,57200,54300,-2900,2350983,720.0,현대건설보통주
762,720,2019-02-28,0.0803858520900321,62200,57200,-5000,1900149,720.0,현대건설보통주
763,720,2018-12-27,0.0406976744186046,51600,53700,2100,826958,720.0,현대건설보통주
764,720,2018-12-19,0.0428082191780821,58400,55900,-2500,1264834,720.0,현대건설보통주
765,720,2018-12-03,0.049090909090909,55000,57700,2700,1015875,720.0,현대건설보통주
766,720,2018-11-19,0.0424710424710424,51800,54000,2200,965861,720.0,현대건설보통주
767,720,2018-11-08,0.0658307210031347,47850,51000,3150,1462126,720.0,현대건설보통주
768,720,2018-11-02,0.0989988876529477,44950,49400,4450,1453516,720.0,현대건설보통주
769,720,2018-10-29,0.0575692963752665,46900,44200,-2700,1527749,720.0,현대건설보통주
770,720,2018-10-26,0.0457782299084435,49150,46900,-2250,1842714,720.0,현대건설보통주
771,720,2018-10-22,0.0542495479204339,55300,52300,-3000,1314999,720.0,현대건설보통주
772,720,2018-10-11,0.0658578856152513,57700,53900,-3800,1918123,720.0,현대건설보통주
773,720,2018-10-10,0.1054263565891472,64500,57700,-6800,2570789,720.0,현대건설보통주
774,720,2018-10-05,0.0406976744186046,68800,66000,-2800,1233457,720.0,현대건설보통주
775,720,2018-09-21,0.0416666666666666,64800,67500,2700,1811770,720.0,현대건설보통주
776,720,2018-09-10,0.0784929356357927,63700,68700,5000,2340749,720.0,현대건설보통주
777,720,2018-09-07,0.0459770114942528,60900,63700,2800,1495669,720.0,현대건설보통주
778,720,2018-08-27,0.0532081377151799,63900,60500,-3400,1898985,720.0,현대건설보통주
779,720,2018-08-13,0.0509868421052631,60800,57700,-3100,1891097,720.0,현대건설보통주
780,720,2018-08-06,0.0419463087248322,59600,57100,-2500,917534,720.0,현대건설보통주
781,720,2018-07-30,0.05,56000,58800,2800,1620963,720.0,현대건설보통주
782,720,2018-07-24,0.078,50000,53900,3900,2951316,720.0,현대건설보통주
783,720,2018-07-11,0.0422264875239923,52100,54300,2200,1898801,720.0,현대건설보통주
784,720,2018-07-09,0.0809352517985611,55600,51100,-4500,2661263,720.0,현대건설보통주
785,720,2018-07-06,0.0470809792843691,53100,55600,2500,1799602,720.0,현대건설보통주
786,720,2018-07-02,0.0608695652173913,57500,54000,-3500,2079104,720.0,현대건설보통주
787,720,2018-06-29,0.0511882998171846,54700,57500,2800,3064322,720.0,현대건설보통주
788,720,2018-06-28,0.042031523642732,57100,54700,-2400,2518686,720.0,현대건설보통주
789,720,2018-06-27,0.0546357615894039,60400,57100,-3300,3387257,720.0,현대건설보통주
790,720,2018-06-26,0.0412698412698412,63000,60400,-2600,2075554,720.0,현대건설보통주
791,720,2018-06-19,0.0450885668276972,62100,59300,-2800,3215191,720.0,현대건설보통주
792,720,2018-06-14,0.0862068965517241,69600,63600,-6000,5394396,720.0,현대건설보통주
793,720,2018-06-11,0.0758928571428571,67200,72300,5100,4398104,720.0,현대건설보통주
794,720,2018-06-05,0.04860088365243,67900,71200,3300,4864801,720.0,현대건설보통주
795,720,2018-06-01,0.0501355013550135,73800,70100,-3700,5274043,720.0,현대건설보통주
796,720,2018-05-29,0.0543615676359039,79100,74800,-4300,10387106,720.0,현대건설보통주
797,720,2018-05-28,0.2988505747126437,60900,79100,18200,16081258,720.0,현대건설보통주
798,720,2018-05-25,0.0977777777777777,67500,60900,-6600,9601681,720.0,현대건설보통주
799,720,2018-05-16,0.0635135135135135,74000,69300,-4700,9894362,720.0,현대건설보통주
800,720,2018-05-14,0.1381987577639751,64400,73300,8900,13176579,720.0,현대건설보통주
801,720,2018-05-08,0.0424886191198786,65900,63100,-2800,5749831,720.0,현대건설보통주
802,720,2018-05-04,0.080327868852459,61000,65900,4900,6159941,720.0,현대건설보통주
803,720,2018-05-03,0.0513219284603421,64300,61000,-3300,5111377,720.0,현대건설보통주
804,720,2018-04-30,0.2619047619047619,50400,63600,13200,12951733,720.0,현대건설보통주
805,720,2018-04-19,0.1220338983050847,44250,49650,5400,5783159,720.0,현대건설보통주
806,720,2018-04-18,0.0912453760789149,40550,44250,3700,2155198,720.0,현대건설보통주
807,720,2018-04-02,0.0446224256292906,43700,41750,-1950,679599,720.0,현대건설보통주
808,720,2018-03-28,0.0401948842874543,41050,42700,1650,1889448,720.0,현대건설보통주
809,720,2018-03-23,0.0458488228004956,40350,38500,-1850,1088300,720.0,현대건설보통주
810,720,2018-03-13,0.0469644902634593,43650,41600,-2050,1166353,720.0,현대건설보통주
811,720,2018-03-09,0.0819875776397515,40250,43550,3300,2324322,720.0,현대건설보통주
812,720,2018-02-19,0.0508905852417302,39300,41300,2000,708801,720.0,현대건설보통주
813,720,2018-02-07,0.0520231213872832,43250,41000,-2250,669259,720.0,현대건설보통주
814,720,2018-01-29,0.0686274509803921,40800,43600,2800,2549812,720.0,현대건설보통주
815,720,2018-01-19,0.0512483574244415,38050,40000,1950,923212,720.0,현대건설보통주
816,720,2018-01-10,0.0533854166666666,38400,40450,2050,2027187,720.0,현대건설보통주
817,720,2018-01-04,0.0454545454545454,36300,37950,1650,1459930,720.0,현대건설보통주
818,720,2017-12-14,0.0506155950752394,36550,34700,-1850,872312,720.0,현대건설보통주
819,720,2017-12-13,0.050287356321839,34800,36550,1750,927689,720.0,현대건설보통주
820,720,2017-11-15,0.0438829787234042,37600,35950,-1650,1542754,720.0,현대건설보통주
821,720,2017-11-07,0.0773263433813892,38150,41100,2950,1881153,720.0,현대건설보통주
822,720,2017-10-30,0.0453400503778337,39700,37900,-1800,729378,720.0,현대건설보통주
823,720,2017-10-12,0.0654205607476635,37450,39900,2450,1101121,720.0,현대건설보통주
824,720,2017-08-03,0.0668896321070234,44850,41850,-3000,1039225,720.0,현대건설보통주
825,720,2017-07-28,0.0504115226337448,48600,46150,-2450,802449,720.0,현대건설보통주
826,720,2017-03-23,0.0512295081967213,48800,51300,2500,623680,720.0,현대건설보통주
827,720,2017-02-01,0.0637785800240673,41550,44200,2650,970881,720.0,현대건설보통주
828,720,2017-01-09,0.044548651817116,42650,40750,-1900,853928,720.0,현대건설보통주
829,720,2016-12-12,0.0650306748466257,40750,43400,2650,605038,720.0,현대건설보통주
830,720,2016-12-01,0.0419313850063532,39350,41000,1650,885772,720.0,현대건설보통주
831,720,2016-11-30,0.0414129110840438,41050,39350,-1700,752250,720.0,현대건설보통주
832,720,2016-11-10,0.0671550671550671,40950,43700,2750,833803,720.0,현대건설보통주
833,720,2016-10-26,0.0484234234234234,44400,42250,-2150,756670,720.0,현대건설보통주
834,720,2016-10-11,0.0425273390036452,41150,42900,1750,1079128,720.0,현대건설보통주
835,720,2016-09-12,0.0538461538461538,39000,36900,-2100,576657,720.0,현대건설보통주
836,720,2016-08-05,0.0421348314606741,35600,37100,1500,750357,720.0,현대건설보통주
837,810,2021-03-02,0.0462427745664739,173000,181000,8000,403111,810.0,삼성화재해상보험보통주
838,810,2020-12-29,0.0408163265306122,196000,188000,-8000,252942,810.0,삼성화재해상보험보통주
839,810,2020-11-30,0.052896725440806,198500,188000,-10500,688925,810.0,삼성화재해상보험보통주
840,810,2020-11-18,0.0519480519480519,192500,202500,10000,314019,810.0,삼성화재해상보험보통주
841,810,2020-11-10,0.056910569105691,184500,195000,10500,276339,810.0,삼성화재해상보험보통주
842,810,2020-08-20,0.0533333333333333,187500,177500,-10000,177302,810.0,삼성화재해상보험보통주
843,810,2020-08-19,0.0445682451253481,179500,187500,8000,225856,810.0,삼성화재해상보험보통주
844,810,2020-08-18,0.0502645502645502,189000,179500,-9500,197936,810.0,삼성화재해상보험보통주
845,810,2020-08-13,0.0476190476190476,178500,187000,8500,563113,810.0,삼성화재해상보험보통주
846,810,2020-08-11,0.0543806646525679,165500,174500,9000,311788,810.0,삼성화재해상보험보통주
847,810,2020-07-10,0.0404312668463611,185500,178000,-7500,113945,810.0,삼성화재해상보험보통주
848,810,2020-06-25,0.0455764075067024,186500,178000,-8500,123282,810.0,삼성화재해상보험보통주
849,810,2020-06-16,0.0533707865168539,178000,187500,9500,126935,810.0,삼성화재해상보험보통주
850,810,2020-06-12,0.0466321243523316,193000,184000,-9000,171353,810.0,삼성화재해상보험보통주
851,810,2020-06-02,0.0884718498659517,186500,203000,16500,301777,810.0,삼성화재해상보험보통주
852,810,2020-05-14,0.0423280423280423,189000,197000,8000,195699,810.0,삼성화재해상보험보통주
853,810,2020-05-04,0.0419947506561679,190500,182500,-8000,170388,810.0,삼성화재해상보험보통주
854,810,2020-04-10,0.0427350427350427,175500,183000,7500,199766,810.0,삼성화재해상보험보통주
855,810,2020-04-02,0.1533333333333333,150000,173000,23000,365885,810.0,삼성화재해상보험보통주
856,810,2020-03-31,0.0511945392491467,146500,154000,7500,203980,810.0,삼성화재해상보험보통주
857,810,2020-03-27,0.0412371134020618,145500,151500,6000,189973,810.0,삼성화재해상보험보통주
858,810,2020-03-26,0.0490196078431372,153000,145500,-7500,192964,810.0,삼성화재해상보험보통주
859,810,2020-03-25,0.0551724137931034,145000,153000,8000,271935,810.0,삼성화재해상보험보통주
860,810,2020-03-24,0.0545454545454545,137500,145000,7500,168219,810.0,삼성화재해상보험보통주
861,810,2020-03-23,0.0617760617760617,129500,137500,8000,243535,810.0,삼성화재해상보험보통주
862,810,2020-03-19,0.0869565217391304,138000,126000,-12000,325928,810.0,삼성화재해상보험보통주
863,810,2020-03-18,0.0769230769230769,149500,138000,-11500,261880,810.0,삼성화재해상보험보통주
864,810,2020-03-17,0.056782334384858,158500,149500,-9000,229767,810.0,삼성화재해상보험보통주
865,810,2020-03-16,0.053731343283582,167500,158500,-9000,178133,810.0,삼성화재해상보험보통주
866,810,2020-03-13,0.0428571428571428,175000,167500,-7500,224625,810.0,삼성화재해상보험보통주
867,810,2019-12-12,0.0483193277310924,238000,249500,11500,321849,810.0,삼성화재해상보험보통주
868,810,2019-11-15,0.042316258351893,224500,234000,9500,125167,810.0,삼성화재해상보험보통주
869,810,2019-08-12,0.0632653061224489,245000,229500,-15500,213954,810.0,삼성화재해상보험보통주
870,810,2019-08-07,0.052734375,256000,242500,-13500,199480,810.0,삼성화재해상보험보통주
871,810,2019-07-19,0.0486381322957198,257000,269500,12500,113610,810.0,삼성화재해상보험보통주
872,810,2019-04-02,0.0404530744336569,309000,296500,-12500,145264,810.0,삼성화재해상보험보통주
873,810,2019-02-01,0.0402930402930402,273000,284000,11000,135095,810.0,삼성화재해상보험보통주
874,810,2018-09-28,0.0422018348623853,272500,284000,11500,229368,810.0,삼성화재해상보험보통주
875,810,2018-02-19,0.0418943533697632,274500,286000,11500,76394,810.0,삼성화재해상보험보통주
876,810,2017-08-01,0.0462328767123287,292000,305500,13500,159583,810.0,삼성화재해상보험보통주
877,810,2017-02-16,0.0511882998171846,273500,259500,-14000,357146,810.0,삼성화재해상보험보통주
878,810,2016-12-21,0.0629251700680272,294000,275500,-18500,278032,810.0,삼성화재해상보험보통주
879,880,2021-05-17,0.0471698113207547,31800,30300,-1500,1434381,880.0,한화보통주
880,880,2021-05-12,0.075036075036075,34650,32050,-2600,1713437,880.0,한화보통주
881,880,2021-05-10,0.073015873015873,31500,33800,2300,1785089,880.0,한화보통주
882,880,2021-05-06,0.0409165302782324,30550,31800,1250,856471,880.0,한화보통주
883,880,2021-01-28,0.0484330484330484,35100,33400,-1700,918372,880.0,한화보통주
884,880,2021-01-22,0.0456431535269709,36150,34500,-1650,1912550,880.0,한화보통주
885,880,2021-01-21,0.1512738853503184,31400,36150,4750,5007958,880.0,한화보통주
886,880,2021-01-07,0.0652920962199312,29100,31000,1900,2129955,880.0,한화보통주
887,880,2020-12-24,0.042910447761194,26800,27950,1150,1676840,880.0,한화보통주
888,880,2020-11-05,0.040650406504065,24600,25600,1000,370571,880.0,한화보통주
889,880,2020-10-30,0.0418326693227091,25100,24050,-1050,416180,880.0,한화보통주
890,880,2020-10-21,0.0497017892644135,25150,26400,1250,357918,880.0,한화보통주
891,880,2020-10-05,0.0536779324055666,25150,26500,1350,623832,880.0,한화보통주
892,880,2020-09-22,0.0456273764258555,26300,25100,-1200,785215,880.0,한화보통주
893,880,2020-09-11,0.0464344941956882,30150,28750,-1400,1330831,880.0,한화보통주
894,880,2020-09-04,0.0915254237288135,29500,32200,2700,5522177,880.0,한화보통주
895,880,2020-09-03,0.059245960502693,27850,29500,1650,2158052,880.0,한화보통주
896,880,2020-08-31,0.053639846743295,26100,27500,1400,1615506,880.0,한화보통주
897,880,2020-08-25,0.0512820512820512,25350,26650,1300,724885,880.0,한화보통주
898,880,2020-08-20,0.048169556840077,25950,24700,-1250,707860,880.0,한화보통주
899,880,2020-07-29,0.0819327731092437,23800,25750,1950,4687631,880.0,한화보통주
900,880,2020-07-27,0.0437636761487965,22850,23850,1000,437617,880.0,한화보통주
901,880,2020-06-16,0.0690423162583518,22450,24000,1550,1372469,880.0,한화보통주
902,880,2020-06-15,0.0892494929006085,24650,22450,-2200,1457992,880.0,한화보통주
903,880,2020-06-11,0.0628465804066543,27050,25350,-1700,2786127,880.0,한화보통주
904,880,2020-06-10,0.0656303972366148,28950,27050,-1900,4514868,880.0,한화보통주
905,880,2020-06-09,0.2669584245076586,22850,28950,6100,10872062,880.0,한화보통주
906,880,2020-06-08,0.0778301886792452,21200,22850,1650,2427303,880.0,한화보통주
907,880,2020-05-04,0.0772946859903381,20700,19100,-1600,401661,880.0,한화보통주
908,880,2020-04-29,0.0670103092783505,19400,20700,1300,576971,880.0,한화보통주
909,880,2020-04-06,0.0791139240506329,15800,17050,1250,436951,880.0,한화보통주
910,880,2020-03-27,0.0460992907801418,14100,14750,650,791704,880.0,한화보통주
911,880,2020-03-25,0.10546875,12800,14150,1350,774346,880.0,한화보통주
912,880,2020-03-24,0.0622406639004149,12050,12800,750,663746,880.0,한화보통주
913,880,2020-03-23,0.1236363636363636,13750,12050,-1700,726395,880.0,한화보통주
914,880,2020-03-20,0.1,12500,13750,1250,918027,880.0,한화보통주
915,880,2020-03-19,0.1525423728813559,14750,12500,-2250,736924,880.0,한화보통주
916,880,2020-03-18,0.0950920245398773,16300,14750,-1550,427518,880.0,한화보통주
917,880,2020-03-13,0.0581717451523545,18050,17000,-1050,599635,880.0,한화보통주
918,880,2020-03-12,0.0647668393782383,19300,18050,-1250,591724,880.0,한화보통주
919,880,2020-02-24,0.0468384074941452,21350,20350,-1000,285066,880.0,한화보통주
920,880,2020-02-06,0.05,22000,23100,1100,190156,880.0,한화보통주
921,880,2020-01-28,0.051063829787234,23500,22300,-1200,263117,880.0,한화보통주
922,880,2020-01-08,0.0486257928118393,23650,22500,-1150,445810,880.0,한화보통주
923,880,2020-01-06,0.0427698574338085,24550,23500,-1050,221121,880.0,한화보통주
924,880,2019-10-14,0.0546218487394958,23800,25100,1300,181027,880.0,한화보통주
925,880,2019-08-19,0.0487238979118329,21550,22600,1050,242186,880.0,한화보통주
926,880,2018-10-26,0.0518134715025906,28950,27450,-1500,367097,880.0,한화보통주
927,880,2018-10-11,0.0781499202551834,31350,28900,-2450,590394,880.0,한화보통주
928,880,2018-09-27,0.0505529225908372,31650,33250,1600,537797,880.0,한화보통주
929,880,2018-09-14,0.0403877221324717,30950,32200,1250,385130,880.0,한화보통주
930,880,2018-08-16,0.0411585365853658,32800,31450,-1350,464174,880.0,한화보통주
931,880,2018-08-03,0.0658307210031347,31900,34000,2100,1024617,880.0,한화보통주
932,880,2018-07-20,0.0515806988352745,30050,31600,1550,544253,880.0,한화보통주
933,880,2018-06-27,0.0410334346504559,32900,31550,-1350,389399,880.0,한화보통주
934,880,2018-06-21,0.0421052631578947,33250,31850,-1400,642528,880.0,한화보통주
935,880,2018-05-11,0.0418781725888324,39400,41050,1650,539986,880.0,한화보통주
936,880,2018-01-05,0.0642201834862385,43600,46400,2800,1016729,880.0,한화보통주
937,880,2018-01-02,0.0421686746987951,41500,43250,1750,319909,880.0,한화보통주
938,880,2017-12-13,0.050632911392405,39500,41500,2000,479003,880.0,한화보통주
939,880,2017-11-13,0.059090909090909,44000,41400,-2600,569475,880.0,한화보통주
940,880,2017-10-10,0.0477272727272727,44000,46100,2100,357878,880.0,한화보통주
941,880,2017-09-25,0.0583153347732181,46300,43600,-2700,544021,880.0,한화보통주
942,880,2017-08-25,0.0428015564202334,51400,49200,-2200,749687,880.0,한화보통주
943,880,2017-07-10,0.0418904403866809,46550,48500,1950,344556,880.0,한화보통주
944,880,2017-02-24,0.0409026798307475,35450,36900,1450,809647,880.0,한화보통주
945,880,2016-11-18,0.0401069518716577,37400,35900,-1500,441453,880.0,한화보통주
946,880,2016-11-01,0.0455153949129852,37350,35650,-1700,568642,880.0,한화보통주
947,880,2016-10-19,0.05,37000,38850,1850,905761,880.0,한화보통주
948,880,2016-08-10,0.0429799426934097,34900,35450,550,483197,880.0,한화보통주
949,990,2021-06-03,0.0520446096654275,53800,56600,2800,2568573,990.0,DB하이텍보통주
950,990,2021-05-24,0.0536044362292051,54100,51200,-2900,1336146,990.0,DB하이텍보통주
951,990,2021-05-17,0.0595667870036101,55400,52100,-3300,2242140,990.0,DB하이텍보통주
952,990,2021-05-11,0.0542372881355932,59000,55800,-3200,1276832,990.0,DB하이텍보통주
953,990,2021-05-10,0.059245960502693,55700,59000,3300,1094299,990.0,DB하이텍보통주
954,990,2021-04-28,0.047457627118644,59000,56200,-2800,946771,990.0,DB하이텍보통주
955,990,2021-04-20,0.0466321243523316,57900,60600,2700,3228457,990.0,DB하이텍보통주
956,990,2021-04-19,0.0702402957486136,54100,57900,3800,2330919,990.0,DB하이텍보통주
957,990,2021-03-30,0.0496323529411764,54400,57100,2700,1088829,990.0,DB하이텍보통주
958,990,2021-03-23,0.0402802101576182,57100,54800,-2300,946415,990.0,DB하이텍보통주
959,990,2021-03-16,0.08206106870229,52400,56700,4300,1950497,990.0,DB하이텍보통주
960,990,2021-03-08,0.044776119402985,53600,51200,-2400,899757,990.0,DB하이텍보통주
961,990,2021-03-04,0.0443262411347517,56400,53900,-2500,992206,990.0,DB하이텍보통주
962,990,2021-02-18,0.0479134466769706,64700,61600,-3100,1427067,990.0,DB하이텍보통주
963,990,2021-02-15,0.0518638573743922,61700,64900,3200,2344050,990.0,DB하이텍보통주
964,990,2021-01-29,0.0807174887892376,66900,61500,-5400,3539007,990.0,DB하이텍보통주
965,990,2021-01-26,0.0426742532005689,70300,67300,-3000,1724188,990.0,DB하이텍보통주
966,990,2021-01-20,0.0914826498422713,63400,69200,5800,6388832,990.0,DB하이텍보통주
967,990,2021-01-18,0.0601001669449081,59900,63500,3600,4551888,990.0,DB하이텍보통주
968,990,2021-01-12,0.1014234875444839,56200,61900,5700,7038777,990.0,DB하이텍보통주
969,990,2021-01-06,0.0741482965931863,49900,53600,3700,5895650,990.0,DB하이텍보통주
970,990,2020-12-29,0.0627027027027027,46250,49150,2900,5805330,990.0,DB하이텍보통주
971,990,2020-12-28,0.0768335273573923,42950,46250,3300,9571591,990.0,DB하이텍보통주
972,990,2020-12-24,0.071072319201995,40100,42950,2850,14750858,990.0,DB하이텍보통주
973,990,2020-12-22,0.0684931506849315,36500,39000,2500,6964980,990.0,DB하이텍보통주
974,990,2020-12-17,0.0400572246065808,34950,36350,1400,2032343,990.0,DB하이텍보통주
975,990,2020-11-25,0.0547550432276657,34700,36600,1900,2938399,990.0,DB하이텍보통주
976,990,2020-11-04,0.0790273556231003,32900,35500,2600,1636970,990.0,DB하이텍보통주
977,990,2020-10-30,0.0434131736526946,33400,31950,-1450,447549,990.0,DB하이텍보통주
978,990,2020-10-26,0.0431432973805855,32450,31050,-1400,859457,990.0,DB하이텍보통주
979,990,2020-10-22,0.0400572246065808,34950,33550,-1400,519839,990.0,DB하이텍보통주
980,990,2020-09-28,0.0889526542324246,34850,37950,3100,1552455,990.0,DB하이텍보통주
981,990,2020-09-11,0.0455764075067024,37300,39000,1700,1857124,990.0,DB하이텍보통주
982,990,2020-09-07,0.0720461095100864,34700,37200,2500,2890169,990.0,DB하이텍보통주
983,990,2020-08-20,0.0518134715025906,38600,36600,-2000,2762922,990.0,DB하이텍보통주
984,990,2020-08-19,0.1188405797101449,34500,38600,4100,3642264,990.0,DB하이텍보통주
985,990,2020-08-18,0.065040650406504,36900,34500,-2400,2177311,990.0,DB하이텍보통주
986,990,2020-08-13,0.063400576368876,34700,36900,2200,3359443,990.0,DB하이텍보통주
987,990,2020-07-30,0.0508221225710014,33450,35150,1700,2990949,990.0,DB하이텍보통주
988,990,2020-07-28,0.072463768115942,31050,33300,2250,5179315,990.0,DB하이텍보통주
989,990,2020-07-10,0.0463917525773195,29100,30450,1350,2477812,990.0,DB하이텍보통주
990,990,2020-07-06,0.0629370629370629,28600,30400,1800,1614199,990.0,DB하이텍보통주
991,990,2020-06-25,0.0406779661016949,29500,28300,-1200,1160238,990.0,DB하이텍보통주
992,990,2020-06-19,0.046594982078853,27900,29200,1300,1344338,990.0,DB하이텍보통주
993,990,2020-06-15,0.0641247833622183,28850,27000,-1850,1371735,990.0,DB하이텍보통주
994,990,2020-06-01,0.0734265734265734,28600,30700,2100,1688404,990.0,DB하이텍보통주
995,990,2020-05-28,0.0424836601307189,30600,29300,-1300,2222420,990.0,DB하이텍보통주
996,990,2020-05-27,0.0642201834862385,32700,30600,-2100,2513763,990.0,DB하이텍보통주
997,990,2020-05-25,0.1776556776556776,27300,32150,4850,5169727,990.0,DB하이텍보통주
998,990,2020-05-06,0.0451866404715127,25450,26600,1150,741881,990.0,DB하이텍보통주
999,990,2020-05-04,0.0485981308411214,26750,25450,-1300,1249717,990.0,DB하이텍보통주
1000,990,2020-04-22,0.0493827160493827,24300,25500,1200,1474327,990.0,DB하이텍보통주
1001,990,2020-04-16,0.0415754923413566,22850,23800,950,1107354,990.0,DB하이텍보통주
1002,990,2020-04-13,0.0632911392405063,23700,22200,-1500,1079063,990.0,DB하이텍보통주
1003,990,2020-04-07,0.0586907449209932,22150,23450,1300,2210126,990.0,DB하이텍보통주
1004,990,2020-04-06,0.0598086124401913,20900,22150,1250,1222679,990.0,DB하이텍보통주
1005,990,2020-03-24,0.1605633802816901,17750,20600,2850,2189418,990.0,DB하이텍보통주
1006,990,2020-03-20,0.1533333333333333,15000,17300,2300,2049125,990.0,DB하이텍보통주
1007,990,2020-03-19,0.093655589123867,16550,15000,-1550,2057984,990.0,DB하이텍보통주
1008,990,2020-03-18,0.1196808510638298,18800,16550,-2250,1431346,990.0,DB하이텍보통주
1009,990,2020-03-16,0.0954653937947494,20950,18950,-2000,1395047,990.0,DB하이텍보통주
1010,990,2020-03-13,0.0541760722347629,22150,20950,-1200,1802753,990.0,DB하이텍보통주
1011,990,2020-03-11,0.0708502024291498,24700,22950,-1750,969978,990.0,DB하이텍보통주
1012,990,2020-03-09,0.0573122529644268,25300,23850,-1450,686153,990.0,DB하이텍보통주
1013,990,2020-03-02,0.0777310924369747,23800,25650,1850,1068640,990.0,DB하이텍보통주
1014,990,2020-02-28,0.0739299610894941,25700,23800,-1900,1465275,990.0,DB하이텍보통주
1015,990,2020-02-27,0.0586080586080586,27300,25700,-1600,934839,990.0,DB하이텍보통주
1016,990,2020-02-13,0.0400696864111498,28700,29850,1150,1597930,990.0,DB하이텍보통주
1017,990,2020-02-03,0.053016453382084,27350,28800,1450,948732,990.0,DB하이텍보통주
1018,990,2020-01-31,0.0519930675909878,28850,27350,-1500,1042212,990.0,DB하이텍보통주
1019,990,2020-01-22,0.0756013745704467,29100,31300,2200,2208977,990.0,DB하이텍보통주
1020,990,2020-01-15,0.044776119402985,30150,28800,-1350,801305,990.0,DB하이텍보통주
1021,990,2020-01-14,0.046875,28800,30150,1350,1095972,990.0,DB하이텍보통주
1022,990,2019-12-27,0.0562851782363977,26650,28150,1500,1105626,990.0,DB하이텍보통주
1023,990,2019-12-17,0.1072961373390558,23300,25800,2500,3165986,990.0,DB하이텍보통주
1024,990,2019-12-16,0.0448430493273542,22300,23300,1000,1172081,990.0,DB하이텍보통주
1025,990,2019-12-06,0.0485933503836317,19550,20500,950,997612,990.0,DB하이텍보통주
1026,990,2019-11-22,0.04,17500,18200,700,413806,990.0,DB하이텍보통주
1027,990,2019-11-15,0.0511363636363636,17600,18500,900,1193531,990.0,DB하이텍보통주
1028,990,2019-11-08,0.0441176470588235,17000,17750,750,553566,990.0,DB하이텍보통주
1029,990,2019-10-11,0.0590062111801242,16100,17050,950,1070930,990.0,DB하이텍보통주
1030,990,2019-09-17,0.0426229508196721,15250,15900,650,930217,990.0,DB하이텍보통주
1031,990,2019-08-09,0.0719696969696969,13200,14150,950,1326060,990.0,DB하이텍보통주
1032,990,2019-08-05,0.0566037735849056,13250,12500,-750,633966,990.0,DB하이텍보통주
1033,990,2019-07-29,0.0401459854014598,13700,13150,-550,447346,990.0,DB하이텍보통주
1034,990,2019-07-15,0.0402930402930402,13650,14200,550,1695873,990.0,DB하이텍보통주
1035,990,2019-07-08,0.130718954248366,15300,13300,-2000,1962498,990.0,DB하이텍보통주
1036,990,2019-07-02,0.0671140939597315,14900,15900,1000,1647526,990.0,DB하이텍보통주
1037,990,2019-06-18,0.0526315789473684,16150,15300,-850,1564559,990.0,DB하이텍보통주
1038,990,2019-06-17,0.0453074433656957,15450,16150,700,1407383,990.0,DB하이텍보통주
1039,990,2019-06-12,0.0472972972972973,14800,15500,700,1312870,990.0,DB하이텍보통주
1040,990,2019-05-21,0.0510204081632653,14700,15450,750,879616,990.0,DB하이텍보통주
1041,990,2019-05-17,0.0427046263345195,14050,14650,600,2103088,990.0,DB하이텍보통주
1042,990,2019-05-09,0.0754098360655737,15250,14100,-1150,1156451,990.0,DB하이텍보통주
1043,990,2019-05-07,0.0401234567901234,16200,15550,-650,643953,990.0,DB하이텍보통주
1044,990,2019-04-30,0.0457516339869281,15300,16000,700,948780,990.0,DB하이텍보통주
1045,990,2019-04-19,0.092250922509225,13550,14800,1250,2393462,990.0,DB하이텍보통주
1046,990,2019-04-18,0.0424028268551236,14150,13550,-600,427069,990.0,DB하이텍보통주
1047,990,2019-04-17,0.0520446096654275,13450,14150,700,590731,990.0,DB하이텍보통주
1048,990,2019-04-03,0.0813953488372093,12900,13950,1050,1094513,990.0,DB하이텍보통주
1049,990,2019-04-01,0.04,12500,13000,500,469412,990.0,DB하이텍보통주
1050,990,2019-03-12,0.0600858369098712,11650,12350,700,298882,990.0,DB하이텍보통주
1051,990,2019-02-15,0.044776119402985,13400,12800,-600,417805,990.0,DB하이텍보통주
1052,990,2019-02-14,0.0592885375494071,12650,13400,750,1193800,990.0,DB하이텍보통주
1053,990,2019-01-31,0.0514705882352941,13600,12900,-700,840384,990.0,DB하이텍보통주
1054,990,2019-01-30,0.0793650793650793,12600,13600,1000,1363435,990.0,DB하이텍보통주
1055,990,2019-01-29,0.05,12000,12600,600,695071,990.0,DB하이텍보통주
1056,990,2019-01-25,0.1050228310502283,10950,12100,1150,888300,990.0,DB하이텍보통주
1057,990,2019-01-21,0.0845070422535211,10650,11550,900,514170,990.0,DB하이텍보통주
1058,990,2018-12-14,0.0432900432900432,11550,11050,-500,205340,990.0,DB하이텍보통주
1059,990,2018-12-06,0.043103448275862,11600,11100,-500,284946,990.0,DB하이텍보통주
1060,990,2018-12-03,0.0425531914893617,11750,12250,500,244661,990.0,DB하이텍보통주
1061,990,2018-11-02,0.087719298245614,11400,12400,1000,692479,990.0,DB하이텍보통주
1062,990,2018-10-30,0.0676328502415458,10350,11050,700,753733,990.0,DB하이텍보통주
1063,990,2018-10-29,0.08,11250,10350,-900,574121,990.0,DB하이텍보통주
1064,990,2018-10-25,0.0699588477366255,12150,11300,-850,907332,990.0,DB하이텍보통주
1065,990,2018-10-23,0.0622568093385214,12850,12050,-800,657153,990.0,DB하이텍보통주
1066,990,2018-10-22,0.0620437956204379,13700,12850,-850,529913,990.0,DB하이텍보통주
1067,990,2018-10-12,0.0494296577946768,13150,13800,650,306748,990.0,DB하이텍보통주
1068,990,2018-10-11,0.0539568345323741,13900,13150,-750,528154,990.0,DB하이텍보통주
1069,990,2018-08-21,0.0462962962962962,16200,16950,750,432716,990.0,DB하이텍보통주
1070,990,2018-08-14,0.0418006430868167,15550,16200,650,678975,990.0,DB하이텍보통주
1071,990,2018-08-09,0.0530973451327433,16950,16050,-900,564644,990.0,DB하이텍보통주
1072,990,2018-08-08,0.0527950310559006,16100,16950,850,732463,990.0,DB하이텍보통주
1073,990,2018-07-30,0.0455840455840455,17550,16750,-800,427182,990.0,DB하이텍보통주
1074,990,2018-07-27,0.0636363636363636,16500,17550,1050,531542,990.0,DB하이텍보통주
1075,990,2018-07-26,0.0489913544668587,17350,16500,-850,781913,990.0,DB하이텍보통주
1076,990,2018-07-23,0.0631868131868131,18200,17050,-1150,624655,990.0,DB하이텍보통주
1077,990,2018-06-28,0.0515970515970515,20350,19300,-1050,730835,990.0,DB하이텍보통주
1078,990,2018-06-25,0.0507246376811594,20700,19650,-1050,1086546,990.0,DB하이텍보통주
1079,990,2018-06-22,0.0725388601036269,19300,20700,1400,926976,990.0,DB하이텍보통주
1080,990,2018-06-05,0.0816326530612244,17150,18550,1400,2225637,990.0,DB하이텍보통주
1081,990,2018-05-30,0.050314465408805,15900,16700,800,1279355,990.0,DB하이텍보통주
1082,990,2018-04-23,0.0620689655172413,14500,13600,-900,738609,990.0,DB하이텍보통주
1083,990,2018-04-12,0.062730627306273,13550,14400,850,560782,990.0,DB하이텍보통주
1084,990,2018-04-05,0.0446096654275092,13450,14050,600,558470,990.0,DB하이텍보통주
1085,990,2018-04-04,0.0460992907801418,14100,13450,-650,498210,990.0,DB하이텍보통주
1086,990,2018-04-02,0.0406779661016949,14750,14150,-600,1074305,990.0,DB하이텍보통주
1087,990,2018-03-23,0.0701219512195122,16400,15250,-1150,683507,990.0,DB하이텍보통주
1088,990,2018-03-16,0.0809061488673139,15450,16700,1250,1330921,990.0,DB하이텍보통주
1089,990,2018-02-01,0.0574324324324324,14800,15650,850,1857832,990.0,DB하이텍보통주
1090,990,2018-01-31,0.088235294117647,13600,14800,1200,2730565,990.0,DB하이텍보통주
1091,990,2018-01-23,0.0583657587548638,12850,13600,750,1003121,990.0,DB하이텍보통주
1092,990,2018-01-18,0.1324786324786324,11700,13250,1550,1799188,990.0,DB하이텍보통주
1093,990,2017-12-21,0.0543933054393305,11950,11300,-650,563731,990.0,DB하이텍보통주
1094,990,2017-11-24,0.0636704119850187,13350,14200,850,1208696,990.0,DB하이텍보통주
1095,990,2017-11-21,0.0611510791366906,13900,13050,-850,1644134,990.0,DB하이텍보통주
1096,990,2017-10-20,0.0449826989619377,14450,15100,650,902653,990.0,DB하이텍보통주
1097,990,2017-10-17,0.0719424460431654,13900,14900,1000,947880,990.0,DB하이텍보통주
1098,990,2017-09-11,0.0526315789473684,14250,15000,750,1118955,990.0,DB하이텍보통주
1099,990,2017-09-07,0.0949367088607595,15800,14300,-1500,2184753,990.0,DB하이텍보통주
1100,990,2017-08-17,0.0644171779141104,16300,17350,1050,1071862,990.0,DB하이텍보통주
1101,990,2017-08-03,0.0523560209424083,19100,18100,-1000,754563,990.0,DB하이텍보통주
1102,990,2017-07-26,0.0628019323671497,20700,19400,-1300,1364097,990.0,DB하이텍보통주
1103,990,2017-06-19,0.0606060606060606,21450,22750,1300,1680968,990.0,DB하이텍보통주
1104,990,2017-06-09,0.1019417475728155,20600,22700,2100,2786053,990.0,DB하이텍보통주
1105,990,2017-05-22,0.0445544554455445,20200,21100,900,855244,990.0,DB하이텍보통주
1106,990,2017-04-25,0.0405727923627685,20950,21800,850,670268,990.0,DB하이텍보통주
1107,990,2017-04-07,0.0507614213197969,19700,20700,1000,7750420,990.0,DB하이텍보통주
1108,990,2017-04-03,0.0654450261780104,19100,20350,1250,1202298,990.0,DB하이텍보통주
1109,990,2017-02-15,0.0414364640883977,18100,18850,750,969711,990.0,DB하이텍보통주
1110,990,2017-02-14,0.0584795321637426,17100,18100,1000,923137,990.0,DB하이텍보통주
1111,990,2017-02-09,0.054054054054054,16650,17550,900,530383,990.0,DB하이텍보통주
1112,990,2017-01-03,0.058282208588957,16300,17250,950,945384,990.0,DB하이텍보통주
1113,990,2016-12-13,0.0477707006369426,15700,16450,750,263343,990.0,DB하이텍보통주
1114,990,2016-11-16,0.0481927710843373,16600,17400,800,426849,990.0,DB하이텍보통주
1115,990,2016-11-07,0.0564263322884012,15950,16850,900,281813,990.0,DB하이텍보통주
1116,990,2016-11-01,0.0410557184750733,17050,16350,-700,494228,990.0,DB하이텍보통주
1117,990,2016-10-18,0.0508474576271186,17700,18600,900,584672,990.0,DB하이텍보통주
1118,990,2016-09-29,0.0588235294117647,17000,18000,1000,684701,990.0,DB하이텍보통주
1119,990,2016-08-29,0.0504201680672268,17850,16950,-900,682161,990.0,DB하이텍보통주
1120,990,2016-08-16,0.0495049504950495,20200,19200,-1000,876910,990.0,DB하이텍보통주
1121,990,2016-08-08,0.0549738219895288,19100,20150,1050,1558441,990.0,DB하이텍보통주
1122,990,2016-08-04,0.0443213296398892,18050,18850,800,781678,990.0,DB하이텍보통주
1123,1040,2021-05-31,0.045662100456621,109500,114500,5000,194144,1040.0,CJ보통주
1124,1040,2021-05-25,0.0462962962962962,108000,113000,5000,239875,1040.0,CJ보통주
1125,1040,2021-05-21,0.0412844036697247,109000,104500,-4500,168019,1040.0,CJ보통주
1126,1040,2021-05-10,0.0621242484969939,99800,106000,6200,363095,1040.0,CJ보통주
1127,1040,2021-01-28,0.060576923076923,104000,97700,-6300,434010,1040.0,CJ보통주
1128,1040,2021-01-18,0.0686695278969957,116500,108500,-8000,441842,1040.0,CJ보통주
1129,1040,2021-01-14,0.1111111111111111,103500,115000,11500,534049,1040.0,CJ보통주
1130,1040,2021-01-13,0.0528992878942014,98300,103500,5200,279740,1040.0,CJ보통주
1131,1040,2021-01-08,0.0800842992623814,94900,102500,7600,495583,1040.0,CJ보통주
1132,1040,2020-12-23,0.048602673147023,82300,86300,4000,290573,1040.0,CJ보통주
1133,1040,2020-09-16,0.0424242424242424,82500,86000,3500,299253,1040.0,CJ보통주
1134,1040,2020-08-25,0.041871921182266,81200,84600,3400,83910,1040.0,CJ보통주
1135,1040,2020-08-20,0.0476190476190476,86100,82000,-4100,129346,1040.0,CJ보통주
1136,1040,2020-08-12,0.0910179640718562,83500,91100,7600,592982,1040.0,CJ보통주
1137,1040,2020-07-02,0.0449826989619377,86700,90600,3900,91426,1040.0,CJ보통주
1138,1040,2020-06-16,0.0602125147579693,84700,89800,5100,88510,1040.0,CJ보통주
1139,1040,2020-05-29,0.0551090700344431,87100,91900,4800,142308,1040.0,CJ보통주
1140,1040,2020-05-06,0.059796437659033,78600,83300,4700,147753,1040.0,CJ보통주
1141,1040,2020-04-27,0.1478382147838214,71700,82300,10600,420439,1040.0,CJ보통주
1142,1040,2020-04-06,0.0867507886435331,63400,68900,5500,163240,1040.0,CJ보통주
1143,1040,2020-03-25,0.0834724540901502,59900,64900,5000,146179,1040.0,CJ보통주
1144,1040,2020-03-24,0.128060263653484,53100,59900,6800,129160,1040.0,CJ보통주
1145,1040,2020-03-23,0.0813148788927335,57800,53100,-4700,96525,1040.0,CJ보통주
1146,1040,2020-03-20,0.0452079566003616,55300,57800,2500,162081,1040.0,CJ보통주
1147,1040,2020-03-19,0.0934426229508196,61000,55300,-5700,152970,1040.0,CJ보통주
1148,1040,2020-03-18,0.0571870170015456,64700,61000,-3700,85941,1040.0,CJ보통주
1149,1040,2020-03-13,0.0741279069767441,68800,63700,-5100,242952,1040.0,CJ보통주
1150,1040,2020-03-12,0.0536451169188445,72700,68800,-3900,263629,1040.0,CJ보통주
1151,1040,2020-03-11,0.0484293193717277,76400,72700,-3700,185801,1040.0,CJ보통주
1152,1040,2020-02-28,0.0428061831153388,84100,80500,-3600,136567,1040.0,CJ보통주
1153,1040,2020-02-24,0.0402234636871508,89500,85900,-3600,72925,1040.0,CJ보통주
1154,1040,2020-02-13,0.0804077010192525,88300,95400,7100,510502,1040.0,CJ보통주
1155,1040,2020-02-12,0.0400471142520612,84900,88300,3400,125344,1040.0,CJ보통주
1156,1040,2020-01-28,0.0422222222222222,90000,86200,-3800,87432,1040.0,CJ보통주
1157,1040,2019-12-10,0.0561674008810572,90800,95900,5100,125099,1040.0,CJ보통주
1158,1040,2019-11-12,0.0456570155902004,89800,93900,4100,158831,1040.0,CJ보통주
1159,1040,2019-11-04,0.0494117647058823,85000,89200,4200,149034,1040.0,CJ보통주
1160,1040,2019-10-04,0.0465686274509803,81600,77800,-3800,106847,1040.0,CJ보통주
1161,1040,2019-08-09,0.0661252900232018,86200,80500,-5700,317900,1040.0,CJ보통주
1162,1040,2019-01-02,0.0452674897119341,121500,116000,-5500,52125,1040.0,CJ보통주
1163,1040,2018-12-21,0.054054054054054,129500,136500,7000,251975,1040.0,CJ보통주
1164,1040,2018-11-15,0.0460251046025104,119500,125000,5500,74419,1040.0,CJ보통주
1165,1040,2018-11-09,0.0769230769230769,110500,119000,8500,238656,1040.0,CJ보통주
1166,1040,2018-10-11,0.0674603174603174,126000,117500,-8500,242323,1040.0,CJ보통주
1167,1040,2018-10-10,0.0454545454545454,132000,126000,-6000,129185,1040.0,CJ보통주
1168,1040,2018-07-06,0.0512820512820512,136500,143500,7000,162942,1040.0,CJ보통주
1169,1040,2018-06-29,0.0402930402930402,136500,142000,5500,125654,1040.0,CJ보통주
1170,1040,2018-06-26,0.0454545454545454,143000,136500,-6500,194468,1040.0,CJ보통주
1171,1040,2018-06-07,0.0408163265306122,147000,153000,6000,141123,1040.0,CJ보통주
1172,1040,2018-05-30,0.0519480519480519,154000,146000,-8000,204346,1040.0,CJ보통주
1173,1040,2017-11-22,0.0411622276029055,206500,198000,-8500,100131,1040.0,CJ보통주
1174,1040,2017-11-20,0.0456852791878172,197000,206000,9000,169986,1040.0,CJ보통주
1175,1040,2017-11-03,0.04,187500,195000,7500,146245,1040.0,CJ보통주
1176,1040,2017-10-26,0.0588235294117647,178500,189000,10500,262386,1040.0,CJ보통주
1177,1040,2017-06-12,0.0402843601895734,211000,202500,-8500,106609,1040.0,CJ보통주
1178,1040,2017-05-08,0.0767195767195767,189000,203500,14500,256846,1040.0,CJ보통주
1179,1040,2017-04-18,0.0454545454545454,176000,184000,8000,298834,1040.0,CJ보통주
1180,1040,2017-03-24,0.0425531914893617,164500,171500,7000,152935,1040.0,CJ보통주
1181,1040,2016-12-06,0.0405797101449275,172500,179500,7000,83400,1040.0,CJ보통주
1182,1040,2016-11-29,0.0705521472392638,163000,174500,11500,132320,1040.0,CJ보통주
1183,1040,2016-11-16,0.0650887573964497,169000,180000,11000,153663,1040.0,CJ보통주
1184,1040,2016-11-02,0.043859649122807,171000,163500,-7500,229697,1040.0,CJ보통주
1185,1040,2016-09-22,0.0497237569060773,181000,190000,9000,134045,1040.0,CJ보통주
1186,1040,2016-08-08,0.0490463215258855,183500,192500,9000,128221,1040.0,CJ보통주
1187,1040,2016-08-05,0.0541237113402061,194000,183500,-10500,241409,1040.0,CJ보통주
1188,1230,2021-05-26,0.0654008438818565,23700,22150,-1550,3732584,1230.0,동국제강보통주
1189,1230,2021-05-20,0.0495049504950495,25250,24000,-1250,3089788,1230.0,동국제강보통주
1190,1230,2021-05-18,0.079059829059829,23400,25250,1850,5334664,1230.0,동국제강보통주
1191,1230,2021-05-13,0.0998116760828625,26550,23900,-2650,5165520,1230.0,동국제강보통주
1192,1230,2021-05-11,0.0486381322957198,25700,26950,1250,6737916,1230.0,동국제강보통주
1193,1230,2021-05-10,0.0532786885245901,24400,25700,1300,4248285,1230.0,동국제강보통주
1194,1230,2021-05-07,0.0427350427350427,23400,24400,1000,4199878,1230.0,동국제강보통주
1195,1230,2021-05-06,0.0516853932584269,22250,23400,1150,4210310,1230.0,동국제강보통주
1196,1230,2021-05-03,0.0876826722338204,23950,21850,-2100,5969767,1230.0,동국제강보통주
1197,1230,2021-04-30,0.0788461538461538,26000,23950,-2050,5051958,1230.0,동국제강보통주
1198,1230,2021-04-27,0.0697674418604651,23650,25300,1650,12328098,1230.0,동국제강보통주
1199,1230,2021-04-23,0.1439024390243902,20500,23450,2950,9352887,1230.0,동국제강보통주
1200,1230,2021-04-21,0.0490956072351421,19350,20300,950,4728714,1230.0,동국제강보통주
1201,1230,2021-04-15,0.0447368421052631,19000,19850,850,3345967,1230.0,동국제강보통주
1202,1230,2021-04-13,0.0439560439560439,18200,19000,800,6107032,1230.0,동국제강보통주
1203,1230,2021-04-12,0.0459770114942528,17400,18200,800,2889727,1230.0,동국제강보통주
1204,1230,2021-04-08,0.073015873015873,15750,16900,1150,6062153,1230.0,동국제강보통주
1205,1230,2021-04-07,0.0606060606060606,14850,15750,900,2763922,1230.0,동국제강보통주
1206,1230,2021-04-05,0.1212121212121212,13200,14800,1600,4618450,1230.0,동국제강보통주
1207,1230,2021-03-29,0.110655737704918,12200,13550,1350,5342467,1230.0,동국제강보통주
1208,1230,2021-03-26,0.079646017699115,11300,12200,900,2348872,1230.0,동국제강보통주
1209,1230,2021-03-22,0.0547945205479452,10950,11550,600,1698225,1230.0,동국제강보통주
1210,1230,2021-03-11,0.0472689075630252,9520,9970,450,2165838,1230.0,동국제강보통주
1211,1230,2021-03-05,0.0446808510638297,9400,9820,420,2663764,1230.0,동국제강보통주
1212,1230,2021-03-03,0.0510204081632653,8820,9270,450,7169711,1230.0,동국제강보통주
1213,1230,2021-02-25,0.0872093023255814,8600,9350,750,4568939,1230.0,동국제강보통주
1214,1230,2021-02-22,0.0508274231678487,8460,8890,430,2286717,1230.0,동국제강보통주
1215,1230,2021-02-02,0.0423076923076923,7800,8130,330,713475,1230.0,동국제강보통주
1216,1230,2021-01-28,0.0438489646772229,8210,7850,-360,991426,1230.0,동국제강보통주
1217,1230,2021-01-27,0.048667439165701,8630,8210,-420,1383532,1230.0,동국제강보통주
1218,1230,2021-01-19,0.0426540284360189,8440,8800,360,1084100,1230.0,동국제강보통주
1219,1230,2021-01-18,0.0463276836158192,8850,8440,-410,1141895,1230.0,동국제강보통주
1220,1230,2021-01-05,0.0518433179723502,8680,9130,450,5632321,1230.0,동국제강보통주
1221,1230,2021-01-04,0.0689655172413793,8120,8680,560,2833807,1230.0,동국제강보통주
1222,1230,2020-12-22,0.0488997555012225,8180,7780,-400,856420,1230.0,동국제강보통주
1223,1230,2020-12-09,0.0795610425240054,7290,7870,580,2113992,1230.0,동국제강보통주
1224,1230,2020-11-23,0.1398305084745762,7080,8070,990,7383075,1230.0,동국제강보통주
1225,1230,2020-11-16,0.0626865671641791,6700,7120,420,1471346,1230.0,동국제강보통주
1226,1230,2020-11-09,0.046801872074883,6410,6710,300,779588,1230.0,동국제강보통주
1227,1230,2020-10-08,0.0610465116279069,6880,7300,420,4232707,1230.0,동국제강보통주
1228,1230,2020-10-05,0.0946372239747634,6340,6940,600,4388050,1230.0,동국제강보통주
1229,1230,2020-09-25,0.0444078947368421,6080,6350,270,883346,1230.0,동국제강보통주
1230,1230,2020-08-25,0.0570522979397781,6310,6670,360,1657026,1230.0,동국제강보통주
1231,1230,2020-08-20,0.0458135860979462,6330,6040,-290,795960,1230.0,동국제강보통주
1232,1230,2020-08-18,0.055813953488372,6450,6090,-360,1308643,1230.0,동국제강보통주
1233,1230,2020-08-06,0.0492610837438423,6090,6390,300,2140866,1230.0,동국제강보통주
1234,1230,2020-07-20,0.0430292598967297,5810,6060,250,1183631,1230.0,동국제강보통주
1235,1230,2020-07-15,0.0409252669039145,5620,5850,230,2377650,1230.0,동국제강보통주
1236,1230,2020-06-25,0.0724137931034482,5800,5380,-420,1459718,1230.0,동국제강보통주
1237,1230,2020-06-16,0.0616438356164383,5840,6200,360,2883158,1230.0,동국제강보통주
1238,1230,2020-06-15,0.1621233859397417,6970,5840,-1130,4757037,1230.0,동국제강보통주
1239,1230,2020-06-12,0.078042328042328,7560,6970,-590,3963664,1230.0,동국제강보통주
1240,1230,2020-06-10,0.0447552447552447,7150,7470,320,1882392,1230.0,동국제강보통주
1241,1230,2020-06-05,0.1532258064516129,6200,7150,950,31027572,1230.0,동국제강보통주
1242,1230,2020-06-04,0.0839160839160839,5720,6200,480,13906088,1230.0,동국제강보통주
1243,1230,2020-06-03,0.3,4400,5720,1320,11488684,1230.0,동국제강보통주
1244,1230,2020-05-26,0.0643564356435643,4040,4300,260,3332773,1230.0,동국제강보통주
1245,1230,2020-05-04,0.0541813898704358,4245,4015,-230,561465,1230.0,동국제강보통주
1246,1230,2020-04-29,0.0468557336621455,4055,4245,190,525036,1230.0,동국제강보통주
1247,1230,2020-04-10,0.045219638242894,3870,4045,175,735460,1230.0,동국제강보통주
1248,1230,2020-04-06,0.0523338048090523,3535,3720,185,526818,1230.0,동국제강보통주
1249,1230,2020-03-25,0.0690184049079754,3260,3485,225,643323,1230.0,동국제강보통주
1250,1230,2020-03-24,0.0759075907590759,3030,3260,230,475718,1230.0,동국제강보통주
1251,1230,2020-03-23,0.1342857142857142,3500,3030,-470,790815,1230.0,동국제강보통주
1252,1230,2020-03-20,0.2589928057553957,2780,3500,720,744596,1230.0,동국제강보통주
1253,1230,2020-03-19,0.1446153846153846,3250,2780,-470,1444120,1230.0,동국제강보통주
1254,1230,2020-03-18,0.062049062049062,3465,3250,-215,1041366,1230.0,동국제강보통주
1255,1230,2020-03-17,0.042817679558011,3620,3465,-155,1151515,1230.0,동국제강보통주
1256,1230,2020-03-12,0.0419235511713933,4055,3885,-170,966189,1230.0,동국제강보통주
1257,1230,2020-03-09,0.0818385650224215,4460,4095,-365,822190,1230.0,동국제강보통주
1258,1230,2020-03-06,0.048025613660619,4685,4460,-225,691106,1230.0,동국제강보통주
1259,1230,2020-02-24,0.0401647785787847,4855,4660,-195,462426,1230.0,동국제강보통주
1260,1230,2020-02-20,0.056083650190114,5260,4965,-295,577848,1230.0,동국제강보통주
1261,1230,2020-02-06,0.0702811244979919,4980,5330,350,459856,1230.0,동국제강보통주
1262,1230,2020-01-28,0.0805860805860805,5460,5020,-440,719470,1230.0,동국제강보통주
1263,1230,2020-01-08,0.0456942003514938,5690,5430,-260,524098,1230.0,동국제강보통주
1264,1230,2019-11-26,0.06890756302521,5950,6360,410,517918,1230.0,동국제강보통주
1265,1230,2019-09-10,0.0418679549114331,6210,6470,260,306882,1230.0,동국제강보통주
1266,1230,2019-08-30,0.0520833333333333,5760,6060,300,302490,1230.0,동국제강보통주
1267,1230,2019-08-26,0.0472312703583061,6140,5850,-290,504765,1230.0,동국제강보통주
1268,1230,2019-08-05,0.0701754385964912,6270,5830,-440,549553,1230.0,동국제강보통주
1269,1230,2019-07-05,0.0455212922173274,6810,7120,310,570552,1230.0,동국제강보통주
1270,1230,2019-05-13,0.0447330447330447,6930,6620,-310,506438,1230.0,동국제강보통주
1271,1230,2019-04-24,0.0447204968944099,8050,7690,-360,384175,1230.0,동국제강보통주
1272,1230,2019-03-15,0.0403422982885085,8180,8510,330,626286,1230.0,동국제강보통주
1273,1230,2019-02-28,0.043173862310385,8570,8200,-370,316637,1230.0,동국제강보통주
1274,1230,2019-02-20,0.0470446320868516,8290,8680,390,563447,1230.0,동국제강보통주
1275,1230,2019-02-18,0.0446096654275092,8070,8430,360,435430,1230.0,동국제강보통주
1276,1230,2019-02-08,0.0454016298020954,8590,8200,-390,274351,1230.0,동국제강보통주
1277,1230,2019-01-30,0.0653266331658291,7960,8480,520,704141,1230.0,동국제강보통주
1278,1230,2019-01-09,0.0529172320217096,7370,7760,390,779922,1230.0,동국제강보통주
1279,1230,2018-12-21,0.0508474576271186,7670,7280,-390,510903,1230.0,동국제강보통주
1280,1230,2018-12-13,0.0444743935309973,7420,7750,330,673146,1230.0,동국제강보통주
1281,1230,2018-12-03,0.0805369127516778,7450,8050,600,873031,1230.0,동국제강보통주
1282,1230,2018-11-07,0.0560398505603985,8030,7580,-450,557838,1230.0,동국제강보통주
1283,1230,2018-11-05,0.0408415841584158,8080,7750,-330,551836,1230.0,동국제강보통주
1284,1230,2018-11-02,0.0933694181326116,7390,8080,690,472987,1230.0,동국제강보통주
1285,1230,2018-11-01,0.0452616690240452,7070,7390,320,422071,1230.0,동국제강보통주
1286,1230,2018-10-11,0.0474406991260923,8010,7630,-380,542069,1230.0,동국제강보통주
1287,1230,2018-10-10,0.0407185628742515,8350,8010,-340,446043,1230.0,동국제강보통주
1288,1230,2018-10-04,0.0617420066152149,9070,8510,-560,862248,1230.0,동국제강보통주
1289,1230,2018-09-19,0.0442477876106194,9040,9440,400,982618,1230.0,동국제강보통주
1290,1230,2018-09-11,0.0786988457502623,9530,8780,-750,1321520,1230.0,동국제강보통주
1291,1230,2018-08-29,0.1505376344086021,8370,9630,1260,5566192,1230.0,동국제강보통주
1292,1230,2018-08-28,0.04625,8000,8370,370,383139,1230.0,동국제강보통주
1293,1230,2018-08-20,0.062261753494282,7870,8360,490,534057,1230.0,동국제강보통주
1294,1230,2018-08-06,0.0501285347043701,7780,8170,390,558926,1230.0,동국제강보통주
1295,1230,2018-07-23,0.0455192034139402,7030,7350,320,377536,1230.0,동국제강보통주
1296,1230,2018-07-06,0.042817679558011,7240,7550,310,415452,1230.0,동국제강보통주
1297,1230,2018-07-02,0.0616113744075829,8440,7920,-520,553045,1230.0,동국제강보통주
1298,1230,2018-06-19,0.0536082474226804,9700,9180,-520,567713,1230.0,동국제강보통주
1299,1230,2018-06-14,0.0449760765550239,10450,9980,-470,717861,1230.0,동국제강보통주
1300,1230,2018-05-30,0.0471698113207547,10600,10100,-500,719564,1230.0,동국제강보통주
1301,1230,2018-05-28,0.1151079136690647,9730,10850,1120,1525428,1230.0,동국제강보통주
1302,1230,2018-05-16,0.0547945205479452,10950,10350,-600,796976,1230.0,동국제강보통주
1303,1230,2018-05-14,0.0526315789473684,10450,11000,550,1240205,1230.0,동국제강보통주
1304,1230,2018-05-09,0.0426540284360189,10550,10100,-450,780420,1230.0,동국제강보통주
1305,1230,2018-04-30,0.1011011011011011,9990,11000,1010,1907960,1230.0,동국제강보통주
1306,1230,2018-04-19,0.0680628272251308,9550,10200,650,1163881,1230.0,동국제강보통주
1307,1230,2018-04-18,0.0403050108932461,9180,9550,370,761376,1230.0,동국제강보통주
1308,1230,2018-04-09,0.0604838709677419,9920,9320,-600,1284702,1230.0,동국제강보통주
1309,1230,2018-03-27,0.0544554455445544,10100,10650,550,733890,1230.0,동국제강보통주
1310,1230,2018-03-23,0.0407766990291262,10300,9880,-420,1394856,1230.0,동국제강보통주
1311,1230,2018-03-19,0.05,10000,10500,500,1831975,1230.0,동국제강보통주
1312,1230,2018-03-08,0.0510204081632653,9800,10300,500,474716,1230.0,동국제강보통주
1313,1230,2018-03-02,0.0511627906976744,10750,10200,-550,707983,1230.0,동국제강보통주
1314,1230,2018-02-05,0.0481927710843373,12450,11850,-600,558396,1230.0,동국제강보통주
1315,1230,2018-01-29,0.0456431535269709,12050,12600,550,1070750,1230.0,동국제강보통주
1316,1230,2018-01-11,0.0590551181102362,12700,11950,-750,994945,1230.0,동국제강보통주
1317,1230,2018-01-10,0.040983606557377,12200,12700,500,988801,1230.0,동국제강보통주
1318,1230,2018-01-03,0.0452488687782805,11050,11550,500,841602,1230.0,동국제강보통주
1319,1230,2017-12-18,0.0893617021276595,11750,10700,-1050,1218774,1230.0,동국제강보통주
1320,1230,2017-12-06,0.0411522633744856,12150,11650,-500,1014448,1230.0,동국제강보통주
1321,1230,2017-12-05,0.0565217391304347,11500,12150,650,1550806,1230.0,동국제강보통주
1322,1230,2017-12-04,0.0407239819004524,11050,11500,450,623223,1230.0,동국제강보통주
1323,1230,2017-10-27,0.0467289719626168,10700,11200,500,492969,1230.0,동국제강보통주
1324,1230,2017-10-26,0.0530973451327433,11300,10700,-600,623638,1230.0,동국제강보통주
1325,1230,2017-10-16,0.0506912442396313,10850,11400,550,1018292,1230.0,동국제강보통주
1326,1230,2017-10-13,0.0637254901960784,10200,10850,650,748181,1230.0,동국제강보통주
1327,1230,2017-10-10,0.0420560747663551,10700,10250,-450,682742,1230.0,동국제강보통주
1328,1230,2017-09-22,0.055045871559633,10900,10300,-600,1110695,1230.0,동국제강보통주
1329,1230,2017-09-20,0.0508474576271186,11800,11200,-600,571374,1230.0,동국제강보통주
1330,1230,2017-09-06,0.0404858299595141,12350,11850,-500,580842,1230.0,동국제강보통주
1331,1230,2017-08-17,0.0551181102362204,12700,13400,700,804358,1230.0,동국제강보통주
1332,1230,2017-08-14,0.0571428571428571,14000,13200,-800,1389493,1230.0,동국제강보통주
1333,1230,2017-08-07,0.0596491228070175,14250,15100,850,1103686,1230.0,동국제강보통주
1334,1230,2017-08-01,0.0418118466898954,14350,14950,600,576975,1230.0,동국제강보통주
1335,1230,2017-07-24,0.0472972972972973,14800,14100,-700,923275,1230.0,동국제강보통주
1336,1230,2017-07-04,0.0444444444444444,15750,15050,-700,1755700,1230.0,동국제강보통주
1337,1230,2017-07-03,0.0750853242320819,14650,15750,1100,2324849,1230.0,동국제강보통주
1338,1230,2017-06-28,0.097378277153558,13350,14650,1300,2887288,1230.0,동국제강보통주
1339,1230,2017-06-23,0.0401606425702811,12450,12950,500,684509,1230.0,동국제강보통주
1340,1230,2017-05-22,0.0739130434782608,11500,12350,850,1061628,1230.0,동국제강보통주
1341,1230,2017-04-03,0.0546875,12800,12100,-700,1010017,1230.0,동국제강보통주
1342,1230,2017-03-15,0.0436507936507936,12600,13150,550,1376140,1230.0,동국제강보통주
1343,1230,2017-03-08,0.0408163265306122,12250,12750,500,825199,1230.0,동국제강보통주
1344,1230,2017-03-03,0.0403225806451612,12400,11900,-500,717649,1230.0,동국제강보통주
1345,1230,2017-02-27,0.0495867768595041,12100,12700,600,726707,1230.0,동국제강보통주
1346,1230,2017-02-01,0.0450819672131147,12200,12750,550,472286,1230.0,동국제강보통주
1347,1230,2017-01-25,0.0625,12800,12000,-800,893476,1230.0,동국제강보통주
1348,1230,2017-01-11,0.1158798283261802,11650,13000,1350,1937374,1230.0,동국제강보통주
1349,1230,2017-01-02,0.0542986425339366,11050,11650,600,507800,1230.0,동국제강보통주
1350,1230,2016-12-29,0.0432900432900432,11550,11050,-500,508792,1230.0,동국제강보통주
1351,1230,2016-12-21,0.043103448275862,11600,12100,500,690104,1230.0,동국제강보통주
1352,1230,2016-12-06,0.1372745490981964,9980,11350,1370,2873993,1230.0,동국제강보통주
1353,1230,2016-11-22,0.0414507772020725,9650,10050,400,772561,1230.0,동국제강보통주
1354,1230,2016-11-14,0.0486486486486486,9250,9700,450,856672,1230.0,동국제강보통주
1355,1230,2016-11-10,0.0694610778443113,8350,8930,580,537673,1230.0,동국제강보통주
1356,1230,2016-11-07,0.0780669144981412,8070,8700,630,637291,1230.0,동국제강보통주
1357,1230,2016-10-18,0.0403530895334174,7930,8250,320,255482,1230.0,동국제강보통주
1358,1230,2016-09-12,0.0421753607103218,9010,8630,-380,286607,1230.0,동국제강보통주
1359,1230,2016-09-07,0.0593023255813953,8600,9110,510,683929,1230.0,동국제강보통주
1360,1230,2016-08-09,0.0418552036199095,8840,9210,370,404787,1230.0,동국제강보통주
1361,1440,2021-06-03,0.1837708830548926,2095,2480,385,282167672,1440.0,대한전선보통주
1362,1440,2021-05-31,0.2077151335311572,1685,2035,350,251213465,1440.0,대한전선보통주
1363,1440,2021-05-28,0.0977198697068403,1535,1685,150,88983037,1440.0,대한전선보통주
1364,1440,2021-05-26,0.0899280575539568,1390,1515,125,98444370,1440.0,대한전선보통주
1365,1440,2021-05-25,0.0570342205323193,1315,1390,75,42586566,1440.0,대한전선보통주
1366,1440,2021-05-21,0.06,1250,1325,75,54622246,1440.0,대한전선보통주
1367,1440,2021-05-10,0.0619834710743801,1210,1285,75,50543701,1440.0,대한전선보통주
1368,1440,2021-05-04,0.0480349344978165,1145,1200,55,44001464,1440.0,대한전선보통주
1369,1440,2021-04-08,0.0425531914893617,1175,1225,50,59108797,1440.0,대한전선보통주
1370,1440,2021-04-06,0.045045045045045,1110,1160,50,22534136,1440.0,대한전선보통주
1371,1440,2021-03-31,0.074074074074074,1080,1160,80,36036769,1440.0,대한전선보통주
1372,1440,2021-03-30,0.1111111111111111,1215,1080,-135,52509801,1440.0,대한전선보통주
1373,1440,2021-03-29,0.08,1125,1215,90,77611298,1440.0,대한전선보통주
1374,1440,2021-03-26,0.0465116279069767,1075,1125,50,33412749,1440.0,대한전선보통주
1375,1440,2021-03-25,0.0643564356435643,1010,1075,65,49845275,1440.0,대한전선보통주
1376,1440,2021-03-22,0.0507614213197969,985,1035,50,19436828,1440.0,대한전선보통주
1377,1440,2021-03-12,0.0483870967741935,930,975,45,16177055,1440.0,대한전선보통주
1378,1440,2021-02-23,0.2063492063492063,1260,1000,-260,244684482,1440.0,대한전선보통주
1379,1440,2021-02-10,0.040983606557377,1220,1270,50,16629449,1440.0,대한전선보통주
1380,1440,2021-02-01,0.090497737556561,1105,1205,100,20817539,1440.0,대한전선보통주
1381,1440,2021-01-29,0.0675105485232067,1185,1105,-80,17223509,1440.0,대한전선보통주
1382,1440,2021-01-28,0.052,1250,1185,-65,14842165,1440.0,대한전선보통주
1383,1440,2021-01-25,0.0899653979238754,1445,1315,-130,201057803,1440.0,대한전선보통주
1384,1440,2021-01-22,0.0433212996389891,1385,1445,60,20669239,1440.0,대한전선보통주
1385,1440,2020-12-29,0.0461538461538461,1300,1360,60,4836746,1440.0,대한전선보통주
1386,1440,2020-12-28,0.0476190476190476,1365,1300,-65,7684819,1440.0,대한전선보통주
1387,1440,2020-12-23,0.0689655172413793,1450,1350,-100,17111317,1440.0,대한전선보통주
1388,1440,2020-12-22,0.0491803278688524,1525,1450,-75,12436607,1440.0,대한전선보통주
1389,1440,2020-12-16,0.0957446808510638,1410,1545,135,107954207,1440.0,대한전선보통주
1390,1440,2020-12-10,0.0719696969696969,1320,1415,95,63607154,1440.0,대한전선보통주
1391,1440,2020-12-08,0.0408921933085501,1345,1290,-55,13318123,1440.0,대한전선보통주
1392,1440,2020-12-04,0.0704225352112676,1420,1320,-100,29729786,1440.0,대한전선보통주
1393,1440,2020-12-01,0.0551948051948051,1540,1455,-85,10968486,1440.0,대한전선보통주
1394,1440,2020-11-27,0.1787072243346007,1315,1550,235,27624526,1440.0,대한전선보통주
1395,1440,2020-11-26,0.0604838709677419,1240,1315,75,13753899,1440.0,대한전선보통주
1396,1440,2020-11-20,0.29979035639413,954,1240,286,281265461,1440.0,대한전선보통주
1397,1440,2020-11-19,0.0506607929515418,908,954,46,18035416,1440.0,대한전선보통주
1398,1440,2020-11-16,0.0546075085324232,879,927,48,11161146,1440.0,대한전선보통주
1399,1440,2020-11-09,0.0544378698224852,845,891,46,10212263,1440.0,대한전선보통주
1400,1440,2020-10-21,0.044047619047619,840,877,37,11109604,1440.0,대한전선보통주
1401,1440,2020-10-16,0.0642424242424242,825,878,53,117458548,1440.0,대한전선보통주
1402,1440,2020-10-12,0.0634328358208955,804,855,51,7699531,1440.0,대한전선보통주
1403,1440,2020-09-07,0.0988095238095238,840,923,83,116289586,1440.0,대한전선보통주
1404,1440,2020-09-04,0.1111111111111111,756,840,84,119908148,1440.0,대한전선보통주
1405,1440,2020-09-03,0.0677966101694915,708,756,48,9804143,1440.0,대한전선보통주
1406,1440,2020-08-20,0.0425531914893617,705,675,-30,4696407,1440.0,대한전선보통주
1407,1440,2020-08-18,0.046639231824417,729,695,-34,5180165,1440.0,대한전선보통주
1408,1440,2020-08-11,0.0496551724137931,725,761,36,8148570,1440.0,대한전선보통주
1409,1440,2020-07-31,0.1119733924611973,902,801,-101,69066380,1440.0,대한전선보통주
1410,1440,2020-07-28,0.0461065573770491,976,931,-45,10228360,1440.0,대한전선보통주
1411,1440,2020-07-27,0.0524271844660194,1030,976,-54,18708702,1440.0,대한전선보통주
1412,1440,2020-07-24,0.2424607961399276,829,1030,201,61410953,1440.0,대한전선보통주
1413,1440,2020-07-20,0.1930618401206636,663,791,128,33816020,1440.0,대한전선보통주
1414,1440,2020-06-16,0.0518518518518518,675,710,35,1425843,1440.0,대한전선보통주
1415,1440,2020-06-15,0.0853658536585365,738,675,-63,3297998,1440.0,대한전선보통주
1416,1440,2020-05-27,0.0446194225721784,762,796,34,8303403,1440.0,대한전선보통주
1417,1440,2020-05-20,0.0488126649076517,758,795,37,8460981,1440.0,대한전선보통주
1418,1440,2020-05-08,0.1492753623188406,690,793,103,29993983,1440.0,대한전선보통주
1419,1440,2020-05-06,0.0415384615384615,650,677,27,2552620,1440.0,대한전선보통주
1420,1440,2020-04-10,0.0443349753694581,609,636,27,4236171,1440.0,대한전선보통주
1421,1440,2020-04-08,0.0948905109489051,548,600,52,5017707,1440.0,대한전선보통주
1422,1440,2020-04-07,0.0661478599221789,514,548,34,2526612,1440.0,대한전선보통주
1423,1440,2020-03-31,0.0412371134020618,485,505,20,1683251,1440.0,대한전선보통주
1424,1440,2020-03-25,0.069047619047619,420,449,29,1340279,1440.0,대한전선보통주
1425,1440,2020-03-23,0.04,425,408,-17,887666,1440.0,대한전선보통주
1426,1440,2020-03-20,0.0493827160493827,405,425,20,1301188,1440.0,대한전선보통주
1427,1440,2020-03-19,0.1455696202531645,474,405,-69,2428699,1440.0,대한전선보통주
1428,1440,2020-03-17,0.0433925049309664,507,485,-22,1066810,1440.0,대한전선보통주
1429,1440,2020-03-13,0.0534069981583793,543,514,-29,1933946,1440.0,대한전선보통주
1430,1440,2020-02-24,0.0457627118644067,590,563,-27,1757953,1440.0,대한전선보통주
1431,1440,2019-10-30,0.0683760683760683,585,625,40,14592367,1440.0,대한전선보통주
1432,1440,2019-09-30,0.0472440944881889,635,605,-30,5146314,1440.0,대한전선보통주
1433,1440,2019-09-27,0.0967184801381692,579,635,56,31603613,1440.0,대한전선보통주
1434,1440,2019-08-26,0.0418760469011725,597,572,-25,707938,1440.0,대한전선보통주
1435,1440,2019-08-05,0.0732113144758735,601,557,-44,2011429,1440.0,대한전선보통주
1436,1440,2019-07-29,0.071097372488408,647,601,-46,1708185,1440.0,대한전선보통주
1437,1440,2019-05-24,0.0466439135381114,879,838,-41,2204185,1440.0,대한전선보통주
1438,1440,2019-05-16,0.0438502673796791,935,894,-41,2487844,1440.0,대한전선보통주
1439,1440,2019-04-22,0.0428571428571428,1050,1005,-45,4466612,1440.0,대한전선보통주
1440,1440,2019-04-18,0.1168831168831168,1155,1020,-135,55826590,1440.0,대한전선보통주
1441,1440,2019-02-28,0.0421940928270042,1185,1135,-50,719097,1440.0,대한전선보통주
1442,1440,2019-02-13,0.0436681222707423,1145,1195,50,2385665,1440.0,대한전선보통주
1443,1440,2019-02-01,0.0535714285714285,1120,1180,60,1546878,1440.0,대한전선보통주
1444,1440,2018-10-29,0.0448780487804878,1025,979,-46,1469118,1440.0,대한전선보통주
1445,1440,2018-10-10,0.0493827160493827,1215,1155,-60,851535,1440.0,대한전선보통주
1446,1440,2018-08-13,0.0413223140495867,1210,1160,-50,906173,1440.0,대한전선보통주
1447,1440,2018-07-24,0.0547945205479452,1095,1155,60,1584245,1440.0,대한전선보통주
1448,1440,2018-07-02,0.0463320463320463,1295,1235,-60,1205765,1440.0,대한전선보통주
1449,1440,2018-06-27,0.0408921933085501,1345,1290,-55,2064712,1440.0,대한전선보통주
1450,1440,2018-06-19,0.047945205479452,1460,1390,-70,2304516,1440.0,대한전선보통주
1451,1440,2018-06-14,0.065625,1600,1495,-105,3479892,1440.0,대한전선보통주
1452,1440,2018-06-11,0.0504731861198738,1585,1665,80,3152012,1440.0,대한전선보통주
1453,1440,2018-06-01,0.0426136363636363,1760,1685,-75,5133079,1440.0,대한전선보통주
1454,1440,2018-05-29,0.0737913486005089,1965,1820,-145,13094070,1440.0,대한전선보통주
1455,1440,2018-05-28,0.2129629629629629,1620,1965,345,28296471,1440.0,대한전선보통주
1456,1440,2018-05-25,0.0847457627118644,1770,1620,-150,10105910,1440.0,대한전선보통주
1457,1440,2018-05-21,0.0531914893617021,1880,1780,-100,10154814,1440.0,대한전선보통주
1458,1440,2018-05-17,0.0736543909348441,1765,1895,130,53394687,1440.0,대한전선보통주
1459,1440,2018-05-16,0.2326086956521739,2300,1765,-535,95048008,1440.0,대한전선보통주
1460,1440,2018-05-15,0.2994350282485876,1770,2300,530,41430593,1440.0,대한전선보통주
1461,1440,2018-05-08,0.0617283950617283,1620,1720,100,6175293,1440.0,대한전선보통주
1462,1440,2018-05-03,0.0410557184750733,1705,1635,-70,1884619,1440.0,대한전선보통주
1463,1440,2018-04-30,0.1233333333333333,1500,1685,185,8169752,1440.0,대한전선보통주
1464,1440,2018-04-19,0.0952380952380952,1365,1495,130,7322786,1440.0,대한전선보통주
1465,1440,2018-03-23,0.0431654676258992,1390,1330,-60,836736,1440.0,대한전선보통주
1466,1440,2018-02-20,0.0424710424710424,1295,1350,55,7104503,1440.0,대한전선보통주
1467,1440,2018-02-02,0.0446735395189003,1455,1390,-65,1249080,1440.0,대한전선보통주
1468,1440,2018-01-29,0.0510948905109489,1370,1440,70,3843904,1440.0,대한전선보통주
1469,1440,2018-01-17,0.1176470588235294,1190,1330,140,18801504,1440.0,대한전선보통주
1470,1440,2018-01-08,0.0775862068965517,1160,1250,90,2872952,1440.0,대한전선보통주
1471,1440,2017-09-06,0.0498084291187739,1305,1370,65,1666327,1440.0,대한전선보통주
1472,1440,2017-08-14,0.072,1250,1340,90,3207156,1440.0,대한전선보통주
1473,1440,2017-08-10,0.0613718411552346,1385,1300,-85,2468652,1440.0,대한전선보통주
1474,1440,2017-08-09,0.1169354838709677,1240,1385,145,12435091,1440.0,대한전선보통주
1475,1440,2017-05-18,0.1011560693641618,1730,1555,-175,8511466,1440.0,대한전선보통주
1476,1440,2017-01-19,0.0414507772020725,1930,2010,80,4320585,1440.0,대한전선보통주
1477,1440,2016-11-15,0.0425,2000,1915,-85,1252785,1440.0,대한전선보통주
1478,1440,2016-11-11,0.0704960835509138,1915,2050,135,2478679,1440.0,대한전선보통주
1479,1440,2016-11-10,0.0435967302452316,1835,1915,80,424231,1440.0,대한전선보통주
1480,1440,2016-11-09,0.0492227979274611,1930,1835,-95,1010500,1440.0,대한전선보통주
1481,1440,2016-11-03,0.040983606557377,1830,1905,75,1402516,1440.0,대한전선보통주
1482,1450,2021-05-17,0.0403225806451612,24800,23800,-1000,1151645,1450.0,현대해상화재보험보통주
1483,1450,2021-05-13,0.0439330543933054,23900,24950,1050,1732371,1450.0,현대해상화재보험보통주
1484,1450,2021-05-12,0.0571992110453648,25350,23900,-1450,2022900,1450.0,현대해상화재보험보통주
1485,1450,2021-05-06,0.0407725321888412,23300,24250,950,1005182,1450.0,현대해상화재보험보통주
1486,1450,2021-02-22,0.0435835351089588,20650,21550,900,1537160,1450.0,현대해상화재보험보통주
1487,1450,2020-11-03,0.0439330543933054,23900,24950,1050,269716,1450.0,현대해상화재보험보통주
1488,1450,2020-10-30,0.0528455284552845,24600,23300,-1300,366010,1450.0,현대해상화재보험보통주
1489,1450,2020-10-27,0.0515267175572519,26200,24850,-1350,410185,1450.0,현대해상화재보험보통주
1490,1450,2020-10-22,0.0690376569037656,23900,25550,1650,677119,1450.0,현대해상화재보험보통주
1491,1450,2020-08-20,0.0543933054393305,23900,22600,-1300,359573,1450.0,현대해상화재보험보통주
1492,1450,2020-08-12,0.0404255319148936,23500,24450,950,525863,1450.0,현대해상화재보험보통주
1493,1450,2020-08-11,0.0633484162895927,22100,23500,1400,500378,1450.0,현대해상화재보험보통주
1494,1450,2020-07-10,0.0433839479392624,23050,22050,-1000,414641,1450.0,현대해상화재보험보통주
1495,1450,2020-06-29,0.0421940928270042,23700,22700,-1000,224409,1450.0,현대해상화재보험보통주
1496,1450,2020-06-25,0.0455445544554455,25250,24100,-1150,150311,1450.0,현대해상화재보험보통주
1497,1450,2020-06-23,0.0412371134020618,24250,25250,1000,326585,1450.0,현대해상화재보험보통주
1498,1450,2020-06-15,0.0503018108651911,24850,23600,-1250,436356,1450.0,현대해상화재보험보통주
1499,1450,2020-06-11,0.0751341681574239,27950,25850,-2100,634307,1450.0,현대해상화재보험보통주
1500,1450,2020-06-09,0.0653846153846153,26000,27700,1700,649727,1450.0,현대해상화재보험보통주
1501,1450,2020-05-18,0.0449438202247191,26700,25500,-1200,487550,1450.0,현대해상화재보험보통주
1502,1450,2020-05-08,0.0417495029821073,25150,26200,1050,280146,1450.0,현대해상화재보험보통주
1503,1450,2020-05-04,0.0517241379310344,26100,24750,-1350,441855,1450.0,현대해상화재보험보통주
1504,1450,2020-04-23,0.0431211498973305,24350,25400,1050,591687,1450.0,현대해상화재보험보통주
1505,1450,2020-04-10,0.0457516339869281,22950,24000,1050,470861,1450.0,현대해상화재보험보통주
1506,1450,2020-04-02,0.0947867298578199,21100,23100,2000,401701,1450.0,현대해상화재보험보통주
1507,1450,2020-04-01,0.0684326710816777,22650,21100,-1550,288423,1450.0,현대해상화재보험보통주
1508,1450,2020-03-31,0.0658823529411764,21250,22650,1400,373747,1450.0,현대해상화재보험보통주
1509,1450,2020-03-27,0.055,20000,21100,1100,379625,1450.0,현대해상화재보험보통주
1510,1450,2020-03-25,0.0862533692722372,18550,20150,1600,524855,1450.0,현대해상화재보험보통주
1511,1450,2020-03-20,0.0423728813559322,17700,18450,750,616369,1450.0,현대해상화재보험보통주
1512,1450,2020-03-19,0.0483870967741935,18600,17700,-900,677705,1450.0,현대해상화재보험보통주
1513,1450,2020-03-16,0.0523415977961432,18150,19100,950,392252,1450.0,현대해상화재보험보통주
1514,1450,2020-03-09,0.0563725490196078,20400,19250,-1150,392502,1450.0,현대해상화재보험보통주
1515,1450,2020-03-02,0.0486725663716814,22600,21500,-1100,539063,1450.0,현대해상화재보험보통주
1516,1450,2020-02-27,0.0696055684454756,21550,23050,1500,559895,1450.0,현대해상화재보험보통주
1517,1450,2019-12-20,0.0463917525773195,29100,27750,-1350,491873,1450.0,현대해상화재보험보통주
1518,1450,2019-12-12,0.0527272727272727,27500,28950,1450,722053,1450.0,현대해상화재보험보통주
1519,1450,2019-11-07,0.0528301886792452,26500,27900,1400,422281,1450.0,현대해상화재보험보통주
1520,1450,2019-11-04,0.0415841584158415,25250,26300,1050,261461,1450.0,현대해상화재보험보통주
1521,1450,2019-10-11,0.0614754098360655,24400,25900,1500,578431,1450.0,현대해상화재보험보통주
1522,1450,2019-08-23,0.0431211498973305,24350,23300,-1050,595793,1450.0,현대해상화재보험보통주
1523,1450,2019-08-12,0.0512820512820512,25350,24050,-1300,266971,1450.0,현대해상화재보험보통주
1524,1450,2019-08-08,0.040983606557377,24400,25400,1000,387762,1450.0,현대해상화재보험보통주
1525,1450,2019-08-07,0.0450097847358121,25550,24400,-1150,516755,1450.0,현대해상화재보험보통주
1526,1450,2019-07-19,0.0433145009416195,26550,27700,1150,332374,1450.0,현대해상화재보험보통주
1527,1450,2019-05-13,0.0857538035961272,36150,33050,-3100,649262,1450.0,현대해상화재보험보통주
1528,1450,2018-11-01,0.0466507177033492,41800,39850,-1950,420757,1450.0,현대해상화재보험보통주
1529,1450,2018-10-31,0.052896725440806,39700,41800,2100,295605,1450.0,현대해상화재보험보통주
1530,1450,2018-10-30,0.0445246690734055,41550,39700,-1850,367650,1450.0,현대해상화재보험보통주
1531,1450,2018-10-15,0.0423076923076923,39000,40650,1650,429741,1450.0,현대해상화재보험보통주
1532,1450,2018-09-27,0.0792602377807133,37850,40850,3000,1044083,1450.0,현대해상화재보험보통주
1533,1450,2018-07-23,0.0558002936857562,34050,35950,1900,444472,1450.0,현대해상화재보험보통주
1534,1450,2018-07-04,0.0422740524781341,34300,35750,1450,332820,1450.0,현대해상화재보험보통주
1535,1450,2018-06-21,0.0481283422459893,37400,35600,-1800,334758,1450.0,현대해상화재보험보통주
1536,1450,2018-06-18,0.0589080459770114,34800,36850,2050,316118,1450.0,현대해상화재보험보통주
1537,1450,2018-05-30,0.0414285714285714,35000,33550,-1450,300242,1450.0,현대해상화재보험보통주
1538,1450,2018-05-23,0.0472972972972973,37000,35250,-1750,504737,1450.0,현대해상화재보험보통주
1539,1450,2018-03-23,0.0539215686274509,40800,38600,-2200,371211,1450.0,현대해상화재보험보통주
1540,1450,2018-03-22,0.0597402597402597,38500,40800,2300,422987,1450.0,현대해상화재보험보통주
1541,1450,2018-03-02,0.049636803874092,41300,39250,-2050,511830,1450.0,현대해상화재보험보통주
1542,1450,2017-12-13,0.0452488687782805,44200,46200,2000,243525,1450.0,현대해상화재보험보통주
1543,1450,2017-12-04,0.0471142520612485,42450,44450,2000,244641,1450.0,현대해상화재보험보통주
1544,1450,2017-10-10,0.0419426048565121,45300,47200,1900,364440,1450.0,현대해상화재보험보통주
1545,1450,2017-08-01,0.0837004405286343,45400,49200,3800,424308,1450.0,현대해상화재보험보통주
1546,1450,2017-07-21,0.0407239819004524,44200,46000,1800,203613,1450.0,현대해상화재보험보통주
1547,1450,2017-07-10,0.0430622009569378,41800,43600,1800,224266,1450.0,현대해상화재보험보통주
1548,1450,2017-02-16,0.0458015267175572,32750,31250,-1500,1111194,1450.0,현대해상화재보험보통주
1549,1450,2017-02-03,0.0496688741721854,30200,31700,1500,816498,1450.0,현대해상화재보험보통주
1550,1450,2017-01-19,0.0442748091603053,32750,31300,-1450,436013,1450.0,현대해상화재보험보통주
1551,1450,2017-01-18,0.0530546623794212,31100,32750,1650,579032,1450.0,현대해상화재보험보통주
1552,1450,2016-12-21,0.0816618911174785,34900,32050,-2850,968905,1450.0,현대해상화재보험보통주
1553,1450,2016-11-23,0.0501432664756446,34900,36650,1750,505146,1450.0,현대해상화재보험보통주
1554,1450,2016-11-08,0.0438247011952191,37650,36000,-1650,317215,1450.0,현대해상화재보험보통주
1555,1450,2016-11-07,0.044382801664355,36050,37650,1600,491240,1450.0,현대해상화재보험보통주
1556,1450,2016-10-10,0.0476190476190476,34650,36300,1650,179232,1450.0,현대해상화재보험보통주
1557,1450,2016-10-05,0.0442359249329758,37300,35650,-1650,495917,1450.0,현대해상화재보험보통주
1558,1450,2016-09-05,0.0446685878962536,34700,36250,1550,327303,1450.0,현대해상화재보험보통주
1559,1740,2021-03-12,0.0667938931297709,5240,5590,350,12133241,1740.0,SK네트웍스보통주
1560,1740,2021-02-09,0.0427807486631016,5610,5370,-240,1891664,1740.0,SK네트웍스보통주
1561,1740,2021-01-21,0.0773109243697479,5950,5490,-460,8680732,1740.0,SK네트웍스보통주
1562,1740,2021-01-20,0.1971830985915492,4970,5950,980,4454180,1740.0,SK네트웍스보통주
1563,1740,2020-08-20,0.0454545454545454,5280,5040,-240,893529,1740.0,SK네트웍스보통주
1564,1740,2020-08-18,0.0403669724770642,5450,5230,-220,896849,1740.0,SK네트웍스보통주
1565,1740,2020-08-06,0.069069069069069,4995,5340,345,1833826,1740.0,SK네트웍스보통주
1566,1740,2020-06-16,0.0683229813664596,4830,5160,330,720401,1740.0,SK네트웍스보통주
1567,1740,2020-06-15,0.0473372781065088,5070,4830,-240,1141273,1740.0,SK네트웍스보통주
1568,1740,2020-05-26,0.0450097847358121,5110,5340,230,1214244,1740.0,SK네트웍스보통주
1569,1740,2020-04-23,0.046816479400749,5340,5590,250,3769298,1740.0,SK네트웍스보통주
1570,1740,2020-04-22,0.04296875,5120,5340,220,2466892,1740.0,SK네트웍스보통주
1571,1740,2020-04-07,0.0499468650371944,4705,4940,235,1909468,1740.0,SK네트웍스보통주
1572,1740,2020-03-24,0.0562162162162162,4625,4885,260,2459028,1740.0,SK네트웍스보통주
1573,1740,2020-03-20,0.1569115815691158,4015,4645,630,3015413,1740.0,SK네트웍스보통주
1574,1740,2020-03-19,0.1262241566920565,4595,4015,-580,3164024,1740.0,SK네트웍스보통주
1575,1740,2020-03-13,0.0560081466395112,4910,4635,-275,4142245,1740.0,SK네트웍스보통주
1576,1740,2020-03-09,0.0512820512820512,5460,5180,-280,3295439,1740.0,SK네트웍스보통주
1577,1740,2020-03-05,0.1446540880503144,4770,5460,690,18345648,1740.0,SK네트웍스보통주
1578,1740,2020-03-04,0.0576496674057649,4510,4770,260,1857250,1740.0,SK네트웍스보통주
1579,1740,2020-02-24,0.0443722943722943,4620,4415,-205,1909260,1740.0,SK네트웍스보통주
1580,1740,2019-11-22,0.0442477876106194,5650,5900,250,1538299,1740.0,SK네트웍스보통주
1581,1740,2019-11-15,0.0442622950819672,6100,5830,-270,2317910,1740.0,SK네트웍스보통주
1582,1740,2019-10-25,0.0428305400372439,5370,5600,230,2747952,1740.0,SK네트웍스보통주
1583,1740,2019-10-22,0.0436507936507936,5040,5260,220,1862152,1740.0,SK네트웍스보통주
1584,1740,2019-09-24,0.0493601462522851,5470,5740,270,3841396,1740.0,SK네트웍스보통주
1585,1740,2019-08-19,0.0795918367346938,4900,5290,390,1390479,1740.0,SK네트웍스보통주
1586,1740,2019-08-01,0.0661322645290581,4990,5320,330,2212705,1740.0,SK네트웍스보통주
1587,1740,2019-07-05,0.0425531914893617,5170,5390,220,1474197,1740.0,SK네트웍스보통주
1588,1740,2019-06-04,0.0444915254237288,4720,4930,210,1362165,1740.0,SK네트웍스보통주
1589,1740,2019-05-09,0.0412186379928315,5580,5350,-230,1957042,1740.0,SK네트웍스보통주
1590,1740,2019-05-07,0.0445969125214408,5830,5570,-260,1923560,1740.0,SK네트웍스보통주
1591,1740,2019-04-17,0.0419906687402799,6430,6160,-270,8537499,1740.0,SK네트웍스보통주
1592,1740,2019-04-16,0.0752508361204013,5980,6430,450,26520949,1740.0,SK네트웍스보통주
1593,1740,2019-04-10,0.0424143556280587,6130,5870,-260,3156857,1740.0,SK네트웍스보통주
1594,1740,2019-02-01,0.0438448566610455,5930,6190,260,3166502,1740.0,SK네트웍스보통주
1595,1740,2019-01-03,0.0598455598455598,5180,5490,310,4795141,1740.0,SK네트웍스보통주
1596,1740,2018-12-27,0.0561122244488977,4990,5270,280,1943731,1740.0,SK네트웍스보통주
1597,1740,2018-11-21,0.052127659574468,4700,4945,245,2201264,1740.0,SK네트웍스보통주
1598,1740,2018-10-29,0.0475663716814159,4520,4305,-215,1154031,1740.0,SK네트웍스보통주
1599,1740,2018-10-11,0.0472972972972973,5180,4935,-245,2414513,1740.0,SK네트웍스보통주
1600,1740,2018-09-27,0.0518234165067178,5210,5480,270,4360064,1740.0,SK네트웍스보통주
1601,1740,2018-09-21,0.0525252525252525,4950,5210,260,2901312,1740.0,SK네트웍스보통주
1602,1740,2018-09-19,0.0576923076923076,5200,4900,-300,3135410,1740.0,SK네트웍스보통주
1603,1740,2018-09-05,0.0562770562770562,4620,4880,260,4341809,1740.0,SK네트웍스보통주
1604,1740,2018-07-30,0.0407938257993384,4535,4720,185,1105539,1740.0,SK네트웍스보통주
1605,1740,2018-07-12,0.0508849557522123,4520,4750,230,2293681,1740.0,SK네트웍스보통주
1606,1740,2018-06-01,0.0493454179254783,4965,5210,245,4349889,1740.0,SK네트웍스보통주
1607,1740,2018-05-03,0.08,5750,5290,-460,5853326,1740.0,SK네트웍스보통주
1608,1740,2017-09-26,0.0406976744186046,6880,7160,280,1758064,1740.0,SK네트웍스보통주
1609,1740,2017-08-11,0.0429629629629629,6750,7040,290,10611579,1740.0,SK네트웍스보통주
1610,1740,2017-08-08,0.0528,6250,6580,330,5135230,1740.0,SK네트웍스보통주
1611,1740,2017-05-10,0.04,7750,7440,-310,4038263,1740.0,SK네트웍스보통주
1612,1740,2017-05-08,0.0408415841584158,8080,7750,-330,2644568,1740.0,SK네트웍스보통주
1613,1740,2017-04-27,0.041025641025641,7800,8120,320,2319490,1740.0,SK네트웍스보통주
1614,1740,2017-02-07,0.0646551724137931,6960,7410,450,4498536,1740.0,SK네트웍스보통주
1615,1740,2017-02-06,0.0545454545454545,6600,6960,360,1484999,1740.0,SK네트웍스보통주
1616,1740,2016-11-09,0.0469208211143695,6820,6500,-320,2086456,1740.0,SK네트웍스보통주
1617,1740,2016-09-29,0.0676100628930817,6360,6790,430,4831378,1740.0,SK네트웍스보통주
1618,2380,2021-05-26,0.0517503805175038,328500,311500,-17000,111731,2380.0,주식회사케이씨씨
1619,2380,2021-05-13,0.0509193776520509,353500,335500,-18000,97468,2380.0,주식회사케이씨씨
1620,2380,2021-05-12,0.0407055630936228,368500,353500,-15000,99693,2380.0,주식회사케이씨씨
1621,2380,2021-05-11,0.0806451612903225,341000,368500,27500,129920,2380.0,주식회사케이씨씨
1622,2380,2021-05-10,0.074015748031496,317500,341000,23500,77202,2380.0,주식회사케이씨씨
1623,2380,2021-05-06,0.0592105263157894,304000,322000,18000,53900,2380.0,주식회사케이씨씨
1624,2380,2021-05-03,0.0495207667731629,313000,297500,-15500,82091,2380.0,주식회사케이씨씨
1625,2380,2021-04-22,0.0802047781569965,293000,316500,23500,99069,2380.0,주식회사케이씨씨
1626,2380,2021-04-08,0.0478927203065134,261000,273500,12500,141916,2380.0,주식회사케이씨씨
1627,2380,2021-04-07,0.044,250000,261000,11000,105274,2380.0,주식회사케이씨씨
1628,2380,2021-04-06,0.075268817204301,232500,250000,17500,150240,2380.0,주식회사케이씨씨
1629,2380,2021-03-31,0.0462555066079295,227000,237500,10500,93931,2380.0,주식회사케이씨씨
1630,2380,2021-03-25,0.0880195599022004,204500,222500,18000,196692,2380.0,주식회사케이씨씨
1631,2380,2020-12-24,0.0555555555555555,189000,199500,10500,116419,2380.0,주식회사케이씨씨
1632,2380,2020-10-05,0.0513698630136986,146000,153500,7500,58733,2380.0,주식회사케이씨씨
1633,2380,2020-09-17,0.0711864406779661,147500,158000,10500,258718,2380.0,주식회사케이씨씨
1634,2380,2020-09-07,0.0633802816901408,142000,151000,9000,100901,2380.0,주식회사케이씨씨
1635,2380,2020-08-20,0.0580204778156996,146500,138000,-8500,163167,2380.0,주식회사케이씨씨
1636,2380,2020-08-18,0.0925925925925925,162000,147000,-15000,144133,2380.0,주식회사케이씨씨
1637,2380,2020-08-11,0.0631578947368421,142500,151500,9000,192996,2380.0,주식회사케이씨씨
1638,2380,2020-08-10,0.0477941176470588,136000,142500,6500,107305,2380.0,주식회사케이씨씨
1639,2380,2020-06-16,0.0520446096654275,134500,141500,7000,120208,2380.0,주식회사케이씨씨
1640,2380,2020-06-15,0.0460992907801418,141000,134500,-6500,136245,2380.0,주식회사케이씨씨
1641,2380,2020-06-11,0.0456026058631921,153500,146500,-7000,139909,2380.0,주식회사케이씨씨
1642,2380,2020-06-03,0.047457627118644,147500,154500,7000,189359,2380.0,주식회사케이씨씨
1643,2380,2020-05-29,0.0590163934426229,152500,143500,-9000,480783,2380.0,주식회사케이씨씨
1644,2380,2020-05-21,0.05,150000,157500,7500,131734,2380.0,주식회사케이씨씨
1645,2380,2020-05-19,0.0419580419580419,143000,149000,6000,101794,2380.0,주식회사케이씨씨
1646,2380,2020-04-27,0.0776699029126213,154500,166500,12000,94332,2380.0,주식회사케이씨씨
1647,2380,2020-04-23,0.0865051903114186,144500,157000,12500,108947,2380.0,주식회사케이씨씨
1648,2380,2020-04-10,0.1050724637681159,138000,152500,14500,154431,2380.0,주식회사케이씨씨
1649,2380,2020-03-26,0.0491803278688524,122000,128000,6000,91248,2380.0,주식회사케이씨씨
1650,2380,2020-03-25,0.0701754385964912,114000,122000,8000,99241,2380.0,주식회사케이씨씨
1651,2380,2020-03-24,0.0654205607476635,107000,114000,7000,78792,2380.0,주식회사케이씨씨
1652,2380,2020-03-23,0.1370967741935483,124000,107000,-17000,73764,2380.0,주식회사케이씨씨
1653,2380,2020-03-20,0.087719298245614,114000,124000,10000,57172,2380.0,주식회사케이씨씨
1654,2380,2020-03-19,0.1330798479087452,131500,114000,-17500,62561,2380.0,주식회사케이씨씨
1655,2380,2020-03-18,0.0436363636363636,137500,131500,-6000,39998,2380.0,주식회사케이씨씨
1656,2380,2020-03-17,0.0517241379310344,145000,137500,-7500,43209,2380.0,주식회사케이씨씨
1657,2380,2020-03-13,0.0553745928338762,153500,145000,-8500,64730,2380.0,주식회사케이씨씨
1658,2380,2020-03-12,0.0640243902439024,164000,153500,-10500,75552,2380.0,주식회사케이씨씨
1659,2380,2020-03-09,0.0405797101449275,172500,165500,-7000,37763,2380.0,주식회사케이씨씨
1660,2380,2020-03-05,0.0416666666666666,168000,175000,7000,47085,2380.0,주식회사케이씨씨
1661,2380,2020-02-28,0.059322033898305,177000,166500,-10500,93350,2380.0,주식회사케이씨씨
1662,2380,2020-02-24,0.0582278481012658,197500,186000,-11500,46674,2380.0,주식회사케이씨씨
1663,2380,2020-02-21,0.0617577197149643,210500,197500,-13000,68511,2380.0,주식회사케이씨씨
1664,2380,2020-02-14,0.079295154185022,227000,209000,-18000,109990,2380.0,주식회사케이씨씨
1665,2380,2020-02-11,0.0488372093023255,215000,225500,10500,52040,2380.0,주식회사케이씨씨
1666,2380,2020-02-06,0.0422885572139303,201000,209500,8500,45149,2380.0,주식회사케이씨씨
1667,2380,2020-01-28,0.0782997762863534,223500,206000,-17500,51805,2380.0,주식회사케이씨씨
1668,2380,2020-01-23,0.0428265524625267,233500,223500,-10000,70364,2380.0,주식회사케이씨씨
1669,2380,2020-01-21,0.1413276231263383,233500,238000,4500,313288,2380.0,주식회사케이씨씨
1670,2380,2019-12-13,0.0412844036697247,218000,227000,9000,36309,2380.0,주식회사케이씨씨
1671,2380,2019-11-04,0.0575221238938053,226000,239000,13000,31603,2380.0,주식회사케이씨씨
1672,2380,2019-07-18,0.0426356589147286,258000,247000,-11000,45339,2380.0,주식회사케이씨씨
1673,2380,2019-06-04,0.04296875,256000,267000,11000,33807,2380.0,주식회사케이씨씨
1674,2380,2019-05-13,0.0486111111111111,288000,274000,-14000,63581,2380.0,주식회사케이씨씨
1675,2380,2019-05-09,0.1724137931034483,348000,288000,-60000,200315,2380.0,주식회사케이씨씨
1676,2380,2019-04-10,0.0688,312500,334000,21500,72019,2380.0,주식회사케이씨씨
1677,2380,2019-03-15,0.0424528301886792,318000,331500,13500,35480,2380.0,주식회사케이씨씨
1678,2380,2018-11-01,0.048582995951417,247000,259000,12000,37674,2380.0,주식회사케이씨씨
1679,2380,2018-05-09,0.0411311053984575,389000,373000,-16000,48466,2380.0,주식회사케이씨씨
1680,2380,2018-03-30,0.0422322775263951,331500,345500,14000,46076,2380.0,주식회사케이씨씨
1681,2380,2018-02-09,0.0406290956749672,381500,366000,-15500,52503,2380.0,주식회사케이씨씨
1682,2380,2017-12-15,0.19375,320000,382000,62000,48736,2380.0,주식회사케이씨씨
1683,2380,2017-12-14,0.1773778920308483,389000,320000,-69000,33022,2380.0,주식회사케이씨씨
1684,2380,2017-09-25,0.0488771466314399,378500,360000,-18500,29982,2380.0,주식회사케이씨씨
1685,2380,2017-08-07,0.0452436194895591,431000,411500,-19500,49134,2380.0,주식회사케이씨씨
1686,2380,2017-05-25,0.0625814863102998,383500,407500,24000,110079,2380.0,주식회사케이씨씨
1687,2380,2017-05-22,0.0462184873949579,357000,373500,16500,100363,2380.0,주식회사케이씨씨
1688,2380,2017-02-03,0.0612244897959183,343000,322000,-21000,107297,2380.0,주식회사케이씨씨
1689,2380,2016-11-08,0.0405228758169934,382500,398000,15500,44188,2380.0,주식회사케이씨씨
1690,2380,2016-10-06,0.0734536082474226,388000,416500,28500,79623,2380.0,주식회사케이씨씨
1691,2380,2016-08-04,0.0597402597402597,385000,408000,23000,68328,2380.0,주식회사케이씨씨
1692,2790,2021-04-28,0.1015151515151515,66000,72700,6700,1287584,2790.0,아모레G보통주
1693,2790,2021-01-29,0.0438311688311688,61600,58900,-2700,293208,2790.0,아모레G보통주
1694,2790,2021-01-26,0.0406626506024096,66400,63700,-2700,229952,2790.0,아모레G보통주
1695,2790,2021-01-18,0.0416,62500,59900,-2600,230649,2790.0,아모레G보통주
1696,2790,2021-01-13,0.0412371134020618,58200,60600,2400,405259,2790.0,아모레G보통주
1697,2790,2020-12-09,0.055350553505535,54200,57200,3000,464140,2790.0,아모레G보통주
1698,2790,2020-11-20,0.0590551181102362,50800,53800,3000,544612,2790.0,아모레G보통주
1699,2790,2020-10-30,0.0418041804180418,45450,43550,-1900,204079,2790.0,아모레G보통주
1700,2790,2020-08-20,0.0495575221238938,56500,53700,-2800,163356,2790.0,아모레G보통주
1701,2790,2020-08-18,0.0552763819095477,59700,56400,-3300,266151,2790.0,아모레G보통주
1702,2790,2020-07-02,0.0494450050454086,49550,52000,2450,301438,2790.0,아모레G보통주
1703,2790,2020-06-30,0.0955414012738853,47100,51600,4500,1747806,2790.0,아모레G보통주
1704,2790,2020-06-25,0.0451354062186559,49850,47600,-2250,223557,2790.0,아모레G보통주
1705,2790,2020-06-15,0.0720887245841035,54100,50200,-3900,228903,2790.0,아모레G보통주
1706,2790,2020-05-29,0.0547445255474452,54800,57800,3000,246501,2790.0,아모레G보통주
1707,2790,2020-05-19,0.056672760511883,54700,57800,3100,257532,2790.0,아모레G보통주
1708,2790,2020-04-08,0.0942698706099815,54100,59200,5100,485599,2790.0,아모레G보통주
1709,2790,2020-04-02,0.0454545454545454,50600,52900,2300,114545,2790.0,아모레G보통주
1710,2790,2020-04-01,0.0866425992779783,55400,50600,-4800,162390,2790.0,아모레G보통주
1711,2790,2020-03-25,0.1033013844515442,46950,51800,4850,263173,2790.0,아모레G보통주
1712,2790,2020-03-24,0.0706955530216647,43850,46950,3100,179382,2790.0,아모레G보통주
1713,2790,2020-03-23,0.1078331637843336,49150,43850,-5300,177304,2790.0,아모레G보통주
1714,2790,2020-03-19,0.0643274853801169,51300,48000,-3300,281988,2790.0,아모레G보통주
1715,2790,2020-03-16,0.0503802281368821,52600,49950,-2650,203610,2790.0,아모레G보통주
1716,2790,2020-03-13,0.0453720508166969,55100,52600,-2500,328339,2790.0,아모레G보통주
1717,2790,2020-03-12,0.0450606585788561,57700,55100,-2600,312917,2790.0,아모레G보통주
1718,2790,2020-03-11,0.0571895424836601,61200,57700,-3500,249719,2790.0,아모레G보통주
1719,2790,2020-02-28,0.0476190476190476,65100,62000,-3100,193127,2790.0,아모레G보통주
1720,2790,2020-02-24,0.0415430267062314,67400,64600,-2800,179160,2790.0,아모레G보통주
1721,2790,2020-02-05,0.0743243243243243,74000,68500,-5500,419078,2790.0,아모레G보통주
1722,2790,2020-01-30,0.0439276485788113,77400,74000,-3400,101839,2790.0,아모레G보통주
1723,2790,2020-01-28,0.0769230769230769,83200,76800,-6400,251693,2790.0,아모레G보통주
1724,2790,2020-01-20,0.0537280701754386,91200,86300,-4900,198397,2790.0,아모레G보통주
1725,2790,2020-01-13,0.0416666666666666,86400,90000,3600,209911,2790.0,아모레G보통주
1726,2790,2020-01-07,0.0606435643564356,80800,85700,4900,197173,2790.0,아모레G보통주
1727,2790,2019-12-20,0.0408921933085501,80700,84000,3300,219287,2790.0,아모레G보통주
1728,2790,2019-12-05,0.0530864197530864,81000,76700,-4300,175164,2790.0,아모레G보통주
1729,2790,2019-10-30,0.1785216178521617,71700,84500,12800,493349,2790.0,아모레G보통주
1730,2790,2019-10-14,0.0676100628930817,63600,67900,4300,224112,2790.0,아모레G보통주
1731,2790,2019-10-11,0.1117318435754189,71600,63600,-8000,451526,2790.0,아모레G보통주
1732,2790,2019-10-08,0.0445402298850574,69600,72700,3100,159911,2790.0,아모레G보통주
1733,2790,2019-09-03,0.0458404074702886,58900,61600,2700,156874,2790.0,아모레G보통주
1734,2790,2019-08-30,0.0825688073394495,54500,59000,4500,196939,2790.0,아모레G보통주
1735,2790,2019-08-26,0.056159420289855,55200,52100,-3100,72436,2790.0,아모레G보통주
1736,2790,2019-08-06,0.0444444444444444,54000,51600,-2400,195074,2790.0,아모레G보통주
1737,2790,2019-08-05,0.0425531914893617,56400,54000,-2400,212960,2790.0,아모레G보통주
1738,2790,2019-07-17,0.0866141732283464,63500,58000,-5500,419090,2790.0,아모레G보통주
1739,2790,2019-07-08,0.0495495495495495,66600,63300,-3300,100731,2790.0,아모레G보통주
1740,2790,2019-07-05,0.0605095541401273,62800,66600,3800,234947,2790.0,아모레G보통주
1741,2790,2019-06-14,0.0434782608695652,64400,61600,-2800,165039,2790.0,아모레G보통주
1742,2790,2019-05-13,0.047683923705722,73400,69900,-3500,130012,2790.0,아모레G보통주
1743,2790,2019-05-09,0.0510471204188481,76400,72500,-3900,163003,2790.0,아모레G보통주
1744,2790,2019-04-30,0.0658385093167701,80500,75200,-5300,409452,2790.0,아모레G보통주
1745,2790,2019-04-15,0.0691906005221932,76600,81900,5300,409712,2790.0,아모레G보통주
1746,2790,2019-04-12,0.0758426966292134,71200,76600,5400,492069,2790.0,아모레G보통주
1747,2790,2019-03-15,0.0497866287339971,70300,73800,3500,278865,2790.0,아모레G보통주
1748,2790,2019-02-20,0.1070889894419306,66300,73400,7100,654272,2790.0,아모레G보통주
1749,2790,2019-02-08,0.047040971168437,65900,62800,-3100,235811,2790.0,아모레G보통주
1750,2790,2019-01-02,0.0660247592847317,72700,67900,-4800,199818,2790.0,아모레G보통주
1751,2790,2018-12-27,0.049490538573508,68700,72100,3400,142865,2790.0,아모레G보통주
1752,2790,2018-12-18,0.051051051051051,66600,70000,3400,299201,2790.0,아모레G보통주
1753,2790,2018-12-12,0.0543478260869565,64400,67900,3500,363191,2790.0,아모레G보통주
1754,2790,2018-11-23,0.0423861852433281,63700,61000,-2700,165815,2790.0,아모레G보통주
1755,2790,2018-11-21,0.0454545454545454,59400,62100,2700,437613,2790.0,아모레G보통주
1756,2790,2018-11-15,0.0481099656357388,58200,61000,2800,434466,2790.0,아모레G보통주
1757,2790,2018-11-01,0.0418679549114331,62100,64700,2600,162600,2790.0,아모레G보통주
1758,2790,2018-10-29,0.1473829201101928,72600,61900,-10700,582796,2790.0,아모레G보통주
1759,2790,2018-10-23,0.0428571428571428,77000,73700,-3300,202177,2790.0,아모레G보통주
1760,2790,2018-10-22,0.0504774897680764,73300,77000,3700,165852,2790.0,아모레G보통주
1761,2790,2018-10-18,0.0442132639791937,76900,73500,-3400,247594,2790.0,아모레G보통주
1762,2790,2018-10-11,0.0431372549019607,76500,73200,-3300,335022,2790.0,아모레G보통주
1763,2790,2018-10-04,0.1459459459459459,92500,79000,-13500,609410,2790.0,아모레G보통주
1764,2790,2018-08-23,0.0446985446985447,96200,100500,4300,193374,2790.0,아모레G보통주
1765,2790,2018-08-01,0.0542797494780793,95800,101000,5200,259450,2790.0,아모레G보통주
1766,2790,2018-07-27,0.04,102500,98400,-4100,252114,2790.0,아모레G보통주
1767,2790,2018-07-17,0.0410958904109589,109500,105000,-4500,131319,2790.0,아모레G보통주
1768,2790,2018-07-04,0.047008547008547,117000,111500,-5500,100924,2790.0,아모레G보통주
1769,2790,2018-05-14,0.0483271375464684,134500,128000,-6500,261395,2790.0,아모레G보통주
1770,2790,2018-05-03,0.0457746478873239,142000,135500,-6500,88167,2790.0,아모레G보통주
1771,2790,2018-04-13,0.05,140000,147000,7000,107349,2790.0,아모레G보통주
1772,2790,2018-04-02,0.0528169014084507,142000,149500,7500,253192,2790.0,아모레G보통주
1773,2790,2018-03-15,0.040590405904059,135500,141000,5500,100126,2790.0,아모레G보통주
1774,2790,2018-03-09,0.0608365019011406,131500,139500,8000,165080,2790.0,아모레G보통주
1775,2790,2018-02-28,0.0418250950570342,131500,126000,-5500,81931,2790.0,아모레G보통주
1776,2790,2018-02-21,0.048,125000,131000,6000,121393,2790.0,아모레G보통주
1777,2790,2018-02-07,0.0551470588235294,136000,128500,-7500,168729,2790.0,아모레G보통주
1778,2790,2018-01-24,0.060702875399361,156500,147000,-9500,199486,2790.0,아모레G보통주
1779,2790,2018-01-04,0.0419580419580419,143000,137000,-6000,98856,2790.0,아모레G보통주
1780,2790,2017-12-12,0.0463576158940397,151000,144000,-7000,165174,2790.0,아모레G보통주
1781,2790,2017-12-04,0.0637583892617449,149000,158500,9500,221321,2790.0,아모레G보통주
1782,2790,2017-11-03,0.0413793103448275,145000,151000,6000,171075,2790.0,아모레G보통주
1783,2790,2017-10-31,0.0651465798045602,153500,143500,-10000,541556,2790.0,아모레G보통주
1784,2790,2017-10-30,0.0477815699658703,146500,153500,7000,324379,2790.0,아모레G보통주
1785,2790,2017-10-26,0.1054545454545454,137500,152000,14500,358167,2790.0,아모레G보통주
1786,2790,2017-10-24,0.0583657587548638,128500,136000,7500,140834,2790.0,아모레G보통주
1787,2790,2017-10-13,0.064516129032258,124000,132000,8000,238735,2790.0,아모레G보통주
1788,2790,2017-09-29,0.0466101694915254,118000,123500,5500,148876,2790.0,아모레G보통주
1789,2790,2017-09-25,0.0537190082644628,121000,114500,-6500,119621,2790.0,아모레G보통주
1790,2790,2017-09-08,0.0434782608695652,126500,121000,-5500,124597,2790.0,아모레G보통주
1791,2790,2017-08-24,0.046875,128000,134000,6000,198194,2790.0,아모레G보통주
1792,2790,2017-07-07,0.0463320463320463,129500,123500,-6000,247823,2790.0,아모레G보통주
1793,2790,2017-06-26,0.0474452554744525,137000,130500,-6500,115461,2790.0,아모레G보통주
1794,2790,2017-06-19,0.0421052631578947,142500,136500,-6000,121348,2790.0,아모레G보통주
1795,2790,2017-05-12,0.0447284345047923,156500,149500,-7000,202565,2790.0,아모레G보통주
1796,2790,2017-05-08,0.068100358422939,139500,149000,9500,327643,2790.0,아모레G보통주
1797,2790,2017-05-04,0.0488721804511278,133000,139500,6500,236086,2790.0,아모레G보통주
1798,2790,2017-04-21,0.0408921933085501,134500,140000,5500,254886,2790.0,아모레G보통주
1799,2790,2017-04-19,0.0555555555555555,126000,133000,7000,208744,2790.0,아모레G보통주
1800,2790,2017-04-17,0.0458333333333333,120000,125500,5500,294995,2790.0,아모레G보통주
1801,2790,2017-03-03,0.1097560975609756,123000,109500,-13500,543308,2790.0,아모레G보통주
1802,2790,2017-03-02,0.0538461538461538,130000,123000,-7000,174354,2790.0,아모레G보통주
1803,2790,2017-02-24,0.0705394190871369,120500,129000,8500,313373,2790.0,아모레G보통주
1804,2790,2017-02-15,0.0408163265306122,122500,127500,5000,203515,2790.0,아모레G보통주
1805,2790,2017-02-02,0.0836501901140684,131500,120500,-11000,535787,2790.0,아모레G보통주
1806,2790,2017-01-16,0.0463320463320463,129500,135500,6000,201949,2790.0,아모레G보통주
1807,2790,2017-01-09,0.04,125000,120000,-5000,203532,2790.0,아모레G보통주
1808,2790,2017-01-02,0.0789473684210526,133000,122500,-10500,195498,2790.0,아모레G보통주
1809,2790,2016-12-08,0.0528455284552845,123000,129500,6500,215964,2790.0,아모레G보통주
1810,2790,2016-12-02,0.0431372549019607,127500,122000,-5500,127946,2790.0,아모레G보통주
1811,2790,2016-11-30,0.047970479704797,135500,129000,-6500,203432,2790.0,아모레G보통주
1812,2790,2016-11-29,0.0711462450592885,126500,135500,9000,277768,2790.0,아모레G보통주
1813,2790,2016-11-21,0.0618181818181818,137500,129000,-8500,314197,2790.0,아모레G보통주
1814,2790,2016-10-25,0.0903426791277258,160500,146000,-14500,682883,2790.0,아모레G보통주
1815,2790,2016-08-23,0.0494699646643109,141500,148500,7000,165548,2790.0,아모레G보통주
1816,2790,2016-08-08,0.0462633451957295,140500,147000,6500,354248,2790.0,아모레G보통주
1817,2790,2016-08-05,0.0570469798657718,149000,140500,-8500,288657,2790.0,아모레G보통주
1818,2790,2016-08-02,0.0410958904109589,146000,152000,6000,253493,2790.0,아모레G보통주
1819,3000,2021-05-13,0.059090909090909,22000,20700,-1300,1352149,3000.0,부광약품보통주
1820,3000,2021-05-10,0.079136690647482,20850,22500,1650,1374240,3000.0,부광약품보통주
1821,3000,2021-05-03,0.0415704387990762,21650,20750,-900,874764,3000.0,부광약품보통주
1822,3000,2021-03-16,0.0883620689655172,23200,25250,2050,5090656,3000.0,부광약품보통주
1823,3000,2021-03-08,0.0464135021097046,23700,22600,-1100,1653006,3000.0,부광약품보통주
1824,3000,2021-03-04,0.0976058931860036,27150,24500,-2650,4003321,3000.0,부광약품보통주
1825,3000,2021-03-03,0.0442307692307692,26000,27150,1150,10915227,3000.0,부광약품보통주
1826,3000,2021-03-02,0.0664272890484739,27850,26000,-1850,23695164,3000.0,부광약품보통주
1827,3000,2021-02-26,0.2983682983682983,21450,27850,6400,23561207,3000.0,부광약품보통주
1828,3000,2021-02-08,0.0776699029126213,25750,23750,-2000,3121432,3000.0,부광약품보통주
1829,3000,2021-02-05,0.2032710280373831,21400,25750,4350,14715885,3000.0,부광약품보통주
1830,3000,2021-02-04,0.0403587443946188,22300,21400,-900,582591,3000.0,부광약품보통주
1831,3000,2021-01-29,0.0427350427350427,23400,22400,-1000,773507,3000.0,부광약품보통주
1832,3000,2021-01-18,0.0614203454894433,26050,24450,-1600,994798,3000.0,부광약품보통주
1833,3000,2021-01-15,0.0405156537753222,27150,26050,-1100,1924869,3000.0,부광약품보통주
1834,3000,2021-01-14,0.0752475247524752,25250,27150,1900,4182366,3000.0,부광약품보통주
1835,3000,2021-01-11,0.063063063063063,27750,26000,-1750,2148379,3000.0,부광약품보통주
1836,3000,2020-12-28,0.0413223140495867,30250,29000,-1250,2737389,3000.0,부광약품보통주
1837,3000,2020-12-24,0.043103448275862,29000,30250,1250,5049939,3000.0,부광약품보통주
1838,3000,2020-12-23,0.1265060240963855,33200,29000,-4200,4682090,3000.0,부광약품보통주
1839,3000,2020-12-22,0.0541310541310541,35100,33200,-1900,4269266,3000.0,부광약품보통주
1840,3000,2020-12-21,0.0850077279752704,32350,35100,2750,15784958,3000.0,부광약품보통주
1841,3000,2020-12-18,0.0623973727422003,30450,32350,1900,17830000,3000.0,부광약품보통주
1842,3000,2020-12-17,0.0424528301886792,31800,30450,-1350,4197707,3000.0,부광약품보통주
1843,3000,2020-12-14,0.1846153846153846,26000,30800,4800,21097380,3000.0,부광약품보통주
1844,3000,2020-12-11,0.0505050505050505,24750,26000,1250,6591543,3000.0,부광약품보통주
1845,3000,2020-12-07,0.046938775510204,24500,25650,1150,1459538,3000.0,부광약품보통주
1846,3000,2020-11-05,0.0411522633744856,24300,25300,1000,670773,3000.0,부광약품보통주
1847,3000,2020-11-03,0.0449678800856531,23350,24400,1050,586790,3000.0,부광약품보통주
1848,3000,2020-10-30,0.0585858585858585,24750,23300,-1450,718980,3000.0,부광약품보통주
1849,3000,2020-10-26,0.0666666666666666,25500,23800,-1700,899681,3000.0,부광약품보통주
1850,3000,2020-10-22,0.0477941176470588,27200,25900,-1300,560289,3000.0,부광약품보통주
1851,3000,2020-10-15,0.0498220640569395,28100,26700,-1400,877499,3000.0,부광약품보통주
1852,3000,2020-09-24,0.0686106346483705,29150,27150,-2000,1275848,3000.0,부광약품보통주
1853,3000,2020-09-22,0.0494233937397034,30350,28850,-1500,1867363,3000.0,부광약품보통주
1854,3000,2020-09-18,0.0410958904109589,32850,31500,-1350,3624054,3000.0,부광약품보통주
1855,3000,2020-09-09,0.0415512465373961,36100,34600,-1500,1457639,3000.0,부광약품보통주
1856,3000,2020-08-28,0.0495049504950495,40400,38400,-2000,12458415,3000.0,부광약품보통주
1857,3000,2020-08-27,0.0659630606860158,37900,40400,2500,6988757,3000.0,부광약품보통주
1858,3000,2020-08-21,0.04,37500,36000,-1500,1897692,3000.0,부광약품보통주
1859,3000,2020-08-20,0.0533707865168539,35600,37500,1900,4222952,3000.0,부광약품보통주
1860,3000,2020-08-14,0.0418918918918918,37000,35450,-1550,1948915,3000.0,부광약품보통주
1861,3000,2020-07-23,0.1006622516556291,37750,41550,3800,26146894,3000.0,부광약품보통주
1862,3000,2020-07-22,0.0792682926829268,41000,37750,-3250,13185010,3000.0,부광약품보통주
1863,3000,2020-07-21,0.056701030927835,38800,41000,2200,25998663,3000.0,부광약품보통주
1864,3000,2020-07-20,0.116546762589928,34750,38800,4050,14850667,3000.0,부광약품보통주
1865,3000,2020-07-16,0.0464135021097046,35550,33900,-1650,1799837,3000.0,부광약품보통주
1866,3000,2020-07-15,0.0456375838926174,37250,35550,-1700,4063593,3000.0,부광약품보통주
1867,3000,2020-07-13,0.0488505747126436,34800,36500,1700,5570762,3000.0,부광약품보통주
1868,3000,2020-06-26,0.0791268758526603,36650,33750,-2900,4418824,3000.0,부광약품보통주
1869,3000,2020-06-19,0.072992700729927,41100,38100,-3000,5896504,3000.0,부광약품보통주
1870,3000,2020-06-18,0.0887417218543046,37750,41100,3350,12198613,3000.0,부광약품보통주
1871,3000,2020-06-16,0.0613668061366806,35850,38050,2200,7094135,3000.0,부광약품보통주
1872,3000,2020-06-15,0.079589216944801,38950,35850,-3100,15065944,3000.0,부광약품보통주
1873,3000,2020-06-12,0.0414438502673796,37400,38950,1550,13173095,3000.0,부광약품보통주
1874,3000,2020-06-09,0.240983606557377,30500,37850,7350,36291673,3000.0,부광약품보통주
1875,3000,2020-06-05,0.0692167577413479,27450,29350,1900,8351038,3000.0,부광약품보통주
1876,3000,2020-05-19,0.0737564322469982,29150,27000,-2150,7066779,3000.0,부광약품보통주
1877,3000,2020-05-18,0.077634011090573,27050,29150,2100,11567944,3000.0,부광약품보통주
1878,3000,2020-05-13,0.0489130434782608,27600,26250,-1350,3626227,3000.0,부광약품보통주
1879,3000,2020-05-12,0.1334702258726899,24350,27600,3250,17499955,3000.0,부광약품보통주
1880,3000,2020-05-04,0.0593869731800766,26100,24550,-1550,3461530,3000.0,부광약품보통주
1881,3000,2020-04-17,0.069023569023569,29700,27650,-2050,10522053,3000.0,부광약품보통주
1882,3000,2020-04-16,0.0722021660649819,27700,29700,2000,31799978,3000.0,부광약품보통주
1883,3000,2020-04-14,0.2449438202247191,22250,27700,5450,39910164,3000.0,부광약품보통주
1884,3000,2020-04-13,0.0843621399176954,24300,22250,-2050,3775183,3000.0,부광약품보통주
1885,3000,2020-04-09,0.0457516339869281,22950,24000,1050,10361424,3000.0,부광약품보통주
1886,3000,2020-04-08,0.0457380457380457,24050,22950,-1100,3939262,3000.0,부광약품보통주
1887,3000,2020-04-07,0.0767754318618042,26050,24050,-2000,6422355,3000.0,부광약품보통주
1888,3000,2020-04-06,0.0991561181434599,23700,26050,2350,10621158,3000.0,부광약품보통주
1889,3000,2020-04-03,0.0417582417582417,22750,23700,950,12675620,3000.0,부광약품보통주
1890,3000,2020-04-01,0.0710059171597633,25350,23550,-1800,14812349,3000.0,부광약품보통주
1891,3000,2020-03-31,0.3,19500,25350,5850,24440577,3000.0,부광약품보통주
1892,3000,2020-03-30,0.1048158640226629,17650,19500,1850,6298741,3000.0,부광약품보통주
1893,3000,2020-03-27,0.043360433604336,18450,17650,-800,6539182,3000.0,부광약품보통주
1894,3000,2020-03-24,0.0504451038575667,16850,17700,850,4271833,3000.0,부광약품보통주
1895,3000,2020-03-23,0.0480225988700565,17700,16850,-850,4535079,3000.0,부광약품보통주
1896,3000,2020-03-20,0.0411764705882352,17000,17700,700,7593404,3000.0,부광약품보통주
1897,3000,2020-03-19,0.1371237458193979,14950,17000,2050,9329193,3000.0,부광약품보통주
1898,3000,2020-03-18,0.0939393939393939,16500,14950,-1550,4596522,3000.0,부광약품보통주
1899,3000,2020-03-17,0.0714285714285714,15400,16500,1100,5790043,3000.0,부광약품보통주
1900,3000,2020-03-16,0.072289156626506,16600,15400,-1200,7618556,3000.0,부광약품보통주
1901,3000,2020-03-13,0.050632911392405,15800,16600,800,8565479,3000.0,부광약품보통주
1902,3000,2020-03-12,0.0705882352941176,17000,15800,-1200,8672712,3000.0,부광약품보통주
1903,3000,2020-03-11,0.1005291005291005,18900,17000,-1900,10405111,3000.0,부광약품보통주
1904,3000,2020-03-10,0.2989690721649484,14550,18900,4350,5685311,3000.0,부광약품보통주
1905,3000,2020-03-05,0.0792452830188679,13250,14300,1050,545518,3000.0,부광약품보통주
1906,3000,2020-03-02,0.047808764940239,12550,13150,600,986821,3000.0,부광약품보통주
1907,3000,2020-02-28,0.0419847328244274,13100,12550,-550,219372,3000.0,부광약품보통주
1908,3000,2020-02-24,0.072463768115942,13800,12800,-1000,337874,3000.0,부광약품보통주
1909,3000,2020-01-09,0.0454545454545454,13200,13800,600,347697,3000.0,부광약품보통주
1910,3000,2020-01-06,0.0615942028985507,13800,12950,-850,394381,3000.0,부광약품보통주
1911,3000,2019-11-04,0.0412371134020618,14550,15150,600,255178,3000.0,부광약품보통주
1912,3000,2019-08-28,0.053231939163498,13150,13850,700,118694,3000.0,부광약품보통주
1913,3000,2019-08-08,0.0418250950570342,13150,13700,550,284927,3000.0,부광약품보통주
1914,3000,2019-08-05,0.1298701298701298,15400,13400,-2000,726769,3000.0,부광약품보통주
1915,3000,2019-07-09,0.0419161676646706,16700,16000,-700,401983,3000.0,부광약품보통주
1916,3000,2019-06-25,0.0503978779840848,18850,17900,-950,358187,3000.0,부광약품보통주
1917,3000,2019-05-31,0.0664739884393063,17300,18450,1150,802529,3000.0,부광약품보통주
1918,3000,2019-05-30,0.0581039755351682,16350,17300,950,1069542,3000.0,부광약품보통주
1919,3000,2019-05-15,0.0662650602409638,16600,17700,1100,636203,3000.0,부광약품보통주
1920,3000,2019-05-13,0.0552325581395348,17200,16250,-950,408273,3000.0,부광약품보통주
1921,3000,2019-05-09,0.0555555555555555,18000,17000,-1000,610637,3000.0,부광약품보통주
1922,3000,2019-03-29,0.0402010050251256,19900,19100,-800,1656294,3000.0,부광약품보통주
1923,3000,2019-02-20,0.0515463917525773,24250,23000,-1250,1180132,3000.0,부광약품보통주
1924,3000,2018-12-27,0.0662020905923344,28700,24000,-4700,589873,3000.0,부광약품보통주
1925,3000,2018-11-06,0.0419287211740041,23850,24850,1000,213732,3000.0,부광약품보통주
1926,3000,2018-11-02,0.0677200902934537,22150,23650,1500,220078,3000.0,부광약품보통주
1927,3000,2018-10-26,0.0493562231759656,23300,22150,-1150,309900,3000.0,부광약품보통주
1928,3000,2018-10-11,0.0783132530120482,24900,22950,-1950,496944,3000.0,부광약품보통주
1929,3000,2018-07-03,0.0453563714902807,23150,22100,-1050,540927,3000.0,부광약품보통주
1930,3000,2018-06-19,0.0703703703703703,27000,25100,-1900,356880,3000.0,부광약품보통주
1931,3000,2018-05-02,0.0653846153846153,26000,27700,1700,834736,3000.0,부광약품보통주
1932,3000,2018-04-23,0.0604395604395604,27300,25650,-1650,675580,3000.0,부광약품보통주
1933,3000,2018-04-12,0.0682926829268292,30750,28650,-2100,1200586,3000.0,부광약품보통주
1934,3000,2018-04-09,0.0988805970149253,26800,29450,2650,1645180,3000.0,부광약품보통주
1935,3000,2018-04-04,0.0547945205479452,25550,26950,1400,1718289,3000.0,부광약품보통주
1936,3000,2018-03-23,0.0553359683794466,25300,23900,-1400,456967,3000.0,부광약품보통주
1937,3000,2018-02-05,0.0450097847358121,25550,24400,-1150,392019,3000.0,부광약품보통주
1938,3000,2018-02-01,0.0489130434782608,27600,26250,-1350,503302,3000.0,부광약품보통주
1939,3000,2018-01-30,0.0754716981132075,26500,28500,2000,1896004,3000.0,부광약품보통주
1940,3000,2018-01-04,0.046816479400749,26700,25450,-1250,661681,3000.0,부광약품보통주
1941,3000,2018-01-03,0.1218487394957983,23800,26700,2900,2093633,3000.0,부광약품보통주
1942,3000,2017-11-14,0.0504201680672268,23800,25000,1200,443374,3000.0,부광약품보통주
1943,3000,2017-05-31,0.045662100456621,21900,22900,1000,436293,3000.0,부광약품보통주
1944,3000,2017-05-08,0.0401891252955082,21150,22000,850,309950,3000.0,부광약품보통주
1945,3000,2017-02-15,0.0548245614035087,22800,24050,1250,175622,3000.0,부광약품보통주
1946,3000,2016-12-13,0.0650095602294455,26150,27850,1700,396300,3000.0,부광약품보통주
1947,3000,2016-12-12,0.0630081300813008,24600,26150,1550,282307,3000.0,부광약품보통주
1948,3000,2016-11-10,0.0909090909090909,23650,25800,2150,193452,3000.0,부광약품보통주
1949,3000,2016-11-09,0.0463709677419354,24800,23650,-1150,280534,3000.0,부광약품보통주
1950,3000,2016-11-02,0.0517928286852589,25100,23800,-1300,207072,3000.0,부광약품보통주
1951,3000,2016-10-31,0.0421455938697318,26100,25000,-1100,166923,3000.0,부광약품보통주
1952,3000,2016-09-30,0.0508196721311475,30500,28950,-1550,449014,3000.0,부광약품보통주
1953,3000,2016-08-09,0.0444839857651245,28100,29350,1250,220322,3000.0,부광약품보통주
1954,3090,2021-05-26,0.0562414266117969,36450,38500,2050,570964,3090.0,대웅보통주
1955,3090,2021-05-24,0.0465425531914893,37600,35850,-1750,420574,3090.0,대웅보통주
1956,3090,2021-05-18,0.0584795321637426,34200,36200,2000,613082,3090.0,대웅보통주
1957,3090,2021-05-10,0.0628654970760233,34200,36350,2150,503994,3090.0,대웅보통주
1958,3090,2021-05-03,0.0798898071625344,36300,33400,-2900,575371,3090.0,대웅보통주
1959,3090,2021-04-30,0.0484927916120576,38150,36300,-1850,634894,3090.0,대웅보통주
1960,3090,2021-04-14,0.0523952095808383,33400,35150,1750,2663667,3090.0,대웅보통주
1961,3090,2021-04-05,0.043010752688172,32550,31150,-1400,276908,3090.0,대웅보통주
1962,3090,2021-03-18,0.0454545454545454,36300,34650,-1650,667493,3090.0,대웅보통주
1963,3090,2021-03-17,0.0629575402635432,34150,36300,2150,1554887,3090.0,대웅보통주
1964,3090,2021-03-16,0.0443425076452599,32700,34150,1450,318411,3090.0,대웅보통주
1965,3090,2021-02-23,0.0679851668726823,40450,37700,-2750,489685,3090.0,대웅보통주
1966,3090,2021-02-16,0.0487238979118329,43100,41000,-2100,796138,3090.0,대웅보통주
1967,3090,2021-02-08,0.0512540894220283,45850,43500,-2350,499229,3090.0,대웅보통주
1968,3090,2021-02-04,0.0589451913133402,48350,45500,-2850,595740,3090.0,대웅보통주
1969,3090,2021-01-28,0.0592885375494071,50600,47600,-3000,580461,3090.0,대웅보통주
1970,3090,2021-01-22,0.0523364485981308,53500,50700,-2800,978098,3090.0,대웅보통주
1971,3090,2021-01-19,0.0521739130434782,57500,54500,-3000,1169994,3090.0,대웅보통주
1972,3090,2021-01-13,0.0731319554848966,62900,58300,-4600,1848138,3090.0,대웅보통주
1973,3090,2021-01-12,0.1353790613718411,55400,62900,7500,9774664,3090.0,대웅보통주
1974,3090,2021-01-11,0.0594227504244482,58900,55400,-3500,1630932,3090.0,대웅보통주
1975,3090,2021-01-08,0.0811232449297972,64100,58900,-5200,1496112,3090.0,대웅보통주
1976,3090,2021-01-05,0.2575187969924812,53200,66900,13700,12973483,3090.0,대웅보통주
1977,3090,2021-01-04,0.0576540755467196,50300,53200,2900,2231955,3090.0,대웅보통주
1978,3090,2020-12-29,0.0806794055201698,47100,50900,3800,2136577,3090.0,대웅보통주
1979,3090,2020-12-24,0.1286764705882352,54400,47400,-7000,5158192,3090.0,대웅보통주
1980,3090,2020-12-23,0.2998712998712998,77700,54400,-23300,6756977,3090.0,대웅보통주
1981,3090,2020-12-22,0.1545319465081723,67300,77700,10400,7436720,3090.0,대웅보통주
1982,3090,2020-12-18,0.1142384105960264,60400,67300,6900,8573014,3090.0,대웅보통주
1983,3090,2020-12-17,0.296137339055794,46600,60400,13800,7980177,3090.0,대웅보통주
1984,3090,2020-12-15,0.0523665659617321,49650,47050,-2600,5917354,3090.0,대웅보통주
1985,3090,2020-12-11,0.1629542790152403,42650,49600,6950,22769754,3090.0,대웅보통주
1986,3090,2020-12-10,0.2674591381872214,33650,42650,9000,16742591,3090.0,대웅보통주
1987,3090,2020-12-09,0.1235392320534223,29950,33650,3700,11348392,3090.0,대웅보통주
1988,3090,2020-12-08,0.0476947535771065,31450,29950,-1500,693061,3090.0,대웅보통주
1989,3090,2020-12-01,0.1676413255360623,25650,29950,4300,12315146,3090.0,대웅보통주
1990,3090,2020-11-26,0.0481927710843373,24900,26100,1200,1096051,3090.0,대웅보통주
1991,3090,2020-11-25,0.0663811563169164,23350,24900,1550,3937711,3090.0,대웅보통주
1992,3090,2020-11-17,0.0516853932584269,22250,21100,-1150,295538,3090.0,대웅보통주
1993,3090,2020-11-11,0.05,23000,21850,-1150,410311,3090.0,대웅보통주
1994,3090,2020-11-10,0.0612244897959183,24500,23000,-1500,351930,3090.0,대웅보통주
1995,3090,2020-11-05,0.0524109014675052,23850,25100,1250,197316,3090.0,대웅보통주
1996,3090,2020-10-30,0.048582995951417,24700,23500,-1200,252976,3090.0,대웅보통주
1997,3090,2020-10-28,0.0644444444444444,22500,23950,1450,370903,3090.0,대웅보통주
1998,3090,2020-10-26,0.0723140495867768,24200,22450,-1750,420387,3090.0,대웅보통주
1999,3090,2020-10-22,0.0543689320388349,25750,24350,-1400,224592,3090.0,대웅보통주
2000,3090,2020-10-16,0.0621572212065813,27350,25650,-1700,428344,3090.0,대웅보통주
2001,3090,2020-10-14,0.0490693739424703,29550,28100,-1450,424938,3090.0,대웅보통주
2002,3090,2020-09-25,0.1152416356877323,26900,30000,3100,1158657,3090.0,대웅보통주
2003,3090,2020-09-24,0.0643478260869565,28750,26900,-1850,456044,3090.0,대웅보통주
2004,3090,2020-09-22,0.0462809917355371,30250,28850,-1400,607921,3090.0,대웅보통주
2005,3090,2020-09-09,0.0732044198895027,36200,33550,-2650,823669,3090.0,대웅보통주
2006,3090,2020-09-08,0.0461133069828722,37950,36200,-1750,615869,3090.0,대웅보통주
2007,3090,2020-09-03,0.0529172320217096,36850,38800,1950,2320140,3090.0,대웅보통주
2008,3090,2020-08-27,0.0510067114093959,37250,35350,-1900,797462,3090.0,대웅보통주
2009,3090,2020-08-25,0.0991379310344827,34800,38250,3450,4673079,3090.0,대웅보통주
2010,3090,2020-08-24,0.0497737556561085,33150,34800,1650,1350445,3090.0,대웅보통주
2011,3090,2020-08-10,0.2031746031746031,31500,37900,6400,15360207,3090.0,대웅보통주
2012,3090,2020-08-07,0.0987124463519313,34950,31500,-3450,9489893,3090.0,대웅보통주
2013,3090,2020-08-06,0.2992565055762082,26900,34950,8050,11020488,3090.0,대웅보통주
2014,3090,2020-08-04,0.0853658536585365,24600,26700,2100,1069732,3090.0,대웅보통주
2015,3090,2020-07-31,0.0411985018726591,26700,25600,-1100,519307,3090.0,대웅보통주
2016,3090,2020-07-24,0.0701030927835051,24250,25950,1700,2133388,3090.0,대웅보통주
2017,3090,2020-07-23,0.0497835497835497,23100,24250,1150,2464508,3090.0,대웅보통주
2018,3090,2020-07-20,0.0532150776053215,22550,23750,1200,923100,3090.0,대웅보통주
2019,3090,2020-07-15,0.0564516129032258,24800,23400,-1400,516903,3090.0,대웅보통주
2020,3090,2020-07-13,0.0521739130434782,23000,24200,1200,724278,3090.0,대웅보통주
2021,3090,2020-07-07,0.0773809523809523,25200,23250,-1950,2343692,3090.0,대웅보통주
2022,3090,2020-07-03,0.056390977443609,26600,25100,-1500,964941,3090.0,대웅보통주
2023,3090,2020-07-01,0.0514705882352941,27200,25800,-1400,648721,3090.0,대웅보통주
2024,3090,2020-06-30,0.0620689655172413,29000,27200,-1800,1347124,3090.0,대웅보통주
2025,3090,2020-06-29,0.0507364975450081,30550,29000,-1550,440345,3090.0,대웅보통주
2026,3090,2020-06-26,0.0408163265306122,31850,30550,-1300,1060588,3090.0,대웅보통주
2027,3090,2020-06-16,0.0862385321100917,27250,29600,2350,2138246,3090.0,대웅보통주
2028,3090,2020-06-15,0.0472027972027972,28600,27250,-1350,3125424,3090.0,대웅보통주
2029,3090,2020-06-09,0.1598360655737705,24400,28300,3900,14161814,3090.0,대웅보통주
2030,3090,2020-06-08,0.0431372549019607,25500,24400,-1100,6037876,3090.0,대웅보통주
2031,3090,2020-06-05,0.2977099236641221,19650,25500,5850,8637281,3090.0,대웅보통주
2032,3090,2020-06-02,0.0988372093023255,17200,18900,1700,1562542,3090.0,대웅보통주
2033,3090,2020-05-04,0.0603448275862069,17400,16350,-1050,1196754,3090.0,대웅보통주
2034,3090,2020-04-29,0.0769230769230769,18850,17400,-1450,1702827,3090.0,대웅보통주
2035,3090,2020-04-28,0.0551378446115288,19950,18850,-1100,1716522,3090.0,대웅보통주
2036,3090,2020-04-24,0.1769911504424778,16950,19950,3000,18444291,3090.0,대웅보통주
2037,3090,2020-04-23,0.0504201680672268,17850,16950,-900,6074318,3090.0,대웅보통주
2038,3090,2020-04-22,0.2981818181818181,13750,17850,4100,2875629,3090.0,대웅보통주
2039,3090,2020-04-21,0.0582191780821917,14600,13750,-850,528254,3090.0,대웅보통주
2040,3090,2020-04-20,0.0735294117647058,13600,14600,1000,1133161,3090.0,대웅보통주
2041,3090,2020-04-16,0.1147540983606557,12200,13600,1400,1203831,3090.0,대웅보통주
2042,3090,2020-04-14,0.0655021834061135,11450,12200,750,2958453,3090.0,대웅보통주
2043,3090,2020-04-02,0.0491071428571428,11200,11750,550,110845,3090.0,대웅보통주
2044,3090,2020-03-31,0.0926829268292682,10250,11200,950,166432,3090.0,대웅보통주
2045,3090,2020-03-27,0.094298245614035,9120,9980,860,173545,3090.0,대웅보통주
2046,3090,2020-03-25,0.0649350649350649,8470,9020,550,276865,3090.0,대웅보통주
2047,3090,2020-03-24,0.218705035971223,6950,8470,1520,269723,3090.0,대웅보통주
2048,3090,2020-03-20,0.1141975308641975,6480,7220,740,238407,3090.0,대웅보통주
2049,3090,2020-03-19,0.1910112359550561,8010,6480,-1530,291401,3090.0,대웅보통주
2050,3090,2020-03-17,0.0553633217993079,8670,8190,-480,207246,3090.0,대웅보통주
2051,3090,2020-03-12,0.066047471620227,9690,9050,-640,317452,3090.0,대웅보통주
2052,3090,2020-03-11,0.0405940594059405,10100,9690,-410,239004,3090.0,대웅보통주
2053,3090,2020-03-04,0.0616740088105726,11350,10650,-700,475083,3090.0,대웅보통주
2054,3090,2020-03-02,0.1182266009852216,10150,11350,1200,383766,3090.0,대웅보통주
2055,3090,2020-02-28,0.0514018691588785,10700,10150,-550,216774,3090.0,대웅보통주
2056,3090,2020-02-24,0.0539419087136929,12050,11400,-650,103487,3090.0,대웅보통주
2057,3090,2020-02-20,0.0683760683760683,11700,12500,800,289541,3090.0,대웅보통주
2058,3090,2020-01-21,0.0637450199203187,12550,11750,-800,162279,3090.0,대웅보통주
2059,3090,2020-01-10,0.0466101694915254,11800,12350,550,162802,3090.0,대웅보통주
2060,3090,2020-01-06,0.0463320463320463,12950,12350,-600,109504,3090.0,대웅보통주
2061,3090,2019-11-27,0.0407407407407407,13500,12950,-550,64486,3090.0,대웅보통주
2062,3090,2019-09-26,0.0517799352750809,15450,14650,-800,306865,3090.0,대웅보통주
2063,3090,2019-09-25,0.0492307692307692,16250,15450,-800,139157,3090.0,대웅보통주
2064,3090,2019-08-30,0.0476190476190476,15750,16500,750,351864,3090.0,대웅보통주
2065,3090,2019-08-08,0.0551724137931034,14500,15300,800,47172,3090.0,대웅보통주
2066,3090,2019-08-05,0.0662460567823343,15850,14800,-1050,49138,3090.0,대웅보통주
2067,3090,2019-06-17,0.0449438202247191,17800,17000,-800,86495,3090.0,대웅보통주
2068,3090,2019-05-31,0.0433526011560693,17300,18050,750,68668,3090.0,대웅보통주
2069,3090,2019-05-29,0.046831955922865,18150,17300,-850,163863,3090.0,대웅보통주
2070,3090,2019-05-28,0.0521739130434782,17250,18150,900,71819,3090.0,대웅보통주
2071,3090,2019-05-13,0.0872817955112219,20050,18300,-1750,471940,3090.0,대웅보통주
2072,3090,2019-05-10,0.0452380952380952,21000,20050,-950,127879,3090.0,대웅보통주
2073,3090,2019-04-02,0.0429292929292929,19800,20650,850,292654,3090.0,대웅보통주
2074,3090,2019-02-07,0.0610079575596817,18850,20000,1150,693486,3090.0,대웅보통주
2075,3090,2018-12-27,0.0473372781065088,16900,17700,800,88928,3090.0,대웅보통주
2076,3090,2018-12-11,0.0621468926553672,17700,16600,-1100,100431,3090.0,대웅보통주
2077,3090,2018-11-06,0.0716612377850162,15350,16450,1100,181632,3090.0,대웅보통주
2078,3090,2018-11-02,0.0542372881355932,14750,15550,800,62551,3090.0,대웅보통주
2079,3090,2018-11-01,0.0611510791366906,13900,14750,850,92212,3090.0,대웅보통주
2080,3090,2018-10-31,0.0446735395189003,14550,13900,-650,156356,3090.0,대웅보통주
2081,3090,2018-10-15,0.0407523510971786,15950,15300,-650,72416,3090.0,대웅보통주
2082,3090,2018-10-11,0.0739644970414201,16900,15650,-1250,113828,3090.0,대웅보통주
2083,3090,2018-09-18,0.043103448275862,17400,18150,750,70202,3090.0,대웅보통주
2084,3090,2018-09-11,0.0608695652173913,17250,18300,1050,189519,3090.0,대웅보통주
2085,3090,2018-08-24,0.051051051051051,16650,17500,850,250837,3090.0,대웅보통주
2086,3090,2018-08-03,0.1133333333333333,15000,16700,1700,644430,3090.0,대웅보통주
2087,3090,2018-08-01,0.0544217687074829,14700,15500,800,92179,3090.0,대웅보통주
2088,3090,2018-07-23,0.0462046204620462,15150,14450,-700,89252,3090.0,대웅보통주
2089,3090,2018-07-18,0.0647058823529411,17000,15900,-1100,194118,3090.0,대웅보통주
2090,3090,2018-06-22,0.0484330484330484,17550,18400,850,104459,3090.0,대웅보통주
2091,3090,2018-06-19,0.047752808988764,17800,16950,-850,122211,3090.0,대웅보통주
2092,3090,2018-05-21,0.0483460559796437,19650,20600,950,248732,3090.0,대웅보통주
2093,3090,2018-05-16,0.0497382198952879,19100,20050,950,183834,3090.0,대웅보통주
2094,3090,2018-05-15,0.045,20000,19100,-900,92652,3090.0,대웅보통주
2095,3090,2018-05-11,0.0578947368421052,19000,20100,1100,161255,3090.0,대웅보통주
2096,3090,2018-04-30,0.085995085995086,20350,18600,-1750,384890,3090.0,대웅보통주
2097,3090,2018-04-18,0.080091533180778,21850,20100,-1750,480789,3090.0,대웅보통주
2098,3090,2018-04-12,0.0669546436285097,23150,21600,-1550,320819,3090.0,대웅보통주
2099,3090,2018-04-04,0.0562060889929742,21350,22550,1200,293212,3090.0,대웅보통주
2100,3090,2018-03-26,0.0695876288659793,19400,20750,1350,165017,3090.0,대웅보통주
2101,3090,2018-03-23,0.0559610705596107,20550,19400,-1150,183982,3090.0,대웅보통주
2102,3090,2018-03-21,0.0606060606060606,19800,21000,1200,456158,3090.0,대웅보통주
2103,3090,2018-03-05,0.0412087912087912,18200,17450,-750,95718,3090.0,대웅보통주
2104,3090,2018-02-07,0.0422535211267605,17750,17000,-750,148214,3090.0,대웅보통주
2105,3090,2018-01-30,0.0456989247311828,18600,19450,850,279079,3090.0,대웅보통주
2106,3090,2018-01-24,0.1225490196078431,20400,17900,-2500,1496276,3090.0,대웅보통주
2107,3090,2018-01-05,0.0427807486631016,18700,19500,800,145512,3090.0,대웅보통주
2108,3090,2017-12-27,0.0932203389830508,17700,19350,1650,378605,3090.0,대웅보통주
2109,3090,2017-12-11,0.0553846153846153,16250,17150,900,234008,3090.0,대웅보통주
2110,3090,2017-12-05,0.0445682451253481,17950,17150,-800,166779,3090.0,대웅보통주
2111,3090,2017-12-01,0.0404624277456647,17300,18000,700,202021,3090.0,대웅보통주
2112,3090,2017-11-22,0.0619946091644204,18550,17400,-1150,443419,3090.0,대웅보통주
2113,3090,2017-11-10,0.0769230769230769,15600,16800,1200,716102,3090.0,대웅보통주
2114,3090,2017-10-31,0.0542372881355932,14750,15550,800,338373,3090.0,대웅보통주
2115,3090,2017-10-11,0.0569395017793594,14050,14850,800,314830,3090.0,대웅보통주
2116,3090,2017-09-25,0.0618892508143322,15350,14400,-950,321546,3090.0,대웅보통주
2117,3090,2017-09-22,0.040625,16000,15350,-650,284686,3090.0,대웅보통주
2118,3090,2017-09-19,0.0602836879432624,14100,14950,850,356160,3090.0,대웅보통주
2119,3090,2017-08-31,0.0626959247648902,15950,14950,-1000,728720,3090.0,대웅보통주
2120,3090,2017-08-10,0.048780487804878,16400,15600,-800,565641,3090.0,대웅보통주
2121,3090,2017-08-07,0.0578778135048231,15550,16450,900,949239,3090.0,대웅보통주
2122,3090,2017-07-26,0.1282051282051282,13650,15400,1750,1497394,3090.0,대웅보통주
2123,3090,2017-07-20,0.0627450980392156,12750,13550,800,215389,3090.0,대웅보통주
2124,3090,2017-06-23,0.0452674897119341,12150,12700,550,269475,3090.0,대웅보통주
2125,3090,2017-06-16,0.0666666666666666,13500,12600,-900,790000,3090.0,대웅보통주
2126,3090,2017-06-15,0.0878378378378378,14800,13500,-1300,1648355,3090.0,대웅보통주
2127,3090,2017-06-05,0.108695652173913,13800,15300,1500,657736,3090.0,대웅보통주
2128,3090,2017-05-23,0.1142857142857142,12250,13650,1400,1009371,3090.0,대웅보통주
2129,3090,2017-04-03,0.0497131931166348,52300,54900,2600,23563,3090.0,대웅보통주
2130,3090,2017-03-24,0.0419651995905834,48850,50900,2050,15201,3090.0,대웅보통주
2131,3090,2017-03-10,0.0455005055611729,49450,51700,2250,8627,3090.0,대웅보통주
2132,3090,2017-02-27,0.040590405904059,54200,52000,-2200,13761,3090.0,대웅보통주
2133,3090,2017-01-24,0.040045766590389,43700,41950,-1750,9511,3090.0,대웅보통주
2134,3090,2017-01-05,0.0728323699421965,43250,46400,3150,20889,3090.0,대웅보통주
2135,3090,2016-12-01,0.0407725321888412,46600,44700,-1900,18389,3090.0,대웅보통주
2136,3090,2016-11-25,0.0646929824561403,45600,48550,2950,9510,3090.0,대웅보통주
2137,3090,2016-11-23,0.084313725490196,51000,46700,-4300,17156,3090.0,대웅보통주
2138,3090,2016-11-16,0.0730223123732251,49300,52900,3600,19026,3090.0,대웅보통주
2139,3090,2016-11-10,0.0628930817610062,47700,50700,3000,12081,3090.0,대웅보통주
2140,3090,2016-11-04,0.07,45000,48150,3150,14713,3090.0,대웅보통주
2141,3090,2016-11-03,0.0489510489510489,42900,45000,2100,13387,3090.0,대웅보통주
2142,3090,2016-10-31,0.0598290598290598,46800,44000,-2800,14776,3090.0,대웅보통주
2143,3090,2016-10-28,0.040983606557377,48800,46800,-2000,3728,3090.0,대웅보통주
2144,3090,2016-10-20,0.0425752855659397,48150,46100,-2050,17399,3090.0,대웅보통주
2145,3240,2021-05-28,0.0521008403361344,1190000,1252000,62000,2816,3240.0,태광산업보통주
2146,3240,2021-05-10,0.0532110091743119,1090000,1148000,58000,1973,3240.0,태광산업보통주
2147,3240,2021-05-06,0.0521327014218009,1055000,1110000,55000,2028,3240.0,태광산업보통주
2148,3240,2021-04-27,0.0411198600174978,1143000,1096000,-47000,2042,3240.0,태광산업보통주
2149,3240,2021-04-23,0.0465549348230912,1074000,1124000,50000,2110,3240.0,태광산업보통주
2150,3240,2021-04-20,0.0435212660731948,1011000,1055000,44000,2608,3240.0,태광산업보통주
2151,3240,2021-02-03,0.0887902330743618,901000,981000,80000,6890,3240.0,태광산업보통주
2152,3240,2021-02-01,0.1120381406436233,839000,933000,94000,8221,3240.0,태광산업보통주
2153,3240,2021-01-08,0.0457920792079207,808000,845000,37000,4029,3240.0,태광산업보통주
2154,3240,2020-11-30,0.0735826296743064,829000,768000,-61000,4181,3240.0,태광산업보통주
2155,3240,2020-11-18,0.0674300254452926,786000,839000,53000,4009,3240.0,태광산업보통주
2156,3240,2020-11-11,0.0533159947984395,769000,810000,41000,5822,3240.0,태광산업보통주
2157,3240,2020-11-02,0.056338028169014,710000,750000,40000,2439,3240.0,태광산업보통주
2158,3240,2020-06-16,0.065340909090909,704000,750000,46000,1819,3240.0,태광산업보통주
2159,3240,2020-06-15,0.0563002680965147,746000,704000,-42000,3143,3240.0,태광산업보통주
2160,3240,2020-06-12,0.048469387755102,784000,746000,-38000,2488,3240.0,태광산업보통주
2161,3240,2020-06-05,0.0524934383202099,762000,802000,40000,3206,3240.0,태광산업보통주
2162,3240,2020-04-29,0.0443864229765013,766000,800000,34000,3814,3240.0,태광산업보통주
2163,3240,2020-04-21,0.0434210526315789,760000,727000,-33000,2702,3240.0,태광산업보통주
2164,3240,2020-04-07,0.0736196319018405,652000,700000,48000,2520,3240.0,태광산업보통주
2165,3240,2020-03-25,0.1277777777777777,540000,609000,69000,3526,3240.0,태광산업보통주
2166,3240,2020-03-24,0.067193675889328,506000,540000,34000,2222,3240.0,태광산업보통주
2167,3240,2020-03-23,0.1260794473229706,579000,506000,-73000,2480,3240.0,태광산업보통주
2168,3240,2020-03-20,0.1673387096774193,496000,579000,83000,3103,3240.0,태광산업보통주
2169,3240,2020-03-19,0.1236749116607773,566000,496000,-70000,3096,3240.0,태광산업보통주
2170,3240,2020-03-16,0.0520504731861198,634000,601000,-33000,2714,3240.0,태광산업보통주
2171,3240,2020-03-13,0.0877697841726618,695000,634000,-61000,2853,3240.0,태광산업보통주
2172,3240,2020-03-12,0.0413793103448275,725000,695000,-30000,2104,3240.0,태광산업보통주
2173,3240,2020-03-09,0.0507614213197969,788000,748000,-40000,1551,3240.0,태광산업보통주
2174,3240,2020-01-28,0.0455465587044534,988000,943000,-45000,1906,3240.0,태광산업보통주
2175,3240,2019-09-16,0.0448028673835125,1116000,1166000,50000,701,3240.0,태광산업보통주
2176,3240,2019-09-03,0.0525328330206379,1066000,1122000,56000,1354,3240.0,태광산업보통주
2177,3240,2019-08-28,0.041625371655104,1009000,1051000,42000,755,3240.0,태광산업보통주
2178,3240,2019-08-12,0.0438756855575868,1094000,1046000,-48000,707,3240.0,태광산업보통주
2179,3240,2019-08-07,0.0570918822479928,1121000,1057000,-64000,2807,3240.0,태광산업보통주
2180,3240,2019-05-30,0.0462962962962962,1404000,1339000,-65000,1578,3240.0,태광산업보통주
2181,3240,2019-04-04,0.0432601880877742,1595000,1664000,69000,1057,3240.0,태광산업보통주
2182,3240,2019-03-15,0.1020793950850661,1587000,1749000,162000,3694,3240.0,태광산업보통주
2183,3240,2019-03-13,0.0439844760672703,1546000,1614000,68000,1610,3240.0,태광산업보통주
2184,3240,2019-02-15,0.0478011472275334,1569000,1494000,-75000,939,3240.0,태광산업보통주
2185,3240,2019-02-14,0.0551445864156018,1487000,1569000,82000,1166,3240.0,태광산업보통주
2186,3240,2018-11-01,0.0440379403794037,1476000,1411000,-65000,1011,3240.0,태광산업보통주
2187,3240,2018-10-11,0.0508373205741626,1672000,1587000,-85000,1545,3240.0,태광산업보통주
2188,3240,2018-09-12,0.0408548082966687,1591000,1656000,65000,1645,3240.0,태광산업보통주
2189,3240,2018-07-09,0.0583333333333333,1440000,1524000,84000,2430,3240.0,태광산업보통주
2190,3240,2018-07-06,0.0427226647356987,1381000,1440000,59000,938,3240.0,태광산업보통주
2191,3240,2018-06-11,0.0641025641025641,1326000,1411000,85000,2282,3240.0,태광산업보통주
2192,3240,2018-05-10,0.0436390532544378,1352000,1411000,59000,1687,3240.0,태광산업보통주
2193,3240,2018-05-08,0.0473235065942591,1289000,1350000,61000,1345,3240.0,태광산업보통주
2194,3240,2018-04-02,0.0604614160700079,1257000,1333000,76000,1673,3240.0,태광산업보통주
2195,3240,2018-03-28,0.0440931780366056,1202000,1255000,53000,1821,3240.0,태광산업보통주
2196,3240,2018-02-13,0.0441826215022091,1358000,1298000,-60000,958,3240.0,태광산업보통주
2197,3240,2018-02-09,0.0566037735849056,1325000,1400000,75000,1654,3240.0,태광산업보통주
2198,3240,2018-01-24,0.049438202247191,1335000,1401000,66000,1122,3240.0,태광산업보통주
2199,3240,2018-01-04,0.0550113036925395,1327000,1254000,-73000,1195,3240.0,태광산업보통주
2200,3240,2017-12-26,0.0464933018124507,1269000,1328000,59000,1241,3240.0,태광산업보통주
2201,3240,2017-12-15,0.0490533562822719,1162000,1219000,57000,1166,3240.0,태광산업보통주
2202,3240,2017-12-01,0.0433412135539795,1269000,1214000,-55000,1271,3240.0,태광산업보통주
2203,3240,2017-11-03,0.0506003430531732,1166000,1225000,59000,1202,3240.0,태광산업보통주
2204,3240,2017-10-19,0.0411449016100178,1118000,1164000,46000,979,3240.0,태광산업보통주
2205,3240,2017-09-29,0.0408542246982358,1077000,1121000,44000,1025,3240.0,태광산업보통주
2206,3240,2017-09-22,0.0410958904109589,1168000,1120000,-48000,854,3240.0,태광산업보통주
2207,3240,2017-07-19,0.0482641828958509,1181000,1238000,57000,1221,3240.0,태광산업보통주
2208,3240,2017-07-18,0.0697463768115942,1104000,1181000,77000,981,3240.0,태광산업보통주
2209,3240,2017-07-13,0.0516746411483253,1045000,1099000,54000,2175,3240.0,태광산업보통주
2210,3240,2017-06-09,0.041038525963149,1194000,1145000,-49000,2293,3240.0,태광산업보통주
2211,3240,2017-06-08,0.0632235084594835,1123000,1194000,71000,3325,3240.0,태광산업보통주
2212,3240,2017-05-25,0.0538687561214495,1021000,1076000,55000,2063,3240.0,태광산업보통주
2213,3240,2017-05-16,0.0823271130625686,911000,986000,75000,3523,3240.0,태광산업보통주
2214,3240,2017-05-11,0.0442477876106194,904000,944000,40000,1583,3240.0,태광산업보통주
2215,3240,2017-01-12,0.0519067796610169,944000,993000,49000,731,3240.0,태광산업보통주
2216,3240,2016-12-07,0.0527448869752422,929000,978000,49000,1400,3240.0,태광산업보통주
2217,3240,2016-11-10,0.0504694835680751,852000,895000,43000,996,3240.0,태광산업보통주
2218,3240,2016-08-18,0.0445652173913043,920000,879000,-41000,1551,3240.0,태광산업보통주
2219,3410,2021-05-03,0.0412371134020618,7760,7440,-320,2825900,3410.0,쌍용C&E보통주
2220,3410,2021-03-26,0.0785714285714285,7000,7550,550,19975688,3410.0,쌍용C&E보통주
2221,3410,2021-01-19,0.0458715596330275,6540,6840,300,5061676,3410.0,쌍용C&E보통주
2222,3410,2020-12-10,0.0585651537335285,6830,7230,400,8649599,3410.0,쌍용C&E보통주
2223,3410,2020-12-04,0.1117117117117117,5550,6700,1150,22171425,3410.0,쌍용C&E보통주
2224,3410,2020-09-18,0.0473684210526315,5700,5970,270,2184869,3410.0,쌍용C&E보통주
2225,3410,2020-09-02,0.0684210526315789,5700,6090,390,6013818,3410.0,쌍용C&E보통주
2226,3410,2020-08-06,0.0675944333996023,5030,5370,340,8643152,3410.0,쌍용C&E보통주
2227,3410,2020-04-23,0.0441176470588235,5440,5200,-240,3216036,3410.0,쌍용C&E보통주
2228,3410,2020-04-22,0.0858283433133732,5010,5440,430,12063898,3410.0,쌍용C&E보통주
2229,3410,2020-04-16,0.0561330561330561,4810,5080,270,2018492,3410.0,쌍용C&E보통주
2230,3410,2020-03-23,0.0448717948717948,4680,4470,-210,982500,3410.0,쌍용C&E보통주
2231,3410,2020-03-20,0.1541307028360049,4055,4680,625,1658698,3410.0,쌍용C&E보통주
2232,3410,2020-03-19,0.1126914660831509,4570,4055,-515,2669126,3410.0,쌍용C&E보통주
2233,3410,2020-03-18,0.0701932858596134,4915,4570,-345,1498036,3410.0,쌍용C&E보통주
2234,3410,2020-02-26,0.0521920668058455,4790,5040,250,2984825,3410.0,쌍용C&E보통주
2235,3410,2020-02-25,0.0597345132743362,4520,4790,270,1558792,3410.0,쌍용C&E보통주
2236,3410,2020-01-08,0.042910447761194,5360,5130,-230,1603812,3410.0,쌍용C&E보통주
2237,3410,2019-12-27,0.0406091370558375,5910,5670,-240,2024909,3410.0,쌍용C&E보통주
2238,3410,2019-12-13,0.0423572744014733,5430,5660,230,1265855,3410.0,쌍용C&E보통주
2239,3410,2019-05-10,0.0416666666666666,6000,5750,-250,1727733,3410.0,쌍용C&E보통주
2240,3410,2019-03-28,0.0614617940199335,6020,6390,370,2877329,3410.0,쌍용C&E보통주
2241,3410,2019-02-28,0.056547619047619,6720,6340,-380,2097382,3410.0,쌍용C&E보통주
2242,3410,2019-01-16,0.0410509031198686,6090,6340,250,2453523,3410.0,쌍용C&E보통주
2243,3410,2018-12-18,0.0528109028960817,5870,6180,310,3494383,3410.0,쌍용C&E보통주
2244,3410,2018-12-17,0.0455284552845528,6150,5870,-280,1458122,3410.0,쌍용C&E보통주
2245,3410,2018-12-13,0.0540069686411149,5740,6050,310,1536226,3410.0,쌍용C&E보통주
2246,3410,2018-12-03,0.0408858603066439,5870,6110,240,2650048,3410.0,쌍용C&E보통주
2247,3410,2018-11-21,0.0545774647887323,5680,5990,310,1753077,3410.0,쌍용C&E보통주
2248,3410,2018-11-19,0.040590405904059,5420,5640,220,1990729,3410.0,쌍용C&E보통주
2249,3410,2018-11-08,0.0686274509803921,5100,5450,350,1819681,3410.0,쌍용C&E보통주
2250,3410,2018-11-02,0.0589451913133402,4835,5120,285,1973744,3410.0,쌍용C&E보통주
2251,3410,2018-10-29,0.0459183673469387,4900,4675,-225,1188330,3410.0,쌍용C&E보통주
2252,3410,2018-10-26,0.0485436893203883,5150,4900,-250,1521844,3410.0,쌍용C&E보통주
2253,3410,2018-10-23,0.0418181818181818,5500,5270,-230,965367,3410.0,쌍용C&E보통주
2254,3410,2018-10-10,0.0910543130990415,6260,5690,-570,3262006,3410.0,쌍용C&E보통주
2255,3410,2018-10-05,0.0416666666666666,6480,6210,-270,1881169,3410.0,쌍용C&E보통주
2256,3410,2018-09-21,0.0606060606060606,6270,6650,380,2609760,3410.0,쌍용C&E보통주
2257,3410,2018-09-10,0.0719874804381846,6390,6850,460,4711908,3410.0,쌍용C&E보통주
2258,3410,2018-08-28,0.0761245674740484,5780,6220,440,5393695,3410.0,쌍용C&E보통주
2259,3410,2018-08-27,0.043046357615894,6040,5780,-260,2829552,3410.0,쌍용C&E보통주
2260,3410,2018-08-23,0.0972477064220183,5450,5980,530,6084708,3410.0,쌍용C&E보통주
2261,3410,2018-08-14,0.0626185958254269,5270,5600,330,2031029,3410.0,쌍용C&E보통주
2262,3410,2018-08-13,0.0738137082601054,5690,5270,-420,3462524,3410.0,쌍용C&E보통주
2263,3410,2018-08-10,0.0942307692307692,5200,5690,490,3598304,3410.0,쌍용C&E보통주
2264,3410,2018-07-25,0.0596707818930041,4860,5150,290,3045161,3410.0,쌍용C&E보통주
2265,3410,2018-07-24,0.0530877573131094,4615,4860,245,2598764,3410.0,쌍용C&E보통주
2266,3410,2018-07-18,0.0698818897637795,5080,4725,-355,2235070,3410.0,쌍용C&E보통주
2267,3410,2018-07-12,0.0578947368421052,5700,5370,-330,2075289,3410.0,쌍용C&E보통주
2268,3410,2018-07-02,0.0598591549295774,28400,26700,-1700,197359,3410.0,쌍용C&E보통주
2269,3410,2018-06-29,0.0518518518518518,27000,28400,1400,512834,3410.0,쌍용C&E보통주
2270,3410,2018-06-28,0.0526315789473684,28500,27000,-1500,389084,3410.0,쌍용C&E보통주
2271,3410,2018-06-27,0.0515806988352745,30050,28500,-1550,369337,3410.0,쌍용C&E보통주
2272,3410,2018-06-19,0.0693240901213171,28850,30850,2000,1094264,3410.0,쌍용C&E보통주
2273,3410,2018-06-14,0.0512396694214876,30250,28700,-1550,642276,3410.0,쌍용C&E보통주
2274,3410,2018-06-12,0.0605590062111801,32200,30250,-1950,899586,3410.0,쌍용C&E보통주
2275,3410,2018-06-11,0.0454545454545454,30800,32200,1400,567663,3410.0,쌍용C&E보통주
2276,3410,2018-06-07,0.0451713395638629,32100,30650,-1450,491749,3410.0,쌍용C&E보통주
2277,3410,2018-05-29,0.082901554404145,38600,35400,-3200,1339442,3410.0,쌍용C&E보통주
2278,3410,2018-05-28,0.2996632996632997,29700,38600,8900,2297866,3410.0,쌍용C&E보통주
2279,3410,2018-05-25,0.0889570552147239,32600,29700,-2900,1250266,3410.0,쌍용C&E보통주
2280,3410,2018-05-16,0.0990752972258916,37850,34100,-3750,1516683,3410.0,쌍용C&E보통주
2281,3410,2018-05-14,0.130307467057101,34150,38600,4450,1964124,3410.0,쌍용C&E보통주
2282,3410,2018-05-11,0.0459418070444104,32650,34150,1500,700909,3410.0,쌍용C&E보통주
2283,3410,2018-05-10,0.0448,31250,32650,1400,751701,3410.0,쌍용C&E보통주
2284,3410,2018-05-04,0.0561056105610561,30300,32000,1700,676279,3410.0,쌍용C&E보통주
2285,3410,2018-05-02,0.0569514237855946,29850,31550,1700,1810352,3410.0,쌍용C&E보통주
2286,3410,2018-04-30,0.1987951807228915,24900,29850,4950,2093454,3410.0,쌍용C&E보통주
2287,3410,2018-04-26,0.0497925311203319,24100,25300,1200,1151528,3410.0,쌍용C&E보통주
2288,3410,2018-04-19,0.0866807610993657,23650,25700,2050,2248527,3410.0,쌍용C&E보통주
2289,3410,2018-04-18,0.0701357466063348,22100,23650,1550,602820,3410.0,쌍용C&E보통주
2290,3410,2018-03-28,0.06,22500,23850,1350,435978,3410.0,쌍용C&E보통주
2291,3410,2018-03-16,0.0502283105022831,21900,20800,-1100,159700,3410.0,쌍용C&E보통주
2292,3410,2018-03-15,0.0922693266832917,20050,21900,1850,251945,3410.0,쌍용C&E보통주
2293,3410,2018-03-09,0.0525,20000,21050,1050,191710,3410.0,쌍용C&E보통주
2294,3410,2018-02-27,0.0503778337531486,19850,20850,1000,196831,3410.0,쌍용C&E보통주
2295,3410,2018-01-29,0.0460829493087557,21700,22700,1000,209901,3410.0,쌍용C&E보통주
2296,3410,2018-01-26,0.0663390663390663,20350,21700,1350,403567,3410.0,쌍용C&E보통주
2297,3410,2018-01-24,0.0527704485488126,18950,19950,1000,281904,3410.0,쌍용C&E보통주
2298,3410,2018-01-09,0.0425,20000,19150,-850,185590,3410.0,쌍용C&E보통주
2299,3410,2018-01-08,0.0899182561307901,18350,20000,1650,279475,3410.0,쌍용C&E보통주
2300,3410,2017-12-15,0.270096463022508,15550,19750,4200,223263,3410.0,쌍용C&E보통주
2301,3410,2017-12-14,0.2005141388174807,19450,15550,-3900,336730,3410.0,쌍용C&E보통주
2302,3410,2017-12-08,0.0444444444444444,20250,19350,-900,151376,3410.0,쌍용C&E보통주
2303,3410,2017-11-23,0.0433673469387755,19600,20450,850,437672,3410.0,쌍용C&E보통주
2304,3410,2017-11-10,0.056,18750,19800,1050,942125,3410.0,쌍용C&E보통주
2305,3410,2017-11-09,0.056338028169014,17750,18750,1000,563572,3410.0,쌍용C&E보통주
2306,3410,2017-11-02,0.087087087087087,16650,18100,1450,1514987,3410.0,쌍용C&E보통주
2307,3410,2017-10-30,0.0412698412698412,15750,16400,650,739920,3410.0,쌍용C&E보통주
2308,3410,2017-10-26,0.0650684931506849,14600,15550,950,750310,3410.0,쌍용C&E보통주
2309,3410,2017-10-13,0.057471264367816,13050,13800,750,570801,3410.0,쌍용C&E보통주
2310,3410,2017-10-12,0.0653061224489796,12250,13050,800,369559,3410.0,쌍용C&E보통주
2311,3410,2017-09-28,0.0555555555555555,12600,11900,-700,455851,3410.0,쌍용C&E보통주
2312,3410,2017-09-11,0.0510948905109489,13700,13000,-700,188076,3410.0,쌍용C&E보통주
2313,3410,2017-08-21,0.0416666666666666,13200,12650,-550,232803,3410.0,쌍용C&E보통주
2314,3410,2017-07-17,0.0685920577617328,13850,14800,950,365909,3410.0,쌍용C&E보통주
2315,3410,2017-06-26,0.0412371134020618,14550,15150,600,986836,3410.0,쌍용C&E보통주
2316,3410,2017-06-05,0.0482315112540192,15550,14800,-750,438517,3410.0,쌍용C&E보통주
2317,3410,2017-05-19,0.0454545454545454,14300,14950,650,256568,3410.0,쌍용C&E보통주
2318,3410,2017-03-28,0.0445205479452054,14600,15250,650,174064,3410.0,쌍용C&E보통주
2319,3410,2017-03-06,0.0412371134020618,14550,13950,-600,139560,3410.0,쌍용C&E보통주
2320,3410,2017-02-28,0.0498338870431893,15050,14300,-750,229410,3410.0,쌍용C&E보통주
2321,3410,2017-02-10,0.0536912751677852,14900,15700,800,180004,3410.0,쌍용C&E보통주
2322,3410,2017-01-25,0.0448275862068965,14500,13850,-650,116087,3410.0,쌍용C&E보통주
2323,3410,2017-01-10,0.0503597122302158,13900,14600,700,165140,3410.0,쌍용C&E보통주
2324,3410,2016-12-28,0.0851851851851851,13500,14650,1150,532805,3410.0,쌍용C&E보통주
2325,3410,2016-12-26,0.0726643598615917,14450,13400,-1050,611891,3410.0,쌍용C&E보통주
2326,3410,2016-12-09,0.0419354838709677,15500,14850,-650,130573,3410.0,쌍용C&E보통주
2327,3410,2016-11-11,0.044776119402985,16750,17500,750,144119,3410.0,쌍용C&E보통주
2328,3410,2016-11-10,0.0534591194968553,15900,16750,850,109544,3410.0,쌍용C&E보통주
2329,3410,2016-11-04,0.0512820512820512,15600,16400,800,141062,3410.0,쌍용C&E보통주
2330,3410,2016-10-28,0.0409356725146198,17100,16400,-700,85681,3410.0,쌍용C&E보통주
2331,3410,2016-10-24,0.0458715596330275,16350,17100,750,95376,3410.0,쌍용C&E보통주
2332,3410,2016-10-17,0.0471976401179941,16950,16150,-800,135835,3410.0,쌍용C&E보통주
2333,3410,2016-10-13,0.0427350427350427,17550,16800,-750,103423,3410.0,쌍용C&E보통주
2334,3410,2016-09-21,0.0618556701030927,14550,15450,900,384204,3410.0,쌍용C&E보통주
2335,3410,2016-09-20,0.0934579439252336,16050,14550,-1500,664022,3410.0,쌍용C&E보통주
2336,3410,2016-09-13,0.0615835777126099,17050,16000,-1050,185893,3410.0,쌍용C&E보통주
2337,3490,2021-06-02,0.0615141955835962,31700,33650,1950,11787950,3490.0,대한항공보통주
2338,3490,2021-05-25,0.0539629005059021,29650,31250,1600,9971928,3490.0,대한항공보통주
2339,3490,2021-05-17,0.0409556313993174,29300,30500,1200,8708514,3490.0,대한항공보통주
2340,3490,2021-05-10,0.0663082437275985,27900,29750,1850,10012006,3490.0,대한항공보통주
2341,3490,2021-05-06,0.0474383301707779,26350,27600,1250,5975426,3490.0,대한항공보통주
2342,3490,2021-03-26,0.0466417910447761,26800,28050,1250,4755324,3490.0,대한항공보통주
2343,3490,2021-02-08,0.0466666666666666,30000,31400,1400,7227875,3490.0,대한항공보통주
2344,3490,2021-01-25,0.0929899856938483,34950,30350,-4600,12392646,3490.0,대한항공보통주
2345,3490,2021-01-22,0.0574886535552193,33050,34950,1900,11501503,3490.0,대한항공보통주
2346,3490,2021-01-19,0.0410509031198686,30450,31700,1250,3076678,3490.0,대한항공보통주
2347,3490,2021-01-18,0.0528771384136858,32150,30450,-1700,4329133,3490.0,대한항공보통주
2348,3490,2021-01-14,0.0755336617405583,30450,32750,2300,11572949,3490.0,대한항공보통주
2349,3490,2021-01-11,0.043010752688172,27900,29100,1200,18754274,3490.0,대한항공보통주
2350,3490,2020-11-17,0.0890538033395176,26950,24550,-2400,29343022,3490.0,대한항공보통주
2351,3490,2020-11-16,0.1252609603340292,23950,26950,3000,74509096,3490.0,대한항공보통주
2352,3490,2020-11-12,0.0428015564202334,25700,24600,-1100,7048416,3490.0,대한항공보통주
2353,3490,2020-11-11,0.0597938144329896,24250,25700,1450,12939812,3490.0,대한항공보통주
2354,3490,2020-11-10,0.1123853211009174,21800,24250,2450,18803992,3490.0,대한항공보통주
2355,3490,2020-11-09,0.048076923076923,20800,21800,1000,5125236,3490.0,대한항공보통주
2356,3490,2020-10-12,0.0455696202531645,19750,20650,900,4863798,3490.0,대한항공보통주
2357,3490,2020-08-20,0.046195652173913,18400,17550,-850,2206150,3490.0,대한항공보통주
2358,3490,2020-08-18,0.0641025641025641,19500,18250,-1250,3203963,3490.0,대한항공보통주
2359,3490,2020-08-07,0.0552486187845303,18100,19100,1000,15844472,3490.0,대한항공보통주
2360,3490,2020-08-06,0.0492753623188405,17250,18100,850,5637601,3490.0,대한항공보통주
2361,3490,2020-07-27,0.0434782608695652,18400,17600,-800,3293141,3490.0,대한항공보통주
2362,3490,2020-07-21,0.077562326869806,18050,19450,1400,3701663,3490.0,대한항공보통주
2363,3490,2020-07-16,0.04,17500,18200,700,2300332,3490.0,대한항공보통주
2364,3490,2020-06-15,0.0404040404040404,19800,19000,-800,1311311,3490.0,대한항공보통주
2365,3490,2020-06-05,0.0633187772925764,22900,20600,-2300,7552462,3490.0,대한항공보통주
2366,3490,2020-06-03,0.0592417061611374,21100,22350,1250,3549822,3490.0,대한항공보통주
2367,3490,2020-05-26,0.0465116279069767,19350,20250,900,2295923,3490.0,대한항공보통주
2368,3490,2020-05-19,0.0803324099722991,18050,19500,1450,4285639,3490.0,대한항공보통주
2369,3490,2020-04-20,0.0645933014354067,20900,19550,-1350,6811234,3490.0,대한항공보통주
2370,3490,2020-04-17,0.0663265306122449,19600,20900,1300,10793150,3490.0,대한항공보통주
2371,3490,2020-04-09,0.0445026178010471,19100,19950,850,2675324,3490.0,대한항공보통주
2372,3490,2020-03-26,0.0576368876080691,17350,18350,1000,4960871,3490.0,대한항공보통주
2373,3490,2020-03-25,0.1566666666666666,15000,17350,2350,4564606,3490.0,대한항공보통주
2374,3490,2020-03-24,0.0489510489510489,14300,15000,700,2680025,3490.0,대한항공보통주
2375,3490,2020-03-23,0.0622950819672131,15250,14300,-950,3347088,3490.0,대한항공보통주
2376,3490,2020-03-20,0.1213235294117647,13600,15250,1650,7782231,3490.0,대한항공보통주
2377,3490,2020-03-19,0.2486187845303867,18100,13600,-4500,5231313,3490.0,대한항공보통주
2378,3490,2020-03-18,0.0858585858585858,19800,18100,-1700,1426430,3490.0,대한항공보통주
2379,3490,2020-03-13,0.0506912442396313,21700,20600,-1100,1799050,3490.0,대한항공보통주
2380,3490,2020-03-12,0.0461538461538461,22750,21700,-1050,1355702,3490.0,대한항공보통주
2381,3490,2020-03-06,0.0517928286852589,25100,23800,-1300,1520202,3490.0,대한항공보통주
2382,3490,2020-03-05,0.0458333333333333,24000,25100,1100,2216940,3490.0,대한항공보통주
2383,3490,2020-03-04,0.0714285714285714,22400,24000,1600,1459603,3490.0,대한항공보통주
2384,3490,2020-02-24,0.0615711252653927,23550,22100,-1450,1633736,3490.0,대한항공보통주
2385,3490,2020-02-04,0.0662525879917184,24150,25750,1600,1956707,3490.0,대한항공보통주
2386,3490,2020-01-28,0.0669291338582677,25400,23700,-1700,1668337,3490.0,대한항공보통주
2387,3490,2020-01-23,0.0415094339622641,26500,25400,-1100,757735,3490.0,대한항공보통주
2388,3490,2020-01-09,0.0437262357414448,26300,27450,1150,614807,3490.0,대한항공보통주
2389,3490,2019-12-23,0.0467625899280575,27800,29100,1300,1847155,3490.0,대한항공보통주
2390,3490,2019-12-06,0.054989816700611,24550,25900,1350,812762,3490.0,대한항공보통주
2391,3490,2019-11-15,0.0505836575875486,25700,27000,1300,686734,3490.0,대한항공보통주
2392,3490,2019-10-14,0.0560344827586206,23200,24500,1300,1109046,3490.0,대한항공보통주
2393,3490,2019-09-11,0.0436681222707423,22900,23900,1000,1362509,3490.0,대한항공보통주
2394,3490,2019-08-05,0.0407766990291262,25750,24700,-1050,641816,3490.0,대한항공보통주
2395,3490,2019-04-16,0.0503311258278145,37750,35850,-1900,2834762,3490.0,대한항공보통주
2396,3490,2019-04-15,0.0603932584269662,35600,37750,2150,6712935,3490.0,대한항공보통주
2397,3490,2019-04-12,0.0755287009063444,33100,35600,2500,2617556,3490.0,대한항공보통주
2398,3490,2019-03-28,0.0527108433734939,33200,31450,-1750,1008170,3490.0,대한항공보통주
2399,3490,2019-01-30,0.046742209631728,35300,36950,1650,1081739,3490.0,대한항공보통주
2400,3490,2019-01-25,0.0426409903713892,36350,34800,-1550,1033315,3490.0,대한항공보통주
2401,3490,2018-11-30,0.0449101796407185,33400,31900,-1500,890923,3490.0,대한항공보통주
2402,3490,2018-11-14,0.0942760942760942,29700,32500,2800,2705130,3490.0,대한항공보통주
2403,3490,2018-11-02,0.0463458110516934,28050,29350,1300,1462021,3490.0,대한항공보통주
2404,3490,2018-10-31,0.063953488372093,25800,27450,1650,641164,3490.0,대한항공보통주
2405,3490,2018-10-11,0.0626151012891344,27150,25450,-1700,881536,3490.0,대한항공보통주
2406,3490,2018-07-02,0.0407079646017699,28250,27100,-1150,740922,3490.0,대한항공보통주
2407,3490,2018-06-29,0.044362292051756,27050,28250,1200,568197,3490.0,대한항공보통주
2408,3490,2018-06-21,0.0554621848739495,29750,28100,-1650,1069115,3490.0,대한항공보통주
2409,3490,2018-06-18,0.0421875,32000,30650,-1350,953419,3490.0,대한항공보통주
2410,3490,2018-04-12,0.0654596100278551,35900,33550,-2350,1340498,3490.0,대한항공보통주
2411,3490,2018-04-03,0.0465793304221251,34350,35950,1600,1488174,3490.0,대한항공보통주
2412,3490,2018-03-29,0.0447284345047923,31300,32700,1400,762724,3490.0,대한항공보통주
2413,3490,2018-03-23,0.0479134466769706,32350,30800,-1550,1026973,3490.0,대한항공보통주
2414,3490,2018-01-02,0.0605612998522895,33850,35900,2050,1360084,3490.0,대한항공보통주
2415,3490,2017-12-13,0.0677419354838709,31000,33100,2100,1669018,3490.0,대한항공보통주
2416,3490,2017-11-17,0.0547504025764895,31050,32750,1700,2631860,3490.0,대한항공보통주
2417,3490,2017-10-26,0.0590163934426229,30500,32300,1800,1358053,3490.0,대한항공보통주
2418,3490,2017-10-19,0.0561224489795918,29400,31050,1650,806595,3490.0,대한항공보통주
2419,3490,2017-07-26,0.0414364640883977,36200,34700,-1500,860548,3490.0,대한항공보통주
2420,3490,2017-06-19,0.0515603799185888,36850,38750,1900,1032867,3490.0,대한항공보통주
2421,3490,2017-05-04,0.0632090761750405,30850,32800,1950,1689919,3490.0,대한항공보통주
2422,3490,2017-03-21,0.042158516020236,29650,30900,1250,1028182,3490.0,대한항공보통주
2423,3490,2017-03-09,0.0503731343283582,26800,28150,1350,1168555,3490.0,대한항공보통주
2424,3490,2017-03-03,0.0477031802120141,28300,26950,-1350,963489,3490.0,대한항공보통주
2425,3490,2017-02-21,0.0411214953271028,26750,27850,1100,1443824,3490.0,대한항공보통주
2426,3490,2016-11-11,0.0570032573289902,30700,28950,-1750,845022,3490.0,대한항공보통주
2427,3490,2016-09-27,0.0436090225563909,33250,34700,1450,808493,3490.0,대한항공보통주
2428,3490,2016-09-22,0.0543478260869565,32200,33950,1750,858426,3490.0,대한항공보통주
2429,3490,2016-09-09,0.0406976744186046,34400,33000,-1400,890950,3490.0,대한항공보통주
2430,3490,2016-09-01,0.0950871632329635,31550,34550,3000,2673595,3490.0,대한항공보통주
2431,3490,2016-08-30,0.0687285223367697,29100,31100,2000,2046185,3490.0,대한항공보통주
2432,3490,2016-08-23,0.0742574257425742,30300,28050,-2250,1632246,3490.0,대한항공보통주
2433,3490,2016-08-10,0.0422535211267605,28400,29600,1200,770204,3490.0,대한항공보통주
2434,3550,2021-05-31,0.0560747663551401,107000,101000,-6000,1061671,3550.0,LG보통주
2435,3550,2021-05-27,0.0869565217391304,126500,108500,-18000,1781390,3550.0,LG보통주
2436,3550,2021-04-28,0.0675105485232067,118500,126500,8000,1380617,3550.0,LG보통주
2437,3550,2021-04-27,0.0443548387096774,124000,118500,-5500,1011527,3550.0,LG보통주
2438,3550,2021-04-26,0.0829694323144104,114500,124000,9500,1416097,3550.0,LG보통주
2439,3550,2021-04-23,0.0504587155963302,109000,114500,5500,639572,3550.0,LG보통주
2440,3550,2021-04-15,0.0788177339901477,101500,109500,8000,1925401,3550.0,LG보통주
2441,3550,2021-04-14,0.0583941605839416,95900,101500,5600,784271,3550.0,LG보통주
2442,3550,2021-04-12,0.0474090407938257,90700,95000,4300,618231,3550.0,LG보통주
2443,3550,2021-02-22,0.0411646586345381,99600,95500,-4100,672404,3550.0,LG보통주
2444,3550,2021-02-18,0.0426540284360189,105500,101000,-4500,560427,3550.0,LG보통주
2445,3550,2021-02-17,0.0538116591928251,111500,105500,-6000,596989,3550.0,LG보통주
2446,3550,2021-02-10,0.0476190476190476,105000,110000,5000,700702,3550.0,LG보통주
2447,3550,2021-01-29,0.0425120772946859,103500,99100,-4400,748985,3550.0,LG보통주
2448,3550,2021-01-26,0.0542986425339366,110500,104500,-6000,863557,3550.0,LG보통주
2449,3550,2021-01-22,0.0735930735930736,115500,107000,-8500,1249988,3550.0,LG보통주
2450,3550,2021-01-21,0.064516129032258,108500,115500,7000,1853456,3550.0,LG보통주
2451,3550,2021-01-20,0.0533980582524271,103000,108500,5500,807210,3550.0,LG보통주
2452,3550,2021-01-14,0.0483091787439613,103500,108500,5000,1006769,3550.0,LG보통주
2453,3550,2021-01-07,0.1048304213771839,97300,107500,10200,3425106,3550.0,LG보통주
2454,3550,2021-01-04,0.1074285714285714,87500,96900,9400,2269706,3550.0,LG보통주
2455,3550,2020-12-23,0.1034482758620689,78300,86400,8100,7758366,3550.0,LG보통주
2456,3550,2020-11-30,0.0611702127659574,75200,70600,-4600,1176464,3550.0,LG보통주
2457,3550,2020-08-21,0.0847029077117572,79100,85800,6700,548515,3550.0,LG보통주
2458,3550,2020-08-20,0.0435308343409915,82700,79100,-3600,475768,3550.0,LG보통주
2459,3550,2020-08-18,0.0406976744186046,86000,82500,-3500,396942,3550.0,LG보통주
2460,3550,2020-08-14,0.0444444444444444,90000,86000,-4000,438723,3550.0,LG보통주
2461,3550,2020-08-10,0.0465116279069767,86000,90000,4000,546654,3550.0,LG보통주
2462,3550,2020-08-07,0.0411622276029055,82600,86000,3400,487203,3550.0,LG보통주
2463,3550,2020-08-05,0.0524296675191815,78200,82300,4100,469770,3550.0,LG보통주
2464,3550,2020-08-04,0.0454545454545454,74800,78200,3400,550498,3550.0,LG보통주
2465,3550,2020-06-17,0.0865384615384615,72800,79100,6300,838913,3550.0,LG보통주
2466,3550,2020-06-16,0.0566037735849056,68900,72800,3900,322346,3550.0,LG보통주
2467,3550,2020-06-15,0.0430555555555555,72000,68900,-3100,408844,3550.0,LG보통주
2468,3550,2020-06-04,0.0515463917525773,67900,71400,3500,616827,3550.0,LG보통주
2469,3550,2020-05-19,0.0504885993485342,61400,64500,3100,375551,3550.0,LG보통주
2470,3550,2020-04-16,0.0415282392026578,60200,62700,2500,594662,3550.0,LG보통주
2471,3550,2020-04-06,0.0910714285714285,56000,61100,5100,283092,3550.0,LG보통주
2472,3550,2020-04-01,0.059322033898305,59000,55500,-3500,354857,3550.0,LG보통주
2473,3550,2020-03-27,0.0444049733570159,56300,58800,2500,421212,3550.0,LG보통주
2474,3550,2020-03-26,0.0473773265651438,59100,56300,-2800,418017,3550.0,LG보통주
2475,3550,2020-03-25,0.1431334622823984,51700,59100,7400,494572,3550.0,LG보통주
2476,3550,2020-03-24,0.1178378378378378,46250,51700,5450,412014,3550.0,LG보통주
2477,3550,2020-03-23,0.0463917525773195,48500,46250,-2250,423348,3550.0,LG보통주
2478,3550,2020-03-19,0.0551181102362204,50800,48000,-2800,544107,3550.0,LG보통주
2479,3550,2020-03-18,0.0695970695970696,54600,50800,-3800,497779,3550.0,LG보통주
2480,3550,2020-03-17,0.0634648370497427,58300,54600,-3700,430706,3550.0,LG보통주
2481,3550,2020-03-16,0.0411184210526315,60800,58300,-2500,346457,3550.0,LG보통주
2482,3550,2020-03-12,0.0444104134762634,65300,62400,-2900,537896,3550.0,LG보통주
2483,3550,2020-02-12,0.0595238095238095,75600,80100,4500,576513,3550.0,LG보통주
2484,3550,2019-03-25,0.0459770114942528,78300,74700,-3600,150144,3550.0,LG보통주
2485,3550,2019-01-15,0.0457142857142857,70000,73200,3200,204124,3550.0,LG보통주
2486,3550,2018-12-12,0.0562962962962962,67500,71300,3800,230477,3550.0,LG보통주
2487,3550,2018-10-31,0.0457413249211356,63400,66300,2900,278055,3550.0,LG보통주
2488,3550,2018-10-11,0.0639880952380952,67200,62900,-4300,514140,3550.0,LG보통주
2489,3550,2018-06-21,0.0407608695652173,73600,70600,-3000,378677,3550.0,LG보통주
2490,3550,2018-05-10,0.0451030927835051,77600,81100,3500,443695,3550.0,LG보통주
2491,3550,2018-01-09,0.0446428571428571,89600,93600,4000,419749,3550.0,LG보통주
2492,3550,2017-11-13,0.0483689538807649,88900,84600,-4300,597891,3550.0,LG보통주
2493,3550,2017-08-30,0.0619578686493184,80700,85700,5000,622956,3550.0,LG보통주
2494,3550,2017-06-12,0.040983606557377,85400,81900,-3500,383009,3550.0,LG보통주
2495,3550,2017-06-09,0.0452876376988984,81700,85400,3700,710929,3550.0,LG보통주
2496,3550,2017-05-24,0.0498687664041994,76200,80000,3800,652389,3550.0,LG보통주
2497,3550,2017-05-08,0.0496350364963503,68500,71900,3400,446813,3550.0,LG보통주
2498,3550,2017-02-01,0.0523648648648648,59200,62300,3100,549859,3550.0,LG보통주
2499,3550,2016-12-26,0.0423728813559322,59000,61500,2500,577508,3550.0,LG보통주
2500,3670,2021-05-04,0.0418118466898954,143500,149500,6000,354856,3670.0,포스코케미칼보통주
2501,3670,2021-04-12,0.0496894409937888,161000,169000,8000,867164,3670.0,포스코케미칼보통주
2502,3670,2021-03-30,0.0582191780821917,146000,154500,8500,575359,3670.0,포스코케미칼보통주
2503,3670,2021-03-11,0.0551724137931034,145000,153000,8000,714139,3670.0,포스코케미칼보통주
2504,3670,2021-03-09,0.0596026490066225,151000,142000,-9000,1131607,3670.0,포스코케미칼보통주
2505,3670,2021-03-08,0.062111801242236,161000,151000,-10000,555247,3670.0,포스코케미칼보통주
2506,3670,2021-02-24,0.0705882352941176,170000,158000,-12000,1135629,3670.0,포스코케미칼보통주
2507,3670,2021-02-19,0.0676923076923076,162500,173500,11000,944987,3670.0,포스코케미칼보통주
2508,3670,2021-02-17,0.0456026058631921,153500,160500,7000,725565,3670.0,포스코케미칼보통주
2509,3670,2021-01-22,0.0568181818181818,132000,139500,7500,1337627,3670.0,포스코케미칼보통주
2510,3670,2021-01-18,0.0426356589147286,129000,123500,-5500,597673,3670.0,포스코케미칼보통주
2511,3670,2021-01-14,0.047808764940239,125500,131500,6000,554272,3670.0,포스코케미칼보통주
2512,3670,2021-01-05,0.0508474576271186,118000,124000,6000,1374593,3670.0,포스코케미칼보통주
2513,3670,2021-01-04,0.1346153846153846,104000,118000,14000,2122467,3670.0,포스코케미칼보통주
2514,3670,2020-12-09,0.1593406593406593,91000,105500,14500,4196459,3670.0,포스코케미칼보통주
2515,3670,2020-12-02,0.0578602620087336,91600,96900,5300,1022585,3670.0,포스코케미칼보통주
2516,3670,2020-11-27,0.0516055045871559,87200,91700,4500,1210760,3670.0,포스코케미칼보통주
2517,3670,2020-11-24,0.0496277915632754,80600,84600,4000,741036,3670.0,포스코케미칼보통주
2518,3670,2020-11-05,0.0523627075351213,78300,82400,4100,527823,3670.0,포스코케미칼보통주
2519,3670,2020-09-24,0.0996523754345307,86300,77700,-8600,1044637,3670.0,포스코케미칼보통주
2520,3670,2020-09-18,0.0519031141868512,86700,91200,4500,1106653,3670.0,포스코케미칼보통주
2521,3670,2020-08-18,0.0461868958109559,93100,88800,-4300,1024762,3670.0,포스코케미칼보통주
2522,3670,2020-08-14,0.05,98000,93100,-4900,1012271,3670.0,포스코케미칼보통주
2523,3670,2020-08-07,0.0946408209806157,87700,96000,8300,2719370,3670.0,포스코케미칼보통주
2524,3670,2020-08-05,0.1058064516129032,77500,85700,8200,4159184,3670.0,포스코케미칼보통주
2525,3670,2020-07-31,0.0413223140495867,72600,75600,3000,1104541,3670.0,포스코케미칼보통주
2526,3670,2020-07-09,0.0808344198174706,76700,82900,6200,1224524,3670.0,포스코케미칼보통주
2527,3670,2020-06-19,0.046831955922865,72600,76000,3400,1309186,3670.0,포스코케미칼보통주
2528,3670,2020-06-17,0.0479651162790697,68800,72100,3300,2719317,3670.0,포스코케미칼보통주
2529,3670,2020-06-16,0.1297208538587849,60900,68800,7900,2644125,3670.0,포스코케미칼보통주
2530,3670,2020-06-15,0.0572755417956656,64600,60900,-3700,1098297,3670.0,포스코케미칼보통주
2531,3670,2020-06-01,0.0576576576576576,55500,58700,3200,645359,3670.0,포스코케미칼보통주
2532,3670,2020-05-27,0.0431177446102819,60300,57700,-2600,699736,3670.0,포스코케미칼보통주
2533,3670,2020-05-13,0.0596421471172962,50300,53300,3000,923860,3670.0,포스코케미칼보통주
2534,3670,2020-04-16,0.0844919786096256,46750,50700,3950,737256,3670.0,포스코케미칼보통주
2535,3670,2020-04-07,0.0454545454545454,44000,46000,2000,715089,3670.0,포스코케미칼보통주
2536,3670,2020-03-25,0.0664993726474278,39850,42500,2650,847683,3670.0,포스코케미칼보통주
2537,3670,2020-03-24,0.077027027027027,37000,39850,2850,841885,3670.0,포스코케미칼보통주
2538,3670,2020-03-20,0.1450151057401812,33100,37900,4800,1026044,3670.0,포스코케미칼보통주
2539,3670,2020-03-19,0.1651954602774274,39650,33100,-6550,1511618,3670.0,포스코케미칼보통주
2540,3670,2020-03-18,0.0811123986095017,43150,39650,-3500,770704,3670.0,포스코케미칼보통주
2541,3670,2020-03-16,0.0766045548654244,48300,44600,-3700,754341,3670.0,포스코케미칼보통주
2542,3670,2020-03-13,0.0603112840466926,51400,48300,-3100,1385885,3670.0,포스코케미칼보통주
2543,3670,2020-03-12,0.0499075785582255,54100,51400,-2700,977763,3670.0,포스코케미칼보통주
2544,3670,2020-03-09,0.0686767169179229,59700,55600,-4100,725587,3670.0,포스코케미칼보통주
2545,3670,2020-02-28,0.0631399317406143,58600,54900,-3700,1026027,3670.0,포스코케미칼보통주
2546,3670,2020-02-21,0.048465266558966,61900,58900,-3000,650423,3670.0,포스코케미칼보통주
2547,3670,2020-02-11,0.0423452768729641,61400,64000,2600,1202957,3670.0,포스코케미칼보통주
2548,3670,2020-02-04,0.0515463917525773,58200,61200,3000,1059952,3670.0,포스코케미칼보통주
2549,3670,2020-01-31,0.0496688741721854,60400,57400,-3000,867910,3670.0,포스코케미칼보통주
2550,3670,2020-01-20,0.0571955719557195,54200,57300,3100,1274235,3670.0,포스코케미칼보통주
2551,3670,2020-01-10,0.0793969849246231,49750,53700,3950,1749322,3670.0,포스코케미칼보통주
2552,3670,2020-01-08,0.0428286852589641,50200,48050,-2150,420156,3670.0,포스코케미칼보통주
2553,3670,2019-10-28,0.0504939626783754,45550,47850,2300,588776,3670.0,포스코케미칼보통주
2554,3670,2019-09-25,0.0537974683544303,47400,44850,-2550,739113,3670.0,포스코케미칼보통주
2555,3670,2019-08-08,0.0479302832244008,45900,48100,2200,404593,3670.0,포스코케미칼보통주
2556,3670,2019-08-05,0.0575539568345323,48650,45850,-2800,364863,3670.0,포스코케미칼보통주
2557,3670,2019-07-29,0.0496031746031746,50400,47900,-2500,503861,3670.0,포스코케미칼보통주
2558,3670,2019-07-22,0.059047619047619,52500,55600,3100,878559,3670.0,포스코케미칼보통주
2559,3670,2019-07-08,0.053763440860215,55800,52800,-3000,363385,3670.0,포스코케미칼보통주
2560,3670,2019-07-04,0.0411985018726591,53400,55600,2200,657560,3670.0,포스코케미칼보통주
2561,3670,2019-06-04,0.0648148148148148,54000,57500,3500,748248,3670.0,포스코케미칼보통주
2562,3670,2019-05-15,0.056640625,51200,54100,2900,319205,3670.0,포스코케미칼보통주
2563,3670,2019-05-09,0.0569395017793594,56200,53000,-3200,682957,3670.0,포스코케미칼보통주
2564,3670,2019-04-18,0.064516129032258,62000,58000,-4000,1401684,3670.0,포스코케미칼보통주
2565,3670,2019-03-25,0.0629800307219662,65100,61000,-4100,727935,3670.0,포스코케미칼보통주
2566,3670,2019-03-21,0.0410742496050552,63300,65900,2600,946363,3670.0,포스코케미칼보통주
2567,3670,2019-03-12,0.0591054313099041,62600,66300,3700,556464,3670.0,포스코케미칼보통주
2568,3670,2019-03-05,0.0426470588235294,68000,65100,-2900,801455,3670.0,포스코케미칼보통주
2569,3670,2019-02-07,0.0616666666666666,60000,63700,3700,964818,3670.0,포스코케미칼보통주
2570,3670,2019-01-25,0.0667838312829525,56900,60700,3800,978032,3670.0,포스코케미칼보통주
2571,3670,2019-01-17,0.0501618122977346,61800,58700,-3100,609103,3670.0,포스코케미칼보통주
2572,3670,2019-01-08,0.0425531914893617,61100,58500,-2600,603462,3670.0,포스코케미칼보통주
2573,3670,2019-01-07,0.0462328767123287,58400,61100,2700,753617,3670.0,포스코케미칼보통주
2574,3670,2019-01-03,0.043261231281198,60100,57500,-2600,1070099,3670.0,포스코케미칼보통주
2575,3670,2019-01-02,0.0565149136577708,63700,60100,-3600,1175854,3670.0,포스코케미칼보통주
2576,3670,2018-12-21,0.0854271356783919,59700,64800,5100,1411732,3670.0,포스코케미칼보통주
2577,3670,2018-12-19,0.0506108202443281,57300,60200,2900,991303,3670.0,포스코케미칼보통주
2578,3670,2018-12-14,0.062111801242236,64400,60400,-4000,1087581,3670.0,포스코케미칼보통주
2579,3670,2018-12-10,0.041860465116279,64500,61800,-2700,958053,3670.0,포스코케미칼보통주
2580,3670,2018-11-28,0.0456431535269709,72300,69000,-3300,970908,3670.0,포스코케미칼보통주
2581,3670,2018-11-26,0.0414285714285714,70000,72900,2900,497982,3670.0,포스코케미칼보통주
2582,3670,2018-11-23,0.042407660738714,73100,70000,-3100,937500,3670.0,포스코케미칼보통주
2583,3670,2018-11-14,0.0435339308578745,78100,74700,-3400,1066183,3670.0,포스코케미칼보통주
2584,3670,2018-11-08,0.0593103448275862,72500,76800,4300,1233681,3670.0,포스코케미칼보통주
2585,3670,2018-11-02,0.0706766917293233,66500,71200,4700,703352,3670.0,포스코케미칼보통주
2586,3670,2018-10-29,0.0628571428571428,70000,65600,-4400,951489,3670.0,포스코케미칼보통주
2587,3670,2018-10-25,0.055045871559633,65400,69000,3600,1286413,3670.0,포스코케미칼보통주
2588,3670,2018-10-23,0.0849056603773584,74200,67900,-6300,1235451,3670.0,포스코케미칼보통주
2589,3670,2018-10-16,0.0445103857566765,67400,70400,3000,787775,3670.0,포스코케미칼보통주
2590,3670,2018-10-12,0.08562197092084,61900,67200,5300,835493,3670.0,포스코케미칼보통주
2591,3670,2018-10-11,0.0788690476190476,67200,61900,-5300,892492,3670.0,포스코케미칼보통주
2592,3670,2018-10-05,0.0743919885550786,69900,64700,-5200,1100463,3670.0,포스코케미칼보통주
2593,3670,2018-10-02,0.0469613259668508,72400,69000,-3400,927840,3670.0,포스코케미칼보통주
2594,3670,2018-09-28,0.0445026178010471,76400,73000,-3400,1536859,3670.0,포스코케미칼보통주
2595,3670,2018-09-27,0.0670391061452514,71600,76400,4800,701593,3670.0,포스코케미칼보통주
2596,3670,2018-09-07,0.0754414125200642,62300,67000,4700,957169,3670.0,포스코케미칼보통주
2597,3670,2018-09-04,0.0677966101694915,59000,63000,4000,881809,3670.0,포스코케미칼보통주
2598,3670,2018-08-27,0.1005802707930367,51700,56900,5200,1372402,3670.0,포스코케미칼보통주
2599,3670,2018-08-21,0.0631578947368421,47500,50500,3000,627314,3670.0,포스코케미칼보통주
2600,3670,2018-08-16,0.0417972831765935,47850,49850,2000,443357,3670.0,포스코케미칼보통주
2601,3670,2018-08-06,0.0423892100192678,51900,49700,-2200,537832,3670.0,포스코케미칼보통주
2602,3670,2018-07-27,0.071583514099783,46100,49400,3300,1066314,3670.0,포스코케미칼보통주
2603,3670,2018-07-25,0.0508083140877598,43300,45500,2200,616673,3670.0,포스코케미칼보통주
2604,3670,2018-07-23,0.046286329386437,46450,44300,-2150,337739,3670.0,포스코케미칼보통주
2605,3670,2018-07-19,0.0414847161572052,45800,47700,1900,732114,3670.0,포스코케미칼보통주
2606,3670,2018-07-03,0.0556186152099886,44050,46500,2450,939091,3670.0,포스코케미칼보통주
2607,3670,2018-06-20,0.0694789081885856,40300,43100,2800,412319,3670.0,포스코케미칼보통주
2608,3670,2018-06-18,0.0547945205479452,43800,41400,-2400,486656,3670.0,포스코케미칼보통주
2609,3670,2018-06-07,0.045045045045045,44400,46400,2000,956229,3670.0,포스코케미칼보통주
2610,3670,2018-05-30,0.0522648083623693,43050,45300,2250,1852656,3670.0,포스코케미칼보통주
2611,3670,2018-05-29,0.0642768850432632,40450,43050,2600,1728339,3670.0,포스코케미칼보통주
2612,3670,2018-05-17,0.0679347826086956,36800,39300,2500,738630,3670.0,포스코케미칼보통주
2613,3670,2018-05-09,0.1026722925457102,35550,39200,3650,1528395,3670.0,포스코케미칼보통주
2614,3670,2018-04-18,0.0912280701754386,42750,38850,-3900,2343328,3670.0,포스코케미칼보통주
2615,3670,2018-04-04,0.0997830802603036,46100,41500,-4600,2013408,3670.0,포스코케미칼보통주
2616,3670,2018-03-26,0.0587606837606837,46800,49550,2750,462988,3670.0,포스코케미칼보통주
2617,3670,2018-03-23,0.0516717325227963,49350,46800,-2550,546106,3670.0,포스코케미칼보통주
2618,3670,2018-03-06,0.0748603351955307,44750,48100,3350,728514,3670.0,포스코케미칼보통주
2619,3670,2018-02-28,0.0561440677966101,47200,44550,-2650,599460,3670.0,포스코케미칼보통주
2620,3670,2018-02-19,0.041896361631753,45350,47250,1900,513006,3670.0,포스코케미칼보통주
2621,3670,2018-02-14,0.0497685185185185,43200,45350,2150,380273,3670.0,포스코케미칼보통주
2622,3670,2018-02-08,0.0619266055045871,43600,46300,2700,869263,3670.0,포스코케미칼보통주
2623,3670,2018-02-05,0.128,50000,43600,-6400,1350266,3670.0,포스코케미칼보통주
2624,3670,2018-01-24,0.0493827160493827,48600,51000,2400,1018165,3670.0,포스코케미칼보통주
2625,3670,2018-01-12,0.0868055555555555,43200,46950,3750,2026670,3670.0,포스코케미칼보통주
2626,3670,2018-01-11,0.0827067669172932,39900,43200,3300,1402176,3670.0,포스코케미칼보통주
2627,3670,2018-01-05,0.0765171503957783,37900,40800,2900,1255699,3670.0,포스코케미칼보통주
2628,3670,2017-12-28,0.0418848167539267,38200,39800,1600,1302506,3670.0,포스코케미칼보통주
2629,3670,2017-12-26,0.0416666666666666,36000,37500,1500,1117729,3670.0,포스코케미칼보통주
2630,3670,2017-12-22,0.0778443113772455,33400,36000,2600,969812,3670.0,포스코케미칼보통주
2631,3670,2017-11-28,0.0524861878453038,36200,34300,-1900,1308304,3670.0,포스코케미칼보통주
2632,3670,2017-11-21,0.0655307994757536,38150,35650,-2500,2733180,3670.0,포스코케미칼보통주
2633,3670,2017-11-16,0.1135693215339233,33900,37750,3850,3144653,3670.0,포스코케미칼보통주
2634,3670,2017-11-14,0.0654952076677316,31300,33350,2050,2224638,3670.0,포스코케미칼보통주
2635,3670,2017-11-09,0.0415973377703826,30050,31300,1250,1733730,3670.0,포스코케미칼보통주
2636,3670,2017-11-06,0.0459770114942528,30450,29050,-1400,1282823,3670.0,포스코케미칼보통주
2637,3670,2017-11-03,0.061633281972265,32450,30450,-2000,2534747,3670.0,포스코케미칼보통주
2638,3670,2017-11-02,0.1094017094017094,29250,32450,3200,4002305,3670.0,포스코케미칼보통주
2639,3670,2017-11-01,0.0409252669039145,28100,29250,1150,687762,3670.0,포스코케미칼보통주
2640,3670,2017-10-23,0.0515097690941385,28150,29600,1450,750673,3670.0,포스코케미칼보통주
2641,3670,2017-10-16,0.0695102685624012,31650,29450,-2200,2522327,3670.0,포스코케미칼보통주
2642,3670,2017-10-10,0.0860033726812816,29650,32200,2550,1474479,3670.0,포스코케미칼보통주
2643,3670,2017-09-22,0.0658783783783783,29600,27650,-1950,2003742,3670.0,포스코케미칼보통주
2644,3670,2017-09-21,0.0512820512820512,31200,29600,-1600,1761264,3670.0,포스코케미칼보통주
2645,3670,2017-09-20,0.0602409638554216,33200,31200,-2000,2029969,3670.0,포스코케미칼보통주
2646,3670,2017-09-19,0.0473186119873817,31700,33200,1500,1691637,3670.0,포스코케미칼보통주
2647,3670,2017-09-11,0.1073253833049403,29350,32500,3150,2748544,3670.0,포스코케미칼보통주
2648,3670,2017-09-05,0.1045454545454545,33000,29550,-3450,4246289,3670.0,포스코케미칼보통주
2649,3670,2017-08-31,0.083743842364532,30450,33000,2550,3517195,3670.0,포스코케미칼보통주
2650,3670,2017-08-30,0.0591304347826086,28750,30450,1700,2060025,3670.0,포스코케미칼보통주
2651,3670,2017-08-29,0.0767790262172284,26700,28750,2050,1849377,3670.0,포스코케미칼보통주
2652,3670,2017-08-24,0.0443159922928709,25950,27100,1150,1267528,3670.0,포스코케미칼보통주
2653,3670,2017-08-18,0.1123348017621145,22700,25250,2550,2144110,3670.0,포스코케미칼보통주
2654,3670,2017-08-09,0.060475161987041,23150,21750,-1400,947012,3670.0,포스코케미칼보통주
2655,3670,2017-08-08,0.0427927927927927,22200,23150,950,792217,3670.0,포스코케미칼보통주
2656,3670,2017-08-07,0.0553191489361702,23500,22200,-1300,859710,3670.0,포스코케미칼보통주
2657,3670,2017-08-04,0.0421286031042128,22550,23500,950,912091,3670.0,포스코케미칼보통주
2658,3670,2017-08-01,0.0859188544152744,20950,22750,1800,1681416,3670.0,포스코케미칼보통주
2659,3670,2017-07-25,0.0579345088161209,19850,21000,1150,1708603,3670.0,포스코케미칼보통주
2660,3670,2017-07-20,0.0771428571428571,17500,18850,1350,1149291,3670.0,포스코케미칼보통주
2661,3670,2017-07-17,0.0459770114942528,17400,18200,800,1101365,3670.0,포스코케미칼보통주
2662,3670,2017-07-12,0.096875,16000,17550,1550,1921797,3670.0,포스코케미칼보통주
2663,3670,2017-07-04,0.0431893687707641,15050,14400,-650,369877,3670.0,포스코케미칼보통주
2664,3670,2017-06-09,0.0436241610738255,14900,15550,650,493026,3670.0,포스코케미칼보통주
2665,3670,2017-05-25,0.0418118466898954,14350,14950,600,377042,3670.0,포스코케미칼보통주
2666,3670,2017-04-11,0.0454545454545454,14300,14950,650,285028,3670.0,포스코케미칼보통주
2667,3670,2017-03-20,0.0427046263345195,14050,14650,600,583940,3670.0,포스코케미칼보통주
2668,3670,2016-11-22,0.0593607305936073,10950,11600,650,221450,3670.0,포스코케미칼보통주
2669,3670,2016-11-14,0.055793991416309,11650,11000,-650,286801,3670.0,포스코케미칼보통주
2670,3850,2021-05-12,0.0431818181818181,22000,22950,950,1419429,3850.0,보령제약보통주
2671,3850,2021-05-04,0.0749464668094218,23350,21600,-1750,2133685,3850.0,보령제약보통주
2672,3850,2021-05-03,0.1254681647940075,26700,23350,-3350,3039290,3850.0,보령제약보통주
2673,3850,2021-04-30,0.0942622950819672,24400,26700,2300,15290897,3850.0,보령제약보통주
2674,3850,2021-04-28,0.0620985010706638,23350,24800,1450,13967351,3850.0,보령제약보통주
2675,3850,2021-04-23,0.0522875816993464,22950,24150,1200,2119627,3850.0,보령제약보통주
2676,3850,2021-04-20,0.047008547008547,23400,22300,-1100,1488370,3850.0,보령제약보통주
2677,3850,2021-04-13,0.0697674418604651,21500,23000,1500,3104372,3850.0,보령제약보통주
2678,3850,2021-03-19,0.0835322195704057,20950,22700,1750,2558446,3850.0,보령제약보통주
2679,3850,2021-03-10,0.0523690773067331,20050,21100,1050,943229,3850.0,보령제약보통주
2680,3850,2021-02-04,0.0450236966824644,21100,20150,-950,1035580,3850.0,보령제약보통주
2681,3850,2021-01-29,0.0620347394540942,20150,21400,1250,19251583,3850.0,보령제약보통주
2682,3850,2021-01-22,0.0541125541125541,23100,21850,-1250,1030978,3850.0,보령제약보통주
2683,3850,2021-01-20,0.0747663551401869,21400,23000,1600,6507534,3850.0,보령제약보통주
2684,3850,2021-01-18,0.048780487804878,22550,21450,-1100,1102270,3850.0,보령제약보통주
2685,3850,2021-01-14,0.0413943355119825,22950,22000,-950,1974954,3850.0,보령제약보통주
2686,3850,2021-01-12,0.0833333333333333,25800,23650,-2150,17709382,3850.0,보령제약보통주
2687,3850,2021-01-11,0.2997481108312342,19850,25800,5950,12639281,3850.0,보령제약보통주
2688,3850,2021-01-05,0.081081081081081,18500,20000,1500,1713680,3850.0,보령제약보통주
2689,3850,2020-12-18,0.0462724935732647,19450,20350,900,1978878,3850.0,보령제약보통주
2690,3850,2020-12-08,0.0531645569620253,19750,18700,-1050,1013542,3850.0,보령제약보통주
2691,3850,2020-12-03,0.1046770601336302,22450,20100,-2350,2814793,3850.0,보령제약보통주
2692,3850,2020-12-01,0.0752427184466019,20600,22150,1550,4593954,3850.0,보령제약보통주
2693,3850,2020-11-27,0.0535714285714285,19600,20650,1050,4211301,3850.0,보령제약보통주
2694,3850,2020-11-26,0.0531400966183574,20700,19600,-1100,3842556,3850.0,보령제약보통주
2695,3850,2020-11-25,0.235820895522388,16750,20700,3950,17677293,3850.0,보령제약보통주
2696,3850,2020-11-05,0.0440677966101694,14750,15400,650,289900,3850.0,보령제약보통주
2697,3850,2020-10-30,0.0410958904109589,14600,14000,-600,196906,3850.0,보령제약보통주
2698,3850,2020-10-26,0.0433333333333333,15000,14350,-650,248398,3850.0,보령제약보통주
2699,3850,2020-09-22,0.0421686746987951,16600,15900,-700,397426,3850.0,보령제약보통주
2700,3850,2020-09-17,0.0457142857142857,17500,16700,-800,569035,3850.0,보령제약보통주
2701,3850,2020-09-16,0.0416666666666666,16800,17500,700,1157282,3850.0,보령제약보통주
2702,3850,2020-09-11,0.0584615384615384,16250,17200,950,700860,3850.0,보령제약보통주
2703,3850,2020-08-20,0.0403726708074534,16100,15450,-650,455293,3850.0,보령제약보통주
2704,3850,2020-08-18,0.048780487804878,16400,15600,-800,411004,3850.0,보령제약보통주
2705,3850,2020-07-27,0.05,17000,16150,-850,895464,3850.0,보령제약보통주
2706,3850,2020-07-23,0.0575079872204472,15650,16550,900,1233692,3850.0,보령제약보통주
2707,3850,2020-06-16,0.0841423948220064,15450,16750,1300,1651082,3850.0,보령제약보통주
2708,3850,2020-06-15,0.0492307692307692,16250,15450,-800,4280149,3850.0,보령제약보통주
2709,3850,2020-05-28,0.0519480519480519,15400,14600,-800,1104368,3850.0,보령제약보통주
2710,3850,2020-05-26,0.0972222222222222,14400,15800,1400,5529877,3850.0,보령제약보통주
2711,3850,2020-05-14,0.0666666666666666,13500,14400,900,1938314,3850.0,보령제약보통주
2712,3850,2020-05-06,0.0438247011952191,12550,13100,550,435608,3850.0,보령제약보통주
2713,3850,2020-04-24,0.0522388059701492,13400,12700,-700,1147168,3850.0,보령제약보통주
2714,3850,2020-04-23,0.0938775510204081,12250,13400,1150,1633341,3850.0,보령제약보통주
2715,3850,2020-04-13,0.048780487804878,12300,12900,600,1206288,3850.0,보령제약보통주
2716,3850,2020-04-06,0.1608695652173913,11500,13350,1850,5856612,3850.0,보령제약보통주
2717,3850,2020-04-01,0.0658436213991769,12150,11350,-800,966907,3850.0,보령제약보통주
2718,3850,2020-03-30,0.0488888888888888,11250,11800,550,614661,3850.0,보령제약보통주
2719,3850,2020-03-27,0.0663507109004739,10550,11250,700,2126795,3850.0,보령제약보통주
2720,3850,2020-03-25,0.1052631578947368,9500,10500,1000,1524829,3850.0,보령제약보통주
2721,3850,2020-03-24,0.1111111111111111,8550,9500,950,490646,3850.0,보령제약보통주
2722,3850,2020-03-23,0.0904255319148936,9400,8550,-850,459287,3850.0,보령제약보통주
2723,3850,2020-03-20,0.0930232558139534,8600,9400,800,407062,3850.0,보령제약보통주
2724,3850,2020-03-19,0.1391391391391391,9990,8600,-1390,663641,3850.0,보령제약보통주
2725,3850,2020-03-16,0.0476190476190476,10500,10000,-500,444231,3850.0,보령제약보통주
2726,3850,2020-03-13,0.0625,11200,10500,-700,644802,3850.0,보령제약보통주
2727,3850,2020-03-12,0.081967213114754,12200,11200,-1000,491087,3850.0,보령제약보통주
2728,3850,2020-02-24,0.0424710424710424,12950,12400,-550,294238,3850.0,보령제약보통주
2729,3850,2020-02-06,0.0439560439560439,13650,14250,600,264159,3850.0,보령제약보통주
2730,3850,2020-01-08,0.0411392405063291,15800,15150,-650,534034,3850.0,보령제약보통주
2731,3850,2019-12-27,0.0751633986928104,15300,16450,1150,816964,3850.0,보령제약보통주
2732,3850,2019-11-28,0.0418006430868167,15550,16200,650,786748,3850.0,보령제약보통주
2733,3850,2019-11-15,0.0442176870748299,14700,15350,650,503885,3850.0,보령제약보통주
2734,3850,2019-11-14,0.0485436893203883,15450,14700,-750,1119241,3850.0,보령제약보통주
2735,3850,2019-11-04,0.070110701107011,13550,14500,950,1088973,3850.0,보령제약보통주
2736,3850,2019-10-30,0.0583657587548638,12850,13600,750,1365215,3850.0,보령제약보통주
2737,3850,2019-08-27,0.068,12500,11650,-850,983791,3850.0,보령제약보통주
2738,3850,2019-08-20,0.043859649122807,11400,11900,500,335724,3850.0,보령제약보통주
2739,3850,2019-08-05,0.0818965517241379,11600,10650,-950,426873,3850.0,보령제약보통주
2740,3850,2019-07-29,0.0441767068273092,12450,11900,-550,424240,3850.0,보령제약보통주
2741,3850,2019-07-19,0.0720338983050847,11800,12650,850,1546180,3850.0,보령제약보통주
2742,3850,2019-07-11,0.0427350427350427,11700,12200,500,579109,3850.0,보령제약보통주
2743,3850,2019-06-24,0.0432900432900432,11550,12050,500,347148,3850.0,보령제약보통주
2744,3850,2019-05-29,0.0491803278688524,12200,11600,-600,277006,3850.0,보령제약보통주
2745,3850,2019-04-25,0.053231939163498,13150,13850,700,1148812,3850.0,보령제약보통주
2746,3850,2019-04-16,0.0562248995983935,12450,13150,700,1400611,3850.0,보령제약보통주
2747,3850,2019-03-28,0.0438247011952191,12550,12000,-550,629760,3850.0,보령제약보통주
2748,3850,2019-03-25,0.0476190476190476,12600,12000,-600,1610933,3850.0,보령제약보통주
2749,3850,2019-03-22,0.1506849315068493,10950,12600,1650,6486701,3850.0,보령제약보통주
2750,3850,2018-12-18,0.0507462686567164,10050,9540,-510,515495,3850.0,보령제약보통주
2751,3850,2018-11-26,0.0428571428571428,10500,10950,450,326969,3850.0,보령제약보통주
2752,3850,2018-11-15,0.0485436893203883,10300,10800,500,389196,3850.0,보령제약보통주
2753,3850,2018-10-23,0.0471698113207547,10600,10100,-500,138627,3850.0,보령제약보통주
2754,3850,2018-10-15,0.041860465116279,10750,10300,-450,204265,3850.0,보령제약보통주
2755,3850,2018-10-10,0.043859649122807,11400,10900,-500,193338,3850.0,보령제약보통주
2756,3850,2018-07-13,0.0561555075593952,9260,9780,520,443584,3850.0,보령제약보통주
2757,3850,2018-06-19,0.0454545454545454,9900,9450,-450,270939,3850.0,보령제약보통주
2758,3850,2018-06-14,0.0547263681592039,10050,10600,550,311600,3850.0,보령제약보통주
2759,3850,2018-05-23,0.0461538461538461,10400,9920,-480,373524,3850.0,보령제약보통주
2760,3850,2018-05-08,0.0428571428571428,10500,10050,-450,334331,3850.0,보령제약보통주
2761,3850,2018-05-04,0.0497737556561085,11050,10500,-550,335458,3850.0,보령제약보통주
2762,3850,2018-05-03,0.0515021459227467,11650,11050,-600,412447,3850.0,보령제약보통주
2763,3850,2018-04-23,0.0714285714285714,63000,58500,-4500,125762,3850.0,보령제약보통주
2764,3850,2018-03-26,0.0641509433962264,53000,56400,3400,79551,3850.0,보령제약보통주
2765,3850,2018-03-23,0.0467625899280575,55600,53000,-2600,89732,3850.0,보령제약보통주
2766,3850,2018-03-22,0.0446735395189003,58200,55600,-2600,68860,3850.0,보령제약보통주
2767,3850,2018-03-20,0.056985294117647,54400,57500,3100,119845,3850.0,보령제약보통주
2768,3850,2018-03-13,0.041015625,51200,53300,2100,83158,3850.0,보령제약보통주
2769,3850,2018-02-07,0.0450191570881226,52200,49850,-2350,104651,3850.0,보령제약보통주
2770,3850,2018-02-05,0.0730837789661319,56100,52000,-4100,126941,3850.0,보령제약보통주
2771,3850,2018-01-26,0.0472027972027972,57200,59900,2700,284189,3850.0,보령제약보통주
2772,3850,2018-01-24,0.053016453382084,54700,57600,2900,204048,3850.0,보령제약보통주
2773,3850,2018-01-18,0.07,50000,53500,3500,221733,3850.0,보령제약보통주
2774,3850,2017-12-28,0.0714285714285714,44800,48000,3200,305601,3850.0,보령제약보통주
2775,3850,2017-12-27,0.0641330166270783,42100,44800,2700,152358,3850.0,보령제약보통주
2776,3850,2017-11-06,0.0404907975460122,40750,42400,1650,72690,3850.0,보령제약보통주
2777,3850,2017-10-27,0.0553549939831528,41550,39250,-2300,175661,3850.0,보령제약보통주
2778,3850,2017-07-31,0.0804851157662624,45350,41700,-3650,152035,3850.0,보령제약보통주
2779,3850,2017-07-13,0.0439672801635991,48900,46750,-2150,114887,3850.0,보령제약보통주
2780,3850,2017-06-05,0.0458015267175572,52400,54800,2400,161629,3850.0,보령제약보통주
2781,3850,2017-05-31,0.054,50000,52700,2700,142661,3850.0,보령제약보통주
2782,3850,2016-12-13,0.0500894454382826,55900,58700,2800,43927,3850.0,보령제약보통주
2783,3850,2016-12-12,0.0507518796992481,53200,55900,2700,29272,3850.0,보령제약보통주
2784,3850,2016-11-16,0.0418760469011725,59700,62200,2500,45755,3850.0,보령제약보통주
2785,3850,2016-11-10,0.0749542961608775,54700,58800,4100,72333,3850.0,보령제약보통주
2786,3850,2016-11-02,0.0502599653379549,57700,54800,-2900,57596,3850.0,보령제약보통주
2787,4000,2021-05-28,0.0522151898734177,63200,66500,3300,647787,4000.0,롯데정밀화학보통주
2788,4000,2021-04-28,0.0544217687074829,73500,69500,-4000,338453,4000.0,롯데정밀화학보통주
2789,4000,2021-04-16,0.1140495867768595,60500,67400,6900,1389614,4000.0,롯데정밀화학보통주
2790,4000,2021-04-05,0.0641247833622183,57700,61400,3700,564191,4000.0,롯데정밀화학보통주
2791,4000,2021-03-22,0.0460405156537753,54300,56800,2500,279340,4000.0,롯데정밀화학보통주
2792,4000,2021-01-22,0.0411663807890223,58300,60700,2400,692156,4000.0,롯데정밀화학보통주
2793,4000,2021-01-20,0.0510948905109489,54800,57600,2800,334442,4000.0,롯데정밀화학보통주
2794,4000,2020-11-19,0.0916030534351145,52400,57200,4800,577950,4000.0,롯데정밀화학보통주
2795,4000,2020-11-03,0.0449897750511247,48900,51100,2200,122513,4000.0,롯데정밀화학보통주
2796,4000,2020-10-20,0.0426716141001855,53900,51600,-2300,240273,4000.0,롯데정밀화학보통주
2797,4000,2020-09-24,0.0677480916030534,52400,48850,-3550,221371,4000.0,롯데정밀화학보통주
2798,4000,2020-09-23,0.0715746421267893,48900,52400,3500,321854,4000.0,롯데정밀화학보통주
2799,4000,2020-09-21,0.0420650095602294,52300,50100,-2200,170643,4000.0,롯데정밀화학보통주
2800,4000,2020-09-08,0.0536912751677852,59600,56400,-3200,478854,4000.0,롯데정밀화학보통주
2801,4000,2020-09-07,0.1245283018867924,53000,59600,6600,1294134,4000.0,롯데정밀화학보통주
2802,4000,2020-09-04,0.1041666666666666,48000,53000,5000,835129,4000.0,롯데정밀화학보통주
2803,4000,2020-09-03,0.0631229235880398,45150,48000,2850,311879,4000.0,롯데정밀화학보통주
2804,4000,2020-08-21,0.0924369747899159,41650,45500,3850,145012,4000.0,롯데정밀화학보통주
2805,4000,2020-08-20,0.0629921259842519,44450,41650,-2800,147562,4000.0,롯데정밀화학보통주
2806,4000,2020-08-14,0.0438413361169102,47900,45800,-2100,134581,4000.0,롯데정밀화학보통주
2807,4000,2020-08-04,0.1042382588774341,43650,48200,4550,435096,4000.0,롯데정밀화학보통주
2808,4000,2020-07-29,0.0417661097852028,41900,43650,1750,143599,4000.0,롯데정밀화학보통주
2809,4000,2020-07-08,0.1136638452237001,41350,46050,4700,672752,4000.0,롯데정밀화학보통주
2810,4000,2020-07-07,0.040251572327044,39750,41350,1600,497976,4000.0,롯데정밀화학보통주
2811,4000,2020-07-06,0.1555232558139535,34400,39750,5350,982025,4000.0,롯데정밀화학보통주
2812,4000,2020-06-16,0.0834512022630834,35350,38300,2950,206351,4000.0,롯데정밀화학보통주
2813,4000,2020-05-20,0.0464480874316939,36600,38300,1700,161411,4000.0,롯데정밀화학보통주
2814,4000,2020-04-29,0.0554803788903924,36950,39000,2050,318543,4000.0,롯데정밀화학보통주
2815,4000,2020-04-23,0.0878787878787878,33000,35900,2900,168892,4000.0,롯데정밀화학보통주
2816,4000,2020-04-14,0.0471698113207547,31800,33300,1500,96671,4000.0,롯데정밀화학보통주
2817,4000,2020-04-01,0.0515297906602254,31050,29450,-1600,124508,4000.0,롯데정밀화학보통주
2818,4000,2020-03-24,0.1062124248496994,24950,27600,2650,113054,4000.0,롯데정밀화학보통주
2819,4000,2020-03-23,0.0724907063197026,26900,24950,-1950,135107,4000.0,롯데정밀화학보통주
2820,4000,2020-03-20,0.1255230125523012,23900,26900,3000,152909,4000.0,롯데정밀화학보통주
2821,4000,2020-03-19,0.1164510166358595,27050,23900,-3150,165380,4000.0,롯데정밀화학보통주
2822,4000,2020-03-13,0.0614886731391585,30900,29000,-1900,189005,4000.0,롯데정밀화학보통주
2823,4000,2020-03-12,0.0521472392638036,32600,30900,-1700,150691,4000.0,롯데정밀화학보통주
2824,4000,2020-02-28,0.0594900849858356,35300,33200,-2100,248660,4000.0,롯데정밀화학보통주
2825,4000,2020-02-24,0.0474967907573812,38950,37100,-1850,102029,4000.0,롯데정밀화학보통주
2826,4000,2020-02-11,0.0515463917525773,38800,40800,2000,144213,4000.0,롯데정밀화학보통주
2827,4000,2020-01-28,0.0446320868516284,41450,39600,-1850,93863,4000.0,롯데정밀화학보통주
2828,4000,2020-01-08,0.0582639714625445,42050,39600,-2450,175093,4000.0,롯데정밀화학보통주
2829,4000,2019-07-29,0.0415019762845849,50600,48500,-2100,77340,4000.0,롯데정밀화학보통주
2830,4000,2019-06-17,0.0528375733855185,51100,53800,2700,279941,4000.0,롯데정밀화학보통주
2831,4000,2019-06-12,0.0418410041841004,47800,49800,2000,177310,4000.0,롯데정밀화학보통주
2832,4000,2019-05-28,0.0475206611570247,48400,50700,2300,245469,4000.0,롯데정밀화학보통주
2833,4000,2019-05-22,0.0656455142231947,45700,48700,3000,190207,4000.0,롯데정밀화학보통주
2834,4000,2019-04-29,0.0551351351351351,46250,48800,2550,117175,4000.0,롯데정밀화학보통주
2835,4000,2019-04-18,0.0524271844660194,51500,48800,-2700,142744,4000.0,롯데정밀화학보통주
2836,4000,2019-04-01,0.0714285714285714,44100,47250,3150,163554,4000.0,롯데정밀화학보통주
2837,4000,2019-02-18,0.040625,48000,49950,1950,214556,4000.0,롯데정밀화학보통주
2838,4000,2019-02-13,0.0540242557883131,45350,47800,2450,292294,4000.0,롯데정밀화학보통주
2839,4000,2019-01-30,0.0408163265306122,44100,45900,1800,216921,4000.0,롯데정밀화학보통주
2840,4000,2019-01-25,0.0764705882352941,42500,45750,3250,423400,4000.0,롯데정밀화학보통주
2841,4000,2018-11-28,0.0443896424167694,40550,42350,1800,211149,4000.0,롯데정밀화학보통주
2842,4000,2018-11-08,0.0547263681592039,40200,42400,2200,177710,4000.0,롯데정밀화학보통주
2843,4000,2018-11-07,0.0439952437574316,42050,40200,-1850,221430,4000.0,롯데정밀화학보통주
2844,4000,2018-10-29,0.0734597156398104,42200,39100,-3100,237350,4000.0,롯데정밀화학보통주
2845,4000,2018-10-26,0.0580357142857142,44800,42200,-2600,271714,4000.0,롯데정밀화학보통주
2846,4000,2018-10-23,0.0561914672216441,48050,45350,-2700,105266,4000.0,롯데정밀화학보통주
2847,4000,2018-10-22,0.0665926748057713,45050,48050,3000,133621,4000.0,롯데정밀화학보통주
2848,4000,2018-10-18,0.0407288317256162,46650,44750,-1900,127523,4000.0,롯데정밀화학보통주
2849,4000,2018-09-17,0.0755395683453237,55600,51400,-4200,278646,4000.0,롯데정밀화학보통주
2850,4000,2018-09-10,0.0470383275261324,57400,54700,-2700,176406,4000.0,롯데정밀화학보통주
2851,4000,2018-07-26,0.0487394957983193,59500,62400,2900,172523,4000.0,롯데정밀화학보통주
2852,4000,2018-07-04,0.0411184210526315,60800,58300,-2500,286608,4000.0,롯데정밀화학보통주
2853,4000,2018-05-31,0.0586419753086419,64800,68600,3800,242713,4000.0,롯데정밀화학보통주
2854,4000,2018-05-08,0.0635155096011816,67700,63400,-4300,207485,4000.0,롯데정밀화학보통주
2855,4000,2018-04-17,0.0453172205438066,66200,69200,3000,97833,4000.0,롯데정밀화학보통주
2856,4000,2018-03-08,0.0649350649350649,69300,73800,4500,178257,4000.0,롯데정밀화학보통주
2857,4000,2018-03-06,0.0705705705705705,66600,71300,4700,158529,4000.0,롯데정밀화학보통주
2858,4000,2018-02-23,0.0518731988472622,69400,73000,3600,129300,4000.0,롯데정밀화학보통주
2859,4000,2018-02-20,0.0414364640883977,72400,69400,-3000,88813,4000.0,롯데정밀화학보통주
2860,4000,2018-01-30,0.0439560439560439,72800,76000,3200,365927,4000.0,롯데정밀화학보통주
2861,4000,2018-01-12,0.0454545454545454,66000,69000,3000,155773,4000.0,롯데정밀화학보통주
2862,4000,2018-01-09,0.0446304044630404,71700,68500,-3200,201892,4000.0,롯데정밀화학보통주
2863,4000,2018-01-05,0.0730948678071539,64300,69000,4700,290424,4000.0,롯데정밀화학보통주
2864,4000,2017-12-15,0.0547263681592039,60300,63600,3300,180355,4000.0,롯데정밀화학보통주
2865,4000,2017-12-13,0.0566037735849056,63600,60000,-3600,509990,4000.0,롯데정밀화학보통주
2866,4000,2017-12-11,0.0658978583196046,60700,64700,4000,343351,4000.0,롯데정밀화학보통주
2867,4000,2017-11-21,0.2040816326530612,49000,59000,10000,1122544,4000.0,롯데정밀화학보통주
2868,4000,2017-11-01,0.1180124223602484,40250,45000,4750,371192,4000.0,롯데정밀화학보통주
2869,4000,2017-09-18,0.0428061831153388,42050,40250,-1800,107307,4000.0,롯데정밀화학보통주
2870,4000,2017-07-14,0.0696517412935323,40200,43000,2800,364775,4000.0,롯데정밀화학보통주
2871,4000,2017-05-22,0.0476772616136919,40900,42850,1950,285325,4000.0,롯데정밀화학보통주
2872,4000,2017-05-19,0.0906666666666666,37500,40900,3400,301767,4000.0,롯데정밀화학보통주
2873,4000,2017-03-16,0.0691244239631336,32550,34800,2250,182125,4000.0,롯데정밀화학보통주
2874,4000,2016-12-15,0.0413793103448275,29000,30200,1200,123325,4000.0,롯데정밀화학보통주
2875,4000,2016-09-30,0.0469696969696969,33000,31450,-1550,144839,4000.0,롯데정밀화학보통주
2876,4020,2021-05-20,0.0556521739130434,57500,54300,-3200,2065329,4020.0,현대제철 보통주
2877,4020,2021-05-18,0.0473588342440801,54900,57500,2600,1272595,4020.0,현대제철 보통주
2878,4020,2021-05-13,0.0594059405940594,60600,57000,-3600,2148949,4020.0,현대제철 보통주
2879,4020,2021-05-06,0.0560578661844484,55300,58400,3100,1936183,4020.0,현대제철 보통주
2880,4020,2021-04-30,0.0496575342465753,58400,55500,-2900,2681652,4020.0,현대제철 보통주
2881,4020,2021-04-27,0.0903846153846153,52000,56700,4700,5322376,4020.0,현대제철 보통주
2882,4020,2021-04-05,0.0628328008519701,46950,49900,2950,2666471,4020.0,현대제철 보통주
2883,4020,2021-03-29,0.043103448275862,46400,48400,2000,3629480,4020.0,현대제철 보통주
2884,4020,2021-03-26,0.0403587443946188,44600,46400,1800,2695386,4020.0,현대제철 보통주
2885,4020,2021-03-25,0.0506478209658421,42450,44600,2150,1720814,4020.0,현대제철 보통주
2886,4020,2021-03-10,0.0526315789473684,43700,41400,-2300,1467881,4020.0,현대제철 보통주
2887,4020,2021-03-03,0.042997542997543,40700,42450,1750,1338879,4020.0,현대제철 보통주
2888,4020,2021-01-29,0.0478527607361963,40750,38800,-1950,1823111,4020.0,현대제철 보통주
2889,4020,2021-01-28,0.0434272300469483,42600,40750,-1850,1418701,4020.0,현대제철 보통주
2890,4020,2021-01-19,0.0607476635514018,42800,45400,2600,1661286,4020.0,현대제철 보통주
2891,4020,2021-01-08,0.0517435320584926,44450,46750,2300,4466707,4020.0,현대제철 보통주
2892,4020,2021-01-07,0.0483490566037735,42400,44450,2050,2582523,4020.0,현대제철 보통주
2893,4020,2021-01-05,0.0570388349514563,41200,43550,2350,3075718,4020.0,현대제철 보통주
2894,4020,2021-01-04,0.0404040404040404,39600,41200,1600,1837076,4020.0,현대제철 보통주
2895,4020,2020-12-09,0.07248322147651,37250,39950,2700,2590180,4020.0,현대제철 보통주
2896,4020,2020-12-04,0.0769230769230769,35100,37800,2700,3296317,4020.0,현대제철 보통주
2897,4020,2020-12-02,0.0401188707280832,33650,35000,1350,2140495,4020.0,현대제철 보통주
2898,4020,2020-12-01,0.0581761006289308,31800,33650,1850,1258823,4020.0,현대제철 보통주
2899,4020,2020-11-23,0.0408163265306122,31850,33150,1300,1384830,4020.0,현대제철 보통주
2900,4020,2020-11-10,0.0523731587561374,30550,32150,1600,2380965,4020.0,현대제철 보통주
2901,4020,2020-11-02,0.0449826989619377,28900,30200,1300,1180933,4020.0,현대제철 보통주
2902,4020,2020-10-27,0.0568720379146919,31650,29850,-1800,2291770,4020.0,현대제철 보통주
2903,4020,2020-10-15,0.0702702702702702,27750,29700,1950,4561744,4020.0,현대제철 보통주
2904,4020,2020-10-13,0.0641509433962264,26500,28200,1700,4046369,4020.0,현대제철 보통주
2905,4020,2020-10-05,0.0914634146341463,24600,26850,2250,2252397,4020.0,현대제철 보통주
2906,4020,2020-09-24,0.040983606557377,24400,23400,-1000,585773,4020.0,현대제철 보통주
2907,4020,2020-08-24,0.0492125984251968,25400,26650,1250,1126401,4020.0,현대제철 보통주
2908,4020,2020-08-20,0.0683918669131238,27050,25200,-1850,1566337,4020.0,현대제철 보통주
2909,4020,2020-08-18,0.0716783216783216,28600,26550,-2050,1767042,4020.0,현대제철 보통주
2910,4020,2020-08-06,0.0647773279352226,24700,26300,1600,1898879,4020.0,현대제철 보통주
2911,4020,2020-08-04,0.041407867494824,24150,25150,1000,1200080,4020.0,현대제철 보통주
2912,4020,2020-07-23,0.0515653775322283,27150,25750,-1400,2404899,4020.0,현대제철 보통주
2913,4020,2020-07-20,0.100418410041841,23900,26300,2400,4640073,4020.0,현대제철 보통주
2914,4020,2020-07-16,0.0535714285714285,22400,23600,1200,2602241,4020.0,현대제철 보통주
2915,4020,2020-07-15,0.0795180722891566,20750,22400,1650,3484654,4020.0,현대제철 보통주
2916,4020,2020-06-16,0.0650602409638554,20750,22100,1350,930222,4020.0,현대제철 보통주
2917,4020,2020-06-15,0.0879120879120879,22750,20750,-2000,1257492,4020.0,현대제철 보통주
2918,4020,2020-06-12,0.0481171548117154,23900,22750,-1150,1303372,4020.0,현대제철 보통주
2919,4020,2020-06-04,0.0475247524752475,25250,24050,-1200,3052110,4020.0,현대제철 보통주
2920,4020,2020-06-03,0.1425339366515837,22100,25250,3150,7488883,4020.0,현대제철 보통주
2921,4020,2020-05-27,0.0567901234567901,20250,21400,1150,1886161,4020.0,현대제철 보통주
2922,4020,2020-05-19,0.0497382198952879,19100,20050,950,1242550,4020.0,현대제철 보통주
2923,4020,2020-04-29,0.0936708860759493,19750,21600,1850,2376088,4020.0,현대제철 보통주
2924,4020,2020-04-10,0.0833333333333333,18600,20150,1550,3203954,4020.0,현대제철 보통주
2925,4020,2020-04-09,0.042016806722689,17850,18600,750,1214050,4020.0,현대제철 보통주
2926,4020,2020-04-01,0.0584958217270195,17950,16900,-1050,877766,4020.0,현대제철 보통주
2927,4020,2020-03-25,0.1556291390728476,15100,17450,2350,1780108,4020.0,현대제철 보통주
2928,4020,2020-03-24,0.1482889733840304,13150,15100,1950,1018706,4020.0,현대제철 보통주
2929,4020,2020-03-23,0.0401459854014598,13700,13150,-550,961766,4020.0,현대제철 보통주
2930,4020,2020-03-19,0.1608832807570978,15850,13300,-2550,1972700,4020.0,현대제철 보통주
2931,4020,2020-03-18,0.081159420289855,17250,15850,-1400,1349690,4020.0,현대제철 보통주
2932,4020,2020-03-17,0.0469613259668508,18100,17250,-850,997979,4020.0,현대제철 보통주
2933,4020,2020-03-16,0.0523560209424083,19100,18100,-1000,947994,4020.0,현대제철 보통주
2934,4020,2020-03-13,0.0637254901960784,20400,19100,-1300,1489380,4020.0,현대제철 보통주
2935,4020,2020-03-12,0.0790067720090293,22150,20400,-1750,1367404,4020.0,현대제철 보통주
2936,4020,2020-03-09,0.055327868852459,24400,23050,-1350,556063,4020.0,현대제철 보통주
2937,4020,2020-02-28,0.046,25000,23850,-1150,843962,4020.0,현대제철 보통주
2938,4020,2020-02-24,0.0556586270871985,26950,25450,-1500,713587,4020.0,현대제철 보통주
2939,4020,2020-02-06,0.0628366247755834,27850,29600,1750,618382,4020.0,현대제철 보통주
2940,4020,2020-01-28,0.05414551607445,29550,27950,-1600,758978,4020.0,현대제철 보통주
2941,4020,2020-01-08,0.0440677966101694,29500,28200,-1300,956084,4020.0,현대제철 보통주
2942,4020,2019-04-01,0.0400890868596882,44900,46700,1800,304864,4020.0,현대제철 보통주
2943,4020,2019-03-05,0.0453172205438066,49650,47400,-2250,621315,4020.0,현대제철 보통주
2944,4020,2019-01-09,0.0787746170678337,45700,49300,3600,742736,4020.0,현대제철 보통주
2945,4020,2018-12-03,0.0661252900232018,43100,45950,2850,849900,4020.0,현대제철 보통주
2946,4020,2018-11-06,0.0427553444180522,42100,43900,1800,427919,4020.0,현대제철 보통주
2947,4020,2018-11-02,0.0481347773766546,41550,43550,2000,491216,4020.0,현대제철 보통주
2948,4020,2018-10-26,0.0545851528384279,45800,43300,-2500,971790,4020.0,현대제철 보통주
2949,4020,2018-10-11,0.0521821631878557,52700,49950,-2750,653970,4020.0,현대제철 보통주
2950,4020,2018-09-11,0.0427046263345195,56200,53800,-2400,647652,4020.0,현대제철 보통주
2951,4020,2018-07-30,0.0487329434697855,51300,53800,2500,630285,4020.0,현대제철 보통주
2952,4020,2018-07-09,0.0455445544554455,50500,48200,-2300,833563,4020.0,현대제철 보통주
2953,4020,2018-07-02,0.0418250950570342,52600,50400,-2200,647501,4020.0,현대제철 보통주
2954,4020,2018-06-27,0.0525362318840579,55200,52300,-2900,908199,4020.0,현대제철 보통주
2955,4020,2018-06-14,0.0691927512355848,60700,56500,-4200,2096119,4020.0,현대제철 보통주
2956,4020,2018-06-08,0.0617283950617283,64800,60800,-4000,6870194,4020.0,현대제철 보통주
2957,4020,2018-05-29,0.0610119047619047,67200,63100,-4100,2264107,4020.0,현대제철 보통주
2958,4020,2018-05-28,0.1448040885860306,58700,67200,8500,6637458,4020.0,현대제철 보통주
2959,4020,2018-05-25,0.0408496732026143,61200,58700,-2500,1363697,4020.0,현대제철 보통주
2960,4020,2018-05-16,0.0582959641255605,66900,63000,-3900,1789916,4020.0,현대제철 보통주
2961,4020,2018-05-14,0.048854961832061,65500,68700,3200,2029868,4020.0,현대제철 보통주
2962,4020,2018-05-10,0.0478468899521531,62700,65700,3000,1966270,4020.0,현대제철 보통주
2963,4020,2018-04-30,0.1263940520446096,53800,60600,6800,2932677,4020.0,현대제철 보통주
2964,4020,2018-04-19,0.0482625482625482,51800,54300,2500,1207130,4020.0,현대제철 보통주
2965,4020,2017-12-18,0.0468227424749163,59800,57000,-2800,586887,4020.0,현대제철 보통주
2966,4020,2017-11-03,0.042031523642732,57100,59500,2400,730943,4020.0,현대제철 보통주
2967,4020,2017-10-27,0.0493601462522851,54700,57400,2700,713770,4020.0,현대제철 보통주
2968,4020,2017-09-26,0.0451866404715127,50900,53200,2300,354194,4020.0,현대제철 보통주
2969,4020,2017-05-22,0.0427046263345195,56200,58600,2400,1056976,4020.0,현대제철 보통주
2970,4020,2017-04-13,0.0564373897707231,56700,53500,-3200,1098685,4020.0,현대제철 보통주
2971,4020,2017-02-01,0.0446735395189003,58200,60800,2600,498322,4020.0,현대제철 보통주
2972,4020,2017-01-11,0.058303886925795,56600,59900,3300,1039584,4020.0,현대제철 보통주
2973,4020,2016-08-09,0.0492146596858638,47750,50100,2350,449900,4020.0,현대제철 보통주
2974,4170,2021-05-13,0.040625,320000,307000,-13000,236725,4170.0,신세계보통주
2975,4170,2021-04-05,0.041970802919708,274000,285500,11500,117152,4170.0,신세계보통주
2976,4170,2021-03-03,0.0432432432432432,277500,289500,12000,317893,4170.0,신세계보통주
2977,4170,2021-02-23,0.0538461538461538,260000,274000,14000,440567,4170.0,신세계보통주
2978,4170,2021-02-18,0.0517928286852589,251000,264000,13000,659870,4170.0,신세계보통주
2979,4170,2021-01-12,0.0493827160493827,243000,255000,12000,379558,4170.0,신세계보통주
2980,4170,2020-12-11,0.0411522633744856,243000,253000,10000,209250,4170.0,신세계보통주
2981,4170,2020-12-09,0.0515021459227467,233000,245000,12000,297341,4170.0,신세계보통주
2982,4170,2020-11-10,0.0555555555555555,216000,228000,12000,394388,4170.0,신세계보통주
2983,4170,2020-10-19,0.0465116279069767,215000,225000,10000,284701,4170.0,신세계보통주
2984,4170,2020-10-12,0.0552884615384615,208000,219500,11500,257103,4170.0,신세계보통주
2985,4170,2020-09-02,0.0465686274509803,204000,213500,9500,199133,4170.0,신세계보통주
2986,4170,2020-08-18,0.0869565217391304,230000,210000,-20000,303466,4170.0,신세계보통주
2987,4170,2020-08-12,0.0400943396226415,212000,220500,8500,310579,4170.0,신세계보통주
2988,4170,2020-06-30,0.0677966101694915,206500,220500,14000,234125,4170.0,신세계보통주
2989,4170,2020-06-15,0.0649350649350649,231000,216000,-15000,137203,4170.0,신세계보통주
2990,4170,2020-06-12,0.0474226804123711,242500,231000,-11500,126017,4170.0,신세계보통주
2991,4170,2020-05-19,0.0536082474226804,242500,255500,13000,173503,4170.0,신세계보통주
2992,4170,2020-04-27,0.0492813141683778,243500,255500,12000,125254,4170.0,신세계보통주
2993,4170,2020-04-17,0.0813704496788008,233500,252500,19000,203883,4170.0,신세계보통주
2994,4170,2020-04-06,0.0599520383693045,208500,221000,12500,141057,4170.0,신세계보통주
2995,4170,2020-03-30,0.042316258351893,224500,215000,-9500,159615,4170.0,신세계보통주
2996,4170,2020-03-25,0.0793650793650793,220500,238000,17500,147830,4170.0,신세계보통주
2997,4170,2020-03-24,0.0677966101694915,206500,220500,14000,98816,4170.0,신세계보통주
2998,4170,2020-03-23,0.078125,224000,206500,-17500,80435,4170.0,신세계보통주
2999,4170,2020-03-20,0.0980392156862745,204000,224000,20000,106243,4170.0,신세계보통주
3000,4170,2020-03-19,0.0973451327433628,226000,204000,-22000,138230,4170.0,신세계보통주
3001,4170,2020-03-18,0.0484210526315789,237500,226000,-11500,105391,4170.0,신세계보통주
3002,4170,2020-03-17,0.0869565217391304,218500,237500,19000,112027,4170.0,신세계보통주
3003,4170,2020-03-13,0.0600414078674948,241500,227000,-14500,188739,4170.0,신세계보통주
3004,4170,2020-03-05,0.0454545454545454,253000,264500,11500,104952,4170.0,신세계보통주
3005,4170,2020-03-04,0.0476190476190476,241500,253000,11500,93059,4170.0,신세계보통주
3006,4170,2020-02-28,0.0522088353413654,249000,236000,-13000,172784,4170.0,신세계보통주
3007,4170,2020-02-25,0.0408997955010225,244500,254500,10000,125682,4170.0,신세계보통주
3008,4170,2020-02-24,0.0738636363636363,264000,244500,-19500,185890,4170.0,신세계보통주
3009,4170,2020-02-20,0.0442477876106194,282500,270000,-12500,153588,4170.0,신세계보통주
3010,4170,2020-02-12,0.0582010582010582,283500,300000,16500,94596,4170.0,신세계보통주
3011,4170,2020-02-06,0.0532110091743119,272500,287000,14500,99051,4170.0,신세계보통주
3012,4170,2020-01-30,0.044883303411131,278500,266000,-12500,123403,4170.0,신세계보통주
3013,4170,2020-01-28,0.1207177814029363,306500,269500,-37000,225560,4170.0,신세계보통주
3014,4170,2020-01-22,0.0429752066115702,302500,315500,13000,89830,4170.0,신세계보통주
3015,4170,2020-01-07,0.0517241379310344,290000,305000,15000,99705,4170.0,신세계보통주
3016,4170,2019-11-28,0.0599250936329588,267000,283000,16000,75969,4170.0,신세계보통주
3017,4170,2019-11-06,0.06875,240000,256500,16500,116783,4170.0,신세계보통주
3018,4170,2019-09-11,0.0445344129554655,247000,258000,11000,73678,4170.0,신세계보통주
3019,4170,2019-09-09,0.0477178423236514,241000,252500,11500,70597,4170.0,신세계보통주
3020,4170,2019-09-05,0.0470588235294117,255000,243000,-12000,82880,4170.0,신세계보통주
3021,4170,2019-09-03,0.0528541226215644,236500,249000,12500,99948,4170.0,신세계보통주
3022,4170,2019-08-29,0.0403587443946188,223000,232000,9000,58273,4170.0,신세계보통주
3023,4170,2019-08-05,0.0587084148727984,255500,240500,-15000,76671,4170.0,신세계보통주
3024,4170,2019-06-21,0.0400641025641025,312000,299500,-12500,103231,4170.0,신세계보통주
3025,4170,2019-06-19,0.042016806722689,297500,310000,12500,73915,4170.0,신세계보통주
3026,4170,2019-05-15,0.0541795665634674,323000,305500,-17500,163904,4170.0,신세계보통주
3027,4170,2019-05-10,0.0456026058631921,307000,321000,14000,94063,4170.0,신세계보통주
3028,4170,2019-05-09,0.058282208588957,326000,307000,-19000,110954,4170.0,신세계보통주
3029,4170,2019-03-26,0.0489731437598736,316500,332000,15500,88380,4170.0,신세계보통주
3030,4170,2019-03-18,0.0766666666666666,300000,323000,23000,158774,4170.0,신세계보통주
3031,4170,2019-02-20,0.047970479704797,271000,284000,13000,168878,4170.0,신세계보통주
3032,4170,2019-02-15,0.0431372549019607,255000,266000,11000,106004,4170.0,신세계보통주
3033,4170,2019-01-23,0.0515873015873015,252000,265000,13000,242494,4170.0,신세계보통주
3034,4170,2018-12-06,0.0616197183098591,284000,266500,-17500,98961,4170.0,신세계보통주
3035,4170,2018-11-23,0.0454545454545454,286000,299000,13000,158351,4170.0,신세계보통주
3036,4170,2018-11-15,0.1043307086614173,254000,280500,26500,209822,4170.0,신세계보통주
3037,4170,2018-11-02,0.0455407969639468,263500,275500,12000,84053,4170.0,신세계보통주
3038,4170,2018-10-26,0.0556586270871985,269500,254500,-15000,155126,4170.0,신세계보통주
3039,4170,2018-10-23,0.0516351118760757,290500,275500,-15000,60877,4170.0,신세계보통주
3040,4170,2018-10-22,0.0430879712746858,278500,290500,12000,69178,4170.0,신세계보통주
3041,4170,2018-10-15,0.0456081081081081,296000,282500,-13500,96722,4170.0,신세계보통주
3042,4170,2018-10-04,0.1266187050359712,347500,303500,-44000,304380,4170.0,신세계보통주
3043,4170,2018-10-02,0.0440165061898211,363500,347500,-16000,95990,4170.0,신세계보통주
3044,4170,2018-09-18,0.0571010248901903,341500,361000,19500,120282,4170.0,신세계보통주
3045,4170,2018-09-13,0.0579029733959311,319500,338000,18500,125928,4170.0,신세계보통주
3046,4170,2018-08-23,0.0915492957746478,284000,310000,26000,243814,4170.0,신세계보통주
3047,4170,2018-08-20,0.0539629005059021,296500,280500,-16000,128549,4170.0,신세계보통주
3048,4170,2018-08-07,0.0445103857566765,337000,322000,-15000,106937,4170.0,신세계보통주
3049,4170,2018-08-01,0.0436746987951807,332000,346500,14500,113027,4170.0,신세계보통주
3050,4170,2018-07-27,0.0470219435736677,319000,334000,15000,104796,4170.0,신세계보통주
3051,4170,2018-07-24,0.0589198036006546,305500,323500,18000,132589,4170.0,신세계보통주
3052,4170,2018-07-16,0.0513595166163142,331000,314000,-17000,114661,4170.0,신세계보통주
3053,4170,2018-07-09,0.0818307905686546,360500,331000,-29500,189240,4170.0,신세계보통주
3054,4170,2018-07-03,0.0748387096774193,387500,358500,-29000,217584,4170.0,신세계보통주
3055,4170,2018-06-26,0.0524433849821215,419500,397500,-22000,128529,4170.0,신세계보통주
3056,4170,2018-06-25,0.0715197956577266,391500,419500,28000,257052,4170.0,신세계보통주
3057,4170,2018-06-20,0.0405228758169934,382500,398000,15500,108479,4170.0,신세계보통주
3058,4170,2018-06-18,0.063321385902031,418500,392000,-26500,112668,4170.0,신세계보통주
3059,4170,2018-05-29,0.0466970387243735,439000,459500,20500,59718,4170.0,신세계보통주
3060,4170,2018-05-25,0.0569280343716433,465500,439000,-26500,82402,4170.0,신세계보통주
3061,4170,2018-05-24,0.046067415730337,445000,465500,20500,78477,4170.0,신세계보통주
3062,4170,2018-05-10,0.0671736375158428,394500,421000,26500,125092,4170.0,신세계보통주
3063,4170,2018-05-03,0.0419161676646706,417500,400000,-17500,56760,4170.0,신세계보통주
3064,4170,2018-04-19,0.0453987730061349,407500,389000,-18500,65746,4170.0,신세계보통주
3065,4170,2018-04-02,0.0727272727272727,357500,383500,26000,95826,4170.0,신세계보통주
3066,4170,2018-03-22,0.0467571644042232,331500,347000,15500,79275,4170.0,신세계보통주
3067,4170,2018-03-09,0.0553846153846153,325000,343000,18000,134516,4170.0,신세계보통주
3068,4170,2018-02-19,0.048465266558966,309500,324500,15000,40460,4170.0,신세계보통주
3069,4170,2018-02-07,0.0604316546762589,347500,326500,-21000,95839,4170.0,신세계보통주
3070,4170,2018-02-05,0.0447552447552447,357500,341500,-16000,44988,4170.0,신세계보통주
3071,4170,2018-02-01,0.0437317784256559,343000,358000,15000,92400,4170.0,신세계보통주
3072,4170,2018-01-26,0.0983870967741935,310000,340500,30500,302543,4170.0,신세계보통주
3073,4170,2018-01-17,0.0540098199672667,305500,322000,16500,83291,4170.0,신세계보통주
3074,4170,2018-01-08,0.046793760831889,288500,302000,13500,64829,4170.0,신세계보통주
3075,4170,2017-12-15,0.04,287500,299000,11500,67207,4170.0,신세계보통주
3076,4170,2017-12-13,0.052823315118397,274500,289000,14500,61962,4170.0,신세계보통주
3077,4170,2017-11-27,0.0474383301707779,263500,276000,12500,87062,4170.0,신세계보통주
3078,4170,2017-11-20,0.0637065637065637,259000,275500,16500,105971,4170.0,신세계보통주
3079,4170,2017-11-08,0.0547667342799188,246500,260000,13500,174633,4170.0,신세계보통주
3080,4170,2017-11-07,0.0835164835164835,227500,246500,19000,258495,4170.0,신세계보통주
3081,4170,2017-10-26,0.0512820512820512,214500,225500,11000,129254,4170.0,신세계보통주
3082,4170,2017-10-16,0.0680100755667506,198500,212000,13500,208557,4170.0,신세계보통주
3083,4170,2017-10-13,0.0558510638297872,188000,198500,10500,138594,4170.0,신세계보통주
3084,4170,2017-09-28,0.0408719346049046,183500,191000,7500,104208,4170.0,신세계보통주
3085,4170,2017-09-26,0.0501392757660167,179500,188500,9000,60132,4170.0,신세계보통주
3086,4170,2017-09-15,0.0444444444444444,180000,188000,8000,61088,4170.0,신세계보통주
3087,4170,2017-08-11,0.0953436807095343,225500,204000,-21500,344824,4170.0,신세계보통주
3088,4170,2017-07-26,0.0533333333333333,225000,237000,12000,78402,4170.0,신세계보통주
3089,4170,2017-07-03,0.0413943355119825,229500,239000,9500,38294,4170.0,신세계보통주
3090,4170,2017-06-27,0.0417582417582417,227500,237000,9500,63252,4170.0,신세계보통주
3091,4170,2017-05-11,0.0575539568345323,208500,220500,12000,96890,4170.0,신세계보통주
3092,4170,2017-04-10,0.045,200000,191000,-9000,61942,4170.0,신세계보통주
3093,4170,2017-03-03,0.0492227979274611,193000,183500,-9500,174813,4170.0,신세계보통주
3094,4170,2017-02-23,0.0448548812664907,189500,198000,8500,149713,4170.0,신세계보통주
3095,4170,2016-10-25,0.0601503759398496,199500,187500,-12000,182809,4170.0,신세계보통주
3096,4170,2016-10-14,0.0449735449735449,189000,197500,8500,113993,4170.0,신세계보통주
3097,4170,2016-08-26,0.0886426592797784,180500,196500,16000,238795,4170.0,신세계보통주
3098,4370,2020-08-27,0.0445682451253481,359000,375000,16000,51644,4370.0,농심보통주
3099,4370,2020-06-17,0.0548523206751054,355500,375000,19500,83629,4370.0,농심보통주
3100,4370,2020-06-12,0.0588235294117647,323000,342000,19000,116060,4370.0,농심보통주
3101,4370,2020-05-21,0.045016077170418,311000,325000,14000,63152,4370.0,농심보통주
3102,4370,2020-05-19,0.0428134556574923,327000,313000,-14000,86901,4370.0,농심보통주
3103,4370,2020-05-13,0.0421393841166936,308500,321500,13000,66568,4370.0,농심보통주
3104,4370,2020-04-24,0.0445205479452054,292000,305000,13000,93184,4370.0,농심보통주
3105,4370,2020-03-30,0.056390977443609,266000,281000,15000,67063,4370.0,농심보통주
3106,4370,2020-03-26,0.0433925049309664,253500,264500,11000,80215,4370.0,농심보통주
3107,4370,2020-03-16,0.0573770491803278,244000,258000,14000,50067,4370.0,농심보통주
3108,4370,2020-03-13,0.0487329434697855,256500,244000,-12500,58652,4370.0,농심보통주
3109,4370,2020-03-04,0.0662768031189083,256500,273500,17000,74157,4370.0,농심보통주
3110,4370,2020-02-19,0.0458015267175572,262000,274000,12000,73065,4370.0,농심보통주
3111,4370,2020-02-12,0.048780487804878,246000,258000,12000,127168,4370.0,농심보통주
3112,4370,2020-02-11,0.0445859872611464,235500,246000,10500,59949,4370.0,농심보통주
3113,4370,2019-09-04,0.041407867494824,241500,251500,10000,25441,4370.0,농심보통주
3114,4370,2019-08-30,0.0434782608695652,230000,240000,10000,15155,4370.0,농심보통주
3115,4370,2019-05-16,0.0486486486486486,277500,264000,-13500,31531,4370.0,농심보통주
3116,4370,2019-03-11,0.0591397849462365,279000,295500,16500,62748,4370.0,농심보통주
3117,4370,2019-02-12,0.0491228070175438,285000,271000,-14000,28518,4370.0,농심보통주
3118,4370,2019-01-22,0.04,275000,286000,11000,25831,4370.0,농심보통주
3119,4370,2019-01-03,0.0677290836653386,251000,268000,17000,43424,4370.0,농심보통주
3120,4370,2018-11-12,0.0472972972972973,222000,232500,10500,23033,4370.0,농심보통주
3121,4370,2018-10-29,0.0467706013363029,224500,214000,-10500,19078,4370.0,농심보통주
3122,4370,2018-08-16,0.0702702702702702,277500,258000,-19500,121040,4370.0,농심보통주
3123,4370,2018-08-14,0.0480274442538593,291500,277500,-14000,38987,4370.0,농심보통주
3124,4370,2018-07-02,0.0415384615384615,325000,311500,-13500,30964,4370.0,농심보통주
3125,4370,2018-06-04,0.0418535127055306,334500,348500,14000,66310,4370.0,농심보통주
3126,4370,2018-04-23,0.0427892234548335,315500,329000,13500,70688,4370.0,농심보통주
3127,4370,2017-11-20,0.056934306569343,342500,362000,19500,75814,4370.0,농심보통주
3128,4370,2017-09-15,0.0489614243323442,337000,353500,16500,46914,4370.0,농심보통주
3129,4370,2017-09-07,0.047040971168437,329500,345000,15500,29948,4370.0,농심보통주
3130,4370,2017-08-16,0.0438184663536776,319500,333500,14000,34203,4370.0,농심보통주
3131,4370,2017-05-08,0.0405616224648986,320500,333500,13000,48888,4370.0,농심보통주
3132,4370,2017-02-23,0.0678466076696165,339000,316000,-23000,177474,4370.0,농심보통주
3133,4370,2017-02-06,0.0484581497797356,340500,357000,16500,46100,4370.0,농심보통주
3134,4370,2017-02-02,0.0598159509202454,326000,345500,19500,61483,4370.0,농심보통주
3135,4370,2016-11-29,0.0714285714285714,308000,330000,22000,44376,4370.0,농심보통주
3136,4370,2016-11-15,0.1009933774834437,302000,332500,30500,123367,4370.0,농심보통주
3137,4370,2016-11-03,0.0578947368421052,285000,301500,16500,28365,4370.0,농심보통주
3138,4370,2016-10-31,0.044776119402985,301500,288000,-13500,24132,4370.0,농심보통주
3139,4370,2016-08-19,0.0432766615146831,323500,309500,-14000,73528,4370.0,농심보통주
3140,4370,2016-08-17,0.0664780763790664,353500,330000,-23500,91386,4370.0,농심보통주
3141,4370,2016-08-10,0.0543318649045521,340500,359000,18500,57183,4370.0,농심보통주
3142,4490,2021-06-02,0.0590094836670179,94900,100500,5600,390271,4490.0,세방전지보통주
3143,4490,2021-05-25,0.0477223427331887,92200,96600,4400,215735,4490.0,세방전지보통주
3144,4490,2021-05-21,0.0584988962472406,90600,95900,5300,618557,4490.0,세방전지보통주
3145,4490,2021-05-18,0.0567786790266512,86300,91200,4900,228554,4490.0,세방전지보통주
3146,4490,2021-05-17,0.0473300970873786,82400,86300,3900,129481,4490.0,세방전지보통주
3147,4490,2021-04-20,0.0412486064659977,89700,93400,3700,358849,4490.0,세방전지보통주
3148,4490,2021-04-13,0.1876606683804627,77800,92400,14600,2072771,4490.0,세방전지보통주
3149,4490,2021-02-24,0.0841584158415841,101000,92500,-8500,396006,4490.0,세방전지보통주
3150,4490,2021-02-22,0.045631067961165,103000,98300,-4700,191801,4490.0,세방전지보통주
3151,4490,2021-02-17,0.0547945205479452,109500,103500,-6000,225970,4490.0,세방전지보통주
3152,4490,2021-02-09,0.0676328502415458,103500,110500,7000,407252,4490.0,세방전지보통주
3153,4490,2021-02-05,0.0405405405405405,111000,106500,-4500,344962,4490.0,세방전지보통주
3154,4490,2021-02-02,0.0515873015873015,126000,119500,-6500,960057,4490.0,세방전지보통주
3155,4490,2021-02-01,0.2413793103448276,101500,126000,24500,1025713,4490.0,세방전지보통주
3156,4490,2021-01-29,0.0977777777777777,112500,101500,-11000,837354,4490.0,세방전지보통주
3157,4490,2021-01-28,0.1312741312741312,129500,112500,-17000,1051900,4490.0,세방전지보통주
3158,4490,2021-01-27,0.1666666666666666,111000,129500,18500,768929,4490.0,세방전지보통주
3159,4490,2021-01-25,0.0663507109004739,105500,112500,7000,377236,4490.0,세방전지보통주
3160,4490,2021-01-22,0.0978147762747138,96100,105500,9400,681652,4490.0,세방전지보통주
3161,4490,2021-01-19,0.1639150943396226,84800,98700,13900,941689,4490.0,세방전지보통주
3162,4490,2021-01-15,0.0683760683760683,81900,87500,5600,524158,4490.0,세방전지보통주
3163,4490,2021-01-12,0.0588914549653579,86600,81500,-5100,322303,4490.0,세방전지보통주
3164,4490,2021-01-07,0.1602564102564102,78000,90500,12500,1626641,4490.0,세방전지보통주
3165,4490,2021-01-06,0.0878661087866108,71700,78000,6300,626075,4490.0,세방전지보통주
3166,4490,2021-01-05,0.044,75000,71700,-3300,358720,4490.0,세방전지보통주
3167,4490,2021-01-04,0.0885341074020319,68900,75000,6100,653195,4490.0,세방전지보통주
3168,4490,2020-12-28,0.0606060606060606,62700,66500,3800,338653,4490.0,세방전지보통주
3169,4490,2020-12-23,0.2993630573248407,47100,61200,14100,2522085,4490.0,세방전지보통주
3170,4490,2020-12-22,0.0782778864970645,51100,47100,-4000,276653,4490.0,세방전지보통주
3171,4490,2020-12-18,0.1770956316410862,42350,49850,7500,837656,4490.0,세방전지보통주
3172,4490,2020-12-14,0.0576036866359447,43400,40900,-2500,126500,4490.0,세방전지보통주
3173,4490,2020-12-09,0.0538555691554467,40850,43050,2200,257053,4490.0,세방전지보통주
3174,4490,2020-12-08,0.0474358974358974,39000,40850,1850,158211,4490.0,세방전지보통주
3175,4490,2020-12-01,0.041002277904328,43900,42100,-1800,212922,4490.0,세방전지보통주
3176,4490,2020-11-30,0.0464839094159713,41950,43900,1950,209194,4490.0,세방전지보통주
3177,4490,2020-11-27,0.0910273081924577,38450,41950,3500,153936,4490.0,세방전지보통주
3178,4490,2020-11-20,0.0588235294117647,34000,36000,2000,142696,4490.0,세방전지보통주
3179,4490,2020-11-16,0.0644171779141104,32600,34700,2100,248678,4490.0,세방전지보통주
3180,4490,2020-08-20,0.0705882352941176,29750,27650,-2100,76149,4490.0,세방전지보통주
3181,4490,2020-06-16,0.0473856209150326,30600,32050,1450,81670,4490.0,세방전지보통주
3182,4490,2020-06-15,0.0496894409937888,32200,30600,-1600,67608,4490.0,세방전지보통주
3183,4490,2020-06-09,0.0462686567164179,33500,31950,-1550,79881,4490.0,세방전지보통주
3184,4490,2020-06-08,0.072,31250,33500,2250,112190,4490.0,세방전지보통주
3185,4490,2020-05-26,0.0410958904109589,29200,30400,1200,63498,4490.0,세방전지보통주
3186,4490,2020-05-04,0.0484429065743944,28900,27500,-1400,66798,4490.0,세방전지보통주
3187,4490,2020-04-27,0.0415913200723327,27650,28800,1150,33804,4490.0,세방전지보통주
3188,4490,2020-04-06,0.0485436893203883,25750,27000,1250,53056,4490.0,세방전지보통주
3189,4490,2020-03-24,0.0630434782608695,23000,24450,1450,40210,4490.0,세방전지보통주
3190,4490,2020-03-23,0.1153846153846153,26000,23000,-3000,48915,4490.0,세방전지보통주
3191,4490,2020-03-20,0.1555555555555555,22500,26000,3500,56794,4490.0,세방전지보통주
3192,4490,2020-03-19,0.1193737769080234,25550,22500,-3050,72914,4490.0,세방전지보통주
3193,4490,2020-03-18,0.0412757973733583,26650,25550,-1100,43595,4490.0,세방전지보통주
3194,4490,2020-03-13,0.0616438356164383,29200,27400,-1800,48732,4490.0,세방전지보통주
3195,4490,2020-03-12,0.0519480519480519,30800,29200,-1600,43279,4490.0,세방전지보통주
3196,4490,2020-02-06,0.0480620155038759,32250,33800,1550,23977,4490.0,세방전지보통주
3197,4490,2019-11-13,0.0453955901426718,38550,40300,1750,26369,4490.0,세방전지보통주
3198,4490,2019-10-16,0.0504527813712807,38650,40600,1950,20051,4490.0,세방전지보통주
3199,4490,2019-07-25,0.0415704387990762,43300,41500,-1800,20809,4490.0,세방전지보통주
3200,4490,2019-07-12,0.0450346420323325,43300,45250,1950,28837,4490.0,세방전지보통주
3201,4490,2019-07-05,0.057347670250896,41850,44250,2400,33112,4490.0,세방전지보통주
3202,4490,2019-03-12,0.0466744457409568,42850,44850,2000,41025,4490.0,세방전지보통주
3203,4490,2019-03-04,0.0434258142340168,41450,43250,1800,49845,4490.0,세방전지보통주
3204,4490,2018-12-13,0.0438247011952191,37650,39300,1650,43182,4490.0,세방전지보통주
3205,4490,2018-11-28,0.0513513513513513,37000,38900,1900,53929,4490.0,세방전지보통주
3206,4490,2018-11-06,0.0476190476190476,35700,37400,1700,27870,4490.0,세방전지보통주
3207,4490,2018-11-02,0.0469897209985315,34050,35650,1600,21014,4490.0,세방전지보통주
3208,4490,2018-10-31,0.0415430267062314,33700,35100,1400,26170,4490.0,세방전지보통주
3209,4490,2018-09-14,0.0432432432432432,37000,38600,1600,44955,4490.0,세방전지보통주
3210,4490,2018-08-23,0.0403587443946188,33450,34800,1350,32978,4490.0,세방전지보통주
3211,4490,2018-05-16,0.0481203007518797,33250,34850,1600,74635,4490.0,세방전지보통주
3212,4490,2018-02-09,0.0616045845272206,34900,37050,2150,62462,4490.0,세방전지보통주
3213,4490,2017-11-15,0.0449775112443778,33350,34850,1500,62157,4490.0,세방전지보통주
3214,4490,2017-06-28,0.0416666666666666,38400,40000,1600,33111,4490.0,세방전지보통주
3215,4800,2021-05-03,0.0814889336016096,99400,107500,8100,537149,4800.0,효성보통주
3216,4800,2021-04-28,0.0502049180327868,97600,102500,4900,313451,4800.0,효성보통주
3217,4800,2021-04-21,0.0568060021436227,93300,98600,5300,322214,4800.0,효성보통주
3218,4800,2021-03-15,0.0567901234567901,81000,85600,4600,240803,4800.0,효성보통주
3219,4800,2021-02-24,0.0457209847596717,85300,81400,-3900,216652,4800.0,효성보통주
3220,4800,2021-02-03,0.0801001251564455,79900,86300,6400,1903007,4800.0,효성보통주
3221,4800,2021-02-01,0.068733153638814,74200,79300,5100,646975,4800.0,효성보통주
3222,4800,2020-12-29,0.0494437577255871,80900,76900,-4000,292426,4800.0,효성보통주
3223,4800,2020-11-24,0.0423076923076923,78000,81300,3300,135319,4800.0,효성보통주
3224,4800,2020-09-08,0.063030303030303,82500,77300,-5200,428875,4800.0,효성보통주
3225,4800,2020-09-04,0.1926470588235294,68000,81100,13100,1349850,4800.0,효성보통주
3226,4800,2020-08-20,0.0427728613569321,67800,64900,-2900,133446,4800.0,효성보통주
3227,4800,2020-08-18,0.0502793296089385,71600,68000,-3600,115736,4800.0,효성보통주
3228,4800,2020-07-27,0.0582241630276564,68700,72700,4000,258125,4800.0,효성보통주
3229,4800,2020-07-24,0.0409090909090909,66000,68700,2700,129237,4800.0,효성보통주
3230,4800,2020-07-15,0.0515297906602254,62100,65300,3200,161777,4800.0,효성보통주
3231,4800,2020-06-15,0.0568011958146487,66900,63100,-3800,114264,4800.0,효성보통주
3232,4800,2020-03-25,0.0981818181818181,55000,60400,5400,124865,4800.0,효성보통주
3233,4800,2020-03-24,0.07421875,51200,55000,3800,108459,4800.0,효성보통주
3234,4800,2020-03-23,0.1033274956217162,57100,51200,-5900,116781,4800.0,효성보통주
3235,4800,2020-03-20,0.1477386934673366,49750,57100,7350,230722,4800.0,효성보통주
3236,4800,2020-03-19,0.1652684563758389,59600,49750,-9850,222224,4800.0,효성보통주
3237,4800,2020-03-18,0.0816640986132511,64900,59600,-5300,115775,4800.0,효성보통주
3238,4800,2020-02-06,0.0629470672389127,69900,74300,4400,146283,4800.0,효성보통주
3239,4800,2019-12-27,0.0557532621589561,84300,79600,-4700,299642,4800.0,효성보통주
3240,4800,2019-08-06,0.0471014492753623,82800,86700,3900,119165,4800.0,효성보통주
3241,4800,2019-07-23,0.0437017994858611,77800,81200,3400,217813,4800.0,효성보통주
3242,4800,2019-07-18,0.062330623306233,73800,78400,4600,132870,4800.0,효성보통주
3243,4800,2019-05-29,0.0445859872611464,78500,75000,-3500,99408,4800.0,효성보통주
3244,4800,2019-05-02,0.0639147802929427,75100,79900,4800,274380,4800.0,효성보통주
3245,4800,2019-04-17,0.0465425531914893,75200,78700,3500,145142,4800.0,효성보통주
3246,4800,2019-02-07,0.044776119402985,67000,70000,3000,241513,4800.0,효성보통주
3247,4800,2019-02-01,0.0428571428571428,70000,67000,-3000,357618,4800.0,효성보통주
3248,4800,2019-01-30,0.0923566878980891,62800,68600,5800,515588,4800.0,효성보통주
3249,4800,2019-01-29,0.0466666666666666,60000,62800,2800,311884,4800.0,효성보통주
3250,4800,2019-01-23,0.0669077757685352,55300,59000,3700,474372,4800.0,효성보통주
3251,4800,2019-01-18,0.0813492063492063,50400,54500,4100,437434,4800.0,효성보통주
3252,4800,2019-01-15,0.050709939148073,49300,51800,2500,229513,4800.0,효성보통주
3253,4800,2019-01-02,0.041,50000,47950,-2050,358877,4800.0,효성보통주
3254,4800,2018-12-28,0.068901303538175,53700,50000,-3700,566289,4800.0,효성보통주
3255,4800,2018-12-27,0.0974789915966386,59500,53700,-5800,564287,4800.0,효성보통주
3256,4800,2018-12-19,0.0802139037433155,56100,60600,4500,481906,4800.0,효성보통주
3257,4800,2018-12-12,0.0471512770137524,50900,53300,2400,301892,4800.0,효성보통주
3258,4800,2018-11-29,0.0692464358452138,49100,52500,3400,467781,4800.0,효성보통주
3259,4800,2018-10-31,0.046938775510204,49000,51300,2300,426006,4800.0,효성보통주
3260,4800,2018-10-30,0.084070796460177,45200,49000,3800,810993,4800.0,효성보통주
3261,4800,2018-10-29,0.0698224852071005,42250,45200,2950,1697330,4800.0,효성보통주
3262,4800,2018-10-26,0.0673289183222958,45300,42250,-3050,304315,4800.0,효성보통주
3263,4800,2018-10-25,0.0523012552301255,47800,45300,-2500,183973,4800.0,효성보통주
3264,4800,2018-10-24,0.0681564245810055,44750,47800,3050,333345,4800.0,효성보통주
3265,4800,2018-10-23,0.0417558886509636,46700,44750,-1950,118704,4800.0,효성보통주
3266,4800,2018-10-11,0.0778947368421052,47500,43800,-3700,280855,4800.0,효성보통주
3267,4800,2018-09-11,0.0435754189944134,44750,46700,1950,251462,4800.0,효성보통주
3268,4800,2018-08-30,0.0574443141852286,42650,45100,2450,551846,4800.0,효성보통주
3269,4800,2018-07-30,0.0408401400233372,42850,44600,1750,310148,4800.0,효성보통주
3270,4800,2018-07-23,0.0444938820912124,44950,42950,-2000,498405,4800.0,효성보통주
3271,4800,2018-07-19,0.0591286307053941,48200,45350,-2850,1030478,4800.0,효성보통주
3272,4800,2018-07-18,0.071290944123314,51900,48200,-3700,1170083,4800.0,효성보통주
3273,4800,2018-07-16,0.0938053097345132,56500,51200,-5300,2486389,4800.0,효성보통주
3274,4800,2018-07-13,0.1701492537313433,134000,56500,-77500,6091316,4800.0,효성보통주
3275,4800,2018-05-28,0.0653846153846153,130000,138500,8500,543691,4800.0,효성보통주
3276,4800,2018-05-02,0.0418250950570342,131500,137000,5500,430937,4800.0,효성보통주
3277,4800,2018-04-30,0.0436507936507936,126000,131500,5500,248860,4800.0,효성보통주
3278,4800,2018-04-12,0.0456431535269709,120500,126000,5500,237728,4800.0,효성보통주
3279,4800,2018-03-23,0.04,125000,120000,-5000,215575,4800.0,효성보통주
3280,4800,2018-02-21,0.0447154471544715,123000,128500,5500,161515,4800.0,효성보통주
3281,4800,2018-02-09,0.0401606425702811,124500,119500,-5000,253266,4800.0,효성보통주
3282,4800,2018-01-29,0.0421455938697318,130500,136000,5500,360714,4800.0,효성보통주
3283,4800,2018-01-08,0.0419580419580419,143000,137000,-6000,298257,4800.0,효성보통주
3284,4800,2018-01-03,0.0611510791366906,139000,147500,8500,672529,4800.0,효성보통주
3285,4800,2017-12-14,0.0451127819548872,133000,139000,6000,315111,4800.0,효성보통주
3286,4800,2017-11-16,0.0595238095238095,126000,133500,7500,326272,4800.0,효성보통주
3287,4800,2017-09-05,0.0454545454545454,154000,161000,7000,265233,4800.0,효성보통주
3288,4800,2017-08-16,0.0526315789473684,171000,162000,-9000,355548,4800.0,효성보통주
3289,4800,2017-07-27,0.0410094637223974,158500,165000,6500,318555,4800.0,효성보통주
3290,4800,2017-07-04,0.0635838150289017,173000,162000,-11000,283880,4800.0,효성보통주
3291,4800,2017-05-22,0.0495049504950495,151500,159000,7500,337128,4800.0,효성보통주
3292,4800,2017-04-26,0.0777777777777777,135000,145500,10500,500952,4800.0,효성보통주
3293,4800,2016-10-04,0.05,130000,136500,6500,261875,4800.0,효성보통주
3294,4800,2016-08-09,0.0526315789473684,133000,140000,7000,203614,4800.0,효성보통주
3295,4990,2021-05-31,0.0677083333333333,38400,41000,2600,1504539,4990.0,롯데지주보통주
3296,4990,2021-05-10,0.0942334739803094,35550,38900,3350,1611068,4990.0,롯데지주보통주
3297,4990,2021-05-03,0.0505464480874316,36600,34750,-1850,790617,4990.0,롯데지주보통주
3298,4990,2021-01-29,0.0427728613569321,33900,32450,-1450,364026,4990.0,롯데지주보통주
3299,4990,2021-01-18,0.0439560439560439,36400,34800,-1600,401138,4990.0,롯데지주보통주
3300,4990,2021-01-11,0.0471063257065948,37150,35400,-1750,583291,4990.0,롯데지주보통주
3301,4990,2020-11-11,0.073170731707317,30750,33000,2250,810692,4990.0,롯데지주보통주
3302,4990,2020-08-18,0.0732436472346786,33450,31000,-2450,408673,4990.0,롯데지주보통주
3303,4990,2020-07-23,0.0543130990415335,31300,33000,1700,2314217,4990.0,롯데지주보통주
3304,4990,2020-06-23,0.0458839406207827,37050,35350,-1700,1360984,4990.0,롯데지주보통주
3305,4990,2020-06-22,0.0570613409415121,35050,37050,2000,1213814,4990.0,롯데지주보통주
3306,4990,2020-06-16,0.0727272727272727,33000,35400,2400,337718,4990.0,롯데지주보통주
3307,4990,2020-06-15,0.0517241379310344,34800,33000,-1800,647255,4990.0,롯데지주보통주
3308,4990,2020-05-22,0.0416107382550335,37250,35700,-1550,490690,4990.0,롯데지주보통주
3309,4990,2020-05-14,0.0413333333333333,37500,35950,-1550,963014,4990.0,롯데지주보통주
3310,4990,2020-04-29,0.0750670241286863,37300,40100,2800,20172140,4990.0,롯데지주보통주
3311,4990,2020-04-28,0.2996515679442508,28700,37300,8600,6209735,4990.0,롯데지주보통주
3312,4990,2020-04-27,0.0830188679245283,26500,28700,2200,399661,4990.0,롯데지주보통주
3313,4990,2020-03-25,0.09009009009009,22200,24200,2000,359348,4990.0,롯데지주보통주
3314,4990,2020-03-24,0.0521327014218009,21100,22200,1100,288322,4990.0,롯데지주보통주
3315,4990,2020-03-20,0.0515970515970515,20350,21400,1050,338433,4990.0,롯데지주보통주
3316,4990,2020-03-19,0.0915178571428571,22400,20350,-2050,297873,4990.0,롯데지주보통주
3317,4990,2020-03-18,0.0528541226215644,23650,22400,-1250,238157,4990.0,롯데지주보통주
3318,4990,2020-03-17,0.0502008032128514,24900,23650,-1250,258102,4990.0,롯데지주보통주
3319,4990,2020-03-13,0.0552486187845303,27150,25650,-1500,469101,4990.0,롯데지주보통주
3320,4990,2020-03-12,0.0654044750430292,29050,27150,-1900,310050,4990.0,롯데지주보통주
3321,4990,2020-01-23,0.0599455040871934,36700,38900,2200,760040,4990.0,롯데지주보통주
3322,4990,2020-01-20,0.057422969187675,35700,37750,2050,2999304,4990.0,롯데지주보통주
3323,4990,2019-08-19,0.0536912751677852,29800,31400,1600,183367,4990.0,롯데지주보통주
3324,4990,2019-08-05,0.0608308605341246,33700,31650,-2050,328855,4990.0,롯데지주보통주
3325,4990,2019-07-08,0.0496054114994363,44350,42150,-2200,181917,4990.0,롯데지주보통주
3326,4990,2019-01-02,0.0521821631878557,52700,49950,-2750,161549,4990.0,롯데지주보통주
3327,4990,2018-11-19,0.0473484848484848,52800,55300,2500,308885,4990.0,롯데지주보통주
3328,4990,2018-11-15,0.0515873015873015,50400,53000,2600,151306,4990.0,롯데지주보통주
3329,4990,2018-11-02,0.0426638917793964,48050,50100,2050,176327,4990.0,롯데지주보통주
3330,4990,2018-10-18,0.0400728597449908,54900,52700,-2200,297278,4990.0,롯데지주보통주
3331,4990,2018-09-28,0.0477064220183486,54500,57100,2600,333643,4990.0,롯데지주보통주
3332,4990,2018-09-21,0.0458891013384321,52300,54700,2400,282980,4990.0,롯데지주보통주
3333,4990,2018-09-13,0.0673267326732673,50500,53900,3400,521389,4990.0,롯데지주보통주
3334,4990,2018-09-11,0.0602910602910602,48100,51000,2900,453369,4990.0,롯데지주보통주
3335,4990,2018-07-17,0.0545808966861598,51300,54100,2800,325410,4990.0,롯데지주보통주
3336,4990,2018-07-04,0.0436363636363636,55000,52600,-2400,207353,4990.0,롯데지주보통주
3337,4990,2018-04-09,0.0557184750733137,68200,64400,-3800,490368,4990.0,롯데지주보통주
3338,4990,2018-04-02,0.0488188976377952,63500,66600,3100,333728,4990.0,롯데지주보통주
3339,4990,2018-02-14,0.0602409638554216,66400,62400,-4000,574852,4990.0,롯데지주보통주
3340,4990,2018-01-03,0.0595419847328244,65500,69400,3900,846812,4990.0,롯데지주보통주
3341,4990,2017-12-26,0.0581583198707592,61900,65500,3600,790010,4990.0,롯데지주보통주
3342,4990,2017-11-22,0.0540098199672667,61100,64400,3300,1906318,4990.0,롯데지주보통주
3343,4990,2017-11-02,0.0576923076923076,72800,68600,-4200,1329562,4990.0,롯데지주보통주
3344,4990,2017-10-31,0.0582386363636363,70400,74500,4100,3165055,4990.0,롯데지주보통주
3345,4990,2017-09-27,0.0514285714285714,175000,166000,-9000,147209,4990.0,롯데지주보통주
3346,4990,2017-09-25,0.0873015873015873,189000,172500,-16500,44748,4990.0,롯데지주보통주
3347,4990,2017-04-20,0.082901554404145,193000,209000,16000,94524,4990.0,롯데지주보통주
3348,4990,2017-03-08,0.0419753086419753,202500,194000,-8500,43827,4990.0,롯데지주보통주
3349,4990,2017-03-07,0.0411311053984575,194500,202500,8000,45444,4990.0,롯데지주보통주
3350,4990,2017-02-02,0.0581395348837209,215000,227500,12500,111740,4990.0,롯데지주보통주
3351,4990,2017-02-01,0.0539215686274509,204000,215000,11000,92981,4990.0,롯데지주보통주
3352,4990,2017-01-26,0.0539845758354755,194500,205000,10500,100576,4990.0,롯데지주보통주
3353,4990,2017-01-20,0.0985915492957746,177500,195000,17500,226697,4990.0,롯데지주보통주
3354,4990,2016-10-25,0.077562326869806,180500,194500,14000,126261,4990.0,롯데지주보통주
3355,5250,2021-05-24,0.067024128686327,37300,34800,-2500,820119,5250.0,녹십자홀딩스보통주
3356,5250,2021-05-17,0.040983606557377,36600,38100,1500,358664,5250.0,녹십자홀딩스보통주
3357,5250,2021-05-13,0.0416124837451235,38450,36850,-1600,423018,5250.0,녹십자홀딩스보통주
3358,5250,2021-05-10,0.0691489361702127,37600,40200,2600,796143,5250.0,녹십자홀딩스보통주
3359,5250,2021-04-28,0.0401002506265664,39900,38300,-1600,509219,5250.0,녹십자홀딩스보통주
3360,5250,2021-04-15,0.0568031704095112,37850,40000,2150,3580475,5250.0,녹십자홀딩스보통주
3361,5250,2021-04-12,0.0405594405594405,35750,37200,1450,667866,5250.0,녹십자홀딩스보통주
3362,5250,2021-04-09,0.080060422960725,33100,35750,2650,2491582,5250.0,녹십자홀딩스보통주
3363,5250,2021-03-09,0.0429958391123439,36050,34500,-1550,427842,5250.0,녹십자홀딩스보통주
3364,5250,2021-02-25,0.0511363636363636,35200,37000,1800,344667,5250.0,녹십자홀딩스보통주
3365,5250,2021-02-18,0.0588942307692307,41600,39150,-2450,760858,5250.0,녹십자홀딩스보통주
3366,5250,2021-02-17,0.0480549199084668,43700,41600,-2100,749352,5250.0,녹십자홀딩스보통주
3367,5250,2021-02-16,0.044205495818399,41850,43700,1850,3247843,5250.0,녹십자홀딩스보통주
3368,5250,2021-01-28,0.0846938775510204,49000,44850,-4150,912171,5250.0,녹십자홀딩스보통주
3369,5250,2021-01-25,0.0505376344086021,46500,48850,2350,1969766,5250.0,녹십자홀딩스보통주
3370,5250,2021-01-22,0.0851808634772462,42850,46500,3650,3788194,5250.0,녹십자홀딩스보통주
3371,5250,2021-01-18,0.0783898305084745,47200,43500,-3700,1712394,5250.0,녹십자홀딩스보통주
3372,5250,2021-01-15,0.0776255707762557,43800,47200,3400,8701399,5250.0,녹십자홀딩스보통주
3373,5250,2021-01-11,0.050314465408805,47700,45300,-2400,1245323,5250.0,녹십자홀딩스보통주
3374,5250,2021-01-08,0.0412060301507537,49750,47700,-2050,2454725,5250.0,녹십자홀딩스보통주
3375,5250,2021-01-05,0.0755597014925373,53600,49550,-4050,6576780,5250.0,녹십자홀딩스보통주
3376,5250,2021-01-04,0.2915662650602409,41500,53600,12100,17193118,5250.0,녹십자홀딩스보통주
3377,5250,2020-12-30,0.1559888579387186,35900,41500,5600,15537860,5250.0,녹십자홀딩스보통주
3378,5250,2020-12-29,0.0829562594268476,33150,35900,2750,1640961,5250.0,녹십자홀딩스보통주
3379,5250,2020-12-23,0.0478796169630642,36550,34800,-1750,512251,5250.0,녹십자홀딩스보통주
3380,5250,2020-12-14,0.0606060606060606,36300,38500,2200,2194518,5250.0,녹십자홀딩스보통주
3381,5250,2020-12-07,0.0450070323488045,35550,37150,1600,3061192,5250.0,녹십자홀딩스보통주
3382,5250,2020-11-25,0.0925925925925925,40500,36750,-3750,3393194,5250.0,녹십자홀딩스보통주
3383,5250,2020-11-23,0.0439698492462311,39800,41550,1750,617657,5250.0,녹십자홀딩스보통주
3384,5250,2020-11-19,0.046875,41600,39650,-1950,791860,5250.0,녹십자홀딩스보통주
3385,5250,2020-11-17,0.2058823529411764,34000,41000,7000,8668179,5250.0,녹십자홀딩스보통주
3386,5250,2020-11-05,0.0971428571428571,35000,38400,3400,13872125,5250.0,녹십자홀딩스보통주
3387,5250,2020-11-04,0.2987012987012987,26950,35000,8050,13947437,5250.0,녹십자홀딩스보통주
3388,5250,2020-11-03,0.1443736730360934,23550,26950,3400,3429260,5250.0,녹십자홀딩스보통주
3389,5250,2020-11-02,0.0466666666666666,22500,23550,1050,302318,5250.0,녹십자홀딩스보통주
3390,5250,2020-10-23,0.049438202247191,22250,23350,1100,1446240,5250.0,녹십자홀딩스보통주
3391,5250,2020-09-24,0.0489361702127659,23500,22350,-1150,169865,5250.0,녹십자홀딩스보통주
3392,5250,2020-09-22,0.0512820512820512,25350,24050,-1300,181572,5250.0,녹십자홀딩스보통주
3393,5250,2020-09-09,0.0757314974182444,29050,26850,-2200,404522,5250.0,녹십자홀딩스보통주
3394,5250,2020-09-08,0.0880149812734082,26700,29050,2350,1183324,5250.0,녹십자홀딩스보통주
3395,5250,2020-08-19,0.0508166969147005,27550,28950,1400,356605,5250.0,녹십자홀딩스보통주
3396,5250,2020-08-18,0.0483592400690846,28950,27550,-1400,331733,5250.0,녹십자홀딩스보통주
3397,5250,2020-08-06,0.0463258785942492,31300,29850,-1450,969770,5250.0,녹십자홀딩스보통주
3398,5250,2020-08-05,0.1465201465201465,27300,31300,4000,4322247,5250.0,녹십자홀딩스보통주
3399,5250,2020-07-23,0.0427046263345195,28100,26900,-1200,558024,5250.0,녹십자홀딩스보통주
3400,5250,2020-07-22,0.0465549348230912,26850,28100,1250,945219,5250.0,녹십자홀딩스보통주
3401,5250,2020-07-20,0.1012396694214876,24200,26650,2450,1746879,5250.0,녹십자홀딩스보통주
3402,5250,2020-07-13,0.0874200426439232,23450,25500,2050,909171,5250.0,녹십자홀딩스보통주
3403,5250,2020-06-16,0.0682819383259911,22700,24250,1550,174436,5250.0,녹십자홀딩스보통주
3404,5250,2020-06-15,0.0580912863070539,24100,22700,-1400,261090,5250.0,녹십자홀딩스보통주
3405,5250,2020-06-09,0.0462555066079295,22700,23750,1050,260563,5250.0,녹십자홀딩스보통주
3406,5250,2020-05-29,0.0593406593406593,22750,21400,-1350,157310,5250.0,녹십자홀딩스보통주
3407,5250,2020-05-11,0.0697674418604651,21500,23000,1500,268259,5250.0,녹십자홀딩스보통주
3408,5250,2020-04-08,0.0647773279352226,24700,23100,-1600,561944,5250.0,녹십자홀딩스보통주
3409,5250,2020-04-07,0.1151241534988713,22150,24700,2550,1813993,5250.0,녹십자홀딩스보통주
3410,5250,2020-04-02,0.0523809523809523,21000,22100,1100,585409,5250.0,녹십자홀딩스보통주
3411,5250,2020-04-01,0.0526315789473684,19950,21000,1050,1011400,5250.0,녹십자홀딩스보통주
3412,5250,2020-03-31,0.0754716981132075,18550,19950,1400,389164,5250.0,녹십자홀딩스보통주
3413,5250,2020-03-30,0.0450704225352112,17750,18550,800,359972,5250.0,녹십자홀딩스보통주
3414,5250,2020-03-24,0.0441640378548895,15850,16550,700,92592,5250.0,녹십자홀딩스보통주
3415,5250,2020-03-23,0.0942857142857142,17500,15850,-1650,100497,5250.0,녹십자홀딩스보통주
3416,5250,2020-03-20,0.174496644295302,14900,17500,2600,105034,5250.0,녹십자홀딩스보통주
3417,5250,2020-03-19,0.1077844311377245,16700,14900,-1800,175614,5250.0,녹십자홀딩스보통주
3418,5250,2020-03-12,0.042016806722689,17850,17100,-750,165373,5250.0,녹십자홀딩스보통주
3419,5250,2020-02-24,0.0483870967741935,18600,17700,-900,69271,5250.0,녹십자홀딩스보통주
3420,5250,2020-01-08,0.0508083140877598,21650,20550,-1100,69893,5250.0,녹십자홀딩스보통주
3421,5250,2019-12-26,0.0470588235294117,21250,22250,1000,60278,5250.0,녹십자홀딩스보통주
3422,5250,2019-10-31,0.04,20000,20800,800,135332,5250.0,녹십자홀딩스보통주
3423,5250,2019-09-17,0.0763358778625954,19650,21150,1500,129173,5250.0,녹십자홀딩스보통주
3424,5250,2019-08-16,0.0431266846361186,18550,17750,-800,55903,5250.0,녹십자홀딩스보통주
3425,5250,2019-08-05,0.0545454545454545,19250,18200,-1050,66403,5250.0,녹십자홀딩스보통주
3426,5250,2019-07-29,0.0512195121951219,20500,19450,-1050,70090,5250.0,녹십자홀딩스보통주
3427,5250,2019-07-25,0.0608108108108108,22200,20850,-1350,103301,5250.0,녹십자홀딩스보통주
3428,5250,2019-07-19,0.055813953488372,21500,22700,1200,59111,5250.0,녹십자홀딩스보통주
3429,5250,2019-07-11,0.0502283105022831,21900,23000,1100,66653,5250.0,녹십자홀딩스보통주
3430,5250,2019-05-09,0.0404255319148936,23500,22550,-950,64374,5250.0,녹십자홀딩스보통주
3431,5250,2019-04-03,0.0433884297520661,24200,25250,1050,49496,5250.0,녹십자홀딩스보통주
3432,5250,2019-02-13,0.0419161676646706,25050,26100,1050,111566,5250.0,녹십자홀딩스보통주
3433,5250,2019-02-11,0.0604166666666666,24000,25450,1450,174386,5250.0,녹십자홀딩스보통주
3434,5250,2018-11-06,0.0631808278867102,22950,24400,1450,135209,5250.0,녹십자홀딩스보통주
3435,5250,2018-11-02,0.0651162790697674,21500,22900,1400,72316,5250.0,녹십자홀딩스보통주
3436,5250,2018-10-31,0.0459770114942528,21750,20750,-1000,129602,5250.0,녹십자홀딩스보통주
3437,5250,2018-10-11,0.0638722554890219,25050,23450,-1600,195712,5250.0,녹십자홀딩스보통주
3438,5250,2018-10-02,0.0489510489510489,28600,27200,-1400,144190,5250.0,녹십자홀딩스보통주
3439,5250,2018-09-27,0.0577849117174959,31150,29350,-1800,387140,5250.0,녹십자홀딩스보통주
3440,5250,2018-08-20,0.0785498489425981,33100,30500,-2600,344285,5250.0,녹십자홀딩스보통주
3441,5250,2018-08-17,0.0694668820678513,30950,33100,2150,1005875,5250.0,녹십자홀딩스보통주
3442,5250,2018-07-13,0.0543130990415335,31300,33000,1700,47829,5250.0,녹십자홀딩스보통주
3443,5250,2018-06-19,0.0896921017402945,37350,34000,-3350,116563,5250.0,녹십자홀딩스보통주
3444,5250,2018-04-18,0.0474452554744525,41100,39150,-1950,74079,5250.0,녹십자홀딩스보통주
3445,5250,2018-03-23,0.0431565967940813,40550,38800,-1750,80775,5250.0,녹십자홀딩스보통주
3446,5250,2018-02-23,0.0401505646173149,39850,41450,1600,80920,5250.0,녹십자홀딩스보통주
3447,5250,2018-02-05,0.0419235511713933,40550,38850,-1700,89219,5250.0,녹십자홀딩스보통주
3448,5250,2018-01-04,0.0539845758354755,38900,36800,-2100,117485,5250.0,녹십자홀딩스보통주
3449,5250,2017-12-13,0.0415549597855227,37300,38850,1550,108774,5250.0,녹십자홀딩스보통주
3450,5250,2017-12-11,0.0473537604456824,35900,37600,1700,49394,5250.0,녹십자홀딩스보통주
3451,5250,2017-11-22,0.0460048426150121,41300,39400,-1900,245337,5250.0,녹십자홀딩스보통주
3452,5250,2017-11-15,0.0417193426042983,39550,41200,1650,394770,5250.0,녹십자홀딩스보통주
3453,5250,2017-10-16,0.0533672172808132,39350,37250,-2100,233194,5250.0,녹십자홀딩스보통주
3454,5250,2017-09-26,0.056338028169014,35500,37500,2000,197262,5250.0,녹십자홀딩스보통주
3455,5250,2017-09-20,0.0805084745762711,35400,38250,2850,531847,5250.0,녹십자홀딩스보통주
3456,5250,2017-09-14,0.0415472779369627,34900,36350,1450,121071,5250.0,녹십자홀딩스보통주
3457,5250,2017-09-13,0.0425240054869684,36450,34900,-1550,149478,5250.0,녹십자홀딩스보통주
3458,5250,2017-09-11,0.0459110473457675,34850,36450,1600,277371,5250.0,녹십자홀딩스보통주
3459,5250,2017-08-29,0.0451713395638629,32100,33550,1450,193797,5250.0,녹십자홀딩스보통주
3460,5250,2017-07-26,0.0581039755351682,32700,34600,1900,259849,5250.0,녹십자홀딩스보통주
3461,5250,2017-07-13,0.0465489566613162,31150,29700,-1450,210454,5250.0,녹십자홀딩스보통주
3462,5250,2017-06-19,0.0459770114942528,30450,31850,1400,184240,5250.0,녹십자홀딩스보통주
3463,5250,2017-06-12,0.0538116591928251,33450,31650,-1800,326211,5250.0,녹십자홀딩스보통주
3464,5250,2017-05-24,0.0415430267062314,33700,35100,1400,223362,5250.0,녹십자홀딩스보통주
3465,5250,2017-03-21,0.1045364891518737,25350,28000,2650,469894,5250.0,녹십자홀딩스보통주
3466,5250,2017-03-10,0.0570866141732283,25400,26850,1450,119771,5250.0,녹십자홀딩스보통주
3467,5250,2017-03-08,0.0433145009416195,26550,25400,-1150,104151,5250.0,녹십자홀딩스보통주
3468,5250,2017-02-17,0.0493827160493827,24300,25500,1200,186692,5250.0,녹십자홀딩스보통주
3469,5250,2017-02-15,0.0572687224669603,22700,24000,1300,214943,5250.0,녹십자홀딩스보통주
3470,5250,2017-01-24,0.0477223427331887,23050,21950,-1100,128978,5250.0,녹십자홀딩스보통주
3471,5250,2017-01-13,0.0433789954337899,21900,22850,950,206230,5250.0,녹십자홀딩스보통주
3472,5250,2016-12-13,0.0646651270207852,21650,23050,1400,238843,5250.0,녹십자홀딩스보통주
3473,5250,2016-12-07,0.0402843601895734,21100,20250,-850,217188,5250.0,녹십자홀딩스보통주
3474,5250,2016-11-24,0.0611246943765281,20450,21700,1250,175558,5250.0,녹십자홀딩스보통주
3475,5250,2016-11-23,0.0850111856823266,22350,20450,-1900,188411,5250.0,녹십자홀딩스보통주
3476,5250,2016-11-10,0.0972222222222222,21600,23700,2100,196737,5250.0,녹십자홀딩스보통주
3477,5250,2016-11-04,0.0449172576832151,21150,22100,950,121482,5250.0,녹십자홀딩스보통주
3478,5250,2016-11-02,0.0642201834862385,21800,20400,-1400,217026,5250.0,녹십자홀딩스보통주
3479,5250,2016-10-31,0.0472103004291845,23300,22200,-1100,121556,5250.0,녹십자홀딩스보통주
3480,5250,2016-10-28,0.0509164969450101,24550,23300,-1250,90716,5250.0,녹십자홀딩스보통주
3481,5250,2016-09-30,0.052892561983471,30250,28650,-1600,135930,5250.0,녹십자홀딩스보통주
3482,5250,2016-09-20,0.0886075949367088,27650,30100,2450,130557,5250.0,녹십자홀딩스보통주
3483,5250,2016-08-22,0.0404984423676012,32100,30800,-1300,137507,5250.0,녹십자홀딩스보통주
3484,5300,2021-05-27,0.0410094637223974,158500,165000,6500,65358,5300.0,롯데칠성음료보통주
3485,5300,2021-05-17,0.051051051051051,166500,158000,-8500,106530,5300.0,롯데칠성음료보통주
3486,5300,2021-05-12,0.0403726708074534,161000,167500,6500,175648,5300.0,롯데칠성음료보통주
3487,5300,2021-05-11,0.0878378378378378,148000,161000,13000,132904,5300.0,롯데칠성음료보통주
3488,5300,2021-05-03,0.0607142857142857,140000,148500,8500,90071,5300.0,롯데칠성음료보통주
3489,5300,2021-04-29,0.062730627306273,135500,144000,8500,137422,5300.0,롯데칠성음료보통주
3490,5300,2021-04-21,0.0561797752808988,133500,141000,7500,94114,5300.0,롯데칠성음료보통주
3491,5300,2021-03-29,0.0944881889763779,127000,139000,12000,175285,5300.0,롯데칠성음료보통주
3492,5300,2021-03-03,0.0701754385964912,114000,122000,8000,58145,5300.0,롯데칠성음료보통주
3493,5300,2021-02-08,0.0436507936507936,126000,131500,5500,67109,5300.0,롯데칠성음료보통주
3494,5300,2021-02-02,0.0632911392405063,118500,126000,7500,55843,5300.0,롯데칠성음료보통주
3495,5300,2021-01-29,0.0530612244897959,122500,116000,-6500,50054,5300.0,롯데칠성음료보통주
3496,5300,2021-01-14,0.0578512396694214,121000,128000,7000,99492,5300.0,롯데칠성음료보통주
3497,5300,2021-01-12,0.0444444444444444,112500,117500,5000,145227,5300.0,롯데칠성음료보통주
3498,5300,2020-12-23,0.0420560747663551,107000,111500,4500,61964,5300.0,롯데칠성음료보통주
3499,5300,2020-11-17,0.0744444444444444,90000,96700,6700,197154,5300.0,롯데칠성음료보통주
3500,5300,2020-08-20,0.0461384152457372,99700,95100,-4600,51820,5300.0,롯데칠성음료보통주
3501,5300,2020-07-20,0.044776119402985,100500,105000,4500,52448,5300.0,롯데칠성음료보통주
3502,5300,2020-06-16,0.0684931506849315,109500,117000,7500,101780,5300.0,롯데칠성음료보통주
3503,5300,2020-06-15,0.0735294117647058,102000,109500,7500,183169,5300.0,롯데칠성음료보통주
3504,5300,2020-04-27,0.0497512437810945,100500,105500,5000,45073,5300.0,롯데칠성음료보통주
3505,5300,2020-04-07,0.0910087719298245,91200,99500,8300,80836,5300.0,롯데칠성음료보통주
3506,5300,2020-03-23,0.0772486772486772,94500,87200,-7300,18872,5300.0,롯데칠성음료보통주
3507,5300,2020-03-20,0.1666666666666666,81000,94500,13500,19007,5300.0,롯데칠성음료보통주
3508,5300,2020-03-19,0.1,90000,81000,-9000,37778,5300.0,롯데칠성음료보통주
3509,5300,2020-01-28,0.0570342205323193,131500,124000,-7500,26963,5300.0,롯데칠성음료보통주
3510,5300,2019-10-30,0.0606060606060606,148500,139500,-9000,27549,5300.0,롯데칠성음료보통주
3511,5300,2019-08-09,0.0433212996389891,138500,132500,-6000,43460,5300.0,롯데칠성음료보통주
3512,5300,2019-08-02,0.0409556313993174,146500,140500,-6000,22078,5300.0,롯데칠성음료보통주
3513,5300,2019-07-30,0.0662251655629139,151000,141000,-10000,46381,5300.0,롯데칠성음료보통주
3514,5300,2019-05-28,0.066860465116279,172000,183500,11500,46397,5300.0,롯데칠성음료보통주
3515,5300,2019-05-23,0.0524691358024691,162000,170500,8500,29701,5300.0,롯데칠성음료보통주
3516,5300,2019-05-16,0.0634920634920634,157500,167500,10000,32684,5300.0,롯데칠성음료보통주
3517,5300,2019-04-24,0.0557219892150988,1669000,1762000,93000,5320,5300.0,롯데칠성음료보통주
3518,5300,2019-03-12,0.0436117936117936,1628000,1699000,71000,6497,5300.0,롯데칠성음료보통주
3519,5300,2019-01-18,0.0485507246376811,1380000,1447000,67000,2769,5300.0,롯데칠성음료보통주
3520,5300,2018-11-15,0.04609375,1280000,1339000,59000,1399,5300.0,롯데칠성음료보통주
3521,5300,2018-10-24,0.0846441947565543,1335000,1448000,113000,2237,5300.0,롯데칠성음료보통주
3522,5300,2018-10-12,0.0414285714285714,1400000,1342000,-58000,1561,5300.0,롯데칠성음료보통주
3523,5300,2018-04-03,0.0627831715210356,1545000,1642000,97000,3782,5300.0,롯데칠성음료보통주
3524,5300,2018-02-09,0.0685752330226364,1502000,1605000,103000,6402,5300.0,롯데칠성음료보통주
3525,5300,2018-02-07,0.0427568602425015,1567000,1500000,-67000,2517,5300.0,롯데칠성음료보통주
3526,5300,2018-02-01,0.0422163588390501,1516000,1580000,64000,2730,5300.0,롯데칠성음료보통주
3527,5300,2018-01-22,0.0719002201027146,1363000,1461000,98000,5011,5300.0,롯데칠성음료보통주
3528,5300,2017-11-08,0.0433070866141732,1270000,1325000,55000,6741,5300.0,롯데칠성음료보통주
3529,5300,2017-11-01,0.0520607375271149,1383000,1311000,-72000,12063,5300.0,롯데칠성음료보통주
3530,5300,2017-10-31,0.0638461538461538,1300000,1383000,83000,13549,5300.0,롯데칠성음료보통주
3531,5300,2017-09-27,0.0498245614035087,1425000,1354000,-71000,14712,5300.0,롯데칠성음료보통주
3532,5300,2017-04-28,0.0760330578512396,1815000,1677000,-138000,11854,5300.0,롯데칠성음료보통주
3533,5300,2017-04-27,0.108735491753207,1637000,1815000,178000,23891,5300.0,롯데칠성음료보통주
3534,5300,2017-04-21,0.0435356200527704,1516000,1582000,66000,10795,5300.0,롯데칠성음료보통주
3535,5300,2017-04-20,0.0601398601398601,1430000,1516000,86000,9108,5300.0,롯데칠성음료보통주
3536,5380,2021-05-28,0.0521541950113378,220500,232000,11500,2394356,5380.0,현대자동차보통주
3537,5380,2021-04-02,0.0662100456621004,219000,233500,14500,3648528,5380.0,현대자동차보통주
3538,5380,2021-02-25,0.0425531914893617,235000,245000,10000,1562697,5380.0,현대자동차보통주
3539,5380,2021-02-08,0.0621242484969939,249500,234000,-15500,3212977,5380.0,현대자동차보통주
3540,5380,2021-02-01,0.0414847161572052,229000,238500,9500,1798912,5380.0,현대자동차보통주
3541,5380,2021-01-19,0.0850622406639004,241000,261500,20500,4976690,5380.0,현대자동차보통주
3542,5380,2021-01-15,0.0419161676646706,250500,240000,-10500,3915078,5380.0,현대자동차보통주
3543,5380,2021-01-11,0.0873983739837398,246000,267500,21500,14433887,5380.0,현대자동차보통주
3544,5380,2021-01-08,0.1941747572815534,206000,246000,40000,19933702,5380.0,현대자동차보통주
3545,5380,2021-01-04,0.0807291666666666,192000,207500,15500,5651695,5380.0,현대자동차보통주
3546,5380,2020-12-03,0.0767123287671232,182500,196500,14000,6053809,5380.0,현대자동차보통주
3547,5380,2020-10-05,0.0476190476190476,178500,187000,8500,2732820,5380.0,현대자동차보통주
3548,5380,2020-09-24,0.0445682451253481,179500,171500,-8000,2841908,5380.0,현대자동차보통주
3549,5380,2020-09-14,0.0495626822157434,171500,180000,8500,3145262,5380.0,현대자동차보통주
3550,5380,2020-08-28,0.0519877675840978,163500,172000,8500,5571784,5380.0,현대자동차보통주
3551,5380,2020-08-20,0.0577507598784194,164500,155000,-9500,3630223,5380.0,현대자동차보통주
3552,5380,2020-08-19,0.0411392405063291,158000,164500,6500,3298626,5380.0,현대자동차보통주
3553,5380,2020-08-18,0.0538922155688622,167000,158000,-9000,4328953,5380.0,현대자동차보통주
3554,5380,2020-08-11,0.0529411764705882,170000,179000,9000,6776406,5380.0,현대자동차보통주
3555,5380,2020-08-10,0.1564625850340136,147000,170000,23000,8460795,5380.0,현대자동차보통주
3556,5380,2020-08-06,0.0783582089552238,134000,144500,10500,4040334,5380.0,현대자동차보통주
3557,5380,2020-08-04,0.0433070866141732,127000,132500,5500,2492506,5380.0,현대자동차보통주
3558,5380,2020-07-23,0.050632911392405,118500,124500,6000,4505464,5380.0,현대자동차보통주
3559,5380,2020-07-17,0.0681818181818181,110000,117500,7500,4265529,5380.0,현대자동차보통주
3560,5380,2020-07-15,0.0738916256157635,101500,109000,7500,4494730,5380.0,현대자동차보통주
3561,5380,2020-06-24,0.0435663627152988,98700,103000,4300,1813817,5380.0,현대자동차보통주
3562,5380,2020-06-16,0.0463917525773195,97000,101500,4500,1389765,5380.0,현대자동차보통주
3563,5380,2020-06-15,0.0628019323671497,103500,97000,-6500,2022775,5380.0,현대자동차보통주
3564,5380,2020-06-12,0.0460829493087557,108500,103500,-5000,1977558,5380.0,현대자동차보통주
3565,5380,2020-06-03,0.0585365853658536,102500,108500,6000,3118795,5380.0,현대자동차보통주
3566,5380,2020-05-19,0.0783460282916213,91900,99100,7200,4564370,5380.0,현대자동차보통주
3567,5380,2020-04-21,0.0420081967213114,97600,93500,-4100,3634142,5380.0,현대자동차보통주
3568,5380,2020-04-09,0.0788888888888888,90000,97100,7100,3787201,5380.0,현대자동차보통주
3569,5380,2020-03-25,0.1296791443850267,74800,84500,9700,4604452,5380.0,현대자동차보통주
3570,5380,2020-03-24,0.0856313497822931,68900,74800,5900,2856282,5380.0,현대자동차보통주
3571,5380,2020-03-20,0.0789074355083459,65900,71100,5200,3349914,5380.0,현대자동차보통주
3572,5380,2020-03-19,0.1034013605442176,73500,65900,-7600,3138004,5380.0,현대자동차보통주
3573,5380,2020-03-18,0.0823970037453183,80100,73500,-6600,2679420,5380.0,현대자동차보통주
3574,5380,2020-03-16,0.0493119266055045,87200,82900,-4300,2674557,5380.0,현대자동차보통주
3575,5380,2020-03-13,0.0821052631578947,95000,87200,-7800,4835445,5380.0,현대자동차보통주
3576,5380,2020-03-12,0.05,100000,95000,-5000,2312355,5380.0,현대자동차보통주
3577,5380,2020-03-09,0.0588235294117647,110500,104000,-6500,1658544,5380.0,현대자동차보통주
3578,5380,2020-02-28,0.0495867768595041,121000,115000,-6000,1777353,5380.0,현대자동차보통주
3579,5380,2020-02-24,0.04296875,128000,122500,-5500,911932,5380.0,현대자동차보통주
3580,5380,2020-02-06,0.064516129032258,124000,132000,8000,1659774,5380.0,현대자동차보통주
3581,5380,2020-01-22,0.0854700854700854,117000,127000,10000,2773421,5380.0,현대자동차보통주
3582,5380,2019-04-03,0.042016806722689,119000,124000,5000,651778,5380.0,현대자동차보통주
3583,5380,2019-03-08,0.0438247011952191,125500,120000,-5500,467762,5380.0,현대자동차보통주
3584,5380,2019-02-27,0.0530612244897959,122500,129000,6500,1233285,5380.0,현대자동차보통주
3585,5380,2019-01-15,0.0493827160493827,121500,127500,6000,828015,5380.0,현대자동차보통주
3586,5380,2018-12-19,0.0423728813559322,118000,123000,5000,841175,5380.0,현대자동차보통주
3587,5380,2018-12-12,0.0627802690582959,111500,118500,7000,1558536,5380.0,현대자동차보통주
3588,5380,2018-11-30,0.07,100000,107000,7000,3017114,5380.0,현대자동차보통주
3589,5380,2018-11-27,0.0620399579390115,95100,101000,5900,1436195,5380.0,현대자동차보통주
3590,5380,2018-11-22,0.0511247443762781,97800,92800,-5000,1527106,5380.0,현대자동차보통주
3591,5380,2018-11-05,0.0545454545454545,110000,104000,-6000,921610,5380.0,현대자동차보통주
3592,5380,2018-10-25,0.0598290598290598,117000,110000,-7000,1633392,5380.0,현대자동차보통주
3593,5380,2018-04-26,0.0457317073170731,164000,156500,-7500,861668,5380.0,현대자동차보통주
3594,5380,2018-03-29,0.0528052805280528,151500,143500,-8000,1532300,5380.0,현대자동차보통주
3595,5380,2018-02-21,0.0423452768729641,153500,160000,6500,537567,5380.0,현대자동차보통주
3596,5380,2018-01-19,0.0451612903225806,155000,162000,7000,637243,5380.0,현대자동차보통주
3597,5380,2018-01-02,0.0416666666666666,156000,149500,-6500,731763,5380.0,현대자동차보통주
3598,5380,2017-12-11,0.0536277602523659,158500,150000,-8500,1235495,5380.0,현대자동차보통주
3599,5380,2017-10-26,0.074074074074074,148500,159500,11000,1550507,5380.0,현대자동차보통주
3600,5380,2017-09-26,0.0460992907801418,141000,147500,6500,841918,5380.0,현대자동차보통주
3601,5380,2017-05-18,0.0410094637223974,158500,165000,6500,1274106,5380.0,현대자동차보통주
3602,5380,2017-05-02,0.0486111111111111,144000,151000,7000,883476,5380.0,현대자동차보통주
3603,5380,2017-04-26,0.0449826989619377,144500,151000,6500,1288277,5380.0,현대자동차보통주
3604,5380,2017-03-21,0.0862619808306709,156500,170000,13500,2100147,5380.0,현대자동차보통주
3605,5380,2017-03-03,0.0437710437710437,148500,142000,-6500,774281,5380.0,현대자동차보통주
3606,5380,2016-12-08,0.0402930402930402,136500,142000,5500,889649,5380.0,현대자동차보통주
3607,5385,2021-05-28,0.0426540284360189,105500,110000,4500,129676,5385.0,현대자동차1우선주
3608,5385,2021-04-02,0.0591133004926108,101500,107500,6000,151389,5385.0,현대자동차1우선주
3609,5385,2021-03-19,0.0502283105022831,109500,104000,-5500,294876,5385.0,현대자동차1우선주
3610,5385,2021-03-18,0.0478468899521531,104500,109500,5000,114712,5385.0,현대자동차1우선주
3611,5385,2021-02-24,0.0454545454545454,110000,105000,-5000,127588,5385.0,현대자동차1우선주
3612,5385,2021-02-03,0.0474137931034482,116000,121500,5500,245461,5385.0,현대자동차1우선주
3613,5385,2021-01-29,0.0504201680672268,119000,113000,-6000,311928,5385.0,현대자동차1우선주
3614,5385,2021-01-21,0.0560344827586206,116000,122500,6500,421610,5385.0,현대자동차1우선주
3615,5385,2021-01-19,0.0582959641255605,111500,118000,6500,459736,5385.0,현대자동차1우선주
3616,5385,2021-01-18,0.047008547008547,117000,111500,-5500,662236,5385.0,현대자동차1우선주
3617,5385,2021-01-11,0.1578947368421052,104500,121000,16500,1653451,5385.0,현대자동차1우선주
3618,5385,2021-01-08,0.1611111111111111,90000,104500,14500,1613820,5385.0,현대자동차1우선주
3619,5385,2020-12-03,0.0423529411764705,85000,88600,3600,346208,5385.0,현대자동차1우선주
3620,5385,2020-09-14,0.0470446320868516,82900,86800,3900,152529,5385.0,현대자동차1우선주
3621,5385,2020-08-20,0.0510328068043742,82300,78100,-4200,297954,5385.0,현대자동차1우선주
3622,5385,2020-08-18,0.0680507497116493,86700,80800,-5900,336178,5385.0,현대자동차1우선주
3623,5385,2020-08-10,0.1265822784810126,79000,89000,10000,966852,5385.0,현대자동차1우선주
3624,5385,2020-08-06,0.0521978021978022,72800,76600,3800,253244,5385.0,현대자동차1우선주
3625,5385,2020-07-17,0.0799319727891156,58800,63500,4700,415950,5385.0,현대자동차1우선주
3626,5385,2020-07-15,0.0431654676258992,55600,58000,2400,268321,5385.0,현대자동차1우선주
3627,5385,2020-06-15,0.0476973684210526,60800,57900,-2900,276494,5385.0,현대자동차1우선주
3628,5385,2020-05-19,0.0707635009310986,53700,57500,3800,222549,5385.0,현대자동차1우선주
3629,5385,2020-04-09,0.0890909090909091,55000,59900,4900,195596,5385.0,현대자동차1우선주
3630,5385,2020-03-31,0.0455927051671732,49350,51600,2250,214284,5385.0,현대자동차1우선주
3631,5385,2020-03-25,0.1085972850678733,44200,49000,4800,407188,5385.0,현대자동차1우선주
3632,5385,2020-03-24,0.0461538461538461,42250,44200,1950,249395,5385.0,현대자동차1우선주
3633,5385,2020-03-20,0.0853960396039604,40400,43850,3450,170162,5385.0,현대자동차1우선주
3634,5385,2020-03-19,0.0941704035874439,44600,40400,-4200,228340,5385.0,현대자동차1우선주
3635,5385,2020-03-18,0.060063224446786,47450,44600,-2850,126626,5385.0,현대자동차1우선주
3636,5385,2020-03-17,0.045271629778672,49700,47450,-2250,125357,5385.0,현대자동차1우선주
3637,5385,2020-03-16,0.0533333333333333,52500,49700,-2800,148700,5385.0,현대자동차1우선주
3638,5385,2020-03-13,0.0641711229946524,56100,52500,-3600,223092,5385.0,현대자동차1우선주
3639,5385,2020-03-12,0.0491525423728813,59000,56100,-2900,115983,5385.0,현대자동차1우선주
3640,5385,2020-03-09,0.0509259259259259,64800,61500,-3300,102333,5385.0,현대자동차1우선주
3641,5385,2020-02-06,0.0452054794520547,73000,76300,3300,74177,5385.0,현대자동차1우선주
3642,5385,2020-01-22,0.0472878998609179,71900,75300,3400,69332,5385.0,현대자동차1우선주
3643,5385,2019-02-27,0.0458970792767733,71900,75200,3300,66072,5385.0,현대자동차1우선주
3644,5385,2019-01-15,0.0473457675753228,69700,73000,3300,64676,5385.0,현대자동차1우선주
3645,5385,2018-12-13,0.0416047548291233,67300,70100,2800,109026,5385.0,현대자동차1우선주
3646,5385,2018-11-30,0.0494417862838915,62700,65800,3100,149869,5385.0,현대자동차1우선주
3647,5385,2018-11-22,0.0414593698175787,60300,57800,-2500,81269,5385.0,현대자동차1우선주
3648,5385,2018-11-20,0.045886075949367,63200,60300,-2900,63874,5385.0,현대자동차1우선주
3649,5385,2018-10-25,0.0505359877488514,65300,62000,-3300,68458,5385.0,현대자동차1우선주
3650,5385,2018-04-24,0.0473118279569892,93000,97400,4400,307217,5385.0,현대자동차1우선주
3651,5385,2018-04-17,0.0401836969001148,87100,90600,3500,229636,5385.0,현대자동차1우선주
3652,5385,2018-04-04,0.0422535211267605,85200,88800,3600,104435,5385.0,현대자동차1우선주
3653,5385,2018-03-19,0.040929203539823,90400,86700,-3700,47154,5385.0,현대자동차1우선주
3654,5385,2017-10-26,0.0571428571428571,94500,99900,5400,94255,5385.0,현대자동차1우선주
3655,5385,2017-03-21,0.075,100000,107500,7500,111577,5385.0,현대자동차1우선주
3656,5385,2016-12-01,0.0417536534446764,95800,91800,-4000,30438,5385.0,현대자동차1우선주
3657,5385,2016-11-10,0.0409041980624327,92900,89100,-3800,60886,5385.0,현대자동차1우선주
3658,5387,2021-05-27,0.0452488687782805,110500,105500,-5000,224459,5387.0,현대자동차2우선주(신형)
3659,5387,2021-04-02,0.0710659898477157,98500,105500,7000,212281,5387.0,현대자동차2우선주(신형)
3660,5387,2021-02-26,0.0467289719626168,107000,102000,-5000,232077,5387.0,현대자동차2우선주(신형)
3661,5387,2021-02-24,0.0460829493087557,108500,103500,-5000,169394,5387.0,현대자동차2우선주(신형)
3662,5387,2021-02-10,0.0462962962962962,108000,113000,5000,94318,5387.0,현대자동차2우선주(신형)
3663,5387,2021-02-08,0.0614035087719298,114000,107000,-7000,190124,5387.0,현대자동차2우선주(신형)
3664,5387,2021-02-01,0.0485436893203883,103000,108000,5000,127937,5387.0,현대자동차2우선주(신형)
3665,5387,2021-01-29,0.0593607305936073,109500,103000,-6500,250714,5387.0,현대자동차2우선주(신형)
3666,5387,2021-01-26,0.0416666666666666,120000,115000,-5000,180599,5387.0,현대자동차2우선주(신형)
3667,5387,2021-01-21,0.0655021834061135,114500,122000,7500,319389,5387.0,현대자동차2우선주(신형)
3668,5387,2021-01-19,0.0981308411214953,107000,117500,10500,287452,5387.0,현대자동차2우선주(신형)
3669,5387,2021-01-11,0.116504854368932,103000,115000,12000,859727,5387.0,현대자동차2우선주(신형)
3670,5387,2021-01-08,0.13561190738699,90700,103000,12300,1253389,5387.0,현대자동차2우선주(신형)
3671,5387,2020-12-03,0.0443181818181818,88000,91900,3900,215355,5387.0,현대자동차2우선주(신형)
3672,5387,2020-09-14,0.0517448856799037,83100,87400,4300,102119,5387.0,현대자동차2우선주(신형)
3673,5387,2020-08-25,0.0439024390243902,82000,85600,3600,108829,5387.0,현대자동차2우선주(신형)
3674,5387,2020-08-20,0.0430622009569378,83600,80000,-3600,163389,5387.0,현대자동차2우선주(신형)
3675,5387,2020-08-18,0.0499419279907084,86100,81800,-4300,225496,5387.0,현대자동차2우선주(신형)
3676,5387,2020-08-10,0.113892365456821,79900,89000,9100,650756,5387.0,현대자동차2우선주(신형)
3677,5387,2020-08-06,0.0581081081081081,74000,78300,4300,176804,5387.0,현대자동차2우선주(신형)
3678,5387,2020-07-22,0.0436046511627907,68800,65800,-3000,261898,5387.0,현대자동차2우선주(신형)
3679,5387,2020-07-17,0.0840064620355412,61900,67100,5200,230788,5387.0,현대자동차2우선주(신형)
3680,5387,2020-07-15,0.0451388888888888,57600,60200,2600,277129,5387.0,현대자동차2우선주(신형)
3681,5387,2020-06-15,0.0793893129770992,65500,60300,-5200,179840,5387.0,현대자동차2우선주(신형)
3682,5387,2020-06-12,0.0507246376811594,69000,65500,-3500,151113,5387.0,현대자동차2우선주(신형)
3683,5387,2020-06-08,0.0456553755522827,67900,71000,3100,202992,5387.0,현대자동차2우선주(신형)
3684,5387,2020-06-05,0.0446153846153846,65000,67900,2900,157515,5387.0,현대자동차2우선주(신형)
3685,5387,2020-05-19,0.0974729241877256,55400,60800,5400,262857,5387.0,현대자동차2우선주(신형)
3686,5387,2020-04-09,0.0476190476190476,60900,63800,2900,74567,5387.0,현대자동차2우선주(신형)
3687,5387,2020-03-26,0.0497131931166348,52300,54900,2600,118551,5387.0,현대자동차2우선주(신형)
3688,5387,2020-03-25,0.0640895218718209,49150,52300,3150,434850,5387.0,현대자동차2우선주(신형)
3689,5387,2020-03-24,0.0479744136460554,46900,49150,2250,107314,5387.0,현대자동차2우선주(신형)
3690,5387,2020-03-19,0.0929549902152641,51100,46350,-4750,136132,5387.0,현대자동차2우선주(신형)
3691,5387,2020-03-18,0.0623853211009174,54500,51100,-3400,185432,5387.0,현대자동차2우선주(신형)
3692,5387,2020-03-17,0.0421792618629174,56900,54500,-2400,120859,5387.0,현대자동차2우선주(신형)
3693,5387,2020-03-16,0.0516666666666666,60000,56900,-3100,122600,5387.0,현대자동차2우선주(신형)
3694,5387,2020-03-13,0.0580847723704866,63700,60000,-3700,262859,5387.0,현대자동차2우선주(신형)
3695,5387,2020-03-09,0.0498614958448753,72200,68600,-3600,179610,5387.0,현대자동차2우선주(신형)
3696,5387,2020-02-06,0.0571428571428571,80500,85100,4600,103138,5387.0,현대자동차2우선주(신형)
3697,5387,2020-01-22,0.0490566037735849,79500,83400,3900,118558,5387.0,현대자동차2우선주(신형)
3698,5387,2019-03-14,0.0419847328244274,78600,75300,-3300,68813,5387.0,현대자동차2우선주(신형)
3699,5387,2019-02-27,0.0460947503201024,78100,81700,3600,299052,5387.0,현대자동차2우선주(신형)
3700,5387,2019-02-13,0.047945205479452,87600,83400,-4200,78585,5387.0,현대자동차2우선주(신형)
3701,5387,2019-01-02,0.0441558441558441,77000,73600,-3400,71224,5387.0,현대자동차2우선주(신형)
3702,5387,2018-12-13,0.0512820512820512,74100,77900,3800,68503,5387.0,현대자동차2우선주(신형)
3703,5387,2018-12-12,0.051063829787234,70500,74100,3600,170048,5387.0,현대자동차2우선주(신형)
3704,5387,2018-11-30,0.0449101796407185,66800,69800,3000,232797,5387.0,현대자동차2우선주(신형)
3705,5387,2018-11-27,0.0412044374009508,63100,65700,2600,71223,5387.0,현대자동차2우선주(신형)
3706,5387,2018-11-22,0.0599700149925037,66700,62700,-4000,127186,5387.0,현대자동차2우선주(신형)
3707,5387,2018-11-20,0.0481049562682215,68600,65300,-3300,68372,5387.0,현대자동차2우선주(신형)
3708,5387,2018-10-25,0.0683760683760683,70200,65400,-4800,225072,5387.0,현대자동차2우선주(신형)
3709,5387,2018-06-15,0.048832271762208,94200,89600,-4600,226349,5387.0,현대자동차2우선주(신형)
3710,5387,2018-06-04,0.0403726708074534,96600,100500,3900,40049,5387.0,현대자동차2우선주(신형)
3711,5387,2018-05-02,0.0434782608695652,115000,110000,-5000,334590,5387.0,현대자동차2우선주(신형)
3712,5387,2018-03-29,0.0401647785787847,97100,93200,-3900,92158,5387.0,현대자동차2우선주(신형)
3713,5387,2018-02-09,0.0409756097560975,102500,98300,-4200,60807,5387.0,현대자동차2우선주(신형)
3714,5387,2017-11-07,0.0480349344978165,114500,109000,-5500,74831,5387.0,현대자동차2우선주(신형)
3715,5387,2017-10-26,0.0679611650485436,103000,110000,7000,188960,5387.0,현대자동차2우선주(신형)
3716,5387,2017-06-14,0.0476190476190476,115500,121000,5500,181209,5387.0,현대자동차2우선주(신형)
3717,5387,2017-04-26,0.0505050505050505,99000,104000,5000,153116,5387.0,현대자동차2우선주(신형)
3718,5387,2017-03-21,0.0676328502415458,103500,110500,7000,333548,5387.0,현대자동차2우선주(신형)
3719,5490,2021-05-20,0.053177691309987,385500,365000,-20500,743678,5490.0,포스코보통주
3720,5490,2021-05-18,0.050408719346049,367000,385500,18500,597298,5490.0,포스코보통주
3721,5490,2021-05-06,0.0504648074369189,376500,395500,19000,716999,5490.0,포스코보통주
3722,5490,2021-04-27,0.0413793103448275,362500,377500,15000,734422,5490.0,포스코보통주
3723,5490,2021-04-05,0.0502354788069073,318500,334500,16000,573076,5490.0,포스코보통주
3724,5490,2021-03-22,0.0519930675909878,288500,303500,15000,592657,5490.0,포스코보통주
3725,5490,2021-03-10,0.0741324921135646,317000,293500,-23500,2910722,5490.0,포스코보통주
3726,5490,2021-03-03,0.0491228070175438,285000,299000,14000,794021,5490.0,포스코보통주
3727,5490,2021-02-23,0.042910447761194,268000,279500,11500,875441,5490.0,포스코보통주
3728,5490,2021-01-05,0.0439560439560439,273000,285000,12000,898657,5490.0,포스코보통주
3729,5490,2020-12-04,0.0556660039761431,251500,265500,14000,662533,5490.0,포스코보통주
3730,5490,2020-12-01,0.0491452991452991,234000,245500,11500,413073,5490.0,포스코보통주
3731,5490,2020-10-23,0.0476190476190476,210000,220000,10000,903396,5490.0,포스코보통주
3732,5490,2020-10-05,0.0459183673469387,196000,205000,9000,723156,5490.0,포스코보통주
3733,5490,2020-08-11,0.0428211586901763,198500,207000,8500,655895,5490.0,포스코보통주
3734,5490,2020-06-29,0.040983606557377,183000,175500,-7500,371334,5490.0,포스코보통주
3735,5490,2020-06-16,0.0714285714285714,175000,187500,12500,409758,5490.0,포스코보통주
3736,5490,2020-06-15,0.0616621983914209,186500,175000,-11500,467754,5490.0,포스코보통주
3737,5490,2020-06-03,0.0714285714285714,189000,202500,13500,1148869,5490.0,포스코보통주
3738,5490,2020-05-19,0.0532544378698224,169000,178000,9000,724613,5490.0,포스코보통주
3739,5490,2020-04-10,0.0820668693009118,164500,178000,13500,977632,5490.0,포스코보통주
3740,5490,2020-03-27,0.0514469453376205,155500,163500,8000,567062,5490.0,포스코보통주
3741,5490,2020-03-25,0.1065292096219931,145500,161000,15500,581137,5490.0,포스코보통주
3742,5490,2020-03-24,0.0543478260869565,138000,145500,7500,476227,5490.0,포스코보통주
3743,5490,2020-03-23,0.0449826989619377,144500,138000,-6500,457989,5490.0,포스코보통주
3744,5490,2020-03-19,0.0542372881355932,147500,139500,-8000,645668,5490.0,포스코보통주
3745,5490,2020-03-18,0.0514469453376205,155500,147500,-8000,559707,5490.0,포스코보통주
3746,5490,2020-03-17,0.0401234567901234,162000,155500,-6500,547216,5490.0,포스코보통주
3747,5490,2020-03-16,0.0526315789473684,171000,162000,-9000,506250,5490.0,포스코보통주
3748,5490,2020-03-09,0.0598958333333333,192000,180500,-11500,551277,5490.0,포스코보통주
3749,5490,2020-02-06,0.0442890442890442,214500,224000,9500,363840,5490.0,포스코보통주
3750,5490,2020-01-28,0.0602910602910602,240500,226000,-14500,583981,5490.0,포스코보통주
3751,5490,2019-10-25,0.0448430493273542,223000,213000,-10000,627591,5490.0,포스코보통주
3752,5490,2019-09-11,0.0606741573033707,222500,236000,13500,638820,5490.0,포스코보통주
3753,5490,2019-04-01,0.0533596837944664,253000,266500,13500,383947,5490.0,포스코보통주
3754,5490,2019-02-08,0.0434782608695652,276000,264000,-12000,375634,5490.0,포스코보통주
3755,5490,2019-01-30,0.0614525139664804,268500,285000,16500,549605,5490.0,포스코보통주
3756,5490,2019-01-09,0.0407331975560081,245500,255500,10000,377323,5490.0,포스코보통주
3757,5490,2018-12-03,0.0484848484848484,247500,259500,12000,490568,5490.0,포스코보통주
3758,5490,2018-11-02,0.0599613152804642,258500,274000,15500,357961,5490.0,포스코보통주
3759,5490,2018-10-11,0.0551470588235294,272000,257000,-15000,462524,5490.0,포스코보통주
3760,5490,2018-10-04,0.0663265306122449,294000,274500,-19500,694978,5490.0,포스코보통주
3761,5490,2018-07-02,0.0425531914893617,329000,315000,-14000,241273,5490.0,포스코보통주
3762,5490,2018-06-19,0.0449438202247191,356000,340000,-16000,299004,5490.0,포스코보통주
3763,5490,2018-06-07,0.0439716312056737,352500,368000,15500,268336,5490.0,포스코보통주
3764,5490,2018-04-30,0.0612535612535612,351000,372500,21500,357719,5490.0,포스코보통주
3765,5490,2018-04-18,0.0495495495495495,333000,349500,16500,461637,5490.0,포스코보통주
3766,5490,2018-03-27,0.0533536585365853,328000,345500,17500,368550,5490.0,포스코보통주
3767,5490,2018-03-23,0.0558002936857562,340500,321500,-19000,450499,5490.0,포스코보통주
3768,5490,2018-02-28,0.0449141347424042,378500,361500,-17000,285527,5490.0,포스코보통주
3769,5490,2018-01-12,0.0545702592087312,366500,386500,20000,295131,5490.0,포스코보통주
3770,5490,2018-01-03,0.0545722713864306,339000,357500,18500,485812,5490.0,포스코보통주
3771,5490,2017-10-16,0.0584615384615384,325000,344000,19000,508392,5490.0,포스코보통주
3772,5490,2017-08-17,0.0470957613814756,318500,333500,15000,229886,5490.0,포스코보통주
3773,5490,2017-08-11,0.048048048048048,333000,317000,-16000,553833,5490.0,포스코보통주
3774,5490,2017-05-22,0.0497237569060773,271500,285000,13500,627805,5490.0,포스코보통주
3775,5490,2017-03-22,0.0426621160409556,293000,280500,-12500,533901,5490.0,포스코보통주
3776,5490,2017-03-16,0.0504504504504504,277500,291500,14000,499310,5490.0,포스코보통주
3777,5490,2017-02-24,0.0410958904109589,292000,280000,-12000,479758,5490.0,포스코보통주
3778,5490,2017-01-11,0.0781563126252505,249500,269000,19500,766951,5490.0,포스코보통주
3779,5490,2016-12-13,0.0513274336283185,282500,268000,-14500,627382,5490.0,포스코보통주
3780,5490,2016-12-08,0.0608365019011406,263000,279000,16000,764667,5490.0,포스코보통주
3781,5490,2016-11-10,0.0669546436285097,231500,247000,15500,668966,5490.0,포스코보통주
3782,5490,2016-11-09,0.045360824742268,242500,231500,-11000,592440,5490.0,포스코보통주
3783,5830,2021-05-06,0.0416666666666666,48000,50000,2000,290144,5830.0,DB손해보험보통주
3784,5830,2021-02-25,0.0467171717171717,39600,41450,1850,448522,5830.0,DB손해보험보통주
3785,5830,2021-02-22,0.0631578947368421,38000,40400,2400,1071937,5830.0,DB손해보험보통주
3786,5830,2020-08-20,0.0613943808532778,48050,45100,-2950,270688,5830.0,DB손해보험보통주
3787,5830,2020-08-19,0.0468409586056644,45900,48050,2150,264669,5830.0,DB손해보험보통주
3788,5830,2020-08-18,0.0536082474226804,48500,45900,-2600,333794,5830.0,DB손해보험보통주
3789,5830,2020-08-11,0.0980834272829763,44350,48700,4350,473612,5830.0,DB손해보험보통주
3790,5830,2020-06-12,0.0427528675703858,47950,45900,-2050,366051,5830.0,DB손해보험보통주
3791,5830,2020-06-11,0.0523715415019762,50600,47950,-2650,389221,5830.0,DB손해보험보통주
3792,5830,2020-06-02,0.0634920634920634,44100,46900,2800,398180,5830.0,DB손해보험보통주
3793,5830,2020-05-29,0.0408839779005524,45250,43400,-1850,1081359,5830.0,DB손해보험보통주
3794,5830,2020-05-21,0.0407098121085595,47900,45950,-1950,523205,5830.0,DB손해보험보통주
3795,5830,2020-05-19,0.0693641618497109,51900,48300,-3600,555616,5830.0,DB손해보험보통주
3796,5830,2020-05-15,0.0560165975103734,48200,50900,2700,438791,5830.0,DB손해보험보통주
3797,5830,2020-05-13,0.0407938257993384,45350,47200,1850,271045,5830.0,DB손해보험보통주
3798,5830,2020-04-27,0.0611764705882353,42500,45100,2600,262434,5830.0,DB손해보험보통주
3799,5830,2020-04-23,0.0435835351089588,41300,43100,1800,346294,5830.0,DB손해보험보통주
3800,5830,2020-04-21,0.0598404255319149,37600,39850,2250,414350,5830.0,DB손해보험보통주
3801,5830,2020-04-14,0.0427807486631016,37400,39000,1600,254540,5830.0,DB손해보험보통주
3802,5830,2020-04-10,0.0405027932960893,35800,37250,1450,465729,5830.0,DB손해보험보통주
3803,5830,2020-04-02,0.0726429675425038,32350,34700,2350,449745,5830.0,DB손해보험보통주
3804,5830,2020-04-01,0.0690647482014388,34750,32350,-2400,429379,5830.0,DB손해보험보통주
3805,5830,2020-03-31,0.0419790104947526,33350,34750,1400,406077,5830.0,DB손해보험보통주
3806,5830,2020-03-25,0.0868055555555555,28800,31300,2500,575367,5830.0,DB손해보험보통주
3807,5830,2020-03-20,0.2016806722689075,23800,28600,4800,995328,5830.0,DB손해보험보통주
3808,5830,2020-03-19,0.0898661567877629,26150,23800,-2350,632258,5830.0,DB손해보험보통주
3809,5830,2020-03-18,0.0576576576576576,27750,26150,-1600,535056,5830.0,DB손해보험보통주
3810,5830,2020-03-17,0.0734557595993322,29950,27750,-2200,589516,5830.0,DB손해보험보통주
3811,5830,2020-03-13,0.0661538461538461,32500,30350,-2150,809595,5830.0,DB손해보험보통주
3812,5830,2020-03-12,0.0538573508005822,34350,32500,-1850,864992,5830.0,DB손해보험보통주
3813,5830,2020-03-10,0.0578734858681022,37150,35000,-2150,706472,5830.0,DB손해보험보통주
3814,5830,2020-03-09,0.0486555697823303,39050,37150,-1900,325168,5830.0,DB손해보험보통주
3815,5830,2020-03-06,0.0417177914110429,40750,39050,-1700,446737,5830.0,DB손해보험보통주
3816,5830,2020-01-02,0.0420650095602294,52300,50100,-2200,194505,5830.0,DB손해보험보통주
3817,5830,2019-12-20,0.0452961672473867,57400,54800,-2600,404523,5830.0,DB손해보험보통주
3818,5830,2019-12-12,0.0897435897435897,54600,59500,4900,423194,5830.0,DB손해보험보통주
3819,5830,2019-11-27,0.0532110091743119,54500,57400,2900,215147,5830.0,DB손해보험보통주
3820,5830,2019-11-15,0.0516252390057361,52300,55000,2700,219825,5830.0,DB손해보험보통주
3821,5830,2019-11-07,0.058252427184466,51500,54500,3000,200516,5830.0,DB손해보험보통주
3822,5830,2019-11-04,0.0420841683366733,49900,52000,2100,134273,5830.0,DB손해보험보통주
3823,5830,2019-10-11,0.0612244897959183,49000,52000,3000,187912,5830.0,DB손해보험보통주
3824,5830,2019-08-12,0.0717017208413001,52300,48550,-3750,326540,5830.0,DB손해보험보통주
3825,5830,2019-07-03,0.0678260869565217,57500,53600,-3900,347286,5830.0,DB손해보험보통주
3826,5830,2019-05-13,0.0609212481426448,67300,63200,-4100,308557,5830.0,DB손해보험보통주
3827,5830,2018-11-12,0.0569800569800569,70200,74200,4000,266592,5830.0,DB손해보험보통주
3828,5830,2018-11-01,0.0584958217270195,71800,67600,-4200,275833,5830.0,DB손해보험보통주
3829,5830,2018-10-31,0.0543318649045521,68100,71800,3700,247234,5830.0,DB손해보험보통주
3830,5830,2018-10-30,0.0448807854137447,71300,68100,-3200,261203,5830.0,DB손해보험보통주
3831,5830,2018-09-27,0.0719640179910044,66700,71500,4800,394816,5830.0,DB손해보험보통주
3832,5830,2018-08-27,0.0423600605143721,66100,63300,-2800,309476,5830.0,DB손해보험보통주
3833,5830,2018-08-06,0.0461538461538461,65000,68000,3000,406095,5830.0,DB손해보험보통주
3834,5830,2018-06-21,0.0472440944881889,63500,60500,-3000,270313,5830.0,DB손해보험보통주
3835,5830,2018-06-18,0.0516666666666666,60000,63100,3100,477428,5830.0,DB손해보험보통주
3836,5830,2017-09-22,0.0453257790368272,70600,73800,3200,251877,5830.0,DB손해보험보통주
3837,5830,2017-08-01,0.0411985018726591,80100,83400,3300,258091,5830.0,DB손해보험보통주
3838,5830,2016-12-21,0.0720461095100864,69400,64400,-5000,484364,5830.0,DB손해보험보통주
3839,5830,2016-11-10,0.0518731988472622,69400,73000,3600,241724,5830.0,DB손해보험보통주
3840,5850,2021-05-31,0.0641025641025641,31200,33200,2000,888939,5850.0,에스엘보통주
3841,5850,2021-05-26,0.0496894409937888,32200,30600,-1600,669915,5850.0,에스엘보통주
3842,5850,2021-05-25,0.0420711974110032,30900,32200,1300,977739,5850.0,에스엘보통주
3843,5850,2021-05-20,0.0471380471380471,29700,31100,1400,1532448,5850.0,에스엘보통주
3844,5850,2021-05-18,0.127134724857685,26350,29700,3350,2401012,5850.0,에스엘보통주
3845,5850,2021-05-13,0.0529100529100529,28350,26850,-1500,700085,5850.0,에스엘보통주
3846,5850,2021-05-12,0.0759013282732447,26350,28350,2000,1641430,5850.0,에스엘보통주
3847,5850,2021-05-10,0.0424242424242424,24750,25800,1050,524463,5850.0,에스엘보통주
3848,5850,2021-04-27,0.0447154471544715,24600,23500,-1100,401089,5850.0,에스엘보통주
3849,5850,2021-04-02,0.0605381165919282,22300,23650,1350,697236,5850.0,에스엘보통주
3850,5850,2021-03-23,0.051440329218107,24300,23050,-1250,262483,5850.0,에스엘보통주
3851,5850,2021-03-18,0.0452586206896551,23200,24250,1050,645662,5850.0,에스엘보통주
3852,5850,2021-03-11,0.0932400932400932,21450,23450,2000,360624,5850.0,에스엘보통주
3853,5850,2021-03-08,0.0408602150537634,23250,22300,-950,164357,5850.0,에스엘보통주
3854,5850,2021-02-24,0.0661157024793388,24200,22600,-1600,324584,5850.0,에스엘보통주
3855,5850,2021-02-23,0.056768558951965,22900,24200,1300,443803,5850.0,에스엘보통주
3856,5850,2021-02-16,0.0483558994197292,25850,24600,-1250,496783,5850.0,에스엘보통주
3857,5850,2021-02-08,0.0931458699472759,28450,25800,-2650,818000,5850.0,에스엘보통주
3858,5850,2021-02-01,0.1538461538461538,24700,28500,3800,1423004,5850.0,에스엘보통주
3859,5850,2021-01-29,0.0444874274661508,25850,24700,-1150,568684,5850.0,에스엘보통주
3860,5850,2021-01-21,0.1810154525386313,22650,26750,4100,6262225,5850.0,에스엘보통주
3861,5850,2021-01-19,0.2901408450704225,17750,22900,5150,6408068,5850.0,에스엘보통주
3862,5850,2021-01-08,0.1533742331288343,16300,18800,2500,3611122,5850.0,에스엘보통주
3863,5850,2020-11-17,0.0451612903225806,15500,16200,700,656828,5850.0,에스엘보통주
3864,5850,2020-10-06,0.0574324324324324,14800,15650,850,1601743,5850.0,에스엘보통주
3865,5850,2020-10-05,0.0459363957597173,14150,14800,650,1910632,5850.0,에스엘보통주
3866,5850,2020-09-29,0.0926640926640926,12950,14150,1200,2246104,5850.0,에스엘보통주
3867,5850,2020-09-24,0.0656934306569343,13700,12800,-900,648582,5850.0,에스엘보통주
3868,5850,2020-09-23,0.0579150579150579,12950,13700,750,1871453,5850.0,에스엘보통주
3869,5850,2020-09-17,0.0769230769230769,12350,13300,950,2102697,5850.0,에스엘보통주
3870,5850,2020-09-01,0.0746887966804979,12050,12950,900,660036,5850.0,에스엘보통주
3871,5850,2020-07-22,0.04296875,12800,12250,-550,436999,5850.0,에스엘보통주
3872,5850,2020-07-17,0.0445344129554655,12350,12900,550,262142,5850.0,에스엘보통주
3873,5850,2020-07-13,0.0711111111111111,11250,12050,800,830502,5850.0,에스엘보통주
3874,5850,2020-05-19,0.051660516605166,13550,14250,700,354769,5850.0,에스엘보통주
3875,5850,2020-05-11,0.0416666666666666,13200,13750,550,262309,5850.0,에스엘보통주
3876,5850,2020-05-04,0.0490566037735849,13250,12600,-650,123196,5850.0,에스엘보통주
3877,5850,2020-04-28,0.044,12500,13050,550,110800,5850.0,에스엘보통주
3878,5850,2020-04-27,0.0416666666666666,12000,12500,500,78968,5850.0,에스엘보통주
3879,5850,2020-04-07,0.0488721804511278,13300,13950,650,123143,5850.0,에스엘보통주
3880,5850,2020-03-31,0.0517928286852589,12550,13200,650,226622,5850.0,에스엘보통주
3881,5850,2020-03-30,0.0546218487394958,11900,12550,650,98162,5850.0,에스엘보통주
3882,5850,2020-03-26,0.091324200913242,10950,11950,1000,284590,5850.0,에스엘보통주
3883,5850,2020-03-25,0.1162079510703364,9810,10950,1140,143113,5850.0,에스엘보통주
3884,5850,2020-03-24,0.0663043478260869,9200,9810,610,132194,5850.0,에스엘보통주
3885,5850,2020-03-23,0.0515463917525773,9700,9200,-500,144556,5850.0,에스엘보통주
3886,5850,2020-03-19,0.0712871287128712,10100,9380,-720,289615,5850.0,에스엘보통주
3887,5850,2020-03-18,0.085972850678733,11050,10100,-950,313441,5850.0,에스엘보통주
3888,5850,2020-03-17,0.0867768595041322,12100,11050,-1050,207287,5850.0,에스엘보통주
3889,5850,2020-03-13,0.0592885375494071,12650,11900,-750,308064,5850.0,에스엘보통주
3890,5850,2020-03-12,0.0524344569288389,13350,12650,-700,165729,5850.0,에스엘보통주
3891,5850,2020-03-06,0.0436241610738255,14900,14250,-650,196964,5850.0,에스엘보통주
3892,5850,2020-02-24,0.0473186119873817,15850,15100,-750,149570,5850.0,에스엘보통주
3893,5850,2020-01-28,0.0496083550913838,19150,18200,-950,177281,5850.0,에스엘보통주
3894,5850,2020-01-23,0.0580110497237569,18100,19150,1050,356529,5850.0,에스엘보통주
3895,5850,2020-01-08,0.0491329479768786,17300,16450,-850,99246,5850.0,에스엘보통주
3896,5850,2019-11-18,0.0886699507389162,20300,18500,-1800,403413,5850.0,에스엘보통주
3897,5850,2019-10-30,0.0427927927927927,22200,21250,-950,68284,5850.0,에스엘보통주
3898,5850,2019-08-09,0.0604026845637583,22350,23700,1350,165951,5850.0,에스엘보통주
3899,5850,2019-07-26,0.0501138952164009,21950,23050,1100,194154,5850.0,에스엘보통주
3900,5850,2019-07-24,0.0424528301886792,21200,22100,900,104272,5850.0,에스엘보통주
3901,5850,2019-06-10,0.0698198198198198,22200,23750,1550,233600,5850.0,에스엘보통주
3902,5850,2019-05-29,0.0450819672131147,24400,23300,-1100,163987,5850.0,에스엘보통주
3903,5850,2019-05-27,0.0961968680089485,22350,24500,2150,150903,5850.0,에스엘보통주
3904,5850,2019-05-09,0.0418410041841004,23900,22900,-1000,116947,5850.0,에스엘보통주
3905,5850,2019-04-18,0.0745341614906832,24150,25950,1800,212379,5850.0,에스엘보통주
3906,5850,2019-04-10,0.0416666666666666,22800,23750,950,148014,5850.0,에스엘보통주
3907,5850,2019-03-27,0.0414746543778801,21700,22600,900,81899,5850.0,에스엘보통주
3908,5850,2019-03-13,0.05720823798627,21850,23100,1250,185980,5850.0,에스엘보통주
3909,5850,2019-02-27,0.1068702290076335,19650,21750,2100,227131,5850.0,에스엘보통주
3910,5850,2019-01-22,0.0402843601895734,21100,20250,-850,54982,5850.0,에스엘보통주
3911,5850,2018-12-17,0.0482573726541554,18650,19550,900,132663,5850.0,에스엘보통주
3912,5850,2018-12-12,0.0840579710144927,17250,18700,1450,184614,5850.0,에스엘보통주
3913,5850,2018-12-06,0.0424242424242424,16500,17200,700,150306,5850.0,에스엘보통주
3914,5850,2018-11-22,0.0432098765432098,16200,15500,-700,93355,5850.0,에스엘보통주
3915,5850,2018-11-15,0.086092715231788,15100,16400,1300,402524,5850.0,에스엘보통주
3916,5850,2018-11-07,0.1030927835051546,14550,13050,-1500,381822,5850.0,에스엘보통주
3917,5850,2018-10-31,0.0431893687707641,15050,14400,-650,175110,5850.0,에스엘보통주
3918,5850,2018-10-30,0.0414012738853503,15700,15050,-650,106908,5850.0,에스엘보통주
3919,5850,2018-10-25,0.0722543352601156,17300,16050,-1250,153871,5850.0,에스엘보통주
3920,5850,2018-10-18,0.0444444444444444,18000,17200,-800,94680,5850.0,에스엘보통주
3921,5850,2018-07-31,0.0487179487179487,19500,20450,950,60672,5850.0,에스엘보통주
3922,5850,2018-07-23,0.048,18750,19650,900,109436,5850.0,에스엘보통주
3923,5850,2018-06-22,0.0591259640102827,19450,18300,-1150,97347,5850.0,에스엘보통주
3924,5850,2018-06-15,0.0733695652173913,18400,19750,1350,90223,5850.0,에스엘보통주
3925,5850,2018-06-14,0.0490956072351421,19350,18400,-950,89271,5850.0,에스엘보통주
3926,5850,2018-06-08,0.0402144772117962,18650,19400,750,87799,5850.0,에스엘보통주
3927,5850,2018-05-24,0.0462287104622871,20550,19600,-950,106624,5850.0,에스엘보통주
3928,5850,2018-04-24,0.046875,22400,21350,-1050,171366,5850.0,에스엘보통주
3929,5850,2018-04-12,0.0644490644490644,24050,22500,-1550,131187,5850.0,에스엘보통주
3930,5850,2018-04-09,0.0467706013363029,22450,23500,1050,221504,5850.0,에스엘보통주
3931,5850,2018-04-06,0.0589622641509434,21200,22450,1250,208950,5850.0,에스엘보통주
3932,5850,2018-03-23,0.0402684563758389,22350,21450,-900,62110,5850.0,에스엘보통주
3933,5850,2018-03-09,0.0413793103448275,21750,22650,900,82862,5850.0,에스엘보통주
3934,5850,2018-02-13,0.0545112781954887,26600,25150,-1450,219714,5850.0,에스엘보통주
3935,5850,2018-02-12,0.0533807829181494,28100,26600,-1500,97175,5850.0,에스엘보통주
3936,5850,2018-02-09,0.060377358490566,26500,28100,1600,224001,5850.0,에스엘보통주
3937,5850,2018-02-08,0.0495049504950495,25250,26500,1250,105770,5850.0,에스엘보통주
3938,5850,2018-02-07,0.0630797773654916,26950,25250,-1700,109850,5850.0,에스엘보통주
3939,5850,2018-01-24,0.0831792975970425,27050,29300,2250,382055,5850.0,에스엘보통주
3940,5850,2018-01-23,0.1341719077568134,23850,27050,3200,339132,5850.0,에스엘보통주
3941,5850,2018-01-17,0.0516129032258064,23250,24450,1200,133927,5850.0,에스엘보통주
3942,5850,2018-01-08,0.0575221238938053,22600,23900,1300,172854,5850.0,에스엘보통주
3943,5850,2017-12-20,0.0656455142231947,22850,24350,1500,471189,5850.0,에스엘보통주
3944,5850,2017-12-15,0.0466200466200466,21450,22450,1000,70626,5850.0,에스엘보통주
3945,5850,2017-12-14,0.0445434298440979,22450,21450,-1000,239148,5850.0,에스엘보통주
3946,5850,2017-11-16,0.0652173913043478,23000,21500,-1500,236530,5850.0,에스엘보통주
3947,5850,2017-10-26,0.0560975609756097,20500,21650,1150,103021,5850.0,에스엘보통주
3948,5850,2017-10-24,0.0734177215189873,19750,21200,1450,137802,5850.0,에스엘보통주
3949,5850,2017-09-26,0.0514285714285714,17500,18400,900,72169,5850.0,에스엘보통주
3950,5850,2017-08-16,0.0492170022371364,22350,21250,-1100,346797,5850.0,에스엘보통주
3951,5850,2017-06-08,0.048661800486618,20550,21550,1000,267698,5850.0,에스엘보통주
3952,5850,2017-05-16,0.0842105263157894,19000,20600,1600,374569,5850.0,에스엘보통주
3953,5850,2017-04-20,0.0422535211267605,17750,18500,750,193802,5850.0,에스엘보통주
3954,5850,2017-04-19,0.0405405405405405,18500,17750,-750,171061,5850.0,에스엘보통주
3955,5850,2017-03-27,0.0460048426150121,20650,19700,-950,179792,5850.0,에스엘보통주
3956,5850,2017-03-16,0.0452261306532663,19900,20800,900,187210,5850.0,에스엘보통주
3957,5850,2017-03-06,0.0524017467248908,22900,21700,-1200,228392,5850.0,에스엘보통주
3958,5850,2017-03-02,0.0665322580645161,24800,23150,-1650,164974,5850.0,에스엘보통주
3959,5850,2017-02-15,0.0967741935483871,23250,25500,2250,274213,5850.0,에스엘보통주
3960,5850,2017-02-13,0.0486111111111111,21600,22650,1050,150315,5850.0,에스엘보통주
3961,5850,2017-02-10,0.04,22500,21600,-900,139623,5850.0,에스엘보통주
3962,5850,2017-02-08,0.0402542372881355,23600,22650,-950,94844,5850.0,에스엘보통주
3963,5850,2017-02-07,0.0559284116331096,22350,23600,1250,127120,5850.0,에스엘보통주
3964,5850,2017-02-02,0.0507399577167019,23650,22450,-1200,178114,5850.0,에스엘보통주
3965,5850,2017-01-18,0.0705128205128205,23400,25050,1650,298836,5850.0,에스엘보통주
3966,5850,2017-01-04,0.0494623655913978,23250,24400,1150,195775,5850.0,에스엘보통주
3967,5850,2017-01-03,0.0763888888888889,21600,23250,1650,343580,5850.0,에스엘보통주
3968,5850,2016-12-06,0.0454545454545454,19800,20700,900,201229,5850.0,에스엘보통주
3969,5850,2016-12-01,0.0428954423592493,18650,19450,800,181803,5850.0,에스엘보통주
3970,5850,2016-11-15,0.0756578947368421,15200,16350,1150,700527,5850.0,에스엘보통주
3971,5850,2016-11-11,0.0410958904109589,14600,15200,600,44810,5850.0,에스엘보통주
3972,5850,2016-11-04,0.0610169491525423,14750,15650,900,59248,5850.0,에스엘보통주
3973,5850,2016-08-18,0.0687285223367697,14550,15550,1000,250730,5850.0,에스엘보통주
3974,5930,2021-02-25,0.0402439024390243,82000,85300,3300,34155986,5930.0,삼성전자보통주
3975,5930,2021-01-08,0.0711700844390832,82900,88800,5900,59013307,5930.0,삼성전자보통주
3976,5930,2020-12-24,0.0527740189445196,73900,77800,3900,32502870,5930.0,삼성전자보통주
3977,5930,2020-11-23,0.0432766615146831,64700,67500,2800,27134398,5930.0,삼성전자보통주
3978,5930,2020-11-16,0.0490506329113924,63200,66300,3100,36354334,5930.0,삼성전자보통주
3979,5930,2020-08-20,0.0415224913494809,57800,55400,-2400,30386029,5930.0,삼성전자보통주
3980,5930,2020-07-28,0.0539568345323741,55600,58600,3000,48431566,5930.0,삼성전자보통주
3981,5930,2020-06-16,0.0440881763527054,49900,52100,2200,21808375,5930.0,삼성전자보통주
3982,5930,2020-06-15,0.0458891013384321,52300,49900,-2400,28772921,5930.0,삼성전자보통주
3983,5930,2020-06-03,0.0603112840466926,51400,54500,3100,49257814,5930.0,삼성전자보통주
3984,5930,2020-04-17,0.0489795918367346,49000,51400,2400,32041675,5930.0,삼성전자보통주
3985,5930,2020-04-01,0.0408376963350785,47750,45800,-1950,27259532,5930.0,삼성전자보통주
3986,5930,2020-03-24,0.1047058823529411,42500,46950,4450,49801908,5930.0,삼성전자보통주
3987,5930,2020-03-23,0.0638766519823788,45400,42500,-2900,41701626,5930.0,삼성전자보통주
3988,5930,2020-03-20,0.0570430733410943,42950,45400,2450,49730008,5930.0,삼성전자보통주
3989,5930,2020-03-19,0.0581140350877193,45600,42950,-2650,56925513,5930.0,삼성전자보통주
3990,5930,2020-03-11,0.0457875457875457,54600,52100,-2500,45707281,5930.0,삼성전자보통주
3991,5930,2020-03-09,0.0407079646017699,56500,54200,-2300,30261485,5930.0,삼성전자보통주
3992,5930,2020-02-24,0.0405405405405405,59200,56800,-2400,25627537,5930.0,삼성전자보통주
3993,5930,2019-05-09,0.0406779661016949,44250,42450,-1800,23029718,5930.0,삼성전자보통주
3994,5930,2019-03-21,0.0408626560726447,44050,45850,1800,21138016,5930.0,삼성전자보통주
3995,5930,2018-11-02,0.0474495848161328,42150,44150,2000,16517112,5930.0,삼성전자보통주
3996,5930,2018-10-11,0.0485651214128035,45300,43100,-2200,19324537,5930.0,삼성전자보통주
3997,5930,2018-09-14,0.0408626560726447,44050,45850,1800,12446344,5930.0,삼성전자보통주
3998,5930,2018-03-06,0.0402654867256637,2260000,2351000,91000,308467,5930.0,삼성전자보통주
3999,5930,2018-02-02,0.0425531914893617,2491000,2385000,-106000,585207,5930.0,삼성전자보통주
4000,5930,2017-11-27,0.0508474576271186,2773000,2632000,-141000,362578,5930.0,삼성전자보통주
4001,5930,2017-09-18,0.0412698412698412,2520000,2624000,104000,230499,5930.0,삼성전자보통주
4002,5930,2017-07-28,0.0409638554216867,2490000,2388000,-102000,523366,5930.0,삼성전자보통주
4003,5930,2016-11-30,0.0411449016100178,1677000,1746000,69000,570704,5930.0,삼성전자보통주
4004,5930,2016-10-11,0.0803571428571428,1680000,1545000,-135000,768543,5930.0,삼성전자보통주
4005,5930,2016-10-06,0.0444718962322421,1619000,1691000,72000,591163,5930.0,삼성전자보통주
4006,5930,2016-09-13,0.0423208191126279,1465000,1527000,62000,494345,5930.0,삼성전자보통주
4007,5930,2016-09-12,0.0698412698412698,1575000,1465000,-110000,529987,5930.0,삼성전자보통주
4008,5930,2016-08-18,0.0472541507024265,1566000,1640000,74000,366541,5930.0,삼성전자보통주
4009,5935,2021-01-11,0.0411311053984575,77800,81000,3200,12293635,5935.0,삼성전자1우선주
4010,5935,2021-01-08,0.0471063257065948,74300,77800,3500,8225064,5935.0,삼성전자1우선주
4011,5935,2020-12-24,0.0414878397711015,69900,72800,2900,5870143,5935.0,삼성전자1우선주
4012,5935,2020-11-23,0.04631217838765,58300,61000,2700,3411903,5935.0,삼성전자1우선주
4013,5935,2020-07-28,0.0421052631578947,47500,49500,2000,6280763,5935.0,삼성전자1우선주
4014,5935,2020-06-03,0.05,44000,46200,2200,4824403,5935.0,삼성전자1우선주
4015,5935,2020-04-17,0.0413711583924349,42300,44050,1750,3207970,5935.0,삼성전자1우선주
4016,5935,2020-03-25,0.0587484035759897,39150,41450,2300,4241958,5935.0,삼성전자1우선주
4017,5935,2020-03-24,0.0875,36000,39150,3150,4179097,5935.0,삼성전자1우선주
4018,5935,2020-03-23,0.0526315789473684,38000,36000,-2000,3367606,5935.0,삼성전자1우선주
4019,5935,2020-03-20,0.0719322990126939,35450,38000,2550,4623584,5935.0,삼성전자1우선주
4020,5935,2020-03-19,0.0671052631578947,38000,35450,-2550,5640126,5935.0,삼성전자1우선주
4021,5935,2020-03-18,0.0416141235813367,39650,38000,-1650,3745813,5935.0,삼성전자1우선주
4022,5935,2020-03-09,0.0410958904109589,47450,45500,-1950,3515886,5935.0,삼성전자1우선주
4023,5935,2020-02-28,0.0420609884332281,47550,45550,-2000,3872934,5935.0,삼성전자1우선주
4024,5935,2019-03-21,0.0580736543909348,35300,37350,2050,2064463,5935.0,삼성전자1우선주
4025,5935,2019-01-09,0.0517799352750809,30900,32500,1600,1829977,5935.0,삼성전자1우선주
4026,5935,2019-01-07,0.0541871921182266,30450,32100,1650,1500454,5935.0,삼성전자1우선주
4027,5935,2018-11-20,0.0404463040446304,35850,34400,-1450,2476205,5935.0,삼성전자1우선주
4028,5935,2018-10-11,0.042817679558011,36200,34650,-1550,1976912,5935.0,삼성전자1우선주
4029,5935,2018-09-14,0.0441595441595441,35100,36650,1550,704944,5935.0,삼성전자1우선주
4030,5935,2018-04-05,0.0413476263399693,1959000,2040000,81000,24534,5935.0,삼성전자1우선주
4031,5935,2018-02-13,0.0558510638297872,1880000,1985000,105000,48889,5935.0,삼성전자1우선주
4032,5935,2018-02-02,0.0417678484701311,2059000,1973000,-86000,68655,5935.0,삼성전자1우선주
4033,5935,2018-01-10,0.0440313111545988,2044000,1954000,-90000,66062,5935.0,삼성전자1우선주
4034,5935,2017-12-28,0.0434348477284073,2003000,2090000,87000,35681,5935.0,삼성전자1우선주
4035,5935,2017-11-27,0.0519077196095829,2254000,2137000,-117000,55388,5935.0,삼성전자1우선주
4036,5935,2017-11-01,0.0424107142857142,2240000,2335000,95000,58951,5935.0,삼성전자1우선주
4037,5935,2017-10-31,0.0491803278688524,2135000,2240000,105000,72304,5935.0,삼성전자1우선주
4038,5935,2017-10-11,0.0489311163895486,2105000,2208000,103000,47010,5935.0,삼성전자1우선주
4039,5935,2017-08-03,0.041858090862685,1959000,1877000,-82000,72665,5935.0,삼성전자1우선주
4040,5935,2017-04-27,0.0475319926873857,1641000,1719000,78000,105630,5935.0,삼성전자1우선주
4041,5935,2017-03-02,0.0474598930481283,1496000,1567000,71000,39627,5935.0,삼성전자1우선주
4042,5935,2017-01-11,0.0406228842247799,1477000,1537000,60000,52422,5935.0,삼성전자1우선주
4043,5935,2016-11-30,0.0495356037151702,1292000,1356000,64000,102488,5935.0,삼성전자1우선주
4044,5935,2016-10-11,0.0650224215246636,1338000,1251000,-87000,65540,5935.0,삼성전자1우선주
4045,5935,2016-09-23,0.0538745387453874,1355000,1282000,-73000,57772,5935.0,삼성전자1우선주
4046,5935,2016-09-13,0.0670628183361629,1178000,1257000,79000,59880,5935.0,삼성전자1우선주
4047,5935,2016-09-12,0.0738993710691823,1272000,1178000,-94000,57393,5935.0,삼성전자1우선주
4048,5935,2016-09-09,0.0479041916167664,1336000,1272000,-64000,44012,5935.0,삼성전자1우선주
4049,5940,2021-05-06,0.0517928286852589,12550,13200,650,2504561,5940.0,엔에이치투자증권보통주
4050,5940,2021-04-30,0.0489795918367346,12250,12850,600,3183626,5940.0,엔에이치투자증권보통주
4051,5940,2021-02-01,0.0678733031674208,11050,11800,750,2125745,5940.0,엔에이치투자증권보통주
4052,5940,2020-12-29,0.047008547008547,11700,11150,-550,1940064,5940.0,엔에이치투자증권보통주
4053,5940,2020-12-01,0.0465116279069767,10750,11250,500,1476918,5940.0,엔에이치투자증권보통주
4054,5940,2020-11-30,0.0401785714285714,11200,10750,-450,2065835,5940.0,엔에이치투자증권보통주
4055,5940,2020-11-16,0.048076923076923,10400,10900,500,2596698,5940.0,엔에이치투자증권보통주
4056,5940,2020-10-28,0.0497354497354497,9450,9920,470,1825112,5940.0,엔에이치투자증권보통주
4057,5940,2020-10-23,0.0609243697478991,9520,10100,580,4073005,5940.0,엔에이치투자증권보통주
4058,5940,2020-08-25,0.0456570155902004,8980,9390,410,1480656,5940.0,엔에이치투자증권보통주
4059,5940,2020-08-20,0.0425531914893617,9400,9000,-400,2024141,5940.0,엔에이치투자증권보통주
4060,5940,2020-08-04,0.0482758620689655,8700,9120,420,3365017,5940.0,엔에이치투자증권보통주
4061,5940,2020-07-13,0.0512820512820512,8190,8610,420,2301339,5940.0,엔에이치투자증권보통주
4062,5940,2020-06-25,0.0430839002267573,8820,8440,-380,4200904,5940.0,엔에이치투자증권보통주
4063,5940,2020-06-23,0.0475184794086589,9470,9020,-450,3843624,5940.0,엔에이치투자증권보통주
4064,5940,2020-06-03,0.0531400966183574,10350,10900,550,4453576,5940.0,엔에이치투자증권보통주
4065,5940,2020-05-29,0.0507317073170731,10250,9730,-520,3744026,5940.0,엔에이치투자증권보통주
4066,5940,2020-05-21,0.0416666666666666,9600,10000,400,3320287,5940.0,엔에이치투자증권보통주
4067,5940,2020-05-19,0.0480349344978165,9160,9600,440,2202344,5940.0,엔에이치투자증권보통주
4068,5940,2020-04-29,0.0707182320441989,9050,9690,640,3947641,5940.0,엔에이치투자증권보통주
4069,5940,2020-04-17,0.0568445475638051,8620,9110,490,2879999,5940.0,엔에이치투자증권보통주
4070,5940,2020-04-01,0.064516129032258,8990,8410,-580,1703845,5940.0,엔에이치투자증권보통주
4071,5940,2020-03-25,0.1856115107913669,6950,8240,1290,3801541,5940.0,엔에이치투자증권보통주
4072,5940,2020-03-24,0.1014263074484944,6310,6950,640,2467754,5940.0,엔에이치투자증권보통주
4073,5940,2020-03-23,0.1260387811634349,7220,6310,-910,2132665,5940.0,엔에이치투자증권보통주
4074,5940,2020-03-20,0.0540145985401459,6850,7220,370,2837378,5940.0,엔에이치투자증권보통주
4075,5940,2020-03-19,0.1080729166666666,7680,6850,-830,2800936,5940.0,엔에이치투자증권보통주
4076,5940,2020-03-18,0.0611246943765281,8180,7680,-500,1661276,5940.0,엔에이치투자증권보통주
4077,5940,2020-03-12,0.0546391752577319,9700,9170,-530,2097940,5940.0,엔에이치투자증권보통주
4078,5940,2020-03-09,0.0425120772946859,10350,9910,-440,1143387,5940.0,엔에이치투자증권보통주
4079,5940,2020-02-24,0.0560747663551401,10700,10100,-600,1459125,5940.0,엔에이치투자증권보통주
4080,5940,2020-01-28,0.0543933054393305,11950,11300,-650,1790625,5940.0,엔에이치투자증권보통주
4081,5940,2019-11-04,0.0619834710743801,12100,12850,750,2274495,5940.0,엔에이치투자증권보통주
4082,5940,2019-09-16,0.0438247011952191,12550,13100,550,1146901,5940.0,엔에이치투자증권보통주
4083,5940,2019-07-29,0.04,13750,13200,-550,1569050,5940.0,엔에이치투자증권보통주
4084,5940,2019-07-03,0.0503355704697986,14900,14150,-750,1127208,5940.0,엔에이치투자증권보통주
4085,5940,2019-04-03,0.0469314079422382,13850,14500,650,2293663,5940.0,엔에이치투자증권보통주
4086,5940,2019-03-29,0.046692607003891,12850,13450,600,842731,5940.0,엔에이치투자증권보통주
4087,5940,2019-01-15,0.0553359683794466,12650,13350,700,1425182,5940.0,엔에이치투자증권보통주
4088,5940,2019-01-07,0.0450819672131147,12200,12750,550,1271676,5940.0,엔에이치투자증권보통주
4089,5940,2019-01-02,0.053639846743295,13050,12350,-700,1139552,5940.0,엔에이치투자증권보통주
4090,5940,2018-11-02,0.0934959349593495,12300,13450,1150,2498229,5940.0,엔에이치투자증권보통주
4091,5940,2018-10-11,0.0472440944881889,12700,12100,-600,1393580,5940.0,엔에이치투자증권보통주
4092,5940,2018-10-10,0.0522388059701492,13400,12700,-700,1578872,5940.0,엔에이치투자증권보통주
4093,5940,2018-08-27,0.0470588235294117,12750,13350,600,1825292,5940.0,엔에이치투자증권보통주
4094,5940,2018-08-21,0.0495867768595041,12100,12700,600,1757662,5940.0,엔에이치투자증권보통주
4095,5940,2018-07-02,0.0568561872909698,14950,14100,-850,1415166,5940.0,엔에이치투자증권보통주
4096,5940,2018-06-14,0.0534124629080118,16850,15950,-900,2482614,5940.0,엔에이치투자증권보통주
4097,5940,2018-06-07,0.0401234567901234,16200,16850,650,1712093,5940.0,엔에이치투자증권보통주
4098,5940,2018-05-30,0.059171597633136,16900,15900,-1000,2557922,5940.0,엔에이치투자증권보통주
4099,5940,2018-05-28,0.0428134556574923,16350,17050,700,1310407,5940.0,엔에이치투자증권보통주
4100,5940,2018-05-11,0.0509554140127388,15700,16500,800,2268239,5940.0,엔에이치투자증권보통주
4101,5940,2018-04-24,0.0476190476190476,14700,15400,700,2097059,5940.0,엔에이치투자증권보통주
4102,5940,2018-04-13,0.0503597122302158,13900,14600,700,2131534,5940.0,엔에이치투자증권보통주
4103,5940,2018-03-23,0.0650684931506849,14600,13650,-950,2589159,5940.0,엔에이치투자증권보통주
4104,5940,2018-03-09,0.0457746478873239,14200,14850,650,2670207,5940.0,엔에이치투자증권보통주
4105,5940,2018-02-02,0.0446428571428571,16800,16050,-750,1861404,5940.0,엔에이치투자증권보통주
4106,5940,2018-01-23,0.0630914826498422,15850,16850,1000,2486622,5940.0,엔에이치투자증권보통주
4107,5940,2018-01-12,0.0631229235880398,15050,16000,950,3133270,5940.0,엔에이치투자증권보통주
4108,5940,2018-01-08,0.0590277777777777,14400,15250,850,3137590,5940.0,엔에이치투자증권보통주
4109,5940,2017-10-12,0.0613718411552346,13850,14700,850,3259470,5940.0,엔에이치투자증권보통주
4110,5940,2017-09-18,0.0437956204379562,13700,14300,600,2189122,5940.0,엔에이치투자증권보통주
4111,5940,2017-09-07,0.05078125,12800,13450,650,1265094,5940.0,엔에이치투자증권보통주
4112,5940,2017-08-03,0.0553633217993079,14450,13650,-800,2711649,5940.0,엔에이치투자증권보통주
4113,5940,2017-07-28,0.0637583892617449,14900,13950,-950,2302683,5940.0,엔에이치투자증권보통주
4114,5940,2017-03-16,0.0447154471544715,12300,12850,550,3017574,5940.0,엔에이치투자증권보통주
4115,5940,2017-02-21,0.0493273542600896,11150,11700,550,2848214,5940.0,엔에이치투자증권보통주
4116,5940,2017-01-26,0.0502283105022831,10950,11500,550,3434371,5940.0,엔에이치투자증권보통주
4117,5940,2017-01-17,0.0460829493087557,10850,11350,500,4335561,5940.0,엔에이치투자증권보통주
4118,5940,2017-01-11,0.0544554455445544,10100,10650,550,3893652,5940.0,엔에이치투자증권보통주
4119,5940,2016-08-02,0.0422535211267605,10650,10200,-450,2097121,5940.0,엔에이치투자증권보통주
4120,6260,2021-06-02,0.0461760461760461,69300,72500,3200,371514,6260.0,LS보통주
4121,6260,2021-05-06,0.0460431654676259,69500,72700,3200,277734,6260.0,LS보통주
4122,6260,2021-05-03,0.0518417462482946,73300,69500,-3800,364069,6260.0,LS보통주
4123,6260,2021-03-29,0.0439393939393939,66000,68900,2900,370721,6260.0,LS보통주
4124,6260,2021-03-12,0.045958795562599,63100,66000,2900,233840,6260.0,LS보통주
4125,6260,2021-02-24,0.0550335570469798,74500,70400,-4100,397159,6260.0,LS보통주
4126,6260,2021-02-22,0.0585714285714285,70000,74100,4100,713389,6260.0,LS보통주
4127,6260,2021-01-28,0.0482954545454545,70400,67000,-3400,362659,6260.0,LS보통주
4128,6260,2021-01-26,0.0471698113207547,74200,70700,-3500,476498,6260.0,LS보통주
4129,6260,2021-01-21,0.0411522633744856,72900,75900,3000,634835,6260.0,LS보통주
4130,6260,2021-01-11,0.0484076433121019,78500,74700,-3800,495757,6260.0,LS보통주
4131,6260,2021-01-07,0.0666666666666666,73500,78400,4900,595599,6260.0,LS보통주
4132,6260,2021-01-05,0.0482758620689655,72500,76000,3500,488812,6260.0,LS보통주
4133,6260,2020-12-16,0.0495750708215297,70600,74100,3500,536708,6260.0,LS보통주
4134,6260,2020-12-09,0.0434782608695652,64400,67200,2800,300976,6260.0,LS보통주
4135,6260,2020-12-01,0.0743670886075949,63200,67900,4700,656579,6260.0,LS보통주
4136,6260,2020-11-23,0.0535117056856187,59800,63000,3200,589951,6260.0,LS보통주
4137,6260,2020-11-09,0.068100358422939,55800,59600,3800,583900,6260.0,LS보통주
4138,6260,2020-11-05,0.0745697896749522,52300,56200,3900,313027,6260.0,LS보통주
4139,6260,2020-11-04,0.0542495479204339,55300,52300,-3000,376897,6260.0,LS보통주
4140,6260,2020-10-26,0.0455341506129597,57100,54500,-2600,288709,6260.0,LS보통주
4141,6260,2020-10-21,0.0483870967741935,55800,58500,2700,306430,6260.0,LS보통주
4142,6260,2020-10-14,0.0476190476190476,60900,58000,-2900,252684,6260.0,LS보통주
4143,6260,2020-10-05,0.0761904761904762,52500,56500,4000,295397,6260.0,LS보통주
4144,6260,2020-09-22,0.0446428571428571,56000,53500,-2500,378464,6260.0,LS보통주
4145,6260,2020-09-21,0.054054054054054,59200,56000,-3200,365509,6260.0,LS보통주
4146,6260,2020-09-17,0.0411184210526315,60800,58300,-2500,409735,6260.0,LS보통주
4147,6260,2020-09-16,0.0602782071097372,64700,60800,-3900,432162,6260.0,LS보통주
4148,6260,2020-09-15,0.060655737704918,61000,64700,3700,529506,6260.0,LS보통주
4149,6260,2020-09-08,0.0909090909090909,63800,58000,-5800,1101049,6260.0,LS보통주
4150,6260,2020-09-07,0.0795262267343485,59100,63800,4700,2386209,6260.0,LS보통주
4151,6260,2020-09-04,0.1831831831831832,49950,59100,9150,1724735,6260.0,LS보통주
4152,6260,2020-09-03,0.0741935483870967,46500,49950,3450,789484,6260.0,LS보통주
4153,6260,2020-08-31,0.0697399527186761,42300,45250,2950,858141,6260.0,LS보통주
4154,6260,2020-08-28,0.0431565967940813,40550,42300,1750,329038,6260.0,LS보통주
4155,6260,2020-08-25,0.0417193426042983,39550,41200,1650,134798,6260.0,LS보통주
4156,6260,2020-08-20,0.0673886883273164,41550,38750,-2800,245825,6260.0,LS보통주
4157,6260,2020-08-18,0.053066037735849,42400,40150,-2250,194971,6260.0,LS보통주
4158,6260,2020-07-22,0.0916870415647921,40900,44650,3750,691010,6260.0,LS보통주
4159,6260,2020-07-20,0.0457516339869281,38250,40000,1750,214789,6260.0,LS보통주
4160,6260,2020-07-15,0.0452674897119341,36450,38100,1650,220393,6260.0,LS보통주
4161,6260,2020-07-02,0.0505780346820809,34600,36350,1750,108441,6260.0,LS보통주
4162,6260,2020-06-16,0.0536723163841807,35400,37300,1900,132135,6260.0,LS보통주
4163,6260,2020-06-15,0.0647291941875825,37850,35400,-2450,159123,6260.0,LS보통주
4164,6260,2020-06-03,0.0461538461538461,39000,40800,1800,268283,6260.0,LS보통주
4165,6260,2020-05-18,0.0423357664233576,34250,35700,1450,135076,6260.0,LS보통주
4166,6260,2020-05-04,0.0597609561752988,37650,35400,-2250,192945,6260.0,LS보통주
4167,6260,2020-04-13,0.0512820512820512,35100,33300,-1800,141732,6260.0,LS보통주
4168,6260,2020-04-02,0.0417362270450751,29950,31200,1250,184046,6260.0,LS보통주
4169,6260,2020-03-25,0.0772277227722772,25250,27200,1950,344906,6260.0,LS보통주
4170,6260,2020-03-24,0.0477178423236514,24100,25250,1150,291793,6260.0,LS보통주
4171,6260,2020-03-23,0.1007462686567164,26800,24100,-2700,264233,6260.0,LS보통주
4172,6260,2020-03-19,0.0884353741496598,29400,26800,-2600,233144,6260.0,LS보통주
4173,6260,2020-03-13,0.0544323483670295,32150,30400,-1750,272805,6260.0,LS보통주
4174,6260,2020-03-12,0.0585651537335285,34150,32150,-2000,219119,6260.0,LS보통주
4175,6260,2020-03-05,0.0524861878453038,36200,38100,1900,145326,6260.0,LS보통주
4176,6260,2020-02-28,0.0412234042553191,37600,36050,-1550,138678,6260.0,LS보통주
4177,6260,2020-02-06,0.0468948035487959,39450,41300,1850,103940,6260.0,LS보통주
4178,6260,2020-01-28,0.0422857142857142,43750,41900,-1850,122097,6260.0,LS보통주
4179,6260,2019-10-30,0.045,50000,47750,-2250,137088,6260.0,LS보통주
4180,6260,2019-08-19,0.0517241379310344,40600,42700,2100,84810,6260.0,LS보통주
4181,6260,2019-08-05,0.0585533869115958,43550,41000,-2550,170201,6260.0,LS보통주
4182,6260,2019-07-11,0.0428265524625267,46700,48700,2000,113901,6260.0,LS보통주
4183,6260,2019-07-01,0.0442105263157894,47500,49600,2100,168404,6260.0,LS보통주
4184,6260,2019-04-24,0.0457142857142857,52500,50100,-2400,264710,6260.0,LS보통주
4185,6260,2019-04-01,0.0458891013384321,52300,54700,2400,153412,6260.0,LS보통주
4186,6260,2019-02-20,0.0553571428571428,56000,59100,3100,380156,6260.0,LS보통주
4187,6260,2019-01-15,0.0424710424710424,51800,54000,2200,110636,6260.0,LS보통주
4188,6260,2019-01-09,0.0794633642930856,48450,52300,3850,214645,6260.0,LS보통주
4189,6260,2018-12-03,0.0698113207547169,53000,56700,3700,205305,6260.0,LS보통주
4190,6260,2018-11-07,0.0650263620386643,56900,53200,-3700,221918,6260.0,LS보통주
4191,6260,2018-11-02,0.1043307086614173,50800,56100,5300,230683,6260.0,LS보통주
4192,6260,2018-10-11,0.0416666666666666,64800,62100,-2700,95766,6260.0,LS보통주
4193,6260,2018-09-13,0.076103500761035,65700,70700,5000,240751,6260.0,LS보통주
4194,6260,2018-08-13,0.0578512396694214,72600,68400,-4200,88858,6260.0,LS보통주
4195,6260,2018-07-25,0.0564738292011019,72600,76700,4100,151322,6260.0,LS보통주
4196,6260,2018-07-09,0.0749665327978581,74700,69100,-5600,209425,6260.0,LS보통주
4197,6260,2018-07-02,0.0466666666666666,75000,71500,-3500,103054,6260.0,LS보통주
4198,6260,2018-06-21,0.0573979591836734,78400,73900,-4500,290075,6260.0,LS보통주
4199,6260,2018-06-18,0.0416666666666666,84000,80500,-3500,123301,6260.0,LS보통주
4200,6260,2018-06-11,0.055079559363525,81700,86200,4500,145093,6260.0,LS보통주
4201,6260,2018-05-29,0.0421753607103218,90100,86300,-3800,126101,6260.0,LS보통주
4202,6260,2018-05-28,0.0777511961722488,83600,90100,6500,213919,6260.0,LS보통주
4203,6260,2018-05-10,0.047314578005115,78200,81900,3700,159812,6260.0,LS보통주
4204,6260,2018-04-30,0.0498652291105121,74200,77900,3700,250729,6260.0,LS보통주
4205,6260,2018-04-18,0.0638930163447251,67300,71600,4300,215129,6260.0,LS보통주
4206,6260,2018-04-04,0.0466760961810466,70700,67400,-3300,178174,6260.0,LS보통주
4207,6260,2018-04-02,0.0402684563758389,74500,71500,-3000,109216,6260.0,LS보통주
4208,6260,2018-03-12,0.0497311827956989,74400,78100,3700,125528,6260.0,LS보통주
4209,6260,2018-03-09,0.0522292993630573,78500,74400,-4100,240013,6260.0,LS보통주
4210,6260,2018-03-08,0.0411140583554376,75400,78500,3100,225427,6260.0,LS보통주
4211,6260,2018-03-07,0.0443213296398892,72200,75400,3200,193827,6260.0,LS보통주
4212,6260,2018-02-19,0.0513157894736842,76000,79900,3900,139251,6260.0,LS보통주
4213,6260,2018-02-14,0.0584958217270195,71800,76000,4200,183632,6260.0,LS보통주
4214,6260,2018-01-31,0.0435835351089588,82600,79000,-3600,302639,6260.0,LS보통주
4215,6260,2018-01-19,0.0408970976253298,75800,78900,3100,155706,6260.0,LS보통주
4216,6260,2017-12-27,0.0410764872521246,70600,73500,2900,219899,6260.0,LS보통주
4217,6260,2017-12-06,0.0409026798307475,70900,68000,-2900,119747,6260.0,LS보통주
4218,6260,2017-12-05,0.0645645645645645,66600,70900,4300,245867,6260.0,LS보통주
4219,6260,2017-11-13,0.0430247718383311,76700,73400,-3300,185549,6260.0,LS보통주
4220,6260,2017-10-17,0.0572139303482587,80400,85000,4600,179727,6260.0,LS보통주
4221,6260,2017-09-08,0.0422360248447205,80500,83900,3400,109431,6260.0,LS보통주
4222,6260,2017-09-01,0.0414201183431952,84500,81000,-3500,153192,6260.0,LS보통주
4223,6260,2017-08-17,0.0556900726392251,82600,87200,4600,141953,6260.0,LS보통주
4224,6260,2017-06-13,0.0497237569060773,72400,76000,3600,86356,6260.0,LS보통주
4225,6260,2017-05-17,0.0525547445255474,68500,72100,3600,237976,6260.0,LS보통주
4226,6260,2017-03-23,0.0422764227642276,61500,64100,2600,201206,6260.0,LS보통주
4227,6260,2017-02-10,0.0934579439252336,64200,70200,6000,291992,6260.0,LS보통주
4228,6260,2016-12-06,0.0420711974110032,61800,64400,2600,250653,6260.0,LS보통주
4229,6260,2016-11-11,0.075268817204301,55800,60000,4200,517043,6260.0,LS보통주
4230,6260,2016-11-10,0.0919765166340508,51100,55800,4700,373234,6260.0,LS보통주
4231,6260,2016-10-28,0.0527240773286467,56900,53900,-3000,248809,6260.0,LS보통주
4232,6260,2016-08-16,0.0603290676416819,54700,58000,3300,345756,6260.0,LS보통주
4233,6280,2021-05-24,0.0610583446404341,368500,346000,-22500,241955,6280.0,녹십자보통주
4234,6280,2021-05-13,0.0788113695090439,387000,356500,-30500,250654,6280.0,녹십자보통주
4235,6280,2021-04-29,0.0663058186738836,369500,345000,-24500,235229,6280.0,녹십자보통주
4236,6280,2021-04-28,0.0561941251596424,391500,369500,-22000,194986,6280.0,녹십자보통주
4237,6280,2021-04-15,0.1015299026425591,359500,396000,36500,1389030,6280.0,녹십자보통주
4238,6280,2021-04-13,0.0867647058823529,340000,369500,29500,264159,6280.0,녹십자보통주
4239,6280,2021-04-09,0.0504587155963302,327000,343500,16500,186223,6280.0,녹십자보통주
4240,6280,2021-04-06,0.0526315789473684,342000,324000,-18000,183218,6280.0,녹십자보통주
4241,6280,2021-03-17,0.0784883720930232,344000,371000,27000,336278,6280.0,녹십자보통주
4242,6280,2021-03-12,0.0590062111801242,322000,341000,19000,160843,6280.0,녹십자보통주
4243,6280,2021-03-09,0.064516129032258,356500,333500,-23000,228183,6280.0,녹십자보통주
4244,6280,2021-03-08,0.048064085447263,374500,356500,-18000,127491,6280.0,녹십자보통주
4245,6280,2021-02-25,0.0573770491803278,366000,387000,21000,148286,6280.0,녹십자보통주
4246,6280,2021-02-22,0.0446998722860791,391500,374000,-17500,169630,6280.0,녹십자보통주
4247,6280,2021-02-18,0.0468384074941452,427000,407000,-20000,193872,6280.0,녹십자보통주
4248,6280,2021-02-03,0.0720930232558139,430000,461000,31000,383390,6280.0,녹십자보통주
4249,6280,2021-01-29,0.0557413600891861,448500,423500,-25000,563336,6280.0,녹십자보통주
4250,6280,2021-01-28,0.0828220858895705,489000,448500,-40500,440718,6280.0,녹십자보통주
4251,6280,2021-01-26,0.093073593073593,462000,505000,43000,1619316,6280.0,녹십자보통주
4252,6280,2021-01-25,0.0870588235294117,425000,462000,37000,446940,6280.0,녹십자보통주
4253,6280,2021-01-22,0.045510455104551,406500,425000,18500,385880,6280.0,녹십자보통주
4254,6280,2021-01-19,0.0422885572139303,402000,419000,17000,224230,6280.0,녹십자보통주
4255,6280,2021-01-14,0.0543337645536869,386500,407500,21000,449907,6280.0,녹십자보통주
4256,6280,2021-01-11,0.0437424058323207,411500,393500,-18000,289252,6280.0,녹십자보통주
4257,6280,2021-01-05,0.0726315789473684,475000,440500,-34500,639277,6280.0,녹십자보통주
4258,6280,2021-01-04,0.1699507389162561,406000,475000,69000,1971283,6280.0,녹십자보통주
4259,6280,2020-12-30,0.0463917525773195,388000,406000,18000,784342,6280.0,녹십자보통주
4260,6280,2020-12-29,0.096045197740113,354000,388000,34000,751877,6280.0,녹십자보통주
4261,6280,2020-12-14,0.1006896551724138,362500,399000,36500,973087,6280.0,녹십자보통주
4262,6280,2020-12-10,0.0577200577200577,346500,366500,20000,492510,6280.0,녹십자보통주
4263,6280,2020-11-25,0.061744966442953,372500,349500,-23000,579019,6280.0,녹십자보통주
4264,6280,2020-11-17,0.0756533700137551,363500,391000,27500,948484,6280.0,녹십자보통주
4265,6280,2020-11-11,0.0826140567200986,405500,372000,-33500,982069,6280.0,녹십자보통주
4266,6280,2020-11-06,0.0779220779220779,385000,415000,30000,981563,6280.0,녹십자보통주
4267,6280,2020-11-03,0.2537313432835821,301500,378000,76500,2859692,6280.0,녹십자보통주
4268,6280,2020-10-29,0.0796296296296296,270000,291500,21500,1020918,6280.0,녹십자보통주
4269,6280,2020-10-28,0.0546875,256000,270000,14000,474301,6280.0,녹십자보통주
4270,6280,2020-10-27,0.0465549348230912,268500,256000,-12500,369537,6280.0,녹십자보통주
4271,6280,2020-10-23,0.1695652173913043,230000,269000,39000,2321642,6280.0,녹십자보통주
4272,6280,2020-10-22,0.0478359908883826,219500,230000,10500,889826,6280.0,녹십자보통주
4273,6280,2020-09-24,0.0672451193058568,230500,215000,-15500,223351,6280.0,녹십자보통주
4274,6280,2020-09-22,0.0611439842209073,253500,238000,-15500,183811,6280.0,녹십자보통주
4275,6280,2020-09-09,0.102787456445993,287000,257500,-29500,737072,6280.0,녹십자보통주
4276,6280,2020-09-08,0.1411530815109344,251500,287000,35500,1477111,6280.0,녹십자보통주
4277,6280,2020-08-21,0.0405643738977072,283500,272000,-11500,364127,6280.0,녹십자보통주
4278,6280,2020-08-20,0.0581395348837209,301000,283500,-17500,728878,6280.0,녹십자보통주
4279,6280,2020-08-19,0.0692717584369449,281500,301000,19500,447985,6280.0,녹십자보통주
4280,6280,2020-08-18,0.0585284280936454,299000,281500,-17500,355437,6280.0,녹십자보통주
4281,6280,2020-08-14,0.0436300174520069,286500,299000,12500,470456,6280.0,녹십자보통주
4282,6280,2020-08-10,0.0486486486486486,277500,291000,13500,557323,6280.0,녹십자보통주
4283,6280,2020-08-05,0.1262729124236252,245500,276500,31000,1190258,6280.0,녹십자보통주
4284,6280,2020-08-03,0.0506607929515418,227000,238500,11500,532562,6280.0,녹십자보통주
4285,6280,2020-07-27,0.0508849557522123,226000,237500,11500,698201,6280.0,녹십자보통주
4286,6280,2020-07-22,0.1095238095238095,210000,233000,23000,1022090,6280.0,녹십자보통주
4287,6280,2020-07-20,0.1684491978609625,187000,218500,31500,2020473,6280.0,녹십자보통주
4288,6280,2020-07-15,0.09,200000,182000,-18000,479526,6280.0,녹십자보통주
4289,6280,2020-07-13,0.1568047337278106,169000,195500,26500,1553714,6280.0,녹십자보통주
4290,6280,2020-07-10,0.119205298013245,151000,169000,18000,709550,6280.0,녹십자보통주
4291,6280,2020-06-16,0.0472972972972973,148000,155000,7000,158629,6280.0,녹십자보통주
4292,6280,2020-05-19,0.050632911392405,158000,150000,-8000,186180,6280.0,녹십자보통주
4293,6280,2020-05-18,0.0429042904290429,151500,158000,6500,178766,6280.0,녹십자보통주
4294,6280,2020-04-08,0.0451807228915662,166000,158500,-7500,535276,6280.0,녹십자보통주
4295,6280,2020-04-07,0.0779220779220779,154000,166000,12000,1489111,6280.0,녹십자보통주
4296,6280,2020-04-06,0.096085409252669,140500,154000,13500,706787,6280.0,녹십자보통주
4297,6280,2020-03-31,0.0615384615384615,130000,138000,8000,296469,6280.0,녹십자보통주
4298,6280,2020-03-30,0.0970464135021097,118500,130000,11500,230530,6280.0,녹십자보통주
4299,6280,2020-03-27,0.0486725663716814,113000,118500,5500,233321,6280.0,녹십자보통주
4300,6280,2020-03-19,0.0553191489361702,117500,111000,-6500,118832,6280.0,녹십자보통주
4301,6280,2020-03-18,0.08203125,128000,117500,-10500,165490,6280.0,녹십자보통주
4302,6280,2020-03-17,0.0847457627118644,118000,128000,10000,202983,6280.0,녹십자보통주
4303,6280,2020-03-16,0.0727272727272727,110000,118000,8000,164716,6280.0,녹십자보통주
4304,6280,2020-03-12,0.0476190476190476,115500,110000,-5500,99853,6280.0,녹십자보통주
4305,6280,2020-03-11,0.0532786885245901,122000,115500,-6500,103962,6280.0,녹십자보통주
4306,6280,2020-03-10,0.046875,128000,122000,-6000,123951,6280.0,녹십자보통주
4307,6280,2020-03-09,0.0622406639004149,120500,128000,7500,228239,6280.0,녹십자보통주
4308,6280,2020-02-28,0.0462184873949579,119000,113500,-5500,64943,6280.0,녹십자보통주
4309,6280,2020-02-27,0.0530973451327433,113000,119000,6000,74164,6280.0,녹십자보통주
4310,6280,2020-01-31,0.0426356589147286,129000,123500,-5500,60213,6280.0,녹십자보통주
4311,6280,2020-01-29,0.0539568345323741,139000,131500,-7500,99305,6280.0,녹십자보통주
4312,6280,2020-01-28,0.0944881889763779,127000,139000,12000,271908,6280.0,녹십자보통주
4313,6280,2020-01-22,0.0452674897119341,121500,127000,5500,53665,6280.0,녹십자보통주
4314,6280,2019-11-25,0.0448979591836734,122500,128000,5500,45832,6280.0,녹십자보통주
4315,6280,2019-10-31,0.0798319327731092,119000,128500,9500,190015,6280.0,녹십자보통주
4316,6280,2019-09-17,0.0486725663716814,113000,118500,5500,70793,6280.0,녹십자보통주
4317,6280,2019-08-05,0.0518867924528301,106000,100500,-5500,56401,6280.0,녹십자보통주
4318,6280,2019-06-04,0.048,125000,119000,-6000,136750,6280.0,녹십자보통주
4319,6280,2019-01-07,0.0413533834586466,133000,138500,5500,53197,6280.0,녹십자보통주
4320,6280,2019-01-03,0.0439560439560439,136500,130500,-6000,41833,6280.0,녹십자보통주
4321,6280,2018-11-02,0.084,125000,135500,10500,85581,6280.0,녹십자보통주
4322,6280,2018-11-01,0.0460251046025104,119500,125000,5500,81481,6280.0,녹십자보통주
4323,6280,2018-10-31,0.0627450980392156,127500,119500,-8000,121214,6280.0,녹십자보통주
4324,6280,2018-10-29,0.053639846743295,130500,123500,-7000,98439,6280.0,녹십자보통주
4325,6280,2018-10-11,0.0588235294117647,153000,144000,-9000,104720,6280.0,녹십자보통주
4326,6280,2018-09-27,0.1361386138613861,202000,174500,-27500,569023,6280.0,녹십자보통주
4327,6280,2018-08-31,0.0509383378016085,186500,196000,9500,81899,6280.0,녹십자보통주
4328,6280,2018-08-17,0.0558659217877094,179000,189000,10000,208485,6280.0,녹십자보통주
4329,6280,2018-06-19,0.0653153153153153,222000,207500,-14500,64383,6280.0,녹십자보통주
4330,6280,2018-06-12,0.0446009389671361,213000,222500,9500,87581,6280.0,녹십자보통주
4331,6280,2018-05-02,0.0508083140877598,216500,227500,11000,124207,6280.0,녹십자보통주
4332,6280,2018-02-19,0.0441176470588235,204000,213000,9000,70621,6280.0,녹십자보통주
4333,6280,2018-02-12,0.0549738219895288,191000,201500,10500,83189,6280.0,녹십자보통주
4334,6280,2018-02-07,0.0583941605839416,205500,193500,-12000,97251,6280.0,녹십자보통주
4335,6280,2018-02-05,0.079646017699115,226000,208000,-18000,81900,6280.0,녹십자보통주
4336,6280,2018-02-01,0.0422832980972515,236500,226500,-10000,77755,6280.0,녹십자보통주
4337,6280,2018-01-31,0.0444444444444444,247500,236500,-11000,54337,6280.0,녹십자보통주
4338,6280,2018-01-23,0.045045045045045,222000,232000,10000,59270,6280.0,녹십자보통주
4339,6280,2018-01-12,0.0506912442396313,217000,228000,11000,103263,6280.0,녹십자보통주
4340,6280,2018-01-04,0.0730088495575221,226000,209500,-16500,122477,6280.0,녹십자보통주
4341,6280,2017-12-22,0.0545023696682464,211000,222500,11500,26317,6280.0,녹십자보통주
4342,6280,2017-12-11,0.0451306413301662,210500,220000,9500,44213,6280.0,녹십자보통주
4343,6280,2017-12-01,0.0441860465116279,215000,224500,9500,35052,6280.0,녹십자보통주
4344,6280,2017-11-30,0.0570175438596491,228000,215000,-13000,56559,6280.0,녹십자보통주
4345,6280,2017-11-20,0.0582959641255605,223000,236000,13000,59328,6280.0,녹십자보통주
4346,6280,2017-11-06,0.0478468899521531,209000,219000,10000,78998,6280.0,녹십자보통주
4347,6280,2017-10-12,0.050632911392405,197500,207500,10000,90723,6280.0,녹십자보통주
4348,6280,2017-09-20,0.08,187500,202500,15000,191252,6280.0,녹십자보통주
4349,6280,2017-02-01,0.0471014492753623,138000,144500,6500,33475,6280.0,녹십자보통주
4350,6280,2016-12-13,0.0510204081632653,147000,154500,7500,67022,6280.0,녹십자보통주
4351,6280,2016-11-23,0.0728476821192053,151000,140000,-11000,164941,6280.0,녹십자보통주
4352,6280,2016-11-10,0.1081081081081081,148000,164000,16000,164498,6280.0,녹십자보통주
4353,6280,2016-11-03,0.0522388059701492,134000,141000,7000,42662,6280.0,녹십자보통주
4354,6280,2016-11-02,0.0530035335689045,141500,134000,-7500,49524,6280.0,녹십자보통주
4355,6280,2016-10-14,0.0458715596330275,163500,156000,-7500,97633,6280.0,녹십자보통주
4356,6280,2016-10-13,0.0410557184750733,170500,163500,-7000,72442,6280.0,녹십자보통주
4357,6360,2021-05-12,0.0518918918918918,46250,43850,-2400,1404383,6360.0,GS건설보통주
4358,6360,2021-04-30,0.0566239316239316,46800,44150,-2650,1429768,6360.0,GS건설보통주
4359,6360,2021-04-08,0.0644783118405627,42650,45400,2750,4408925,6360.0,GS건설보통주
4360,6360,2021-03-09,0.0453920220082531,36350,38000,1650,1279560,6360.0,GS건설보통주
4361,6360,2021-02-04,0.0476744186046511,43000,40950,-2050,1980674,6360.0,GS건설보통주
4362,6360,2021-02-01,0.0943643512450851,38150,41750,3600,1327909,6360.0,GS건설보통주
4363,6360,2021-01-29,0.0486284289276807,40100,38150,-1950,1303011,6360.0,GS건설보통주
4364,6360,2021-01-05,0.0512483574244415,38050,40000,1950,1920208,6360.0,GS건설보통주
4365,6360,2020-12-30,0.0573426573426573,35750,37800,2050,1378490,6360.0,GS건설보통주
4366,6360,2020-12-22,0.0418353576248313,37050,35500,-1550,917280,6360.0,GS건설보통주
4367,6360,2020-12-10,0.0853485064011379,35150,38150,3000,2081867,6360.0,GS건설보통주
4368,6360,2020-12-04,0.0667701863354037,32200,34350,2150,1718281,6360.0,GS건설보통주
4369,6360,2020-11-11,0.040133779264214,29900,31100,1200,968952,6360.0,GS건설보통주
4370,6360,2020-11-09,0.0497335701598579,28150,29550,1400,916458,6360.0,GS건설보통주
4371,6360,2020-11-02,0.0411985018726591,26700,27800,1100,472993,6360.0,GS건설보통주
4372,6360,2020-10-29,0.0437828371278458,28550,27300,-1250,626704,6360.0,GS건설보통주
4373,6360,2020-09-01,0.0425101214574898,24700,25750,1050,520847,6360.0,GS건설보통주
4374,6360,2020-08-20,0.0534351145038167,26200,24800,-1400,801921,6360.0,GS건설보통주
4375,6360,2020-08-18,0.0577617328519855,27700,26100,-1600,769250,6360.0,GS건설보통주
4376,6360,2020-08-04,0.0660377358490566,26500,28250,1750,3501113,6360.0,GS건설보통주
4377,6360,2020-07-15,0.0402298850574712,26100,27150,1050,869825,6360.0,GS건설보통주
4378,6360,2020-06-25,0.0406189555125725,25850,24800,-1050,413373,6360.0,GS건설보통주
4379,6360,2020-06-16,0.0473372781065088,25350,26550,1200,439340,6360.0,GS건설보통주
4380,6360,2020-06-15,0.0541044776119402,26800,25350,-1450,522259,6360.0,GS건설보통주
4381,6360,2020-05-26,0.1226611226611226,24050,27000,2950,2922611,6360.0,GS건설보통주
4382,6360,2020-05-19,0.0461215932914046,23850,24950,1100,713762,6360.0,GS건설보통주
4383,6360,2020-04-14,0.0441501103752759,22650,23650,1000,843169,6360.0,GS건설보통주
4384,6360,2020-04-08,0.0581113801452784,20650,21850,1200,1069596,6360.0,GS건설보통주
4385,6360,2020-04-06,0.0408163265306122,19600,20400,800,645128,6360.0,GS건설보통주
4386,6360,2020-04-02,0.0469973890339425,19150,20050,900,833845,6360.0,GS건설보통주
4387,6360,2020-04-01,0.0658536585365853,20500,19150,-1350,736565,6360.0,GS건설보통주
4388,6360,2020-03-31,0.0817941952506596,18950,20500,1550,1394932,6360.0,GS건설보통주
4389,6360,2020-03-25,0.0778097982708933,17350,18700,1350,890296,6360.0,GS건설보통주
4390,6360,2020-03-24,0.0911949685534591,15900,17350,1450,781275,6360.0,GS건설보통주
4391,6360,2020-03-23,0.1016949152542373,17700,15900,-1800,733315,6360.0,GS건설보통주
4392,6360,2020-03-20,0.1760797342192691,15050,17700,2650,1108678,6360.0,GS건설보통주
4393,6360,2020-03-19,0.1473087818696883,17650,15050,-2600,1851550,6360.0,GS건설보통주
4394,6360,2020-03-18,0.1040609137055837,19700,17650,-2050,755478,6360.0,GS건설보통주
4395,6360,2020-03-13,0.0632054176072234,22150,20750,-1400,1525797,6360.0,GS건설보통주
4396,6360,2020-03-12,0.0809128630705394,24100,22150,-1950,1149867,6360.0,GS건설보통주
4397,6360,2020-03-09,0.0762081784386617,26900,24850,-2050,914767,6360.0,GS건설보통주
4398,6360,2020-02-24,0.0447227191413237,27950,26700,-1250,706434,6360.0,GS건설보통주
4399,6360,2020-02-06,0.0502599653379549,28850,30300,1450,530131,6360.0,GS건설보통주
4400,6360,2020-01-28,0.0412541254125412,30300,29050,-1250,371547,6360.0,GS건설보통주
4401,6360,2020-01-08,0.0547008547008547,29250,27650,-1600,913844,6360.0,GS건설보통주
4402,6360,2019-11-15,0.0464,31250,32700,1450,440805,6360.0,GS건설보통주
4403,6360,2019-08-13,0.0542168674698795,33200,31400,-1800,591828,6360.0,GS건설보통주
4404,6360,2019-08-08,0.0435483870967741,31000,32350,1350,490484,6360.0,GS건설보통주
4405,6360,2019-07-09,0.0606860158311345,37900,35600,-2300,1021937,6360.0,GS건설보통주
4406,6360,2019-05-09,0.0471464019851116,40300,38400,-1900,470394,6360.0,GS건설보통주
4407,6360,2019-03-29,0.0402930402930402,40950,42600,1650,537515,6360.0,GS건설보통주
4408,6360,2019-03-15,0.0531400966183574,41400,43600,2200,929803,6360.0,GS건설보통주
4409,6360,2018-12-27,0.0495283018867924,42400,44500,2100,707136,6360.0,GS건설보통주
4410,6360,2018-12-13,0.068771138669673,44350,47400,3050,925143,6360.0,GS건설보통주
4411,6360,2018-11-22,0.0414129110840438,41050,39350,-1700,989048,6360.0,GS건설보통주
4412,6360,2018-11-14,0.0447058823529411,42500,40600,-1900,929325,6360.0,GS건설보통주
4413,6360,2018-11-02,0.0696517412935323,40200,43000,2800,895115,6360.0,GS건설보통주
4414,6360,2018-10-24,0.0789200415368639,48150,44350,-3800,1931892,6360.0,GS건설보통주
4415,6360,2018-10-11,0.0436046511627907,51600,49350,-2250,1186200,6360.0,GS건설보통주
4416,6360,2018-10-01,0.0420650095602294,52300,54500,2200,1001216,6360.0,GS건설보통주
4417,6360,2018-09-10,0.0526315789473684,49400,52000,2600,1299871,6360.0,GS건설보통주
4418,6360,2018-08-23,0.0433839479392624,46100,48100,2000,969472,6360.0,GS건설보통주
4419,6360,2018-07-26,0.0947368421052631,47500,43000,-4500,3169657,6360.0,GS건설보통주
4420,6360,2018-07-24,0.059090909090909,44000,46600,2600,833890,6360.0,GS건설보통주
4421,6360,2018-07-18,0.0539956803455723,46300,43800,-2500,893032,6360.0,GS건설보통주
4422,6360,2018-07-13,0.0479375696767001,44850,47000,2150,686671,6360.0,GS건설보통주
4423,6360,2018-07-06,0.0519911504424778,45200,47550,2350,650845,6360.0,GS건설보통주
4424,6360,2018-07-02,0.05,46000,43700,-2300,723279,6360.0,GS건설보통주
4425,6360,2018-06-27,0.045501551189245,48350,46150,-2200,919448,6360.0,GS건설보통주
4426,6360,2018-06-22,0.047191011235955,44500,46600,2100,1013222,6360.0,GS건설보통주
4427,6360,2018-06-20,0.0550996483001172,42650,45000,2350,976968,6360.0,GS건설보통주
4428,6360,2018-06-05,0.0474137931034482,46400,48600,2200,833973,6360.0,GS건설보통주
4429,6360,2018-05-29,0.0707364341085271,51600,47950,-3650,1726808,6360.0,GS건설보통주
4430,6360,2018-05-28,0.1241830065359477,45900,51600,5700,4391058,6360.0,GS건설보통주
4431,6360,2018-05-16,0.055260361317747,47050,44450,-2600,1533025,6360.0,GS건설보통주
4432,6360,2018-05-14,0.0722477064220183,43600,46750,3150,2085396,6360.0,GS건설보통주
4433,6360,2018-05-10,0.0437956204379562,41100,42900,1800,1086659,6360.0,GS건설보통주
4434,6360,2018-05-04,0.0532837670384138,40350,42500,2150,1368509,6360.0,GS건설보통주
4435,6360,2018-04-30,0.0822281167108753,37700,40800,3100,3417632,6360.0,GS건설보통주
4436,6360,2018-04-19,0.0453257790368272,35300,36900,1600,1718011,6360.0,GS건설보통주
4437,6360,2018-04-18,0.0428360413589364,33850,35300,1450,1201400,6360.0,GS건설보통주
4438,6360,2018-04-09,0.1499148211243611,29350,33750,4400,5072323,6360.0,GS건설보통주
4439,6360,2018-03-23,0.0413793103448275,29000,27800,-1200,516224,6360.0,GS건설보통주
4440,6360,2018-02-07,0.0469483568075117,31950,30450,-1500,641802,6360.0,GS건설보통주
4441,6360,2018-01-30,0.0412698412698412,31500,32800,1300,2113250,6360.0,GS건설보통주
4442,6360,2018-01-19,0.0531732418524871,29150,30700,1550,927324,6360.0,GS건설보통주
4443,6360,2018-01-04,0.058303886925795,28300,29950,1650,1360644,6360.0,GS건설보통주
4444,6360,2017-12-13,0.0450281425891182,26650,27850,1200,553102,6360.0,GS건설보통주
4445,6360,2017-12-05,0.0512820512820512,27300,28700,1400,1361967,6360.0,GS건설보통주
4446,6360,2017-11-07,0.0483271375464684,26900,28200,1300,1468416,6360.0,GS건설보통주
4447,6360,2017-09-26,0.0571428571428571,26250,27750,1500,749380,6360.0,GS건설보통주
4448,6360,2017-09-19,0.0474452554744525,27400,28700,1300,606413,6360.0,GS건설보통주
4449,6360,2017-08-03,0.0596546310832025,31850,29950,-1900,1494518,6360.0,GS건설보통주
4450,6360,2017-05-25,0.056910569105691,30750,32500,1750,1590793,6360.0,GS건설보통주
4451,6360,2017-05-04,0.0404530744336569,30900,29650,-1250,1960881,6360.0,GS건설보통주
4452,6360,2017-04-05,0.0536912751677852,29800,31400,1600,630378,6360.0,GS건설보통주
4453,6360,2017-03-07,0.0453781512605042,29750,31100,1350,969810,6360.0,GS건설보통주
4454,6360,2017-01-26,0.0789980732177264,25950,28000,2050,1254846,6360.0,GS건설보통주
4455,6360,2016-12-12,0.0462776659959758,24850,26000,1150,510796,6360.0,GS건설보통주
4456,6360,2016-11-25,0.0448343079922027,25650,24500,-1150,1208447,6360.0,GS건설보통주
4457,6360,2016-11-16,0.0418250950570342,26300,27400,1100,571227,6360.0,GS건설보통주
4458,6360,2016-11-09,0.0441988950276243,27150,25950,-1200,861013,6360.0,GS건설보통주
4459,6360,2016-10-26,0.0495867768595041,30250,28750,-1500,705403,6360.0,GS건설보통주
4460,6360,2016-10-17,0.04,30000,28800,-1200,535742,6360.0,GS건설보통주
4461,6360,2016-09-12,0.0451388888888888,28800,27500,-1300,462693,6360.0,GS건설보통주
4462,6360,2016-08-19,0.0476190476190476,29400,30800,1400,1225223,6360.0,GS건설보통주
4463,6400,2021-05-13,0.0489731437598736,633000,602000,-31000,588763,6400.0,삼성SDI보통주
4464,6400,2021-04-13,0.0534351145038167,655000,690000,35000,908436,6400.0,삼성SDI보통주
4465,6400,2021-03-17,0.0602941176470588,680000,639000,-41000,863521,6400.0,삼성SDI보통주
4466,6400,2021-03-11,0.080188679245283,636000,687000,51000,709286,6400.0,삼성SDI보통주
4467,6400,2021-02-26,0.0426136363636363,704000,674000,-30000,579115,6400.0,삼성SDI보통주
4468,6400,2021-02-22,0.0402597402597402,770000,739000,-31000,504042,6400.0,삼성SDI보통주
4469,6400,2021-01-29,0.0430247718383311,767000,734000,-33000,764317,6400.0,삼성SDI보통주
4470,6400,2021-01-22,0.0630872483221476,745000,792000,47000,973969,6400.0,삼성SDI보통주
4471,6400,2021-01-18,0.0420624151967435,737000,706000,-31000,644139,6400.0,삼성SDI보통주
4472,6400,2021-01-08,0.0587392550143266,698000,739000,41000,890113,6400.0,삼성SDI보통주
4473,6400,2021-01-04,0.0684713375796178,628000,671000,43000,694737,6400.0,삼성SDI보통주
4474,6400,2020-12-30,0.0449251247920133,601000,628000,27000,503572,6400.0,삼성SDI보통주
4475,6400,2020-12-29,0.0751341681574239,559000,601000,42000,827634,6400.0,삼성SDI보통주
4476,6400,2020-11-24,0.0494296577946768,526000,552000,26000,610630,6400.0,삼성SDI보통주
4477,6400,2020-11-09,0.0681362725450901,499000,533000,34000,824167,6400.0,삼성SDI보통주
4478,6400,2020-11-05,0.0533188248095756,459500,484000,24500,727072,6400.0,삼성SDI보통주
4479,6400,2020-11-03,0.0443181818181818,440000,459500,19500,712258,6400.0,삼성SDI보통주
4480,6400,2020-10-20,0.0472154963680387,413000,432500,19500,317386,6400.0,삼성SDI보통주
4481,6400,2020-09-24,0.0607101947308132,436500,410000,-26500,722856,6400.0,삼성SDI보통주
4482,6400,2020-08-20,0.0460299194476409,434500,414500,-20000,726581,6400.0,삼성SDI보통주
4483,6400,2020-08-14,0.0573248407643312,471000,444000,-27000,1061360,6400.0,삼성SDI보통주
4484,6400,2020-08-05,0.125,416000,468000,52000,1319206,6400.0,삼성SDI보통주
4485,6400,2020-08-03,0.0427672955974842,397500,414500,17000,1058971,6400.0,삼성SDI보통주
4486,6400,2020-06-16,0.078909612625538,348500,376000,27500,846115,6400.0,삼성SDI보통주
4487,6400,2020-06-15,0.0816864295125164,379500,348500,-31000,1182814,6400.0,삼성SDI보통주
4488,6400,2020-05-27,0.0592783505154639,388000,365000,-23000,1676145,6400.0,삼성SDI보통주
4489,6400,2020-05-26,0.1149425287356321,348000,388000,40000,1454090,6400.0,삼성SDI보통주
4490,6400,2020-05-20,0.04251968503937,317500,331000,13500,614805,6400.0,삼성SDI보통주
4491,6400,2020-05-13,0.0897887323943662,284000,309500,25500,1659104,6400.0,삼성SDI보통주
4492,6400,2020-04-17,0.0571955719557195,271000,286500,15500,2107737,6400.0,삼성SDI보통주
4493,6400,2020-04-16,0.0775347912524851,251500,271000,19500,1230799,6400.0,삼성SDI보통주
4494,6400,2020-04-14,0.041407867494824,241500,251500,10000,640598,6400.0,삼성SDI보통주
4495,6400,2020-03-25,0.0446247464503042,246500,257500,11000,1368513,6400.0,삼성SDI보통주
4496,6400,2020-03-24,0.1281464530892448,218500,246500,28000,1668595,6400.0,삼성SDI보통주
4497,6400,2020-03-20,0.1830601092896175,183000,216500,33500,1818258,6400.0,삼성SDI보통주
4498,6400,2020-03-19,0.1738148984198645,221500,183000,-38500,2233285,6400.0,삼성SDI보통주
4499,6400,2020-03-18,0.0995934959349593,246000,221500,-24500,1105362,6400.0,삼성SDI보통주
4500,6400,2020-03-16,0.0882882882882882,277500,253000,-24500,994249,6400.0,삼성SDI보통주
4501,6400,2020-03-09,0.0679304897314376,316500,295000,-21500,728826,6400.0,삼성SDI보통주
4502,6400,2020-02-28,0.0468497576736672,309500,295000,-14500,919096,6400.0,삼성SDI보통주
4503,6400,2020-02-24,0.0460624071322436,336500,321000,-15500,704622,6400.0,삼성SDI보통주
4504,6400,2020-02-11,0.0668740279937791,321500,343000,21500,874870,6400.0,삼성SDI보통주
4505,6400,2020-02-04,0.0845070422535211,284000,308000,24000,939164,6400.0,삼성SDI보통주
4506,6400,2020-01-13,0.0401606425702811,249000,259000,10000,641733,6400.0,삼성SDI보통주
4507,6400,2020-01-10,0.0709677419354838,232500,249000,16500,819751,6400.0,삼성SDI보통주
4508,6400,2019-12-27,0.047191011235955,222500,233000,10500,411543,6400.0,삼성SDI보통주
4509,6400,2019-12-04,0.0548523206751054,237000,224000,-13000,555044,6400.0,삼성SDI보통주
4510,6400,2019-09-25,0.0649895178197065,238500,223000,-15500,641510,6400.0,삼성SDI보통주
4511,6400,2019-08-14,0.0407331975560081,245500,255500,10000,349485,6400.0,삼성SDI보통주
4512,6400,2019-08-09,0.048728813559322,236000,247500,11500,277745,6400.0,삼성SDI보통주
4513,6400,2019-07-31,0.050632911392405,237000,249000,12000,617734,6400.0,삼성SDI보통주
4514,6400,2019-05-30,0.0491400491400491,203500,213500,10000,452930,6400.0,삼성SDI보통주
4515,6400,2019-05-09,0.0711297071129707,239000,222000,-17000,725606,6400.0,삼성SDI보통주
4516,6400,2019-03-21,0.048076923076923,208000,218000,10000,1179042,6400.0,삼성SDI보통주
4517,6400,2019-02-07,0.0572687224669603,227000,240000,13000,692664,6400.0,삼성SDI보통주
4518,6400,2019-01-07,0.0796019900497512,201000,217000,16000,549913,6400.0,삼성SDI보통주
4519,6400,2018-12-21,0.0523809523809523,210000,221000,11000,706872,6400.0,삼성SDI보통주
4520,6400,2018-12-19,0.0419753086419753,202500,211000,8500,336919,6400.0,삼성SDI보통주
4521,6400,2018-12-14,0.0486111111111111,216000,205500,-10500,459055,6400.0,삼성SDI보통주
4522,6400,2018-12-03,0.0702179176755447,206500,221000,14500,511045,6400.0,삼성SDI보통주
4523,6400,2018-11-20,0.0606741573033707,222500,209000,-13500,594077,6400.0,삼성SDI보통주
4524,6400,2018-11-09,0.0545851528384279,229000,216500,-12500,698588,6400.0,삼성SDI보통주
4525,6400,2018-10-24,0.0709812108559499,239500,222500,-17000,811416,6400.0,삼성SDI보통주
4526,6400,2018-10-23,0.045816733067729,251000,239500,-11500,514080,6400.0,삼성SDI보통주
4527,6400,2018-10-12,0.0748898678414096,227000,244000,17000,516051,6400.0,삼성SDI보통주
4528,6400,2018-10-11,0.0482180293501048,238500,227000,-11500,419946,6400.0,삼성SDI보통주
4529,6400,2018-08-27,0.0401785714285714,224000,233000,9000,394144,6400.0,삼성SDI보통주
4530,6400,2018-08-21,0.0432692307692307,208000,217000,9000,318915,6400.0,삼성SDI보통주
4531,6400,2018-08-10,0.0656455142231947,228500,213500,-15000,625069,6400.0,삼성SDI보통주
4532,6400,2018-07-23,0.0495689655172413,232000,220500,-11500,440882,6400.0,삼성SDI보통주
4533,6400,2018-07-06,0.0744186046511627,215000,231000,16000,853958,6400.0,삼성SDI보통주
4534,6400,2018-06-20,0.0601851851851851,216000,229000,13000,454949,6400.0,삼성SDI보통주
4535,6400,2018-06-18,0.0530785562632696,235500,223000,-12500,646476,6400.0,삼성SDI보통주
4536,6400,2018-06-04,0.0478468899521531,209000,219000,10000,610620,6400.0,삼성SDI보통주
4537,6400,2018-06-01,0.0423940149625935,200500,209000,8500,357994,6400.0,삼성SDI보통주
4538,6400,2018-05-14,0.0471204188481675,191000,200000,9000,456025,6400.0,삼성SDI보통주
4539,6400,2018-04-04,0.040506329113924,197500,189500,-8000,363317,6400.0,삼성SDI보통주
4540,6400,2018-03-23,0.0408653846153846,208000,199500,-8500,453539,6400.0,삼성SDI보통주
4541,6400,2018-03-19,0.0440835266821345,215500,206000,-9500,635991,6400.0,삼성SDI보통주
4542,6400,2018-03-09,0.0796703296703296,182000,196500,14500,1178221,6400.0,삼성SDI보통주
4543,6400,2018-03-06,0.0558823529411764,170000,179500,9500,378661,6400.0,삼성SDI보통주
4544,6400,2018-02-14,0.0463768115942029,172500,180500,8000,386259,6400.0,삼성SDI보통주
4545,6400,2018-02-02,0.0453333333333333,187500,179000,-8500,1541960,6400.0,삼성SDI보통주
4546,6400,2018-02-01,0.0482233502538071,197000,187500,-9500,1296858,6400.0,삼성SDI보통주
4547,6400,2018-01-19,0.0642201834862385,218000,204000,-14000,969072,6400.0,삼성SDI보통주
4548,6400,2018-01-05,0.0575539568345323,208500,220500,12000,631052,6400.0,삼성SDI보통주
4549,6400,2017-12-21,0.0426540284360189,211000,202000,-9000,281320,6400.0,삼성SDI보통주
4550,6400,2017-12-05,0.0467289719626168,214000,204000,-10000,514290,6400.0,삼성SDI보통주
4551,6400,2017-11-27,0.043010752688172,232500,222500,-10000,462103,6400.0,삼성SDI보통주
4552,6400,2017-11-22,0.0411899313501144,218500,227500,9000,554363,6400.0,삼성SDI보통주
4553,6400,2017-11-01,0.0898058252427184,206000,224500,18500,1325337,6400.0,삼성SDI보통주
4554,6400,2017-10-16,0.0578703703703703,216000,203500,-12500,771109,6400.0,삼성SDI보통주
4555,6400,2017-10-10,0.0755667506297229,198500,213500,15000,632311,6400.0,삼성SDI보통주
4556,6400,2017-09-28,0.0453460620525059,209500,200000,-9500,677664,6400.0,삼성SDI보통주
4557,6400,2017-09-13,0.0425,200000,208500,8500,554660,6400.0,삼성SDI보통주
4558,6400,2017-09-11,0.0519480519480519,192500,202500,10000,618610,6400.0,삼성SDI보통주
4559,6400,2017-08-14,0.044378698224852,169000,176500,7500,218942,6400.0,삼성SDI보통주
4560,6400,2017-08-02,0.0436046511627907,172000,179500,7500,364917,6400.0,삼성SDI보통주
4561,6400,2017-07-28,0.0404624277456647,173000,166000,-7000,781325,6400.0,삼성SDI보통주
4562,6400,2017-07-26,0.0576923076923076,182000,171500,-10500,482123,6400.0,삼성SDI보통주
4563,6400,2017-07-19,0.0582010582010582,189000,178000,-11000,644301,6400.0,삼성SDI보통주
4564,6400,2017-07-13,0.0492753623188405,172500,181000,8500,557722,6400.0,삼성SDI보통주
4565,6400,2017-07-05,0.0504451038575667,168500,177000,8500,516326,6400.0,삼성SDI보통주
4566,6400,2017-06-26,0.0486322188449848,164500,172500,8000,607350,6400.0,삼성SDI보통주
4567,6400,2017-06-19,0.0508474576271186,147500,155000,7500,375439,6400.0,삼성SDI보통주
4568,6400,2017-06-12,0.0482315112540192,155500,148000,-7500,599554,6400.0,삼성SDI보통주
4569,6400,2017-06-01,0.0422960725075528,165500,158500,-7000,400254,6400.0,삼성SDI보통주
4570,6400,2017-05-11,0.0600706713780918,141500,150000,8500,664511,6400.0,삼성SDI보통주
4571,6400,2017-03-08,0.04,125000,130000,5000,653779,6400.0,삼성SDI보통주
4572,6400,2017-01-19,0.0622222222222222,112500,105500,-7000,694866,6400.0,삼성SDI보통주
4573,6400,2016-12-15,0.0440122824974411,97700,102000,4300,508417,6400.0,삼성SDI보통주
4574,6400,2016-12-08,0.041896361631753,90700,94500,3800,413025,6400.0,삼성SDI보통주
4575,6400,2016-09-12,0.0585365853658536,102500,96500,-6000,626466,6400.0,삼성SDI보통주
4576,6400,2016-09-01,0.0606060606060606,115500,108500,-7000,920876,6400.0,삼성SDI보통주
4577,6400,2016-08-22,0.0464135021097046,118500,124000,5500,422550,6400.0,삼성SDI보통주
4578,6400,2016-08-03,0.0467289719626168,107000,112000,5000,468199,6400.0,삼성SDI보통주
4579,6650,2021-05-11,0.0635179153094462,307000,287500,-19500,172626,6650.0,대한유화보통주
4580,6650,2021-05-03,0.0571428571428571,315000,297000,-18000,128742,6650.0,대한유화보통주
4581,6650,2021-04-29,0.0624071322436849,336500,315500,-21000,226488,6650.0,대한유화보통주
4582,6650,2021-04-28,0.0730027548209366,363000,336500,-26500,182941,6650.0,대한유화보통주
4583,6650,2021-04-27,0.0401146131805157,349000,363000,14000,199664,6650.0,대한유화보통주
4584,6650,2021-04-26,0.0559757942511346,330500,349000,18500,148858,6650.0,대한유화보통주
4585,6650,2021-04-22,0.062700964630225,311000,330500,19500,185080,6650.0,대한유화보통주
4586,6650,2021-04-05,0.0513219284603421,321500,305000,-16500,130733,6650.0,대한유화보통주
4587,6650,2021-03-10,0.0524737631184407,333500,316000,-17500,105339,6650.0,대한유화보통주
4588,6650,2021-02-25,0.0495626822157434,343000,360000,17000,119676,6650.0,대한유화보통주
4589,6650,2021-02-24,0.0641200545702592,366500,343000,-23500,100733,6650.0,대한유화보통주
4590,6650,2021-02-16,0.0736698499317871,366500,393500,27000,185997,6650.0,대한유화보통주
4591,6650,2021-02-10,0.2185970636215334,306500,373500,67000,587686,6650.0,대한유화보통주
4592,6650,2021-02-02,0.0765217391304347,287500,309500,22000,247394,6650.0,대한유화보통주
4593,6650,2021-01-29,0.0485762144053601,298500,284000,-14500,180529,6650.0,대한유화보통주
4594,6650,2021-01-27,0.0547445255474452,274000,289000,15000,274423,6650.0,대한유화보통주
4595,6650,2021-01-07,0.0487364620938628,277000,290500,13500,251334,6650.0,대한유화보통주
4596,6650,2021-01-06,0.1787234042553191,235000,277000,42000,621523,6650.0,대한유화보통주
4597,6650,2020-12-30,0.0454545454545454,220000,230000,10000,150308,6650.0,대한유화보통주
4598,6650,2020-11-18,0.0565217391304347,230000,243000,13000,109989,6650.0,대한유화보통주
4599,6650,2020-11-09,0.0471698113207547,212000,222000,10000,99454,6650.0,대한유화보통주
4600,6650,2020-11-05,0.0403022670025188,198500,206500,8000,134061,6650.0,대한유화보통주
4601,6650,2020-10-27,0.0434782608695652,195500,187000,-8500,72394,6650.0,대한유화보통주
4602,6650,2020-10-20,0.0580110497237569,181000,191500,10500,94594,6650.0,대한유화보통주
4603,6650,2020-10-08,0.0431266846361186,185500,193500,8000,190787,6650.0,대한유화보통주
4604,6650,2020-10-05,0.1321321321321321,166500,188500,22000,242004,6650.0,대한유화보통주
4605,6650,2020-09-23,0.046979865771812,149000,156000,7000,81377,6650.0,대한유화보통주
4606,6650,2020-09-22,0.0509554140127388,157000,149000,-8000,75646,6650.0,대한유화보통주
4607,6650,2020-09-09,0.0684039087947882,153500,164000,10500,485086,6650.0,대한유화보통주
4608,6650,2020-09-08,0.0586206896551724,145000,153500,8500,690399,6650.0,대한유화보통주
4609,6650,2020-09-07,0.2554112554112554,115500,145000,29500,915584,6650.0,대한유화보통주
4610,6650,2020-08-20,0.059322033898305,118000,111000,-7000,56636,6650.0,대한유화보통주
4611,6650,2020-07-29,0.0694980694980695,129500,120500,-9000,231753,6650.0,대한유화보통주
4612,6650,2020-07-28,0.0401606425702811,124500,129500,5000,87545,6650.0,대한유화보통주
4613,6650,2020-07-15,0.0530612244897959,122500,129000,6500,109855,6650.0,대한유화보통주
4614,6650,2020-07-13,0.0829694323144104,114500,124000,9500,92819,6650.0,대한유화보통주
4615,6650,2020-06-19,0.0826086956521739,115000,124500,9500,148175,6650.0,대한유화보통주
4616,6650,2020-06-16,0.107981220657277,106500,118000,11500,94733,6650.0,대한유화보통주
4617,6650,2020-06-15,0.0779220779220779,115500,106500,-9000,55901,6650.0,대한유화보통주
4618,6650,2020-06-12,0.0493827160493827,121500,115500,-6000,70103,6650.0,대한유화보통주
4619,6650,2020-05-28,0.0415094339622641,132500,127000,-5500,62284,6650.0,대한유화보통주
4620,6650,2020-05-22,0.0492424242424242,132000,125500,-6500,94367,6650.0,대한유화보통주
4621,6650,2020-05-19,0.0501930501930501,129500,136000,6500,119927,6650.0,대한유화보통주
4622,6650,2020-05-07,0.04,125000,130000,5000,91677,6650.0,대한유화보통주
4623,6650,2020-05-04,0.1316725978647686,140500,122000,-18500,186289,6650.0,대한유화보통주
4624,6650,2020-04-24,0.0477941176470588,136000,142500,6500,197210,6650.0,대한유화보통주
4625,6650,2020-04-23,0.0708661417322834,127000,136000,9000,183691,6650.0,대한유화보통주
4626,6650,2020-04-22,0.0583333333333333,120000,127000,7000,155520,6650.0,대한유화보통주
4627,6650,2020-04-20,0.0934579439252336,107000,117000,10000,106525,6650.0,대한유화보통주
4628,6650,2020-04-16,0.0426540284360189,105500,110000,4500,94558,6650.0,대한유화보통주
4629,6650,2020-04-14,0.147986942328618,91900,105500,13600,213404,6650.0,대한유화보통주
4630,6650,2020-03-31,0.0698529411764705,81600,87300,5700,69006,6650.0,대한유화보통주
4631,6650,2020-03-25,0.1146853146853146,71500,79700,8200,79469,6650.0,대한유화보통주
4632,6650,2020-03-24,0.080060422960725,66200,71500,5300,38473,6650.0,대한유화보통주
4633,6650,2020-03-23,0.0405797101449275,69000,66200,-2800,51051,6650.0,대한유화보통주
4634,6650,2020-03-20,0.1219512195121951,61500,69000,7500,108370,6650.0,대한유화보통주
4635,6650,2020-03-19,0.1214285714285714,70000,61500,-8500,77868,6650.0,대한유화보통주
4636,6650,2020-03-18,0.0410958904109589,73000,70000,-3000,51065,6650.0,대한유화보통주
4637,6650,2020-03-16,0.0689655172413793,81200,75600,-5600,38570,6650.0,대한유화보통주
4638,6650,2020-03-13,0.055813953488372,86000,81200,-4800,106083,6650.0,대한유화보통주
4639,6650,2020-03-12,0.0742734122712594,92900,86000,-6900,75134,6650.0,대한유화보통주
4640,6650,2020-03-10,0.0513698630136986,87600,92100,4500,100848,6650.0,대한유화보통주
4641,6650,2020-03-04,0.0435280641466208,87300,91100,3800,39332,6650.0,대한유화보통주
4642,6650,2020-02-28,0.0562293274531422,90700,85600,-5100,60681,6650.0,대한유화보통주
4643,6650,2020-02-06,0.0591900311526479,96300,102000,5700,48128,6650.0,대한유화보통주
4644,6650,2020-01-31,0.0400410677618069,97400,93500,-3900,46173,6650.0,대한유화보통주
4645,6650,2020-01-28,0.0694444444444444,108000,100500,-7500,67869,6650.0,대한유화보통주
4646,6650,2020-01-14,0.0416666666666666,108000,112500,4500,36570,6650.0,대한유화보통주
4647,6650,2020-01-08,0.041860465116279,107500,103000,-4500,63318,6650.0,대한유화보통주
4648,6650,2020-01-06,0.043859649122807,114000,109000,-5000,57109,6650.0,대한유화보통주
4649,6650,2019-10-11,0.040983606557377,122000,127000,5000,42764,6650.0,대한유화보통주
4650,6650,2019-09-11,0.0428015564202334,128500,134000,5500,55388,6650.0,대한유화보통주
4651,6650,2019-08-26,0.0519480519480519,115500,109500,-6000,48772,6650.0,대한유화보통주
4652,6650,2019-08-19,0.0448430493273542,111500,116500,5000,19498,6650.0,대한유화보통주
4653,6650,2019-08-05,0.0711297071129707,119500,111000,-8500,59846,6650.0,대한유화보통주
4654,6650,2019-07-30,0.0427350427350427,117000,122000,5000,33595,6650.0,대한유화보통주
4655,6650,2019-07-19,0.040983606557377,122000,127000,5000,37706,6650.0,대한유화보통주
4656,6650,2019-05-29,0.0434782608695652,138000,132000,-6000,47543,6650.0,대한유화보통주
4657,6650,2019-05-09,0.0462046204620462,151500,144500,-7000,36046,6650.0,대한유화보통주
4658,6650,2019-02-28,0.0463215258855585,183500,175000,-8500,69168,6650.0,대한유화보통주
4659,6650,2019-02-18,0.0501474926253687,169500,178000,8500,64778,6650.0,대한유화보통주
4660,6650,2019-02-08,0.0520231213872832,173000,164000,-9000,54838,6650.0,대한유화보통주
4661,6650,2019-01-25,0.0495356037151702,161500,169500,8000,76068,6650.0,대한유화보통주
4662,6650,2019-01-09,0.0486111111111111,144000,151000,7000,49035,6650.0,대한유화보통주
4663,6650,2019-01-07,0.088235294117647,136000,148000,12000,101700,6650.0,대한유화보통주
4664,6650,2019-01-03,0.0542372881355932,147500,139500,-8000,71169,6650.0,대한유화보통주
4665,6650,2018-12-10,0.0474683544303797,158000,150500,-7500,88810,6650.0,대한유화보통주
4666,6650,2018-12-03,0.0625,160000,170000,10000,110410,6650.0,대한유화보통주
4667,6650,2018-11-26,0.0617283950617283,162000,172000,10000,72676,6650.0,대한유화보통주
4668,6650,2018-11-07,0.0502958579881656,169000,160500,-8500,91158,6650.0,대한유화보통주
4669,6650,2018-11-02,0.0732484076433121,157000,168500,11500,118323,6650.0,대한유화보통주
4670,6650,2018-10-29,0.0603174603174603,157500,148000,-9500,76094,6650.0,대한유화보통주
4671,6650,2018-10-26,0.0843023255813953,172000,157500,-14500,91826,6650.0,대한유화보통주
4672,6650,2018-10-24,0.1052631578947368,152000,168000,16000,218876,6650.0,대한유화보통주
4673,6650,2018-10-23,0.0470219435736677,159500,152000,-7500,78327,6650.0,대한유화보통주
4674,6650,2018-10-11,0.0520231213872832,173000,164000,-9000,63573,6650.0,대한유화보통주
4675,6650,2018-10-04,0.0529247910863509,179500,170000,-9500,107764,6650.0,대한유화보통주
4676,6650,2018-09-11,0.0769230769230769,208000,192000,-16000,170768,6650.0,대한유화보통주
4677,6650,2018-08-22,0.0770791075050709,246500,227500,-19000,219134,6650.0,대한유화보통주
4678,6650,2018-08-01,0.0681362725450901,249500,232500,-17000,133022,6650.0,대한유화보통주
4679,6650,2018-07-26,0.0818965517241379,232000,251000,19000,106208,6650.0,대한유화보통주
4680,6650,2018-07-12,0.0511727078891258,234500,246500,12000,83903,6650.0,대한유화보통주
4681,6650,2018-07-02,0.0419161676646706,250500,240000,-10500,30608,6650.0,대한유화보통주
4682,6650,2018-06-27,0.0489236790606653,255500,243000,-12500,68844,6650.0,대한유화보통주
4683,6650,2018-06-14,0.0477941176470588,272000,259000,-13000,60523,6650.0,대한유화보통주
4684,6650,2018-06-08,0.0545808966861598,256500,270500,14000,104663,6650.0,대한유화보통주
4685,6650,2018-06-04,0.0464646464646464,247500,259000,11500,56716,6650.0,대한유화보통주
4686,6650,2018-05-28,0.0557851239669421,242000,255500,13500,90437,6650.0,대한유화보통주
4687,6650,2018-05-04,0.0566371681415929,282500,266500,-16000,55743,6650.0,대한유화보통주
4688,6650,2018-05-03,0.0462962962962962,270000,282500,12500,78917,6650.0,대한유화보통주
4689,6650,2018-04-16,0.0539130434782608,287500,272000,-15500,90328,6650.0,대한유화보통주
4690,6650,2018-03-05,0.0663507109004739,316500,295500,-21000,71240,6650.0,대한유화보통주
4691,6650,2018-02-21,0.0416047548291233,336500,322500,-14000,75486,6650.0,대한유화보통주
4692,6650,2018-02-19,0.0412844036697247,327000,340500,13500,41142,6650.0,대한유화보통주
4693,6650,2018-02-08,0.0414673046251993,313500,326500,13000,50130,6650.0,대한유화보통주
4694,6650,2018-02-07,0.0765832106038291,339500,313500,-26000,50914,6650.0,대한유화보통주
4695,6650,2018-01-29,0.0678233438485804,317000,338500,21500,70471,6650.0,대한유화보통주
4696,6650,2018-01-22,0.0575657894736842,304000,321500,17500,90354,6650.0,대한유화보통주
4697,6650,2018-01-12,0.0656303972366148,289500,308500,19000,147129,6650.0,대한유화보통주
4698,6650,2018-01-08,0.1021194605009633,259500,286000,26500,208590,6650.0,대한유화보통주
4699,6650,2017-11-15,0.0421686746987951,249000,238500,-10500,96820,6650.0,대한유화보통주
4700,6650,2017-11-02,0.0698602794411177,250500,268000,17500,179964,6650.0,대한유화보통주
4701,6650,2017-10-30,0.0421455938697318,261000,250000,-11000,86492,6650.0,대한유화보통주
4702,6650,2017-09-11,0.0433962264150943,265000,276500,11500,54766,6650.0,대한유화보통주
4703,6650,2017-08-14,0.0509803921568627,255000,268000,13000,115349,6650.0,대한유화보통주
4704,6650,2017-07-31,0.0572597137014314,244500,258500,14000,85748,6650.0,대한유화보통주
4705,6650,2017-07-14,0.0421052631578947,237500,247500,10000,79173,6650.0,대한유화보통주
4706,6650,2017-05-25,0.1015936254980079,251000,276500,25500,139177,6650.0,대한유화보통주
4707,6650,2017-05-22,0.0918803418803418,234000,255500,21500,156452,6650.0,대한유화보통주
4708,6650,2017-02-01,0.0481481481481481,270000,283000,13000,48790,6650.0,대한유화보통주
4709,6650,2017-01-31,0.0425531914893617,282000,270000,-12000,46073,6650.0,대한유화보통주
4710,6650,2017-01-18,0.048780487804878,287000,273000,-14000,52092,6650.0,대한유화보통주
4711,6650,2017-01-09,0.0403669724770642,272500,283500,11000,37546,6650.0,대한유화보통주
4712,6650,2016-12-15,0.0685483870967741,248000,265000,17000,54498,6650.0,대한유화보통주
4713,6650,2016-12-08,0.0523138832997987,248500,261500,13000,66313,6650.0,대한유화보통주
4714,6650,2016-12-06,0.0570824524312896,236500,250000,13500,95823,6650.0,대한유화보통주
4715,6650,2016-11-14,0.1002444987775061,204500,225000,20500,106862,6650.0,대한유화보통주
4716,6650,2016-11-10,0.0430379746835443,197500,206000,8500,54260,6650.0,대한유화보통주
4717,6650,2016-10-18,0.0656934306569343,205500,219000,13500,76385,6650.0,대한유화보통주
4718,6650,2016-08-29,0.0478468899521531,209000,199000,-10000,58793,6650.0,대한유화보통주
4719,6800,2021-05-12,0.0422535211267605,10650,10200,-450,4638973,6800.0,미래에셋증권보통주
4720,6800,2021-05-10,0.0588235294117647,10200,10800,600,9102554,6800.0,미래에셋증권보통주
4721,6800,2021-05-06,0.0433884297520661,9680,10100,420,3072217,6800.0,미래에셋증권보통주
4722,6800,2021-01-05,0.0421052631578947,9500,9900,400,4213078,6800.0,미래에셋증권보통주
4723,6800,2020-12-01,0.0654008438818565,9480,10100,620,6220266,6800.0,미래에셋증권보통주
4724,6800,2020-11-30,0.0491474423269809,9970,9480,-490,5120909,6800.0,미래에셋증권보통주
4725,6800,2020-11-11,0.0573951434878587,9060,9580,520,4253446,6800.0,미래에셋증권보통주
4726,6800,2020-09-22,0.040586245772266,8870,8510,-360,2984344,6800.0,미래에셋증권보통주
4727,6800,2020-08-20,0.040992448759439,9270,8890,-380,5406199,6800.0,미래에셋증권보통주
4728,6800,2020-08-10,0.0771850170261067,8810,9490,680,9216565,6800.0,미래에셋증권보통주
4729,6800,2020-08-05,0.0491803278688524,8540,8960,420,6962066,6800.0,미래에셋증권보통주
4730,6800,2020-08-04,0.0648379052369077,8020,8540,520,6792951,6800.0,미래에셋증권보통주
4731,6800,2020-07-31,0.0576407506702412,7460,7890,430,6002025,6800.0,미래에셋증권보통주
4732,6800,2020-07-17,0.0449141347424042,7570,7910,340,5462291,6800.0,미래에셋증권보통주
4733,6800,2020-07-15,0.0466760961810466,7070,7400,330,4946484,6800.0,미래에셋증권보통주
4734,6800,2020-07-13,0.0452554744525547,6850,7160,310,5858403,6800.0,미래에셋증권보통주
4735,6800,2020-06-25,0.0472779369627507,6980,6650,-330,3610969,6800.0,미래에셋증권보통주
4736,6800,2020-06-16,0.0632911392405063,6320,6720,400,3761634,6800.0,미래에셋증권보통주
4737,6800,2020-06-15,0.0760233918128654,6840,6320,-520,4175382,6800.0,미래에셋증권보통주
4738,6800,2020-06-03,0.0743034055727554,6460,6940,480,9158624,6800.0,미래에셋증권보통주
4739,6800,2020-05-29,0.0434108527131782,6450,6170,-280,9966883,6800.0,미래에셋증권보통주
4740,6800,2020-05-28,0.047077922077922,6160,6450,290,7651448,6800.0,미래에셋증권보통주
4741,6800,2020-05-22,0.0442930153321976,5870,5610,-260,3626474,6800.0,미래에셋증권보통주
4742,6800,2020-05-19,0.0600375234521576,5330,5650,320,5154711,6800.0,미래에셋증권보통주
4743,6800,2020-04-29,0.0485981308411214,5350,5610,260,8511707,6800.0,미래에셋증권보통주
4744,6800,2020-04-27,0.0446601941747572,5150,5380,230,3807428,6800.0,미래에셋증권보통주
4745,6800,2020-04-17,0.075098814229249,5060,5440,380,8448983,6800.0,미래에셋증권보통주
4746,6800,2020-04-06,0.040650406504065,4920,5120,200,3772042,6800.0,미래에셋증권보통주
4747,6800,2020-04-01,0.0711574952561669,5270,4895,-375,5245398,6800.0,미래에셋증권보통주
4748,6800,2020-03-25,0.1966426858513189,4170,4990,820,9379585,6800.0,미래에셋증권보통주
4749,6800,2020-03-24,0.1599443671766342,3595,4170,575,7099214,6800.0,미래에셋증권보통주
4750,6800,2020-03-23,0.0978670012547051,3985,3595,-390,7702606,6800.0,미래에셋증권보통주
4751,6800,2020-03-20,0.1069444444444444,3600,3985,385,8484456,6800.0,미래에셋증권보통주
4752,6800,2020-03-19,0.2052980132450331,4530,3600,-930,10119912,6800.0,미래에셋증권보통주
4753,6800,2020-03-18,0.1029702970297029,5050,4530,-520,5423802,6800.0,미래에셋증권보통주
4754,6800,2020-03-17,0.0578358208955223,5360,5050,-310,4446265,6800.0,미래에셋증권보통주
4755,6800,2020-03-13,0.05,5800,5510,-290,4486498,6800.0,미래에셋증권보통주
4756,6800,2020-03-12,0.0476190476190476,6090,5800,-290,4142758,6800.0,미래에셋증권보통주
4757,6800,2020-03-09,0.0462249614791987,6490,6190,-300,2834246,6800.0,미래에셋증권보통주
4758,6800,2020-02-06,0.0420899854862119,6890,7180,290,2328672,6800.0,미래에셋증권보통주
4759,6800,2020-01-28,0.0502645502645502,7560,7180,-380,2642995,6800.0,미래에셋증권보통주
4760,6800,2020-01-14,0.0402684563758389,7450,7750,300,4135800,6800.0,미래에셋증권보통주
4761,6800,2019-11-04,0.0436005625879043,7110,7420,310,2345234,6800.0,미래에셋증권보통주
4762,6800,2019-08-30,0.0449438202247191,7120,7440,320,1659651,6800.0,미래에셋증권보통주
4763,6800,2019-08-09,0.0411347517730496,7050,7340,290,1981435,6800.0,미래에셋증권보통주
4764,6800,2019-01-24,0.0475524475524475,7150,7490,340,5297098,6800.0,미래에셋증권보통주
4765,6800,2019-01-15,0.0460624071322436,6730,7040,310,4298158,6800.0,미래에셋증권보통주
4766,6800,2019-01-07,0.0484375,6400,6710,310,2599575,6800.0,미래에셋증권보통주
4767,6800,2018-11-06,0.0428994082840236,6760,7050,290,3179272,6800.0,미래에셋증권보통주
4768,6800,2018-11-02,0.0775193798449612,6450,6950,500,3605496,6800.0,미래에셋증권보통주
4769,6800,2018-10-11,0.0693717277486911,7640,7110,-530,4563308,6800.0,미래에셋증권보통주
4770,6800,2018-08-13,0.0415094339622641,7950,7620,-330,3961139,6800.0,미래에셋증권보통주
4771,6800,2018-07-02,0.0469483568075117,8520,8120,-400,3240268,6800.0,미래에셋증권보통주
4772,6800,2018-05-30,0.0488798370672097,9820,9340,-480,4680330,6800.0,미래에셋증권보통주
4773,6800,2018-05-11,0.0534591194968553,9540,10050,510,7460206,6800.0,미래에셋증권보통주
4774,6800,2018-03-23,0.0491631799163179,9560,9090,-470,4821340,6800.0,미래에셋증권보통주
4775,6800,2018-03-09,0.0509209100758396,9230,9700,470,5252509,6800.0,미래에셋증권보통주
4776,6800,2018-03-06,0.0436241610738255,8940,9330,390,3338487,6800.0,미래에셋증권보통주
4777,6800,2018-01-23,0.0916496945010183,9820,10500,680,8053335,6800.0,미래에셋증권보통주
4778,6800,2017-12-18,0.1346153846153846,10400,9000,-1400,18243412,6800.0,미래에셋증권보통주
4779,6800,2017-12-15,0.0458715596330275,10900,10400,-500,7305919,6800.0,미래에셋증권보통주
4780,6800,2017-11-22,0.062200956937799,10450,11100,650,12474819,6800.0,미래에셋증권보통주
4781,6800,2017-11-15,0.044776119402985,10050,10500,450,6504939,6800.0,미래에셋증권보통주
4782,6800,2017-10-18,0.0412844036697247,10900,10450,-450,3455422,6800.0,미래에셋증권보통주
4783,6800,2017-10-12,0.0445544554455445,10100,10550,450,6041312,6800.0,미래에셋증권보통주
4784,6800,2017-09-18,0.0441176470588235,10200,10650,450,5529504,6800.0,미래에셋증권보통주
4785,6800,2017-09-07,0.0483193277310924,9520,9980,460,2994815,6800.0,미래에셋증권보통주
4786,6800,2017-08-03,0.0452488687782805,11050,10550,-500,6219174,6800.0,미래에셋증권보통주
4787,6800,2017-07-28,0.0446428571428571,11200,10700,-500,5977846,6800.0,미래에셋증권보통주
4788,6800,2017-06-29,0.056338028169014,10650,11250,600,12223296,6800.0,미래에셋증권보통주
4789,6800,2017-06-09,0.0585817060637204,9730,10300,570,11849953,6800.0,미래에셋증권보통주
4790,6800,2017-02-06,0.0584795321637426,8550,9050,500,10594749,6800.0,미래에셋증권보통주
4791,6800,2017-01-26,0.0463733650416171,8410,8800,390,6423039,6800.0,미래에셋증권보통주
4792,6800,2017-01-17,0.0557532621589561,8430,8900,470,4900806,6800.0,미래에셋증권보통주
4793,6800,2017-01-11,0.05125,8000,8410,410,4428570,6800.0,미래에셋증권보통주
4794,6800,2017-01-04,0.0404172099087353,7670,7980,310,4203488,6800.0,미래에셋증권보통주
4795,6800,2016-11-21,0.0537352555701179,7630,7220,-410,3032409,6800.0,미래에셋증권보통주
4796,6800,2016-08-02,0.0407040704070407,9090,8720,-370,3262504,6800.0,미래에셋증권보통주
4797,7070,2021-05-31,0.0536912751677852,37250,39250,2000,1801163,7070.0,지에스리테일보통주
4798,7070,2021-03-16,0.040595399188092,36950,38450,1500,1016336,7070.0,지에스리테일보통주
4799,7070,2021-03-03,0.0417827298050139,35900,37400,1500,777888,7070.0,지에스리테일보통주
4800,7070,2020-10-19,0.0450581395348837,34400,35950,1550,1065599,7070.0,지에스리테일보통주
4801,7070,2020-10-14,0.0414937759336099,36150,34650,-1500,739178,7070.0,지에스리테일보통주
4802,7070,2020-10-12,0.0971168437025796,32950,36150,3200,1868585,7070.0,지에스리테일보통주
4803,7070,2020-08-20,0.0573529411764705,34000,32050,-1950,372691,7070.0,지에스리테일보통주
4804,7070,2020-08-18,0.0682788051209103,35150,32750,-2400,623963,7070.0,지에스리테일보통주
4805,7070,2020-05-25,0.0747549019607843,40800,43850,3050,742290,7070.0,지에스리테일보통주
4806,7070,2020-05-14,0.07,40000,42800,2800,1734947,7070.0,지에스리테일보통주
4807,7070,2020-05-13,0.0416666666666666,38400,40000,1600,726854,7070.0,지에스리테일보통주
4808,7070,2020-04-27,0.1661341853035143,31300,36500,5200,2303525,7070.0,지에스리테일보통주
4809,7070,2020-04-01,0.0631067961165048,30900,28950,-1950,281137,7070.0,지에스리테일보통주
4810,7070,2020-03-31,0.0655172413793103,29000,30900,1900,348311,7070.0,지에스리테일보통주
4811,7070,2020-03-25,0.0626151012891344,27150,28850,1700,254012,7070.0,지에스리테일보통주
4812,7070,2020-03-24,0.0462427745664739,25950,27150,1200,168773,7070.0,지에스리테일보통주
4813,7070,2020-03-23,0.0894736842105263,28500,25950,-2550,227836,7070.0,지에스리테일보통주
4814,7070,2020-03-20,0.0857142857142857,26250,28500,2250,302467,7070.0,지에스리테일보통주
4815,7070,2020-03-19,0.0979381443298969,29100,26250,-2850,387862,7070.0,지에스리테일보통주
4816,7070,2019-08-01,0.0455764075067024,37300,39000,1700,319830,7070.0,지에스리테일보통주
4817,7070,2019-04-12,0.0466321243523316,38600,40400,1800,242241,7070.0,지에스리테일보통주
4818,7070,2019-01-10,0.0651890482398957,38350,35850,-2500,854146,7070.0,지에스리테일보통주
4819,7070,2018-11-22,0.0413105413105413,35100,36550,1450,302858,7070.0,지에스리테일보통주
4820,7070,2018-11-20,0.0410958904109589,36500,35000,-1500,239431,7070.0,지에스리테일보통주
4821,7070,2018-11-02,0.0638297872340425,35250,37500,2250,660006,7070.0,지에스리테일보통주
4822,7070,2018-10-31,0.0401069518716577,37400,35900,-1500,650054,7070.0,지에스리테일보통주
4823,7070,2018-10-10,0.0737812911725955,37950,40750,2800,459308,7070.0,지에스리테일보통주
4824,7070,2018-09-13,0.0585106382978723,37600,39800,2200,386288,7070.0,지에스리테일보통주
4825,7070,2018-08-10,0.0689655172413793,33350,35650,2300,1186747,7070.0,지에스리테일보통주
4826,7070,2018-07-20,0.0775193798449612,32250,29750,-2500,1642649,7070.0,지에스리테일보통주
4827,7070,2018-07-18,0.0437317784256559,34300,32800,-1500,569168,7070.0,지에스리테일보통주
4828,7070,2018-07-16,0.1070496083550913,38300,34200,-4100,1411330,7070.0,지에스리테일보통주
4829,7070,2018-07-03,0.0470588235294117,42500,40500,-2000,313687,7070.0,지에스리테일보통주
4830,7070,2018-06-07,0.0568181818181818,39600,41850,2250,752875,7070.0,지에스리테일보통주
4831,7070,2018-06-04,0.0540897097625329,37900,39950,2050,446848,7070.0,지에스리테일보통주
4832,7070,2018-05-24,0.0507544581618655,36450,38300,1850,306933,7070.0,지에스리테일보통주
4833,7070,2018-05-16,0.0458715596330275,38150,36400,-1750,408966,7070.0,지에스리테일보통주
4834,7070,2018-05-02,0.0793010752688172,37200,40150,2950,1297966,7070.0,지에스리테일보통주
4835,7070,2018-04-30,0.0909090909090909,34100,37200,3100,904035,7070.0,지에스리테일보통주
4836,7070,2018-04-18,0.0474777448071216,33700,35300,1600,193081,7070.0,지에스리테일보통주
4837,7070,2018-04-03,0.0610119047619047,33600,35650,2050,604356,7070.0,지에스리테일보통주
4838,7070,2018-03-30,0.0635179153094462,30700,32650,1950,354700,7070.0,지에스리테일보통주
4839,7070,2018-03-26,0.0453857791225416,33050,31550,-1500,348357,7070.0,지에스리테일보통주
4840,7070,2018-03-09,0.0401188707280832,33650,35000,1350,455305,7070.0,지에스리테일보통주
4841,7070,2018-01-31,0.0453431372549019,40800,38950,-1850,652100,7070.0,지에스리테일보통주
4842,7070,2018-01-09,0.0554838709677419,38750,40900,2150,319511,7070.0,지에스리테일보통주
4843,7070,2017-12-22,0.0528401585204755,37850,39850,2000,318367,7070.0,지에스리테일보통주
4844,7070,2017-12-21,0.0417721518987341,39500,37850,-1650,362101,7070.0,지에스리테일보통주
4845,7070,2017-12-11,0.0496453900709219,42300,40200,-2100,397932,7070.0,지에스리테일보통주
4846,7070,2017-12-05,0.0583941605839416,41100,43500,2400,772748,7070.0,지에스리테일보통주
4847,7070,2017-11-29,0.0602409638554216,37350,39600,2250,1066529,7070.0,지에스리테일보통주
4848,7070,2017-11-20,0.0450704225352112,35500,37100,1600,267018,7070.0,지에스리테일보통주
4849,7070,2017-11-07,0.0672645739910313,33450,35700,2250,1035651,7070.0,지에스리테일보통주
4850,7070,2017-09-01,0.047087980173482,40350,38450,-1900,875431,7070.0,지에스리테일보통주
4851,7070,2017-08-03,0.1495901639344262,48800,41500,-7300,2221068,7070.0,지에스리테일보통주
4852,7070,2017-07-17,0.0616161616161616,49500,46450,-3050,678729,7070.0,지에스리테일보통주
4853,7070,2017-06-12,0.0404929577464788,56800,54500,-2300,337060,7070.0,지에스리테일보통주
4854,7070,2017-05-08,0.0437262357414448,52600,54900,2300,398705,7070.0,지에스리테일보통주
4855,7070,2017-02-10,0.0469667318982387,51100,53500,2400,527343,7070.0,지에스리테일보통주
4856,7070,2017-02-03,0.0400801603206412,49900,51900,2000,347095,7070.0,지에스리테일보통주
4857,7070,2017-02-02,0.0403846153846153,52000,49900,-2100,306836,7070.0,지에스리테일보통주
4858,7070,2016-10-28,0.0609357997823721,45950,48750,2800,614115,7070.0,지에스리테일보통주
4859,7070,2016-09-23,0.0489882854100106,46950,49250,2300,327429,7070.0,지에스리테일보통주
4860,7310,2020-11-11,0.0422018348623853,545000,568000,23000,17622,7310.0,오뚜기보통주
4861,7310,2020-08-28,0.05,580000,609000,29000,12069,7310.0,오뚜기보통주
4862,7310,2020-06-16,0.0491803278688524,549000,576000,27000,7139,7310.0,오뚜기보통주
4863,7310,2020-06-15,0.056701030927835,582000,549000,-33000,12241,7310.0,오뚜기보통주
4864,7310,2020-05-15,0.1029962546816479,534000,589000,55000,33378,7310.0,오뚜기보통주
4865,7310,2020-04-06,0.0749506903353057,507000,545000,38000,17628,7310.0,오뚜기보통주
4866,7310,2020-04-02,0.0455026455026455,472500,494000,21500,7116,7310.0,오뚜기보통주
4867,7310,2020-03-24,0.0551090700344431,435500,459500,24000,6335,7310.0,오뚜기보통주
4868,7310,2020-03-23,0.0593952483801295,463000,435500,-27500,5658,7310.0,오뚜기보통주
4869,7310,2020-03-20,0.0668202764976958,434000,463000,29000,9719,7310.0,오뚜기보통주
4870,7310,2020-03-12,0.0451745379876796,487000,465000,-22000,11914,7310.0,오뚜기보통주
4871,7310,2020-03-04,0.0519877675840978,490500,516000,25500,13686,7310.0,오뚜기보통주
4872,7310,2020-02-25,0.0459558823529411,544000,519000,-25000,15490,7310.0,오뚜기보통주
4873,7310,2020-02-24,0.0625,512000,544000,32000,31966,7310.0,오뚜기보통주
4874,7310,2020-02-06,0.0617529880478087,502000,533000,31000,7062,7310.0,오뚜기보통주
4875,7310,2019-01-04,0.0578512396694214,726000,768000,42000,9335,7310.0,오뚜기보통주
4876,7310,2018-10-24,0.0505359877488514,653000,686000,33000,7244,7310.0,오뚜기보통주
4877,7310,2018-08-14,0.0599769319492502,867000,815000,-52000,5567,7310.0,오뚜기보통주
4878,7310,2018-06-22,0.0475030450669914,821000,860000,39000,6826,7310.0,오뚜기보통주
4879,7310,2018-06-07,0.0520094562647754,846000,890000,44000,13220,7310.0,오뚜기보통주
4880,7310,2018-06-01,0.0580246913580246,810000,857000,47000,21285,7310.0,오뚜기보통주
4881,7310,2018-05-16,0.0495314591700133,747000,784000,37000,7726,7310.0,오뚜기보통주
4882,7310,2018-04-03,0.0407055630936228,737000,767000,30000,13330,7310.0,오뚜기보통주
4883,7310,2018-03-08,0.0680173661360347,691000,738000,47000,15307,7310.0,오뚜기보통주
4884,7310,2017-11-20,0.0468948035487959,789000,826000,37000,22021,7310.0,오뚜기보통주
4885,7310,2017-11-17,0.0492021276595744,752000,789000,37000,17901,7310.0,오뚜기보통주
4886,7310,2017-10-18,0.04,750000,780000,30000,11702,7310.0,오뚜기보통주
4887,7310,2017-07-24,0.07248322147651,745000,799000,54000,53654,7310.0,오뚜기보통주
4888,7310,2017-06-08,0.0409638554216867,830000,864000,34000,20808,7310.0,오뚜기보통주
4889,7310,2017-05-10,0.0405759162303664,764000,795000,31000,13768,7310.0,오뚜기보통주
4890,7310,2017-03-24,0.0514285714285714,700000,736000,36000,12663,7310.0,오뚜기보통주
4891,7310,2017-02-06,0.0991379310344827,696000,765000,69000,29577,7310.0,오뚜기보통주
4892,7310,2017-02-03,0.0403587443946188,669000,696000,27000,15101,7310.0,오뚜기보통주
4893,7310,2016-11-29,0.0438066465256797,662000,691000,29000,5523,7310.0,오뚜기보통주
4894,7310,2016-11-15,0.1083591331269349,646000,716000,70000,16922,7310.0,오뚜기보통주
4895,7310,2016-11-03,0.0666666666666666,615000,656000,41000,6394,7310.0,오뚜기보통주
4896,7310,2016-11-02,0.0450310559006211,644000,615000,-29000,6364,7310.0,오뚜기보통주
4897,7310,2016-09-20,0.0573888091822094,697000,737000,40000,14282,7310.0,오뚜기보통주
4898,7310,2016-09-07,0.0422535211267605,710000,680000,-30000,11695,7310.0,오뚜기보통주
4899,8560,2021-05-24,0.0421052631578947,4275,4455,180,6155259,8560.0,메리츠증권보통주
4900,8560,2021-05-17,0.1383196721311475,4880,4205,-675,16356571,8560.0,메리츠증권보통주
4901,8560,2021-05-06,0.0437100213219616,4690,4895,205,2143595,8560.0,메리츠증권보통주
4902,8560,2021-03-31,0.0429864253393665,4420,4610,190,4074105,8560.0,메리츠증권보통주
4903,8560,2020-12-29,0.0743073047858942,3970,3675,-295,8987901,8560.0,메리츠증권보통주
4904,8560,2020-11-16,0.0461538461538461,3575,3740,165,5973480,8560.0,메리츠증권보통주
4905,8560,2020-08-20,0.0602582496413199,3485,3275,-210,4820465,8560.0,메리츠증권보통주
4906,8560,2020-08-12,0.0419681620839363,3455,3600,145,7962588,8560.0,메리츠증권보통주
4907,8560,2020-08-10,0.044776119402985,3350,3500,150,5735708,8560.0,메리츠증권보통주
4908,8560,2020-08-04,0.1073717948717948,3120,3455,335,10319453,8560.0,메리츠증권보통주
4909,8560,2020-06-25,0.0464396284829721,3230,3080,-150,2788360,8560.0,메리츠증권보통주
4910,8560,2020-06-16,0.0440944881889763,3175,3315,140,2692293,8560.0,메리츠증권보통주
4911,8560,2020-06-15,0.0592592592592592,3375,3175,-200,2962443,8560.0,메리츠증권보통주
4912,8560,2020-06-01,0.0487062404870624,3285,3445,160,2800366,8560.0,메리츠증권보통주
4913,8560,2020-05-29,0.0450581395348837,3440,3285,-155,6007608,8560.0,메리츠증권보통주
4914,8560,2020-05-22,0.0450704225352112,3550,3390,-160,2786246,8560.0,메리츠증권보통주
4915,8560,2020-05-18,0.0578386605783866,3285,3475,190,4150719,8560.0,메리츠증권보통주
4916,8560,2020-04-29,0.0616883116883116,3080,3270,190,6622479,8560.0,메리츠증권보통주
4917,8560,2020-04-17,0.0541958041958041,2860,3015,155,4152343,8560.0,메리츠증권보통주
4918,8560,2020-04-14,0.0427807486631016,2805,2925,120,3565629,8560.0,메리츠증권보통주
4919,8560,2020-04-10,0.0660550458715596,2725,2905,180,6989575,8560.0,메리츠증권보통주
4920,8560,2020-04-03,0.0495412844036697,2725,2590,-135,4515421,8560.0,메리츠증권보통주
4921,8560,2020-04-01,0.0530035335689045,2830,2680,-150,2257775,8560.0,메리츠증권보통주
4922,8560,2020-03-31,0.0404411764705882,2720,2830,110,3151491,8560.0,메리츠증권보통주
4923,8560,2020-03-25,0.0793991416309012,2330,2515,185,7073877,8560.0,메리츠증권보통주
4924,8560,2020-03-24,0.059090909090909,2200,2330,130,4626769,8560.0,메리츠증권보통주
4925,8560,2020-03-23,0.0946502057613168,2430,2200,-230,3098503,8560.0,메리츠증권보통주
4926,8560,2020-03-20,0.1516587677725118,2110,2430,320,3942213,8560.0,메리츠증권보통주
4927,8560,2020-03-19,0.2199630314232902,2705,2110,-595,6081565,8560.0,메리츠증권보통주
4928,8560,2020-03-18,0.0688468158347676,2905,2705,-200,2713096,8560.0,메리츠증권보통주
4929,8560,2020-03-13,0.0660522273425499,3255,3040,-215,4141093,8560.0,메리츠증권보통주
4930,8560,2020-03-12,0.0537790697674418,3440,3255,-185,3040668,8560.0,메리츠증권보통주
4931,8560,2020-03-09,0.0408163265306122,3675,3525,-150,2503832,8560.0,메리츠증권보통주
4932,8560,2020-01-30,0.0573065902578796,3490,3690,200,7267035,8560.0,메리츠증권보통주
4933,8560,2020-01-09,0.0420289855072463,3450,3595,145,2739820,8560.0,메리츠증권보통주
4934,8560,2019-12-27,0.041871921182266,4060,3890,-170,3427975,8560.0,메리츠증권보통주
4935,8560,2019-12-06,0.1107099879663056,4155,3695,-460,11560659,8560.0,메리츠증권보통주
4936,8560,2019-08-27,0.0429645542427497,4655,4855,200,3971330,8560.0,메리츠증권보통주
4937,8560,2019-08-02,0.040281973816717,4965,4765,-200,2116641,8560.0,메리츠증권보통주
4938,8560,2019-07-03,0.0452898550724637,5520,5270,-250,2218799,8560.0,메리츠증권보통주
4939,8560,2019-05-14,0.0521235521235521,5180,4910,-270,6931242,8560.0,메리츠증권보통주
4940,8560,2019-04-01,0.0624360286591606,4885,5190,305,6123261,8560.0,메리츠증권보통주
4941,8560,2019-03-04,0.0402611534276387,4595,4780,185,3679129,8560.0,메리츠증권보통주
4942,8560,2019-02-07,0.0403930131004366,4580,4765,185,3593560,8560.0,메리츠증권보통주
4943,8560,2019-01-02,0.0478971962616822,4280,4075,-205,1925868,8560.0,메리츠증권보통주
4944,8560,2018-11-02,0.0448318804483188,4015,4195,180,3619648,8560.0,메리츠증권보통주
4945,8560,2018-10-22,0.0457516339869281,3825,4000,175,2307997,8560.0,메리츠증권보통주
4946,8560,2018-10-11,0.0408163265306122,3920,3760,-160,2905816,8560.0,메리츠증권보통주
4947,8560,2018-09-11,0.0438709677419354,3875,4045,170,3034191,8560.0,메리츠증권보통주
4948,8560,2018-07-06,0.0411764705882352,3400,3540,140,1897757,8560.0,메리츠증권보통주
4949,8560,2018-05-11,0.0409638554216867,4150,4320,170,4358797,8560.0,메리츠증권보통주
4950,8560,2018-05-04,0.0620347394540942,4030,4280,250,6947361,8560.0,메리츠증권보통주
4951,8560,2018-03-23,0.04903078677309,4385,4170,-215,3841142,8560.0,메리츠증권보통주
4952,8560,2018-03-09,0.0416197975253093,4445,4630,185,4185108,8560.0,메리츠증권보통주
4953,8560,2018-01-23,0.0412573673870334,5090,5300,210,2973132,8560.0,메리츠증권보통주
4954,8560,2018-01-05,0.0533333333333333,4500,4740,240,4804181,8560.0,메리츠증권보통주
4955,8560,2017-11-01,0.0437710437710437,4455,4650,195,3835676,8560.0,메리츠증권보통주
4956,8560,2017-10-12,0.0493827160493827,4455,4675,220,6119652,8560.0,메리츠증권보통주
4957,8560,2017-09-18,0.06,4500,4770,270,4055596,8560.0,메리츠증권보통주
4958,8560,2017-08-03,0.0810313075506445,5430,4990,-440,6549390,8560.0,메리츠증권보통주
4959,8560,2017-06-29,0.0661070304302203,4765,5080,315,13292092,8560.0,메리츠증권보통주
4960,8560,2017-06-09,0.0467391304347826,4600,4815,215,4703146,8560.0,메리츠증권보통주
4961,8560,2017-05-29,0.0842992623814541,4745,4345,-400,12497193,8560.0,메리츠증권보통주
4962,8560,2017-05-11,0.0432242990654205,4280,4465,185,5501952,8560.0,메리츠증권보통주
4963,8560,2016-12-28,0.0619946091644204,3710,3480,-230,5840903,8560.0,메리츠증권보통주
4964,8560,2016-12-15,0.0550070521861777,3545,3740,195,7269418,8560.0,메리츠증권보통주
4965,8560,2016-11-10,0.0582959641255605,3345,3540,195,3878064,8560.0,메리츠증권보통주
4966,8560,2016-10-14,0.0497076023391812,3420,3590,170,9412637,8560.0,메리츠증권보통주
4967,8770,2021-05-31,0.042094455852156,97400,101500,4100,1199756,8770.0,호텔신라보통주
4968,8770,2021-05-26,0.0458422174840085,93800,98100,4300,1736088,8770.0,호텔신라보통주
4969,8770,2021-03-15,0.0405727923627685,83800,87200,3400,1855348,8770.0,호텔신라보통주
4970,8770,2020-12-09,0.040590405904059,81300,84600,3300,1584583,8770.0,호텔신라보통주
4971,8770,2020-11-10,0.0581241743725231,75700,80100,4400,3178169,8770.0,호텔신라보통주
4972,8770,2020-09-02,0.0455172413793103,72500,75800,3300,1333521,8770.0,호텔신라보통주
4973,8770,2020-08-18,0.0925221799746514,78900,71600,-7300,1522556,8770.0,호텔신라보통주
4974,8770,2020-08-12,0.0662068965517241,72500,77300,4800,2874821,8770.0,호텔신라보통주
4975,8770,2020-06-30,0.0757575757575757,66000,71000,5000,3299832,8770.0,호텔신라보통주
4976,8770,2020-06-15,0.0547588005215123,76700,72500,-4200,830788,8770.0,호텔신라보통주
4977,8770,2020-05-19,0.0475594493116395,79900,83700,3800,1320419,8770.0,호텔신라보통주
4978,8770,2020-04-28,0.0485933503836317,78200,82000,3800,1661552,8770.0,호텔신라보통주
4979,8770,2020-04-17,0.048582995951417,74100,77700,3600,1671138,8770.0,호텔신라보통주
4980,8770,2020-04-07,0.0455192034139402,70300,73500,3200,1121802,8770.0,호텔신라보통주
4981,8770,2020-04-06,0.0492537313432835,67000,70300,3300,805194,8770.0,호텔신라보통주
4982,8770,2020-04-01,0.0411347517730496,70500,67600,-2900,718939,8770.0,호텔신라보통주
4983,8770,2020-03-25,0.1018518518518518,64800,71400,6600,1246474,8770.0,호텔신라보통주
4984,8770,2020-03-24,0.0485436893203883,61800,64800,3000,885966,8770.0,호텔신라보통주
4985,8770,2020-03-23,0.087149187592319,67700,61800,-5900,735001,8770.0,호텔신라보통주
4986,8770,2020-03-20,0.0746031746031746,63000,67700,4700,835080,8770.0,호텔신라보통주
4987,8770,2020-03-19,0.0961262553802008,69700,63000,-6700,1094365,8770.0,호텔신라보통주
4988,8770,2020-03-18,0.0581081081081081,74000,69700,-4300,1270816,8770.0,호텔신라보통주
4989,8770,2020-03-17,0.0481586402266288,70600,74000,3400,923565,8770.0,호텔신라보통주
4990,8770,2020-03-16,0.0599201065246338,75100,70600,-4500,755600,8770.0,호텔신라보통주
4991,8770,2020-03-13,0.0493670886075949,79000,75100,-3900,1613653,8770.0,호텔신라보통주
4992,8770,2020-03-10,0.0432098765432098,81000,84500,3500,813711,8770.0,호텔신라보통주
4993,8770,2020-03-04,0.0402439024390243,82000,85300,3300,595455,8770.0,호텔신라보통주
4994,8770,2020-02-28,0.0429082240762812,83900,80300,-3600,1041668,8770.0,호텔신라보통주
4995,8770,2020-02-24,0.0562429696287964,88900,83900,-5000,1047798,8770.0,호텔신라보통주
4996,8770,2020-02-12,0.0562770562770562,92400,97600,5200,1076967,8770.0,호텔신라보통주
4997,8770,2020-02-06,0.0674157303370786,89000,95000,6000,1166680,8770.0,호텔신라보통주
4998,8770,2020-01-28,0.1030927835051546,97000,87000,-10000,2383525,8770.0,호텔신라보통주
4999,8770,2020-01-20,0.0506912442396313,108500,103000,-5500,1168346,8770.0,호텔신라보통주
5000,8770,2020-01-07,0.0474183350895679,94900,99400,4500,736235,8770.0,호텔신라보통주
5001,8770,2019-12-30,0.0400916380297823,87300,90800,3500,726313,8770.0,호텔신라보통주
5002,8770,2019-12-27,0.0417661097852028,83800,87300,3500,553933,8770.0,호텔신라보통주
5003,8770,2019-11-06,0.0476787954830614,79700,83500,3800,1049659,8770.0,호텔신라보통주
5004,8770,2019-10-30,0.0439414114513981,75100,78400,3300,919970,8770.0,호텔신라보통주
5005,8770,2019-10-28,0.04630788485607,79900,76200,-3700,1085951,8770.0,호텔신라보통주
5006,8770,2019-10-01,0.0429234338747099,86200,82500,-3700,653709,8770.0,호텔신라보통주
5007,8770,2019-09-03,0.0583756345177665,78800,83400,4600,1093997,8770.0,호텔신라보통주
5008,8770,2019-08-29,0.0446194225721784,76200,79600,3400,1192725,8770.0,호텔신라보통주
5009,8770,2019-08-08,0.0522088353413654,74700,78600,3900,538608,8770.0,호텔신라보통주
5010,8770,2019-08-06,0.0468948035487959,78900,75200,-3700,751155,8770.0,호텔신라보통주
5011,8770,2019-07-29,0.0432172869147659,83300,79700,-3600,759098,8770.0,호텔신라보통주
5012,8770,2019-07-08,0.04,90000,86400,-3600,517045,8770.0,호텔신라보통주
5013,8770,2019-07-02,0.060790273556231,98700,92700,-6000,1156447,8770.0,호텔신라보통주
5014,8770,2019-06-21,0.0519607843137254,102000,96700,-5300,1036507,8770.0,호텔신라보통주
5015,8770,2019-06-19,0.0478128179043743,98300,103000,4700,557754,8770.0,호텔신라보통주
5016,8770,2019-06-04,0.0432489451476793,94800,90700,-4100,817996,8770.0,호텔신라보통주
5017,8770,2019-05-23,0.0611835506519558,99700,93600,-6100,936540,8770.0,호텔신라보통주
5018,8770,2019-05-15,0.0473933649289099,105500,100500,-5000,1373470,8770.0,호텔신라보통주
5019,8770,2019-05-13,0.0688073394495412,109000,101500,-7500,812571,8770.0,호텔신라보통주
5020,8770,2019-05-10,0.0430622009569378,104500,109000,4500,791825,8770.0,호텔신라보통주
5021,8770,2019-05-09,0.045662100456621,109500,104500,-5000,753620,8770.0,호텔신라보통주
5022,8770,2019-04-29,0.041860465116279,107500,112000,4500,740348,8770.0,호텔신라보통주
5023,8770,2019-04-09,0.0478128179043743,98300,103000,4700,864936,8770.0,호텔신라보통주
5024,8770,2019-04-04,0.0495156081808396,92900,97500,4600,994923,8770.0,호텔신라보통주
5025,8770,2019-03-18,0.0733104238258877,87300,93700,6400,1914249,8770.0,호텔신라보통주
5026,8770,2019-03-15,0.0530759951749095,82900,87300,4400,1176116,8770.0,호텔신라보통주
5027,8770,2019-03-07,0.0521091811414392,80600,84800,4200,1231286,8770.0,호텔신라보통주
5028,8770,2019-02-20,0.0444726810673443,78700,82200,3500,1548212,8770.0,호텔신라보통주
5029,8770,2019-02-08,0.0403645833333333,76800,73700,-3100,975776,8770.0,호텔신라보통주
5030,8770,2019-01-28,0.0554870530209617,81100,76600,-4500,1824331,8770.0,호텔신라보통주
5031,8770,2019-01-25,0.0410783055198973,77900,81100,3200,1172736,8770.0,호텔신라보통주
5032,8770,2019-01-14,0.0667613636363636,70400,75100,4700,1852458,8770.0,호텔신라보통주
5033,8770,2019-01-02,0.0444444444444444,76500,73100,-3400,666916,8770.0,호텔신라보통주
5034,8770,2018-12-27,0.0496551724137931,72500,76100,3600,857814,8770.0,호텔신라보통주
5035,8770,2018-12-06,0.0742924528301886,84800,78500,-6300,1073993,8770.0,호텔신라보통주
5036,8770,2018-11-15,0.1295546558704453,74100,83700,9600,2433830,8770.0,호텔신라보통주
5037,8770,2018-11-09,0.049673202614379,76500,72700,-3800,1241548,8770.0,호텔신라보통주
5038,8770,2018-11-02,0.0865384615384615,72800,79100,6300,1002692,8770.0,호텔신라보통주
5039,8770,2018-10-26,0.0621761658031088,77200,72400,-4800,1231409,8770.0,호텔신라보통주
5040,8770,2018-10-15,0.0434285714285714,87500,83700,-3800,472235,8770.0,호텔신라보통주
5041,8770,2018-10-12,0.0644768856447688,82200,87500,5300,896671,8770.0,호텔신라보통주
5042,8770,2018-10-11,0.0648464163822525,87900,82200,-5700,1380635,8770.0,호텔신라보통주
5043,8770,2018-10-10,0.0466377440347071,92200,87900,-4300,936866,8770.0,호텔신라보통주
5044,8770,2018-10-04,0.0751219512195121,102500,94800,-7700,1699004,8770.0,호텔신라보통주
5045,8770,2018-10-02,0.0509259259259259,108000,102500,-5500,538215,8770.0,호텔신라보통주
5046,8770,2018-09-27,0.0430622009569378,104500,109000,4500,536308,8770.0,호텔신라보통주
5047,8770,2018-08-23,0.055,100000,105500,5500,795345,8770.0,호텔신라보통주
5048,8770,2018-08-20,0.0411764705882352,102000,97800,-4200,506303,8770.0,호텔신라보통주
5049,8770,2018-08-13,0.048780487804878,102500,97500,-5000,617841,8770.0,호텔신라보통주
5050,8770,2018-08-10,0.0420560747663551,107000,102500,-4500,426581,8770.0,호텔신라보통주
5051,8770,2018-08-01,0.0721442885771543,99800,107000,7200,913356,8770.0,호텔신라보통주
5052,8770,2018-07-24,0.0723684210526315,91200,97800,6600,841272,8770.0,호텔신라보통주
5053,8770,2018-07-19,0.0876847290640394,101500,92600,-8900,1572519,8770.0,호텔신라보통주
5054,8770,2018-07-09,0.1111111111111111,112500,100000,-12500,1606714,8770.0,호텔신라보통주
5055,8770,2018-07-06,0.0416666666666666,108000,112500,4500,470618,8770.0,호텔신라보통주
5056,8770,2018-07-03,0.0630252100840336,119000,111500,-7500,1509731,8770.0,호텔신라보통주
5057,8770,2018-06-26,0.0530612244897959,122500,116000,-6500,535876,8770.0,호텔신라보통주
5058,8770,2018-06-18,0.0436507936507936,126000,120500,-5500,393753,8770.0,호텔신라보통주
5059,8770,2018-06-15,0.0454545454545454,132000,126000,-6000,412576,8770.0,호텔신라보통주
5060,8770,2018-05-25,0.0470588235294117,127500,121500,-6000,411479,8770.0,호텔신라보통주
5061,8770,2018-05-24,0.0537190082644628,121000,127500,6500,515366,8770.0,호텔신라보통주
5062,8770,2018-04-30,0.0497737556561085,110500,116000,5500,855646,8770.0,호텔신라보통주
5063,8770,2018-04-13,0.04,100000,104000,4000,337139,8770.0,호텔신라보통주
5064,8770,2018-04-12,0.0476190476190476,105000,100000,-5000,577677,8770.0,호텔신라보통주
5065,8770,2018-04-02,0.0636079249217935,95900,102000,6100,1037147,8770.0,호텔신라보통주
5066,8770,2018-03-30,0.042391304347826,92000,95900,3900,493183,8770.0,호텔신라보통주
5067,8770,2018-03-26,0.0437710437710437,89100,93000,3900,437682,8770.0,호텔신라보통주
5068,8770,2018-03-09,0.1081730769230769,83200,92200,9000,1628652,8770.0,호텔신라보통주
5069,8770,2018-02-09,0.040983606557377,85400,81900,-3500,334811,8770.0,호텔신라보통주
5070,8770,2018-02-07,0.0759776536312849,89500,82700,-6800,644330,8770.0,호텔신라보통주
5071,8770,2018-02-05,0.0501567398119122,95700,90900,-4800,495651,8770.0,호텔신라보통주
5072,8770,2018-02-01,0.0440860215053763,93000,97100,4100,546926,8770.0,호텔신라보통주
5073,8770,2018-01-09,0.0577149587750294,84900,89800,4900,913864,8770.0,호텔신라보통주
5074,8770,2017-12-12,0.0550996483001172,85300,80600,-4700,931748,8770.0,호텔신라보통주
5075,8770,2017-11-20,0.063960639606396,81300,86500,5200,998332,8770.0,호텔신라보통주
5076,8770,2017-10-30,0.0927246790299572,70100,76600,6500,2075860,8770.0,호텔신라보통주
5077,8770,2017-10-26,0.0860719874804381,63900,69400,5500,1848902,8770.0,호텔신라보통주
5078,8770,2017-10-13,0.0637931034482758,58000,61700,3700,841337,8770.0,호텔신라보통주
5079,8770,2017-09-28,0.0441176470588235,54400,56800,2400,566251,8770.0,호텔신라보통주
5080,8770,2017-07-26,0.0793388429752066,60500,65300,4800,2300303,8770.0,호텔신라보통주
5081,8770,2017-07-17,0.0415913200723327,55300,57600,2300,484711,8770.0,호텔신라보통주
5082,8770,2017-07-12,0.078095238095238,52500,56600,4100,996194,8770.0,호텔신라보통주
5083,8770,2017-06-13,0.0415973377703826,60100,57600,-2500,1042301,8770.0,호텔신라보통주
5084,8770,2017-05-17,0.04631217838765,58300,61000,2700,1169854,8770.0,호텔신라보통주
5085,8770,2017-05-04,0.0520231213872832,51900,54600,2700,794215,8770.0,호텔신라보통주
5086,8770,2017-04-21,0.0458891013384321,52300,54700,2400,1514485,8770.0,호텔신라보통주
5087,8770,2017-04-17,0.07465825446898,47550,51100,3550,1438793,8770.0,호텔신라보통주
5088,8770,2017-04-03,0.0421286031042128,45100,47000,1900,927726,8770.0,호텔신라보통주
5089,8770,2017-03-03,0.1309523809523809,50400,43800,-6600,3051489,8770.0,호텔신라보통주
5090,8770,2017-02-23,0.0596707818930041,48600,51500,2900,2481442,8770.0,호텔신라보통주
5091,8770,2017-01-26,0.0456026058631921,46050,43950,-2100,1087281,8770.0,호텔신라보통주
5092,8770,2017-01-19,0.0474716202270381,48450,46150,-2300,669530,8770.0,호텔신라보통주
5093,8770,2016-12-19,0.044378698224852,50700,48450,-2250,830048,8770.0,호텔신라보통주
5094,8770,2016-11-21,0.0416666666666666,52800,50600,-2200,406013,8770.0,호텔신라보통주
5095,8770,2016-11-10,0.0466019417475728,51500,53900,2400,332158,8770.0,호텔신라보통주
5096,8770,2016-11-02,0.0562613430127041,55100,52000,-3100,646147,8770.0,호텔신라보통주
5097,8770,2016-10-25,0.0693548387096774,62000,57700,-4300,1442578,8770.0,호텔신라보통주
5098,8930,2021-05-27,0.0429629629629629,67500,70400,2900,237834,8930.0,한미사이언스보통주
5099,8930,2021-05-24,0.0472103004291845,69900,66600,-3300,233219,8930.0,한미사이언스보통주
5100,8930,2021-05-18,0.0760059612518628,67100,72200,5100,1069689,8930.0,한미사이언스보통주
5101,8930,2021-05-14,0.1060402684563758,74500,66600,-7900,720625,8930.0,한미사이언스보통주
5102,8930,2021-05-13,0.0567375886524822,70500,74500,4000,596471,8930.0,한미사이언스보통주
5103,8930,2021-05-07,0.0494011976047904,66800,70100,3300,265781,8930.0,한미사이언스보통주
5104,8930,2021-05-03,0.0534682080924855,69200,65500,-3700,294007,8930.0,한미사이언스보통주
5105,8930,2021-04-22,0.0418353576248313,74100,71000,-3100,384974,8930.0,한미사이언스보통주
5106,8930,2021-04-21,0.0739130434782608,69000,74100,5100,1070244,8930.0,한미사이언스보통주
5107,8930,2021-04-19,0.0798122065727699,63900,69000,5100,949271,8930.0,한미사이언스보통주
5108,8930,2021-04-15,0.0794701986754966,60400,65200,4800,1847822,8930.0,한미사이언스보통주
5109,8930,2021-04-07,0.0426287744227353,56300,58700,2400,159851,8930.0,한미사이언스보통주
5110,8930,2021-03-02,0.0527131782945736,64500,61100,-3400,384911,8930.0,한미사이언스보통주
5111,8930,2021-02-25,0.0508744038155802,62900,66100,3200,172810,8930.0,한미사이언스보통주
5112,8930,2021-02-17,0.0562248995983935,74700,70500,-4200,335397,8930.0,한미사이언스보통주
5113,8930,2021-01-29,0.0539906103286385,85200,80600,-4600,311776,8930.0,한미사이언스보통주
5114,8930,2021-01-25,0.0534351145038167,78600,82800,4200,487627,8930.0,한미사이언스보통주
5115,8930,2021-01-20,0.0570291777188328,75400,79700,4300,780318,8930.0,한미사이언스보통주
5116,8930,2021-01-18,0.0598726114649681,78500,73800,-4700,286046,8930.0,한미사이언스보통주
5117,8930,2021-01-12,0.0439560439560439,81900,78300,-3600,447200,8930.0,한미사이언스보통주
5118,8930,2021-01-08,0.0629834254143646,90500,84800,-5700,779077,8930.0,한미사이언스보통주
5119,8930,2021-01-07,0.0710059171597633,84500,90500,6000,1937708,8930.0,한미사이언스보통주
5120,8930,2021-01-06,0.0974025974025974,77000,84500,7500,3809822,8930.0,한미사이언스보통주
5121,8930,2020-12-29,0.1088235294117647,68000,74100,6100,1252112,8930.0,한미사이언스보통주
5122,8930,2020-12-22,0.0481283422459893,74800,71200,-3600,326958,8930.0,한미사이언스보통주
5123,8930,2020-12-11,0.0425824175824175,72800,75900,3100,916991,8930.0,한미사이언스보통주
5124,8930,2020-12-08,0.1402298850574712,87000,74800,-12200,2325917,8930.0,한미사이언스보통주
5125,8930,2020-12-07,0.1269430051813471,77200,87000,9800,2809066,8930.0,한미사이언스보통주
5126,8930,2020-12-04,0.0981507823613086,70300,77200,6900,2316057,8930.0,한미사이언스보통주
5127,8930,2020-11-30,0.0700152207001522,65700,70300,4600,1975619,8930.0,한미사이언스보통주
5128,8930,2020-11-27,0.1116751269035533,59100,65700,6600,1871463,8930.0,한미사이언스보통주
5129,8930,2020-11-26,0.0478723404255319,56400,59100,2700,2733199,8930.0,한미사이언스보통주
5130,8930,2020-11-18,0.0617977528089887,53400,56700,3300,458376,8930.0,한미사이언스보통주
5131,8930,2020-10-30,0.0431654676258992,55600,53200,-2400,191848,8930.0,한미사이언스보통주
5132,8930,2020-10-26,0.0453808752025931,61700,58900,-2800,270454,8930.0,한미사이언스보통주
5133,8930,2020-10-23,0.0511073253833049,58700,61700,3000,449282,8930.0,한미사이언스보통주
5134,8930,2020-10-16,0.0696428571428571,56000,59900,3900,314056,8930.0,한미사이언스보통주
5135,8930,2020-09-29,0.0671506352087114,55100,58800,3700,540935,8930.0,한미사이언스보통주
5136,8930,2020-09-24,0.0602189781021897,54800,51500,-3300,236407,8930.0,한미사이언스보통주
5137,8930,2020-09-22,0.0442176870748299,58800,56200,-2600,218358,8930.0,한미사이언스보통주
5138,8930,2020-08-27,0.055,60000,56700,-3300,391973,8930.0,한미사이언스보통주
5139,8930,2020-08-25,0.0749128919860627,57400,61700,4300,907095,8930.0,한미사이언스보통주
5140,8930,2020-08-18,0.0916271721958925,63300,57500,-5800,699055,8930.0,한미사이언스보통주
5141,8930,2020-08-13,0.0445151033386327,62900,65700,2800,1069341,8930.0,한미사이언스보통주
5142,8930,2020-08-10,0.0445468509984639,65100,62200,-2900,3286285,8930.0,한미사이언스보통주
5143,8930,2020-08-06,0.1114245416078984,70900,63000,-7900,955942,8930.0,한미사이언스보통주
5144,8930,2020-08-05,0.2985347985347985,54600,70900,16300,526200,8930.0,한미사이언스보통주
5145,8930,2020-08-04,0.1075050709939148,49300,54600,5300,6240654,8930.0,한미사이언스보통주
5146,8930,2020-08-03,0.1682464454976303,42200,49300,7100,5989647,8930.0,한미사이언스보통주
5147,8930,2020-07-29,0.0941558441558441,46200,41850,-4350,2501803,8930.0,한미사이언스보통주
5148,8930,2020-07-28,0.2995780590717299,35550,46200,10650,5604461,8930.0,한미사이언스보통주
5149,8930,2020-06-29,0.0423728813559322,35400,33900,-1500,198495,8930.0,한미사이언스보통주
5150,8930,2020-06-19,0.0523627075351213,39150,37100,-2050,470556,8930.0,한미사이언스보통주
5151,8930,2020-06-17,0.0611111111111111,36000,38200,2200,980017,8930.0,한미사이언스보통주
5152,8930,2020-06-16,0.0650887573964497,33800,36000,2200,873943,8930.0,한미사이언스보통주
5153,8930,2020-06-12,0.0518731988472622,34700,32900,-1800,271214,8930.0,한미사이언스보통주
5154,8930,2020-06-05,0.116554054054054,29600,33050,3450,925171,8930.0,한미사이언스보통주
5155,8930,2020-05-14,0.0942148760330578,30250,27400,-2850,575243,8930.0,한미사이언스보통주
5156,8930,2020-04-23,0.0461254612546125,27100,28350,1250,124409,8930.0,한미사이언스보통주
5157,8930,2020-04-07,0.0412757973733583,26650,27750,1100,208767,8930.0,한미사이언스보통주
5158,8930,2020-04-01,0.0538033395176252,26950,25500,-1450,178348,8930.0,한미사이언스보통주
5159,8930,2020-03-31,0.0506822612085769,25650,26950,1300,201080,8930.0,한미사이언스보통주
5160,8930,2020-03-30,0.046938775510204,24500,25650,1150,137820,8930.0,한미사이언스보통주
5161,8930,2020-03-25,0.0868544600938967,21300,23150,1850,237168,8930.0,한미사이언스보통주
5162,8930,2020-03-24,0.0895140664961636,19550,21300,1750,206427,8930.0,한미사이언스보통주
5163,8930,2020-03-23,0.0623501199040767,20850,19550,-1300,193923,8930.0,한미사이언스보통주
5164,8930,2020-03-19,0.1711340206185567,24250,20100,-4150,259625,8930.0,한미사이언스보통주
5165,8930,2020-03-18,0.0545808966861598,25650,24250,-1400,148478,8930.0,한미사이언스보통주
5166,8930,2020-03-13,0.0649819494584837,27700,25900,-1800,243601,8930.0,한미사이언스보통주
5167,8930,2020-03-12,0.0766666666666666,30000,27700,-2300,279002,8930.0,한미사이언스보통주
5168,8930,2020-03-05,0.0802568218298555,31150,33650,2500,165975,8930.0,한미사이언스보통주
5169,8930,2020-02-28,0.0419354838709677,31000,29700,-1300,193529,8930.0,한미사이언스보통주
5170,8930,2020-02-24,0.0619195046439628,32300,30300,-2000,185025,8930.0,한미사이언스보통주
5171,8930,2020-02-06,0.0540958268933539,32350,34100,1750,124891,8930.0,한미사이언스보통주
5172,8930,2020-01-28,0.0430555555555555,36000,34450,-1550,166895,8930.0,한미사이언스보통주
5173,8930,2020-01-08,0.0455764075067024,37300,35600,-1700,210042,8930.0,한미사이언스보통주
5174,8930,2019-12-30,0.0421195652173913,36800,38350,1550,95436,8930.0,한미사이언스보통주
5175,8930,2019-12-10,0.0457433290978398,39350,37550,-1800,360958,8930.0,한미사이언스보통주
5176,8930,2019-10-23,0.0481481481481481,40500,42450,1950,273819,8930.0,한미사이언스보통주
5177,8930,2019-10-07,0.0568181818181818,39600,41850,2250,167748,8930.0,한미사이언스보통주
5178,8930,2019-10-01,0.0467171717171717,39600,41450,1850,109361,8930.0,한미사이언스보통주
5179,8930,2019-09-17,0.075268817204301,41850,45000,3150,223866,8930.0,한미사이언스보통주
5180,8930,2019-08-09,0.0411622276029055,41300,43000,1700,102309,8930.0,한미사이언스보통주
5181,8930,2019-08-05,0.0745272525027808,44950,41600,-3350,137600,8930.0,한미사이언스보통주
5182,8930,2019-07-04,0.276957163958641,67700,48950,-18750,906389,8930.0,한미사이언스보통주
5183,8930,2019-05-09,0.044959128065395,73400,70100,-3300,67867,8930.0,한미사이언스보통주
5184,8930,2018-11-13,0.0434782608695652,66700,69600,2900,71659,8930.0,한미사이언스보통주
5185,8930,2018-11-02,0.04047976011994,66700,69400,2700,72246,8930.0,한미사이언스보통주
5186,8930,2018-10-26,0.0518934081346423,71300,67600,-3700,86247,8930.0,한미사이언스보통주
5187,8930,2018-10-23,0.0663129973474801,75400,70400,-5000,133323,8930.0,한미사이언스보통주
5188,8930,2018-10-11,0.0417193426042983,79100,75800,-3300,98556,8930.0,한미사이언스보통주
5189,8930,2018-10-01,0.0546697038724373,87800,83000,-4800,140484,8930.0,한미사이언스보통주
5190,8930,2018-09-27,0.0504939626783754,91100,86500,-4600,247744,8930.0,한미사이언스보통주
5191,8930,2018-08-13,0.0414507772020725,77200,74000,-3200,144316,8930.0,한미사이언스보통주
5192,8930,2018-08-06,0.0432960893854748,71600,74700,3100,184317,8930.0,한미사이언스보통주
5193,8930,2018-07-25,0.0416666666666666,69600,66700,-2900,109625,8930.0,한미사이언스보통주
5194,8930,2018-07-11,0.04,70000,67200,-2800,107382,8930.0,한미사이언스보통주
5195,8930,2018-07-04,0.0588235294117647,62900,66600,3700,137026,8930.0,한미사이언스보통주
5196,8930,2018-06-19,0.0483383685800604,66200,63000,-3200,144249,8930.0,한미사이언스보통주
5197,8930,2018-05-09,0.0636237897648686,72300,76900,4600,107534,8930.0,한미사이언스보통주
5198,8930,2018-04-23,0.048926014319809,83800,79700,-4100,163268,8930.0,한미사이언스보통주
5199,8930,2018-04-12,0.0414507772020725,96500,92500,-4000,142608,8930.0,한미사이언스보통주
5200,8930,2018-04-10,0.0452099031216361,92900,97100,4200,229155,8930.0,한미사이언스보통주
5201,8930,2018-03-12,0.0634201585503963,88300,93900,5600,217362,8930.0,한미사이언스보통주
5202,8930,2018-02-28,0.0486976217440543,88300,84000,-4300,171785,8930.0,한미사이언스보통주
5203,8930,2018-02-19,0.0867724867724867,94500,86300,-8200,555431,8930.0,한미사이언스보통주
5204,8930,2018-02-05,0.0647058823529411,102000,95400,-6600,185920,8930.0,한미사이언스보통주
5205,8930,2018-01-04,0.0436681222707423,114500,109500,-5000,146833,8930.0,한미사이언스보통주
5206,8930,2017-12-22,0.0430622009569378,104500,109000,4500,133451,8930.0,한미사이언스보통주
5207,8930,2017-12-11,0.0571428571428571,105000,111000,6000,121575,8930.0,한미사이언스보통주
5208,8930,2017-11-30,0.0460251046025104,119500,114000,-5500,272905,8930.0,한미사이언스보통주
5209,8930,2017-11-22,0.0550847457627118,118000,111500,-6500,394975,8930.0,한미사이언스보통주
5210,8930,2017-11-17,0.0495867768595041,121000,115000,-6000,491976,8930.0,한미사이언스보통주
5211,8930,2017-11-15,0.214139344262295,97600,118500,20900,2251419,8930.0,한미사이언스보통주
5212,8930,2017-10-19,0.0587002096436058,95400,101000,5600,739923,8930.0,한미사이언스보통주
5213,8930,2017-10-12,0.0448087431693989,91500,95600,4100,416800,8930.0,한미사이언스보통주
5214,8930,2017-09-19,0.0534698521046643,87900,92600,4700,426833,8930.0,한미사이언스보통주
5215,8930,2017-08-28,0.043132803632236,88100,91900,3800,541069,8930.0,한미사이언스보통주
5216,8930,2017-08-18,0.0781841109709962,79300,85500,6200,302712,8930.0,한미사이언스보통주
5217,8930,2017-08-07,0.0506493506493506,77000,80900,3900,159692,8930.0,한미사이언스보통주
5218,8930,2017-08-03,0.056580565805658,81300,76700,-4600,324896,8930.0,한미사이언스보통주
5219,8930,2017-07-28,0.04627539503386,88600,84500,-4100,244508,8930.0,한미사이언스보통주
5220,8930,2017-06-30,0.0409090909090909,88000,84400,-3600,431408,8930.0,한미사이언스보통주
5221,8930,2017-06-28,0.0568060021436227,93300,88000,-5300,522058,8930.0,한미사이언스보통주
5222,8930,2017-06-20,0.052518756698821,93300,88400,-4900,669999,8930.0,한미사이언스보통주
5223,8930,2017-06-16,0.0925553319919517,99400,90200,-9200,1133894,8930.0,한미사이언스보통주
5224,8930,2017-06-13,0.0971098265895953,86500,94900,8400,787830,8930.0,한미사이언스보통주
5225,8930,2017-06-09,0.0545454545454545,82500,87000,4500,693653,8930.0,한미사이언스보통주
5226,8930,2017-06-08,0.0590500641848523,77900,82500,4600,559241,8930.0,한미사이언스보통주
5227,8930,2017-05-31,0.0586552217453505,69900,74000,4100,553801,8930.0,한미사이언스보통주
5228,8930,2017-05-11,0.0576631259484066,65900,69700,3800,693539,8930.0,한미사이언스보통주
5229,8930,2017-05-08,0.0741350906095551,60700,65200,4500,878564,8930.0,한미사이언스보통주
5230,8930,2017-02-27,0.040880503144654,63600,66200,2600,339302,8930.0,한미사이언스보통주
5231,8930,2017-02-07,0.0451505016722408,59800,62500,2700,254833,8930.0,한미사이언스보통주
5232,8930,2017-01-20,0.0484429065743944,57800,60600,2800,324318,8930.0,한미사이언스보통주
5233,8930,2017-01-13,0.0412186379928315,55800,58100,2300,347925,8930.0,한미사이언스보통주
5234,8930,2017-01-02,0.072013093289689,61100,56700,-4400,353721,8930.0,한미사이언스보통주
5235,8930,2016-12-29,0.1132075471698113,68900,61100,-7800,747580,8930.0,한미사이언스보통주
5236,8930,2016-12-26,0.0467289719626168,64200,67200,3000,234835,8930.0,한미사이언스보통주
5237,8930,2016-12-23,0.0456026058631921,61400,64200,2800,202421,8930.0,한미사이언스보통주
5238,8930,2016-12-07,0.1483050847457627,70800,60300,-10500,1809192,8930.0,한미사이언스보통주
5239,8930,2016-11-25,0.0566572237960339,70600,74600,4000,233737,8930.0,한미사이언스보통주
5240,8930,2016-11-23,0.0450204638472032,73300,70000,-3300,214121,8930.0,한미사이언스보통주
5241,8930,2016-11-10,0.1725067385444744,74200,87000,12800,654708,8930.0,한미사이언스보통주
5242,8930,2016-11-09,0.0487179487179487,78000,74200,-3800,311369,8930.0,한미사이언스보통주
5243,8930,2016-11-03,0.0551626591230551,70700,74600,3900,223943,8930.0,한미사이언스보통주
5244,8930,2016-11-02,0.0497311827956989,74400,70700,-3700,208936,8930.0,한미사이언스보통주
5245,8930,2016-10-31,0.0415617128463476,79400,76100,-3300,304775,8930.0,한미사이언스보통주
5246,8930,2016-10-28,0.0691676436107854,85300,79400,-5900,236129,8930.0,한미사이언스보통주
5247,8930,2016-10-25,0.0456100342075256,87700,83700,-4000,205757,8930.0,한미사이언스보통주
5248,8930,2016-10-10,0.0478781284004352,91900,96300,4400,299448,8930.0,한미사이언스보통주
5249,8930,2016-10-07,0.0688956433637284,98700,91900,-6800,644455,8930.0,한미사이언스보통주
5250,8930,2016-10-04,0.0833333333333333,114000,104500,-9500,1266560,8930.0,한미사이언스보통주
5251,8930,2016-09-30,0.1827956989247312,139500,114000,-25500,1862415,8930.0,한미사이언스보통주
5252,8930,2016-09-20,0.0424710424710424,129500,135000,5500,194723,8930.0,한미사이언스보통주
5253,8930,2016-08-23,0.044776119402985,134000,140000,6000,141576,8930.0,한미사이언스보통주
5254,9150,2021-05-12,0.0625,176000,165000,-11000,1978102,9150.0,삼성전기보통주
5255,9150,2021-03-02,0.0633245382585752,189500,201500,12000,1104639,9150.0,삼성전기보통주
5256,9150,2021-01-19,0.0481012658227848,197500,207000,9500,948876,9150.0,삼성전기보통주
5257,9150,2021-01-13,0.0544041450777202,193000,203500,10500,2946385,9150.0,삼성전기보통주
5258,9150,2021-01-08,0.0604395604395604,182000,193000,11000,1490294,9150.0,삼성전기보통주
5259,9150,2020-12-29,0.0567164179104477,167500,177000,9500,1167680,9150.0,삼성전기보통주
5260,9150,2020-11-13,0.048780487804878,143500,150500,7000,1730367,9150.0,삼성전기보통주
5261,9150,2020-08-20,0.0708955223880597,134000,124500,-9500,1028248,9150.0,삼성전기보통주
5262,9150,2020-07-28,0.0471014492753623,138000,144500,6500,1373437,9150.0,삼성전기보통주
5263,9150,2020-07-22,0.0402930402930402,136500,142000,5500,1750571,9150.0,삼성전기보통주
5264,9150,2020-07-21,0.0419847328244274,131000,136500,5500,1092107,9150.0,삼성전기보통주
5265,9150,2020-06-16,0.064516129032258,124000,132000,8000,768348,9150.0,삼성전기보통주
5266,9150,2020-06-15,0.0570342205323193,131500,124000,-7500,769516,9150.0,삼성전기보통주
5267,9150,2020-06-10,0.0428015564202334,128500,134000,5500,1293070,9150.0,삼성전기보통주
5268,9150,2020-05-06,0.045662100456621,109500,114500,5000,884474,9150.0,삼성전기보통주
5269,9150,2020-04-17,0.0857142857142857,105000,114000,9000,2444154,9150.0,삼성전기보통주
5270,9150,2020-04-06,0.0691823899371069,95400,102000,6600,1642997,9150.0,삼성전기보통주
5271,9150,2020-03-24,0.1098654708520179,89200,99000,9800,1608106,9150.0,삼성전기보통주
5272,9150,2020-03-23,0.0746887966804979,96400,89200,-7200,1434217,9150.0,삼성전기보통주
5273,9150,2020-03-20,0.1248541423570595,85700,96400,10700,2158834,9150.0,삼성전기보통주
5274,9150,2020-03-19,0.1155830753353973,96900,85700,-11200,2639619,9150.0,삼성전기보통주
5275,9150,2020-03-18,0.0592233009708737,103000,96900,-6100,1992989,9150.0,삼성전기보통주
5276,9150,2020-03-16,0.072072072072072,111000,103000,-8000,1640758,9150.0,삼성전기보통주
5277,9150,2020-03-12,0.0696721311475409,122000,113500,-8500,2613065,9150.0,삼성전기보통주
5278,9150,2020-03-11,0.0505836575875486,128500,122000,-6500,1375292,9150.0,삼성전기보통주
5279,9150,2020-03-10,0.0447154471544715,123000,128500,5500,1377581,9150.0,삼성전기보통주
5280,9150,2020-03-09,0.0646387832699619,131500,123000,-8500,1271059,9150.0,삼성전기보통주
5281,9150,2020-02-28,0.0418250950570342,131500,126000,-5500,1472050,9150.0,삼성전기보통주
5282,9150,2020-02-11,0.0601503759398496,133000,141000,8000,1510533,9150.0,삼성전기보통주
5283,9150,2020-02-04,0.072,125000,134000,9000,1124528,9150.0,삼성전기보통주
5284,9150,2020-01-30,0.0490566037735849,132500,126000,-6500,1115743,9150.0,삼성전기보통주
5285,9150,2020-01-09,0.056,125000,132000,7000,1402192,9150.0,삼성전기보통주
5286,9150,2019-11-11,0.0560344827586206,116000,109500,-6500,1014932,9150.0,삼성전기보통주
5287,9150,2019-09-19,0.0401647785787847,97100,101000,3900,1592520,9150.0,삼성전기보통주
5288,9150,2019-09-05,0.0593311758360302,92700,98200,5500,3257453,9150.0,삼성전기보통주
5289,9150,2019-08-26,0.0419026047565118,88300,84600,-3700,1105933,9150.0,삼성전기보통주
5290,9150,2019-08-14,0.047945205479452,87600,91800,4200,1088073,9150.0,삼성전기보통주
5291,9150,2019-07-16,0.0413043478260869,92000,95800,3800,1641908,9150.0,삼성전기보통주
5292,9150,2019-04-17,0.0491071428571428,112000,117500,5500,2382798,9150.0,삼성전기보통주
5293,9150,2019-03-27,0.0539714867617108,98200,103500,5300,1924182,9150.0,삼성전기보통주
5294,9150,2019-02-28,0.0446428571428571,112000,107000,-5000,1674724,9150.0,삼성전기보통주
5295,9150,2019-02-12,0.0560747663551401,107000,113000,6000,2711585,9150.0,삼성전기보통주
5296,9150,2019-01-29,0.070754716981132,106000,113500,7500,3658161,9150.0,삼성전기보통주
5297,9150,2019-01-25,0.106060606060606,99000,109500,10500,4169300,9150.0,삼성전기보통주
5298,9150,2019-01-14,0.0407747196738022,98100,94100,-4000,1506639,9150.0,삼성전기보통주
5299,9150,2019-01-09,0.0601503759398496,93100,98700,5600,1995921,9150.0,삼성전기보통주
5300,9150,2019-01-03,0.06,100000,94000,-6000,2242797,9150.0,삼성전기보통주
5301,9150,2018-12-27,0.0507614213197969,98500,103500,5000,1338258,9150.0,삼성전기보통주
5302,9150,2018-12-14,0.0688073394495412,109000,101500,-7500,3174288,9150.0,삼성전기보통주
5303,9150,2018-12-10,0.0515021459227467,116500,110500,-6000,1792137,9150.0,삼성전기보통주
5304,9150,2018-12-03,0.0414937759336099,120500,125500,5000,1492039,9150.0,삼성전기보통주
5305,9150,2018-11-20,0.0480349344978165,114500,109000,-5500,1630336,9150.0,삼성전기보통주
5306,9150,2018-11-15,0.0401785714285714,112000,116500,4500,1483985,9150.0,삼성전기보통주
5307,9150,2018-11-12,0.0416666666666666,120000,115000,-5000,2153274,9150.0,삼성전기보통주
5308,9150,2018-11-09,0.04,125000,120000,-5000,2377256,9150.0,삼성전기보통주
5309,9150,2018-11-06,0.0634328358208955,134000,125500,-8500,3259269,9150.0,삼성전기보통주
5310,9150,2018-11-01,0.1101694915254237,118000,131000,13000,4171021,9150.0,삼성전기보통주
5311,9150,2018-10-30,0.0755555555555555,112500,121000,8500,3146241,9150.0,삼성전기보통주
5312,9150,2018-10-24,0.0622568093385214,128500,120500,-8000,3548987,9150.0,삼성전기보통주
5313,9150,2018-10-23,0.0586080586080586,136500,128500,-8000,1939614,9150.0,삼성전기보통주
5314,9150,2018-10-12,0.056,125000,132000,7000,2083832,9150.0,삼성전기보통주
5315,9150,2018-10-11,0.0494296577946768,131500,125000,-6500,2211351,9150.0,삼성전기보통주
5316,9150,2018-09-14,0.0482758620689655,145000,152000,7000,873332,9150.0,삼성전기보통주
5317,9150,2018-09-12,0.0424836601307189,153000,146500,-6500,1756437,9150.0,삼성전기보통주
5318,9150,2018-08-27,0.0426229508196721,152500,159000,6500,872233,9150.0,삼성전기보통주
5319,9150,2018-08-21,0.0749063670411985,133500,143500,10000,1251586,9150.0,삼성전기보통주
5320,9150,2018-08-10,0.0574324324324324,148000,139500,-8500,1964817,9150.0,삼성전기보통주
5321,9150,2018-08-06,0.0441640378548895,158500,151500,-7000,904004,9150.0,삼성전기보통주
5322,9150,2018-07-30,0.0613496932515337,163000,153000,-10000,1060421,9150.0,삼성전기보통주
5323,9150,2018-07-24,0.0743243243243243,148000,159000,11000,1060592,9150.0,삼성전기보통주
5324,9150,2018-07-13,0.0416666666666666,156000,162500,6500,996142,9150.0,삼성전기보통주
5325,9150,2018-07-09,0.0437710437710437,148500,155000,6500,897046,9150.0,삼성전기보통주
5326,9150,2018-07-04,0.0594059405940594,151500,142500,-9000,1033259,9150.0,삼성전기보통주
5327,9150,2018-06-20,0.0704225352112676,142000,152000,10000,1186214,9150.0,삼성전기보통주
5328,9150,2018-06-07,0.0431654676258992,139000,145000,6000,819096,9150.0,삼성전기보통주
5329,9150,2018-05-31,0.0509803921568627,127500,134000,6500,1310135,9150.0,삼성전기보통주
5330,9150,2018-05-21,0.0458333333333333,120000,125500,5500,892586,9150.0,삼성전기보통주
5331,9150,2018-05-17,0.0404858299595141,123500,118500,-5000,1036518,9150.0,삼성전기보통주
5332,9150,2018-05-09,0.0474137931034482,116000,121500,5500,1287493,9150.0,삼성전기보통주
5333,9150,2018-05-04,0.0407239819004524,110500,115000,4500,1046778,9150.0,삼성전기보통주
5334,9150,2018-05-03,0.0555555555555555,117000,110500,-6500,2001664,9150.0,삼성전기보통주
5335,9150,2018-04-24,0.0526315789473684,123500,117000,-6500,1365265,9150.0,삼성전기보통주
5336,9150,2018-04-16,0.0632911392405063,118500,126000,7500,1931596,9150.0,삼성전기보통주
5337,9150,2018-04-12,0.0694444444444444,108000,115500,7500,2888785,9150.0,삼성전기보통주
5338,9150,2018-01-05,0.082995951417004,98800,107000,8200,2045463,9150.0,삼성전기보통주
5339,9150,2017-11-17,0.0430622009569378,104500,109000,4500,2119111,9150.0,삼성전기보통주
5340,9150,2017-11-13,0.0430622009569378,104500,100000,-4500,751762,9150.0,삼성전기보통주
5341,9150,2017-11-07,0.04,100000,104000,4000,865030,9150.0,삼성전기보통주
5342,9150,2017-10-30,0.0596707818930041,97200,103000,5800,1490876,9150.0,삼성전기보통주
5343,9150,2017-10-10,0.0490196078431372,102000,107000,5000,908194,9150.0,삼성전기보통주
5344,9150,2017-09-11,0.048076923076923,104000,109000,5000,1348094,9150.0,삼성전기보통주
5345,9150,2017-08-14,0.0406147091108671,91100,94800,3700,695261,9150.0,삼성전기보통주
5346,9150,2017-07-28,0.081,100000,91900,-8100,2581821,9150.0,삼성전기보통주
5347,9150,2017-07-13,0.045,100000,104500,4500,1521245,9150.0,삼성전기보통주
5348,9150,2017-07-03,0.0441176470588235,102000,97500,-4500,1559815,9150.0,삼성전기보통주
5349,9150,2017-06-28,0.0639269406392694,109500,102500,-7000,1868011,9150.0,삼성전기보통주
5350,9150,2017-06-26,0.0945273631840796,100500,110000,9500,1520608,9150.0,삼성전기보통주
5351,9150,2017-06-22,0.0526315789473684,95000,100000,5000,1925614,9150.0,삼성전기보통주
5352,9150,2017-06-19,0.0492170022371364,89400,93800,4400,1173788,9150.0,삼성전기보통주
5353,9150,2017-06-12,0.0429732868757259,86100,82400,-3700,1006493,9150.0,삼성전기보통주
5354,9150,2017-03-29,0.0454545454545454,66000,69000,3000,993872,9150.0,삼성전기보통주
5355,9150,2017-03-13,0.0408163265306122,58800,61200,2400,729098,9150.0,삼성전기보통주
5356,9150,2017-02-24,0.0411184210526315,60800,58300,-2500,855809,9150.0,삼성전기보통주
5357,9150,2017-02-09,0.0417422867513611,55100,57400,2300,667152,9150.0,삼성전기보통주
5358,9150,2016-11-15,0.0662393162393162,46800,49900,3100,1766428,9150.0,삼성전기보통주
5359,9150,2016-11-07,0.0482456140350877,45600,47800,2200,364493,9150.0,삼성전기보통주
5360,9150,2016-09-12,0.0755813953488372,51600,47700,-3900,1958606,9150.0,삼성전기보통주
5361,9150,2016-08-18,0.0568965517241379,58000,61300,3300,1158876,9150.0,삼성전기보통주
5362,9150,2016-08-04,0.0652173913043478,55200,58800,3600,1198425,9150.0,삼성전기보통주
5363,9240,2021-06-01,0.0460829493087557,108500,113500,5000,91092,9240.0,한샘보통주
5364,9240,2021-05-25,0.056338028169014,106500,112500,6000,83442,9240.0,한샘보통주
5365,9240,2021-04-08,0.0726495726495726,117000,125500,8500,255257,9240.0,한샘보통주
5366,9240,2021-03-26,0.0704225352112676,106500,114000,7500,246510,9240.0,한샘보통주
5367,9240,2021-02-18,0.0428571428571428,105000,100500,-4500,120927,9240.0,한샘보통주
5368,9240,2021-02-08,0.048780487804878,102500,107500,5000,319023,9240.0,한샘보통주
5369,9240,2021-02-05,0.0632780082987551,96400,102500,6100,177827,9240.0,한샘보통주
5370,9240,2021-01-11,0.0465116279069767,107500,102500,-5000,178616,9240.0,한샘보통주
5371,9240,2020-12-15,0.05,100000,105000,5000,212584,9240.0,한샘보통주
5372,9240,2020-11-19,0.0526315789473684,95000,100000,5000,143989,9240.0,한샘보통주
5373,9240,2020-11-10,0.0496453900709219,98700,93800,-4900,203185,9240.0,한샘보통주
5374,9240,2020-11-03,0.0676532769556025,94600,101000,6400,121073,9240.0,한샘보통주
5375,9240,2020-10-30,0.058,100000,94200,-5800,585442,9240.0,한샘보통주
5376,9240,2020-10-21,0.0497512437810945,100500,105500,5000,113685,9240.0,한샘보통주
5377,9240,2020-10-15,0.0678733031674208,110500,103000,-7500,288989,9240.0,한샘보통주
5378,9240,2020-10-13,0.0675105485232067,118500,110500,-8000,369276,9240.0,한샘보통주
5379,9240,2020-09-25,0.0483091787439613,103500,108500,5000,182307,9240.0,한샘보통주
5380,9240,2020-09-23,0.0627530364372469,98800,105000,6200,224164,9240.0,한샘보통주
5381,9240,2020-08-21,0.0772578890097932,91900,99000,7100,170764,9240.0,한샘보통주
5382,9240,2020-08-20,0.0688956433637284,98700,91900,-6800,160942,9240.0,한샘보통주
5383,9240,2020-08-04,0.0630722278738555,98300,104500,6200,132479,9240.0,한샘보통주
5384,9240,2020-07-22,0.0407239819004524,110500,106000,-4500,123217,9240.0,한샘보통주
5385,9240,2020-07-14,0.0444444444444444,112500,117500,5000,270433,9240.0,한샘보통주
5386,9240,2020-07-09,0.1733615221987315,94600,111000,16400,1265273,9240.0,한샘보통주
5387,9240,2020-07-03,0.0598006644518272,90300,95700,5400,338005,9240.0,한샘보통주
5388,9240,2020-07-01,0.0533642691415313,86200,90800,4600,304547,9240.0,한샘보통주
5389,9240,2020-06-29,0.0419501133786848,88200,84500,-3700,59619,9240.0,한샘보통주
5390,9240,2020-06-26,0.0437869822485207,84500,88200,3700,96382,9240.0,한샘보통주
5391,9240,2020-06-16,0.0886392009987515,80100,87200,7100,108566,9240.0,한샘보통주
5392,9240,2020-06-15,0.0609613130128956,85300,80100,-5200,107263,9240.0,한샘보통주
5393,9240,2020-06-12,0.0458612975391498,89400,85300,-4100,123824,9240.0,한샘보통주
5394,9240,2020-06-03,0.0536842105263157,95000,89900,-5100,215296,9240.0,한샘보통주
5395,9240,2020-06-02,0.1033681765389082,86100,95000,8900,350997,9240.0,한샘보통주
5396,9240,2020-05-27,0.0558722919042189,87700,82800,-4900,132821,9240.0,한샘보통주
5397,9240,2020-05-18,0.0425287356321839,87000,83300,-3700,135886,9240.0,한샘보통주
5398,9240,2020-05-13,0.0723192019950124,80200,86000,5800,286113,9240.0,한샘보통주
5399,9240,2020-05-12,0.0429128738621586,76900,80200,3300,233329,9240.0,한샘보통주
5400,9240,2020-05-08,0.0499306518723994,72100,75700,3600,157753,9240.0,한샘보통주
5401,9240,2020-04-27,0.0513552068473609,70100,73700,3600,191188,9240.0,한샘보통주
5402,9240,2020-04-21,0.0562962962962962,67500,71300,3800,356690,9240.0,한샘보통주
5403,9240,2020-04-20,0.0579937304075235,63800,67500,3700,193921,9240.0,한샘보통주
5404,9240,2020-04-07,0.0992647058823529,54400,59800,5400,192569,9240.0,한샘보통주
5405,9240,2020-04-06,0.0421455938697318,52200,54400,2200,81984,9240.0,한샘보통주
5406,9240,2020-03-25,0.0653061224489796,49000,52200,3200,149836,9240.0,한샘보통주
5407,9240,2020-03-24,0.0458911419423692,46850,49000,2150,218630,9240.0,한샘보통주
5408,9240,2020-03-23,0.129182156133829,53800,46850,-6950,179247,9240.0,한샘보통주
5409,9240,2020-03-20,0.046692607003891,51400,53800,2400,215454,9240.0,한샘보통주
5410,9240,2020-03-19,0.1669367909238249,61700,51400,-10300,220303,9240.0,한샘보통주
5411,9240,2020-03-18,0.0419254658385093,64400,61700,-2700,111179,9240.0,한샘보통주
5412,9240,2020-03-17,0.1103448275862069,58000,64400,6400,135398,9240.0,한샘보통주
5413,9240,2020-03-12,0.0688,62500,58200,-4300,220416,9240.0,한샘보통주
5414,9240,2020-02-24,0.0482654600301659,66300,63100,-3200,143887,9240.0,한샘보통주
5415,9240,2020-02-17,0.0404040404040404,69300,72100,2800,92487,9240.0,한샘보통주
5416,9240,2020-02-04,0.0478873239436619,71000,74400,3400,98491,9240.0,한샘보통주
5417,9240,2020-01-15,0.0438247011952191,75300,78600,3300,141071,9240.0,한샘보통주
5418,9240,2020-01-07,0.0680173661360347,69100,73800,4700,286832,9240.0,한샘보통주
5419,9240,2020-01-03,0.04047976011994,66700,69400,2700,309676,9240.0,한샘보통주
5420,9240,2020-01-02,0.0723472668810289,62200,66700,4500,258851,9240.0,한샘보통주
5421,9240,2019-11-25,0.0545454545454545,60500,63800,3300,119771,9240.0,한샘보통주
5422,9240,2019-10-28,0.061056105610561,60600,64300,3700,252620,9240.0,한샘보통주
5423,9240,2019-08-12,0.0566037735849056,63600,67200,3600,142832,9240.0,한샘보통주
5424,9240,2019-07-30,0.0684210526315789,57000,60900,3900,249174,9240.0,한샘보통주
5425,9240,2019-07-29,0.1592920353982301,67800,57000,-10800,647014,9240.0,한샘보통주
5426,9240,2019-07-01,0.0477489768076398,73300,69800,-3500,124898,9240.0,한샘보통주
5427,9240,2019-06-10,0.0720288115246098,83300,77300,-6000,398950,9240.0,한샘보통주
5428,9240,2019-05-30,0.0463733650416171,84100,80200,-3900,265202,9240.0,한샘보통주
5429,9240,2019-05-29,0.0788608981380065,91300,84100,-7200,240705,9240.0,한샘보통주
5430,9240,2019-05-28,0.0446224256292906,87400,91300,3900,219884,9240.0,한샘보통주
5431,9240,2019-05-09,0.0677966101694915,94400,88000,-6400,377264,9240.0,한샘보통주
5432,9240,2019-04-29,0.0601851851851851,108000,101500,-6500,327868,9240.0,한샘보통주
5433,9240,2019-04-17,0.0408163265306122,98000,102000,4000,230741,9240.0,한샘보통주
5434,9240,2019-04-11,0.0649627263045793,93900,100000,6100,395952,9240.0,한샘보통주
5435,9240,2019-04-01,0.0947712418300653,91800,100500,8700,389993,9240.0,한샘보통주
5436,9240,2019-03-26,0.0533175355450237,84400,88900,4500,128882,9240.0,한샘보통주
5437,9240,2019-03-22,0.0546875,89600,84700,-4900,291479,9240.0,한샘보통주
5438,9240,2019-02-18,0.0615199034981905,82900,88000,5100,290666,9240.0,한샘보통주
5439,9240,2019-02-11,0.0527777777777777,72000,75800,3800,304786,9240.0,한샘보통주
5440,9240,2019-01-16,0.0465116279069767,73100,69700,-3400,211069,9240.0,한샘보통주
5441,9240,2019-01-11,0.0595238095238095,67200,71200,4000,250730,9240.0,한샘보통주
5442,9240,2019-01-09,0.0521327014218009,63300,66600,3300,131744,9240.0,한샘보통주
5443,9240,2019-01-08,0.0438066465256797,66200,63300,-2900,231768,9240.0,한샘보통주
5444,9240,2018-12-27,0.0425531914893617,65800,68600,2800,170009,9240.0,한샘보통주
5445,9240,2018-12-20,0.0543478260869565,64400,67900,3500,383038,9240.0,한샘보통주
5446,9240,2018-12-19,0.0715474209650582,60100,64400,4300,216777,9240.0,한샘보통주
5447,9240,2018-12-04,0.0557377049180327,61000,64400,3400,377469,9240.0,한샘보통주
5448,9240,2018-12-03,0.0409556313993174,58600,61000,2400,198871,9240.0,한샘보통주
5449,9240,2018-11-28,0.053763440860215,55800,58800,3000,282640,9240.0,한샘보통주
5450,9240,2018-11-27,0.0469043151969981,53300,55800,2500,269622,9240.0,한샘보통주
5451,9240,2018-11-19,0.077490774907749,54200,58400,4200,296853,9240.0,한샘보통주
5452,9240,2018-11-15,0.0546875,51200,54000,2800,219033,9240.0,한샘보통주
5453,9240,2018-10-29,0.0499001996007984,50100,47600,-2500,265300,9240.0,한샘보통주
5454,9240,2018-10-16,0.2117263843648208,61400,48400,-13000,1772942,9240.0,한샘보통주
5455,9240,2018-10-11,0.0616740088105726,68100,63900,-4200,175182,9240.0,한샘보통주
5456,9240,2018-09-20,0.0606767794632438,85700,80500,-5200,176721,9240.0,한샘보통주
5457,9240,2018-09-13,0.048235294117647,85000,89100,4100,140457,9240.0,한샘보통주
5458,9240,2018-08-23,0.0457018498367791,91900,87700,-4200,125488,9240.0,한샘보통주
5459,9240,2018-08-14,0.0487562189054726,100500,95600,-4900,66808,9240.0,한샘보통주
5460,9240,2018-07-24,0.0431726907630522,99600,95300,-4300,155070,9240.0,한샘보통주
5461,9240,2018-07-23,0.0462184873949579,95200,99600,4400,156123,9240.0,한샘보통주
5462,9240,2018-07-20,0.0801932367149758,103500,95200,-8300,200773,9240.0,한샘보통주
5463,9240,2018-07-18,0.0585585585585585,111000,104500,-6500,41884,9240.0,한샘보통주
5464,9240,2018-05-08,0.0491071428571428,112000,106500,-5500,228015,9240.0,한샘보통주
5465,9240,2018-04-27,0.0416666666666666,120000,115000,-5000,169423,9240.0,한샘보통주
5466,9240,2018-04-17,0.1530612244897959,147000,124500,-22500,470485,9240.0,한샘보통주
5467,9240,2018-02-19,0.0561403508771929,142500,150500,8000,67098,9240.0,한샘보통주
5468,9240,2018-02-09,0.0418006430868167,155500,149000,-6500,144741,9240.0,한샘보통주
5469,9240,2018-02-08,0.0401234567901234,162000,155500,-6500,71419,9240.0,한샘보통주
5470,9240,2018-02-07,0.0451612903225806,155000,162000,7000,70641,9240.0,한샘보통주
5471,9240,2018-02-06,0.0773809523809523,168000,155000,-13000,253086,9240.0,한샘보통주
5472,9240,2018-01-19,0.0526315789473684,171000,180000,9000,103164,9240.0,한샘보통주
5473,9240,2018-01-05,0.0523255813953488,172000,163000,-9000,167265,9240.0,한샘보통주
5474,9240,2017-12-08,0.0546448087431694,183000,173000,-10000,43518,9240.0,한샘보통주
5475,9240,2017-11-27,0.0925373134328358,167500,183000,15500,201768,9240.0,한샘보통주
5476,9240,2017-10-30,0.0501392757660167,179500,170500,-9000,70083,9240.0,한샘보통주
5477,9240,2017-10-25,0.0495626822157434,171500,180000,8500,142409,9240.0,한샘보통주
5478,9240,2017-10-16,0.1142857142857142,157500,175500,18000,188534,9240.0,한샘보통주
5479,9240,2017-09-18,0.0671140939597315,149000,159000,10000,119042,9240.0,한샘보통주
5480,9240,2017-09-04,0.0416666666666666,168000,161000,-7000,108563,9240.0,한샘보통주
5481,9240,2017-07-18,0.0646900269541779,185500,173500,-12000,272714,9240.0,한샘보통주
5482,9240,2017-06-20,0.0454545454545454,198000,189000,-9000,149577,9240.0,한샘보통주
5483,9240,2017-06-19,0.0503597122302158,208500,198000,-10500,85513,9240.0,한샘보통주
5484,9240,2017-06-01,0.0431818181818181,220000,210500,-9500,75370,9240.0,한샘보통주
5485,9240,2017-01-19,0.0415647921760391,204500,213000,8500,87648,9240.0,한샘보통주
5486,9240,2017-01-05,0.0497382198952879,191000,200500,9500,84654,9240.0,한샘보통주
5487,9240,2016-12-08,0.0416666666666666,192000,200000,8000,83616,9240.0,한샘보통주
5488,9240,2016-11-18,0.0664819944598338,180500,192500,12000,139328,9240.0,한샘보통주
5489,9240,2016-11-10,0.05,180000,189000,9000,70526,9240.0,한샘보통주
5490,9240,2016-11-04,0.0408163265306122,171500,178500,7000,43325,9240.0,한샘보통주
5491,9240,2016-10-25,0.0693641618497109,173000,185000,12000,296230,9240.0,한샘보통주
5492,9240,2016-10-17,0.0427350427350427,175500,168000,-7500,112417,9240.0,한샘보통주
5493,9240,2016-09-20,0.0754098360655737,152500,164000,11500,208592,9240.0,한샘보통주
5494,9240,2016-09-19,0.0664335664335664,143000,152500,9500,123799,9240.0,한샘보통주
5495,9240,2016-08-16,0.0421348314606741,178000,170500,-7500,110570,9240.0,한샘보통주
5496,9540,2021-06-01,0.0456140350877193,142500,149000,6500,819339,9540.0,한국조선해양보통주
5497,9540,2021-05-20,0.0519480519480519,154000,146000,-8000,567446,9540.0,한국조선해양보통주
5498,9540,2021-05-12,0.043613707165109,160500,153500,-7000,750161,9540.0,한국조선해양보통주
5499,9540,2021-04-26,0.0673758865248227,141000,150500,9500,1065089,9540.0,한국조선해양보통주
5500,9540,2021-03-26,0.1139240506329113,118500,132000,13500,1926320,9540.0,한국조선해양보통주
5501,9540,2021-03-09,0.0405405405405405,111000,115500,4500,814808,9540.0,한국조선해양보통주
5502,9540,2021-02-25,0.0458715596330275,109000,114000,5000,502114,9540.0,한국조선해양보통주
5503,9540,2021-02-23,0.0769230769230769,104000,112000,8000,1164157,9540.0,한국조선해양보통주
5504,9540,2021-02-15,0.0594059405940594,101000,107000,6000,494738,9540.0,한국조선해양보통주
5505,9540,2021-02-01,0.0627659574468085,94000,99900,5900,449837,9540.0,한국조선해양보통주
5506,9540,2021-01-29,0.0437436419125127,98300,94000,-4300,780382,9540.0,한국조선해양보통주
5507,9540,2021-01-28,0.0409756097560975,102500,98300,-4200,674753,9540.0,한국조선해양보통주
5508,9540,2021-01-05,0.0681818181818181,110000,117500,7500,1108466,9540.0,한국조선해양보통주
5509,9540,2020-12-11,0.0682926829268292,102500,109500,7000,932001,9540.0,한국조선해양보통주
5510,9540,2020-11-23,0.0647181628392484,95800,102000,6200,1141724,9540.0,한국조선해양보통주
5511,9540,2020-11-19,0.0483383685800604,99300,94500,-4800,889242,9540.0,한국조선해양보통주
5512,9540,2020-11-16,0.0715059588299024,92300,98900,6600,1026744,9540.0,한국조선해양보통주
5513,9540,2020-11-09,0.0868516284680337,82900,90100,7200,1228520,9540.0,한국조선해양보통주
5514,9540,2020-09-24,0.043103448275862,81200,77700,-3500,368708,9540.0,한국조선해양보통주
5515,9540,2020-08-20,0.0426695842450765,91400,87500,-3900,468677,9540.0,한국조선해양보통주
5516,9540,2020-08-18,0.0458811261730969,95900,91500,-4400,1118237,9540.0,한국조선해양보통주
5517,9540,2020-08-14,0.0620155038759689,90300,95900,5600,983827,9540.0,한국조선해양보통주
5518,9540,2020-08-11,0.0516055045871559,87200,91700,4500,775258,9540.0,한국조선해양보통주
5519,9540,2020-07-13,0.07168458781362,83700,89700,6000,473931,9540.0,한국조선해양보통주
5520,9540,2020-06-16,0.0718424101969872,86300,92500,6200,329689,9540.0,한국조선해양보통주
5521,9540,2020-06-15,0.087737843551797,94600,86300,-8300,558684,9540.0,한국조선해양보통주
5522,9540,2020-06-12,0.0444444444444444,99000,94600,-4400,451334,9540.0,한국조선해양보통주
5523,9540,2020-06-03,0.0499490316004077,98100,103000,4900,920385,9540.0,한국조선해양보통주
5524,9540,2020-06-02,0.0639913232104121,92200,98100,5900,1921151,9540.0,한국조선해양보통주
5525,9540,2020-05-27,0.0804195804195804,85800,92700,6900,1476514,9540.0,한국조선해양보통주
5526,9540,2020-05-25,0.048811013767209,79900,83800,3900,740036,9540.0,한국조선해양보통주
5527,9540,2020-05-06,0.0404040404040404,79200,82400,3200,429041,9540.0,한국조선해양보통주
5528,9540,2020-05-04,0.0423216444981862,82700,79200,-3500,453170,9540.0,한국조선해양보통주
5529,9540,2020-04-29,0.0684754521963824,77400,82700,5300,1107897,9540.0,한국조선해양보통주
5530,9540,2020-04-21,0.0493827160493827,81000,77000,-4000,758374,9540.0,한국조선해양보통주
5531,9540,2020-04-13,0.0538641686182669,85400,80800,-4600,360328,9540.0,한국조선해양보통주
5532,9540,2020-04-09,0.0515723270440251,79500,83600,4100,453140,9540.0,한국조선해양보통주
5533,9540,2020-04-06,0.0535248041775456,76600,80700,4100,262082,9540.0,한국조선해양보통주
5534,9540,2020-03-25,0.0690121786197564,73900,79000,5100,492705,9540.0,한국조선해양보통주
5535,9540,2020-03-24,0.0772594752186588,68600,73900,5300,294642,9540.0,한국조선해양보통주
5536,9540,2020-03-23,0.109090909090909,77000,68600,-8400,324195,9540.0,한국조선해양보통주
5537,9540,2020-03-20,0.1613876319758672,66300,77000,10700,517444,9540.0,한국조선해양보통주
5538,9540,2020-03-19,0.0778859527121001,71900,66300,-5600,661951,9540.0,한국조선해양보통주
5539,9540,2020-03-18,0.0852417302798982,78600,71900,-6700,404985,9540.0,한국조선해양보통주
5540,9540,2020-03-16,0.0531520395550061,80900,76600,-4300,526279,9540.0,한국조선해양보통주
5541,9540,2020-03-13,0.0920314253647587,89100,80900,-8200,969928,9540.0,한국조선해양보통주
5542,9540,2020-03-12,0.0670157068062827,95500,89100,-6400,612408,9540.0,한국조선해양보통주
5543,9540,2020-03-09,0.0901408450704225,106500,96900,-9600,812249,9540.0,한국조선해양보통주
5544,9540,2020-03-05,0.0424528301886792,106000,110500,4500,298132,9540.0,한국조선해양보통주
5545,9540,2020-02-24,0.0535714285714285,112000,106000,-6000,286441,9540.0,한국조선해양보통주
5546,9540,2020-02-06,0.1227272727272727,110000,123500,13500,678051,9540.0,한국조선해양보통주
5547,9540,2020-01-28,0.048,125000,119000,-6000,221836,9540.0,한국조선해양보통주
5548,9540,2020-01-09,0.0443548387096774,124000,129500,5500,328602,9540.0,한국조선해양보통주
5549,9540,2019-10-30,0.04296875,128000,122500,-5500,215726,9540.0,한국조선해양보통주
5550,9540,2019-08-30,0.0426540284360189,105500,110000,4500,247446,9540.0,한국조선해양보통주
5551,9540,2019-08-20,0.0533980582524271,103000,108500,5500,347794,9540.0,한국조선해양보통주
5552,9540,2019-08-19,0.0762800417972831,95700,103000,7300,379578,9540.0,한국조선해양보통주
5553,9540,2019-08-02,0.0467289719626168,107000,102000,-5000,333053,9540.0,한국조선해양보통주
5554,9540,2019-07-25,0.0552995391705069,108500,102500,-6000,613245,9540.0,한국조선해양보통주
5555,9540,2019-05-30,0.0405405405405405,111000,115500,4500,186414,9540.0,한국조선해양보통주
5556,9540,2019-05-13,0.0476190476190476,115500,110000,-5500,366584,9540.0,한국조선해양보통주
5557,9540,2019-05-09,0.0414937759336099,120500,115500,-5000,456761,9540.0,한국조선해양보통주
5558,9540,2019-04-23,0.0583333333333333,120000,127000,7000,644267,9540.0,한국조선해양보통주
5559,9540,2019-03-25,0.0753968253968253,126000,116500,-9500,743725,9540.0,한국조선해양보통주
5560,9540,2019-02-01,0.075812274368231,138500,128000,-10500,1709513,9540.0,한국조선해양보통주
5561,9540,2019-01-31,0.0415224913494809,144500,138500,-6000,1538515,9540.0,한국조선해양보통주
5562,9540,2019-01-04,0.053231939163498,131500,138500,7000,369927,9540.0,한국조선해양보통주
5563,9540,2019-01-03,0.047808764940239,125500,131500,6000,334941,9540.0,한국조선해양보통주
5564,9540,2018-12-27,0.0401606425702811,124500,129500,5000,324481,9540.0,한국조선해양보통주
5565,9540,2018-12-12,0.0526315789473684,133000,140000,7000,329188,9540.0,한국조선해양보통주
5566,9540,2018-11-16,0.05078125,128000,134500,6500,393648,9540.0,한국조선해양보통주
5567,9540,2018-11-14,0.0599250936329588,133500,125500,-8000,488221,9540.0,한국조선해양보통주
5568,9540,2018-11-06,0.0534979423868312,121500,128000,6500,415458,9540.0,한국조선해양보통주
5569,9540,2018-11-01,0.0682730923694779,124500,116000,-8500,495843,9540.0,한국조선해양보통주
5570,9540,2018-10-30,0.0600858369098712,116500,123500,7000,330059,9540.0,한국조선해양보통주
5571,9540,2018-10-23,0.0476190476190476,126000,120000,-6000,392126,9540.0,한국조선해양보통주
5572,9540,2018-10-18,0.0528301886792452,132500,125500,-7000,269037,9540.0,한국조선해양보통주
5573,9540,2018-10-11,0.059040590405904,135500,127500,-8000,425337,9540.0,한국조선해양보통주
5574,9540,2018-10-08,0.0498220640569395,140500,133500,-7000,325392,9540.0,한국조선해양보통주
5575,9540,2018-09-27,0.05078125,128000,134500,6500,338182,9540.0,한국조선해양보통주
5576,9540,2018-08-22,0.0493273542600896,111500,117000,5500,3108253,9540.0,한국조선해양보통주
5577,9540,2018-08-20,0.0922330097087378,103000,112500,9500,485114,9540.0,한국조선해양보통주
5578,9540,2018-08-16,0.0416666666666666,108000,103500,-4500,236325,9540.0,한국조선해양보통주
5579,9540,2018-08-03,0.0637254901960784,102000,108500,6500,261405,9540.0,한국조선해양보통주
5580,9540,2018-08-02,0.0422535211267605,106500,102000,-4500,214657,9540.0,한국조선해양보통주
5581,9540,2018-07-26,0.0598377281947261,98600,104500,5900,538714,9540.0,한국조선해양보통주
5582,9540,2018-06-27,0.075,108000,99900,-8100,538434,9540.0,한국조선해양보통주
5583,9540,2018-06-19,0.0452488687782805,110500,105500,-5000,285114,9540.0,한국조선해양보통주
5584,9540,2018-06-14,0.0411522633744856,121500,116500,-5000,258444,9540.0,한국조선해양보통주
5585,9540,2018-05-28,0.0532786885245901,122000,115500,-6500,975702,9540.0,한국조선해양보통주
5586,9540,2018-05-04,0.0418410041841004,119500,124500,5000,727152,9540.0,한국조선해양보통주
5587,9540,2018-04-26,0.0577777777777777,112500,119000,6500,448058,9540.0,한국조선해양보통주
5588,9540,2018-04-25,0.0425531914893617,117500,112500,-5000,307780,9540.0,한국조선해양보통주
5589,9540,2018-04-05,0.0702479338842975,121000,129500,8500,612806,9540.0,한국조선해양보통주
5590,9540,2018-04-02,0.0454545454545454,132000,126000,-6000,545347,9540.0,한국조선해양보통주
5591,9540,2018-03-30,0.04,137500,132000,-5500,762270,9540.0,한국조선해양보통주
5592,9540,2018-03-29,0.0418118466898954,143500,137500,-6000,530692,9540.0,한국조선해양보통주
5593,9540,2018-03-08,0.0547445255474452,137000,144500,7500,682091,9540.0,한국조선해양보통주
5594,9540,2018-03-06,0.1255060728744939,123500,139000,15500,956555,9540.0,한국조선해양보통주
5595,9540,2018-03-05,0.0572519083969465,131000,123500,-7500,403601,9540.0,한국조선해양보통주
5596,9540,2018-02-23,0.04,125000,130000,5000,354833,9540.0,한국조선해양보통주
5597,9540,2018-02-05,0.0503597122302158,139000,132000,-7000,176805,9540.0,한국조선해양보통주
5598,9540,2018-01-04,0.0641025641025641,117000,124500,7500,555511,9540.0,한국조선해양보통주
5599,9540,2018-01-03,0.0883720930232558,107500,117000,9500,556159,9540.0,한국조선해양보통주
5600,9540,2018-01-02,0.0696517412935323,100500,107500,7000,451405,9540.0,한국조선해양보통주
5601,9540,2017-12-27,0.2875,136000,96900,-39100,2122027,9540.0,한국조선해양보통주
5602,9540,2017-12-08,0.0732600732600732,136500,126500,-10000,514973,9540.0,한국조선해양보통주
5603,9540,2017-12-07,0.048780487804878,143500,136500,-7000,322124,9540.0,한국조선해양보통주
5604,9540,2017-12-06,0.0620915032679738,153000,143500,-9500,379419,9540.0,한국조선해양보통주
5605,9540,2017-11-13,0.0539682539682539,157500,149000,-8500,392636,9540.0,한국조선해양보통주
5606,9540,2017-11-07,0.0412698412698412,157500,164000,6500,383572,9540.0,한국조선해양보통주
5607,9540,2017-10-31,0.0433333333333333,150000,156500,6500,365366,9540.0,한국조선해양보통주
5608,9540,2017-09-26,0.0575539568345323,139000,147000,8000,307007,9540.0,한국조선해양보통주
5609,9540,2017-09-19,0.0760869565217391,138000,148500,10500,478535,9540.0,한국조선해양보통주
5610,9540,2017-08-21,0.048076923076923,156000,148500,-7500,740324,9540.0,한국조선해양보통주
5611,9540,2017-08-01,0.0458452722063037,174500,182500,8000,461779,9540.0,한국조선해양보통주
5612,9540,2017-06-13,0.0423728813559322,177000,184500,7500,514888,9540.0,한국조선해양보통주
5613,9540,2017-05-10,0.1424242424242424,165000,180500,15500,4003517,9540.0,한국조선해양보통주
5614,9540,2017-03-16,0.066066066066066,166500,177500,11000,727126,9540.0,한국조선해양보통주
5615,9540,2017-02-28,0.0511182108626198,156500,164500,8000,668880,9540.0,한국조선해양보통주
5616,9540,2017-02-21,0.0404040404040404,148500,154500,6000,398700,9540.0,한국조선해양보통주
5617,9540,2017-02-01,0.0528301886792452,132500,139500,7000,233800,9540.0,한국조선해양보통주
5618,9540,2017-01-04,0.0482758620689655,145000,138000,-7000,543478,9540.0,한국조선해양보통주
5619,9540,2016-12-01,0.056338028169014,142000,150000,8000,384857,9540.0,한국조선해양보통주
5620,9540,2016-11-16,0.0477815699658703,146500,153500,7000,1265581,9540.0,한국조선해양보통주
5621,9540,2016-11-10,0.0579710144927536,138000,146000,8000,302139,9540.0,한국조선해양보통주
5622,9540,2016-11-09,0.0482758620689655,145000,138000,-7000,420397,9540.0,한국조선해양보통주
5623,9540,2016-11-07,0.0474452554744525,137000,143500,6500,178557,9540.0,한국조선해양보통주
5624,9540,2016-10-26,0.0482315112540192,155500,148000,-7500,351600,9540.0,한국조선해양보통주
5625,9540,2016-10-06,0.0428571428571428,140000,146000,6000,373680,9540.0,한국조선해양보통주
5626,9540,2016-09-12,0.0598591549295774,142000,133500,-8500,366884,9540.0,한국조선해양보통주
5627,9540,2016-09-05,0.0441176470588235,136000,142000,6000,371542,9540.0,한국조선해양보통주
5628,9540,2016-08-31,0.053639846743295,130500,137500,7000,333691,9540.0,한국조선해양보통주
5629,9540,2016-08-26,0.0407407407407407,135000,129500,-5500,305364,9540.0,한국조선해양보통주
5630,9540,2016-08-05,0.0553359683794466,126500,133500,7000,547678,9540.0,한국조선해양보통주
5631,9830,2021-04-14,0.0423991726990692,48350,50400,2050,3902161,9830.0,한화솔루션보통주
5632,9830,2021-03-25,0.0666666666666666,45000,48000,3000,5821647,9830.0,한화솔루션보통주
5633,9830,2021-03-12,0.05,42000,44100,2100,2172858,9830.0,한화솔루션보통주
5634,9830,2021-02-26,0.0445387062566277,47150,45050,-2100,2395483,9830.0,한화솔루션보통주
5635,9830,2021-02-25,0.0431415929203539,45200,47150,1950,1934318,9830.0,한화솔루션보통주
5636,9830,2021-02-05,0.0711462450592885,50600,54200,3600,4396197,9830.0,한화솔루션보통주
5637,9830,2021-01-28,0.0498154981549815,54200,51500,-2700,2426414,9830.0,한화솔루션보통주
5638,9830,2021-01-19,0.0635838150289017,51900,55200,3300,2844189,9830.0,한화솔루션보통주
5639,9830,2021-01-12,0.0545774647887323,56800,53700,-3100,5750071,9830.0,한화솔루션보통주
5640,9830,2021-01-07,0.0413533834586466,53200,55400,2200,9056721,9830.0,한화솔루션보통주
5641,9830,2021-01-05,0.0955284552845528,49200,53900,4700,14113184,9830.0,한화솔루션보통주
5642,9830,2020-12-29,0.0543840177580466,45050,47500,2450,6843784,9830.0,한화솔루션보통주
5643,9830,2020-12-16,0.0672546857772877,45350,48400,3050,8267648,9830.0,한화솔루션보통주
5644,9830,2020-11-11,0.0511583011583011,51800,49150,-2650,7737530,9830.0,한화솔루션보통주
5645,9830,2020-11-09,0.0897703549060542,47900,52200,4300,15888865,9830.0,한화솔루션보통주
5646,9830,2020-11-05,0.1229508196721311,42700,47950,5250,19428105,9830.0,한화솔루션보통주
5647,9830,2020-11-04,0.0885805763073639,46850,42700,-4150,16978851,9830.0,한화솔루션보통주
5648,9830,2020-11-02,0.0697940503432494,43700,46750,3050,5601799,9830.0,한화솔루션보통주
5649,9830,2020-10-30,0.0427163198247535,45650,43700,-1950,4600153,9830.0,한화솔루션보통주
5650,9830,2020-10-28,0.0419026047565118,44150,46000,1850,4956972,9830.0,한화솔루션보통주
5651,9830,2020-10-27,0.0486935866983372,42100,44150,2050,5211897,9830.0,한화솔루션보통주
5652,9830,2020-10-26,0.0539325842696629,44500,42100,-2400,3406654,9830.0,한화솔루션보통주
5653,9830,2020-10-22,0.06,47500,44650,-2850,5287965,9830.0,한화솔루션보통주
5654,9830,2020-10-21,0.099537037037037,43200,47500,4300,9053186,9830.0,한화솔루션보통주
5655,9830,2020-10-16,0.0420258620689655,46400,44450,-1950,4980817,9830.0,한화솔루션보통주
5656,9830,2020-10-08,0.0952914798206278,44600,48850,4250,13729142,9830.0,한화솔루션보통주
5657,9830,2020-10-07,0.0543735224586288,42300,44600,2300,6719948,9830.0,한화솔루션보통주
5658,9830,2020-10-05,0.0962288686605981,38450,42150,3700,8537654,9830.0,한화솔루션보통주
5659,9830,2020-09-28,0.0881934566145092,35150,38250,3100,6826054,9830.0,한화솔루션보통주
5660,9830,2020-09-25,0.0525606469002695,37100,35150,-1950,6251598,9830.0,한화솔루션보통주
5661,9830,2020-09-21,0.0740305522914218,42550,39400,-3150,7903616,9830.0,한화솔루션보통주
5662,9830,2020-09-11,0.0588832487309644,49250,46350,-2900,8204101,9830.0,한화솔루션보통주
5663,9830,2020-09-09,0.0541711809317443,46150,48650,2500,14657670,9830.0,한화솔루션보통주
5664,9830,2020-09-08,0.0591233435270132,49050,46150,-2900,8641722,9830.0,한화솔루션보통주
5665,9830,2020-09-04,0.061269146608315,45700,48500,2800,23454822,9830.0,한화솔루션보통주
5666,9830,2020-09-03,0.1554993678887484,39550,45700,6150,22636230,9830.0,한화솔루션보통주
5667,9830,2020-08-31,0.0610889774236387,37650,39950,2300,6128511,9830.0,한화솔루션보통주
5668,9830,2020-08-28,0.0502092050209205,35850,37650,1800,5049845,9830.0,한화솔루션보통주
5669,9830,2020-08-25,0.1151419558359621,31700,35350,3650,8467820,9830.0,한화솔루션보통주
5670,9830,2020-08-20,0.0544323483670295,32150,30400,-1750,4915229,9830.0,한화솔루션보통주
5671,9830,2020-08-05,0.0625,27200,28900,1700,4866007,9830.0,한화솔루션보통주
5672,9830,2020-08-04,0.0522243713733075,25850,27200,1350,6901336,9830.0,한화솔루션보통주
5673,9830,2020-07-21,0.060665362035225,25550,27100,1550,8478952,9830.0,한화솔루션보통주
5674,9830,2020-07-20,0.0690376569037656,23900,25550,1650,5258251,9830.0,한화솔루션보통주
5675,9830,2020-07-15,0.0526315789473684,22800,24000,1200,4409705,9830.0,한화솔루션보통주
5676,9830,2020-07-14,0.0617283950617283,24300,22800,-1500,7112510,9830.0,한화솔루션보통주
5677,9830,2020-07-13,0.0752212389380531,22600,24300,1700,7247577,9830.0,한화솔루션보통주
5678,9830,2020-07-09,0.1225,20000,22450,2450,14229896,9830.0,한화솔루션보통주
5679,9830,2020-06-26,0.0422163588390501,18950,19750,800,2034552,9830.0,한화솔루션보통주
5680,9830,2020-06-23,0.0427807486631016,18700,19500,800,5042231,9830.0,한화솔루션보통주
5681,9830,2020-06-16,0.1014492753623188,17250,19000,1750,3885617,9830.0,한화솔루션보통주
5682,9830,2020-06-15,0.0675675675675675,18500,17250,-1250,3493372,9830.0,한화솔루션보통주
5683,9830,2020-06-09,0.066860465116279,17200,18350,1150,10652835,9830.0,한화솔루션보통주
5684,9830,2020-06-01,0.0402476780185758,16150,16800,650,1397120,9830.0,한화솔루션보통주
5685,9830,2020-05-26,0.0559006211180124,16100,17000,900,2319656,9830.0,한화솔루션보통주
5686,9830,2020-05-21,0.0476190476190476,15750,16500,750,4338602,9830.0,한화솔루션보통주
5687,9830,2020-05-19,0.0606060606060606,14850,15750,900,1987485,9830.0,한화솔루션보통주
5688,9830,2020-05-12,0.040133779264214,14950,15550,600,7961875,9830.0,한화솔루션보통주
5689,9830,2020-05-11,0.0454545454545454,14300,14950,650,7973700,9830.0,한화솔루션보통주
5690,9830,2020-05-04,0.0515463917525773,14550,13800,-750,1355893,9830.0,한화솔루션보통주
5691,9830,2020-04-17,0.0510948905109489,13700,14400,700,1425705,9830.0,한화솔루션보통주
5692,9830,2020-04-10,0.0483271375464684,13450,14100,650,1957413,9830.0,한화솔루션보통주
5693,9830,2020-04-01,0.0485074626865671,13400,12750,-650,1139918,9830.0,한화솔루션보통주
5694,9830,2020-03-25,0.1884057971014492,10350,12300,1950,2653737,9830.0,한화솔루션보통주
5695,9830,2020-03-24,0.0998937300743889,9410,10350,940,1439012,9830.0,한화솔루션보통주
5696,9830,2020-03-23,0.1038095238095238,10500,9410,-1090,1982452,9830.0,한화솔루션보통주
5697,9830,2020-03-20,0.1052631578947368,9500,10500,1000,2408986,9830.0,한화솔루션보통주
5698,9830,2020-03-19,0.188034188034188,11700,9500,-2200,3460681,9830.0,한화솔루션보통주
5699,9830,2020-03-18,0.1,13000,11700,-1300,1453345,9830.0,한화솔루션보통주
5700,9830,2020-03-13,0.0958904109589041,14600,13200,-1400,3519200,9830.0,한화솔루션보통주
5701,9830,2020-03-12,0.1015384615384615,16250,14600,-1650,2360786,9830.0,한화솔루션보통주
5702,9830,2020-03-09,0.1016483516483516,18200,16350,-1850,2107166,9830.0,한화솔루션보통주
5703,9830,2020-02-28,0.050531914893617,18800,17850,-950,1402829,9830.0,한화솔루션보통주
5704,9830,2020-02-24,0.0591133004926108,20300,19100,-1200,1594503,9830.0,한화솔루션보통주
5705,9830,2020-02-20,0.0477453580901856,18850,19750,900,2917067,9830.0,한화솔루션보통주
5706,9830,2020-02-06,0.0784883720930232,17200,18550,1350,1491394,9830.0,한화솔루션보통주
5707,9830,2020-01-28,0.0704960835509138,19150,17800,-1350,1259404,9830.0,한화솔루션보통주
5708,9830,2020-01-09,0.073170731707317,18450,19800,1350,1562109,9830.0,한화솔루션보통주
5709,9830,2020-01-08,0.0415584415584415,19250,18450,-800,1216990,9830.0,한화솔루션보통주
5710,9830,2019-11-13,0.0784883720930232,17200,18550,1350,4074829,9830.0,한화솔루션보통주
5711,9830,2019-10-30,0.0415430267062314,16850,16150,-700,1642337,9830.0,한화솔루션보통주
5712,9830,2019-08-16,0.0404624277456647,17300,16600,-700,862261,9830.0,한화솔루션보통주
5713,9830,2019-08-07,0.0554016620498614,18050,17050,-1000,1032635,9830.0,한화솔루션보통주
5714,9830,2019-06-19,0.0867469879518072,20750,22550,1800,2999747,9830.0,한화솔루션보통주
5715,9830,2019-05-22,0.0404761904761904,21000,21850,850,996198,9830.0,한화솔루션보통주
5716,9830,2019-05-15,0.0539215686274509,20400,21500,1100,949537,9830.0,한화솔루션보통주
5717,9830,2019-04-29,0.0473815461346633,20050,21000,950,676153,9830.0,한화솔루션보통주
5718,9830,2019-04-18,0.0420353982300885,22600,21650,-950,863641,9830.0,한화솔루션보통주
5719,9830,2019-04-01,0.0406698564593301,20900,21750,850,800513,9830.0,한화솔루션보통주
5720,9830,2019-02-20,0.0642201834862385,21800,23200,1400,3490382,9830.0,한화솔루션보통주
5721,9830,2019-01-11,0.0594059405940594,20200,21400,1200,2176714,9830.0,한화솔루션보통주
5722,9830,2019-01-09,0.0412371134020618,19400,20200,800,770974,9830.0,한화솔루션보통주
5723,9830,2019-01-03,0.0404040404040404,19800,19000,-800,1282979,9830.0,한화솔루션보통주
5724,9830,2018-12-06,0.0481283422459893,18700,19600,900,3177446,9830.0,한화솔루션보통주
5725,9830,2018-11-13,0.0621468926553672,17700,16600,-1100,2628573,9830.0,한화솔루션보통주
5726,9830,2018-11-02,0.1009174311926605,16350,18000,1650,2459409,9830.0,한화솔루션보통주
5727,9830,2018-10-31,0.0419354838709677,15500,16150,650,1160264,9830.0,한화솔루션보통주
5728,9830,2018-10-29,0.081081081081081,16650,15300,-1350,2333283,9830.0,한화솔루션보통주
5729,9830,2018-10-26,0.0403458213256484,17350,16650,-700,912288,9830.0,한화솔루션보통주
5730,9830,2018-10-22,0.042042042042042,16650,17350,700,839896,9830.0,한화솔루션보통주
5731,9830,2018-10-11,0.0668523676880222,17950,16750,-1200,1650365,9830.0,한화솔루션보통주
5732,9830,2018-10-10,0.0477453580901856,18850,17950,-900,1547807,9830.0,한화솔루션보통주
5733,9830,2018-09-11,0.0481012658227848,19750,18800,-950,3066919,9830.0,한화솔루션보통주
5734,9830,2018-08-29,0.0597014925373134,20100,21300,1200,3037760,9830.0,한화솔루션보통주
5735,9830,2018-08-03,0.0558252427184466,20600,21750,1150,1791916,9830.0,한화솔루션보통주
5736,9830,2018-07-27,0.0441176470588235,20400,21300,900,1221621,9830.0,한화솔루션보통주
5737,9830,2018-07-02,0.05720823798627,21850,20600,-1250,1248493,9830.0,한화솔루션보통주
5738,9830,2018-06-27,0.0507726269315673,22650,21500,-1150,1438092,9830.0,한화솔루션보통주
5739,9830,2018-06-19,0.0606694560669456,23900,22450,-1450,2496210,9830.0,한화솔루션보통주
5740,9830,2018-06-14,0.0410958904109589,25550,24500,-1050,1395185,9830.0,한화솔루션보통주
5741,9830,2018-05-10,0.0545454545454545,27500,29000,1500,1273757,9830.0,한화솔루션보통주
5742,9830,2018-04-05,0.0506993006993006,28600,30050,1450,924809,9830.0,한화솔루션보통주
5743,9830,2018-03-22,0.0408858603066439,29350,30550,1200,1108297,9830.0,한화솔루션보통주
5744,9830,2018-03-05,0.0434782608695652,32200,30800,-1400,1293571,9830.0,한화솔루션보통주
5745,9830,2018-02-23,0.0432098765432098,32400,33800,1400,1365757,9830.0,한화솔루션보통주
5746,9830,2018-02-19,0.0403100775193798,32250,33550,1300,731692,9830.0,한화솔루션보통주
5747,9830,2018-01-15,0.0568356374807987,32550,34400,1850,2349331,9830.0,한화솔루션보통주
5748,9830,2017-12-28,0.0411861614497528,30350,31600,1250,1202174,9830.0,한화솔루션보통주
5749,9830,2017-12-11,0.0468227424749163,29900,31300,1400,1420901,9830.0,한화솔루션보통주
5750,9830,2017-12-04,0.046712802768166,28900,30250,1350,1006704,9830.0,한화솔루션보통주
5751,9830,2017-11-16,0.0494037478705281,29350,30800,1450,1178656,9830.0,한화솔루션보통주
5752,9830,2017-10-30,0.0440251572327044,31800,30400,-1400,2251692,9830.0,한화솔루션보통주
5753,9830,2017-09-25,0.0926966292134831,35600,32300,-3300,3879110,9830.0,한화솔루션보통주
5754,9830,2017-08-14,0.0534124629080118,33700,35500,1800,2673780,9830.0,한화솔루션보통주
5755,9830,2017-07-31,0.0401234567901234,32400,33700,1300,1369363,9830.0,한화솔루션보통주
5756,9830,2017-06-20,0.0637931034482758,29000,30850,1850,4455044,9830.0,한화솔루션보통주
5757,9830,2017-05-11,0.0423076923076923,26000,27100,1100,3250927,9830.0,한화솔루션보통주
5758,9830,2017-03-28,0.0655737704918032,24400,26000,1600,3226519,9830.0,한화솔루션보통주
5759,9830,2017-01-31,0.0422018348623853,27250,26100,-1150,1280466,9830.0,한화솔루션보통주
5760,9830,2017-01-17,0.0613026819923371,26100,27700,1600,3234686,9830.0,한화솔루션보통주
5761,9830,2016-12-06,0.0446808510638297,23500,24550,1050,1467833,9830.0,한화솔루션보통주
5762,9830,2016-11-11,0.0438247011952191,25100,24000,-1100,2322179,9830.0,한화솔루션보통주
5763,9830,2016-11-09,0.1214285714285714,28000,24600,-3400,7755672,9830.0,한화솔루션보통주
5764,9830,2016-11-07,0.0575815738963531,26050,27550,1500,1604588,9830.0,한화솔루션보통주
5765,9830,2016-10-14,0.0471512770137524,25450,26650,1200,1948563,9830.0,한화솔루션보통주
5766,10060,2021-06-02,0.0595238095238095,126000,133500,7500,1096338,10060.0,OCI보통주
5767,10060,2021-05-28,0.0490566037735849,132500,126000,-6500,568819,10060.0,OCI보통주
5768,10060,2021-05-27,0.0772357723577235,123000,132500,9500,900650,10060.0,OCI보통주
5769,10060,2021-05-24,0.0470588235294117,127500,121500,-6000,246770,10060.0,OCI보통주
5770,10060,2021-05-17,0.055793991416309,116500,123000,6500,446093,10060.0,OCI보통주
5771,10060,2021-05-11,0.0489795918367346,122500,116500,-6000,445753,10060.0,OCI보통주
5772,10060,2021-04-29,0.0631970260223048,134500,126000,-8500,813959,10060.0,OCI보통주
5773,10060,2021-04-28,0.0494699646643109,141500,134500,-7000,926790,10060.0,OCI보통주
5774,10060,2021-04-22,0.1085271317829457,129000,143000,14000,1336224,10060.0,OCI보통주
5775,10060,2021-04-21,0.0408921933085501,134500,129000,-5500,389299,10060.0,OCI보통주
5776,10060,2021-04-16,0.0481927710843373,124500,130500,6000,574041,10060.0,OCI보통주
5777,10060,2021-04-07,0.0474137931034482,116000,121500,5500,545383,10060.0,OCI보통주
5778,10060,2021-03-29,0.072072072072072,111000,119000,8000,700755,10060.0,OCI보통주
5779,10060,2021-03-18,0.04,125000,120000,-5000,465759,10060.0,OCI보통주
5780,10060,2021-03-08,0.0909090909090909,137500,125000,-12500,878024,10060.0,OCI보통주
5781,10060,2021-03-05,0.0826771653543307,127000,137500,10500,1004283,10060.0,OCI보통주
5782,10060,2021-02-25,0.1290322580645161,108500,122500,14000,920751,10060.0,OCI보통주
5783,10060,2021-02-24,0.076595744680851,117500,108500,-9000,465723,10060.0,OCI보통주
5784,10060,2021-02-18,0.0598290598290598,117000,124000,7000,918553,10060.0,OCI보통주
5785,10060,2021-02-15,0.043859649122807,114000,119000,5000,801995,10060.0,OCI보통주
5786,10060,2021-02-10,0.1014492753623188,103500,114000,10500,1234575,10060.0,OCI보통주
5787,10060,2021-02-04,0.0420560747663551,107000,102500,-4500,344848,10060.0,OCI보통주
5788,10060,2021-02-01,0.1026422764227642,98400,108500,10100,1325140,10060.0,OCI보통주
5789,10060,2021-01-29,0.0446601941747572,103000,98400,-4600,376029,10060.0,OCI보통주
5790,10060,2021-01-19,0.0507614213197969,98500,103500,5000,318521,10060.0,OCI보통주
5791,10060,2021-01-15,0.0509259259259259,108000,102500,-5500,415417,10060.0,OCI보통주
5792,10060,2021-01-13,0.0485436893203883,103000,108000,5000,721012,10060.0,OCI보통주
5793,10060,2021-01-11,0.07429718875502,99600,107000,7400,1424904,10060.0,OCI보통주
5794,10060,2021-01-04,0.0591397849462365,93000,98500,5500,787830,10060.0,OCI보통주
5795,10060,2020-12-29,0.1208791208791208,81900,91800,9900,1174397,10060.0,OCI보통주
5796,10060,2020-12-28,0.0509849362688296,86300,81900,-4400,540817,10060.0,OCI보통주
5797,10060,2020-12-24,0.0498783454987834,82200,86300,4100,821613,10060.0,OCI보통주
5798,10060,2020-12-22,0.0605022831050228,87600,82300,-5300,861249,10060.0,OCI보통주
5799,10060,2020-12-21,0.140625,76800,87600,10800,1531675,10060.0,OCI보통주
5800,10060,2020-12-17,0.0685314685314685,71500,76400,4900,1300607,10060.0,OCI보통주
5801,10060,2020-12-16,0.0483870967741935,68200,71500,3300,722044,10060.0,OCI보통주
5802,10060,2020-12-02,0.0463096960926193,69100,72300,3200,613020,10060.0,OCI보통주
5803,10060,2020-11-09,0.0614439324116743,65100,69100,4000,873547,10060.0,OCI보통주
5804,10060,2020-11-05,0.083752093802345,59700,64700,5000,1207534,10060.0,OCI보통주
5805,10060,2020-11-04,0.0829493087557603,65100,59700,-5400,1286912,10060.0,OCI보통주
5806,10060,2020-11-02,0.0485436893203883,61800,64800,3000,390840,10060.0,OCI보통주
5807,10060,2020-10-30,0.066465256797583,66200,61800,-4400,632086,10060.0,OCI보통주
5808,10060,2020-10-28,0.0829187396351575,60300,65300,5000,1131502,10060.0,OCI보통주
5809,10060,2020-10-26,0.0414673046251993,62700,60100,-2600,251607,10060.0,OCI보통주
5810,10060,2020-10-21,0.0453781512605042,59500,62200,2700,277067,10060.0,OCI보통주
5811,10060,2020-10-08,0.0862944162436548,59100,64200,5100,1182112,10060.0,OCI보통주
5812,10060,2020-10-05,0.043859649122807,57000,59500,2500,261552,10060.0,OCI보통주
5813,10060,2020-09-24,0.0477031802120141,56600,53900,-2700,570597,10060.0,OCI보통주
5814,10060,2020-09-21,0.0445859872611464,62800,60000,-2800,336753,10060.0,OCI보통주
5815,10060,2020-09-17,0.0535168195718654,65400,61900,-3500,677681,10060.0,OCI보통주
5816,10060,2020-09-11,0.0557103064066852,71800,67800,-4000,556004,10060.0,OCI보통주
5817,10060,2020-08-27,0.0698689956331877,68700,63900,-4800,831801,10060.0,OCI보통주
5818,10060,2020-08-24,0.1160130718954248,61200,68300,7100,1882621,10060.0,OCI보통주
5819,10060,2020-08-19,0.0744680851063829,56400,60600,4200,690872,10060.0,OCI보통주
5820,10060,2020-08-18,0.0738916256157635,60900,56400,-4500,502935,10060.0,OCI보통주
5821,10060,2020-08-10,0.0553745928338762,61400,64800,3400,1036574,10060.0,OCI보통주
5822,10060,2020-08-06,0.0452418096723869,64100,61200,-2900,840966,10060.0,OCI보통주
5823,10060,2020-08-05,0.1245614035087719,57000,64100,7100,2991692,10060.0,OCI보통주
5824,10060,2020-08-04,0.0458715596330275,54500,57000,2500,544493,10060.0,OCI보통주
5825,10060,2020-07-29,0.0434782608695652,52900,55200,2300,1251127,10060.0,OCI보통주
5826,10060,2020-07-24,0.0597539543057996,56900,53500,-3400,1241635,10060.0,OCI보통주
5827,10060,2020-07-23,0.0548172757475083,60200,56900,-3300,1503331,10060.0,OCI보통주
5828,10060,2020-07-21,0.2995594713656387,45400,59000,13600,4869651,10060.0,OCI보통주
5829,10060,2020-07-20,0.0424799081515499,43550,45400,1850,307058,10060.0,OCI보통주
5830,10060,2020-07-14,0.0650319829424307,46900,43850,-3050,508168,10060.0,OCI보통주
5831,10060,2020-07-10,0.0463157894736842,47500,45300,-2200,730005,10060.0,OCI보통주
5832,10060,2020-07-09,0.1072261072261072,42900,47500,4600,2547860,10060.0,OCI보통주
5833,10060,2020-07-06,0.0407911001236094,40450,42100,1650,386172,10060.0,OCI보통주
5834,10060,2020-07-02,0.075880758807588,36900,39700,2800,761643,10060.0,OCI보통주
5835,10060,2020-06-16,0.0759668508287292,36200,38950,2750,231698,10060.0,OCI보통주
5836,10060,2020-06-15,0.0670103092783505,38800,36200,-2600,350742,10060.0,OCI보통주
5837,10060,2020-06-12,0.0501835985312117,40850,38800,-2050,377610,10060.0,OCI보통주
5838,10060,2020-06-03,0.04551201011378,39550,41350,1800,677117,10060.0,OCI보통주
5839,10060,2020-05-29,0.091118800461361,43350,39400,-3950,1911489,10060.0,OCI보통주
5840,10060,2020-05-26,0.0728155339805825,41200,44200,3000,510138,10060.0,OCI보통주
5841,10060,2020-05-22,0.0508083140877598,43300,41100,-2200,414590,10060.0,OCI보통주
5842,10060,2020-05-21,0.0920554854981084,39650,43300,3650,1666180,10060.0,OCI보통주
5843,10060,2020-05-11,0.0402439024390243,41000,39350,-1650,220940,10060.0,OCI보통주
5844,10060,2020-05-08,0.056701030927835,38800,41000,2200,254570,10060.0,OCI보통주
5845,10060,2020-04-27,0.0529100529100529,37800,39800,2000,209235,10060.0,OCI보통주
5846,10060,2020-04-09,0.0476190476190476,36750,38500,1750,217027,10060.0,OCI보통주
5847,10060,2020-04-06,0.0447330447330447,34650,36200,1550,186350,10060.0,OCI보통주
5848,10060,2020-03-25,0.1077943615257048,30150,33400,3250,381662,10060.0,OCI보통주
5849,10060,2020-03-24,0.1125461254612546,27100,30150,3050,286104,10060.0,OCI보통주
5850,10060,2020-03-23,0.1056105610561056,30300,27100,-3200,265349,10060.0,OCI보통주
5851,10060,2020-03-20,0.1390977443609022,26600,30300,3700,441636,10060.0,OCI보통주
5852,10060,2020-03-19,0.2106824925816023,33700,26600,-7100,613687,10060.0,OCI보통주
5853,10060,2020-03-18,0.0703448275862069,36250,33700,-2550,268644,10060.0,OCI보통주
5854,10060,2020-03-13,0.0921212121212121,41250,37450,-3800,500873,10060.0,OCI보통주
5855,10060,2020-03-12,0.0963855421686747,45650,41250,-4400,541456,10060.0,OCI보통주
5856,10060,2020-03-09,0.064453125,51200,47900,-3300,250363,10060.0,OCI보통주
5857,10060,2020-02-28,0.0601145038167938,52400,49250,-3150,494824,10060.0,OCI보통주
5858,10060,2020-02-24,0.0588235294117647,56100,52800,-3300,252175,10060.0,OCI보통주
5859,10060,2020-02-11,0.1188455008488964,58900,65900,7000,1336793,10060.0,OCI보통주
5860,10060,2020-02-06,0.0748175182481751,54800,58900,4100,310638,10060.0,OCI보통주
5861,10060,2020-01-28,0.0603174603174603,63000,59200,-3800,234021,10060.0,OCI보통주
5862,10060,2020-01-08,0.0487012987012987,61600,58600,-3000,210974,10060.0,OCI보통주
5863,10060,2019-09-30,0.0419790104947526,66700,69500,2800,125369,10060.0,OCI보통주
5864,10060,2019-09-25,0.0524137931034482,72500,68700,-3800,207697,10060.0,OCI보통주
5865,10060,2019-09-11,0.0550724637681159,69000,72800,3800,331695,10060.0,OCI보통주
5866,10060,2019-08-16,0.0427098674521354,67900,65000,-2900,186775,10060.0,OCI보통주
5867,10060,2019-08-05,0.0536451169188445,72700,68800,-3900,201301,10060.0,OCI보통주
5868,10060,2019-07-29,0.0448318804483188,80300,76700,-3600,333390,10060.0,OCI보통주
5869,10060,2019-07-26,0.08646188850967,87900,80300,-7600,416543,10060.0,OCI보통주
5870,10060,2019-07-15,0.0523321956769055,87900,92500,4600,170452,10060.0,OCI보통주
5871,10060,2019-07-10,0.0459518599562363,91400,87200,-4200,152255,10060.0,OCI보통주
5872,10060,2019-03-07,0.05,104000,98800,-5200,319596,10060.0,OCI보통주
5873,10060,2019-02-25,0.0492610837438423,101500,106500,5000,445512,10060.0,OCI보통주
5874,10060,2019-02-12,0.0553398058252427,103000,97300,-5700,458017,10060.0,OCI보통주
5875,10060,2019-01-03,0.1333333333333333,106500,92300,-14200,721402,10060.0,OCI보통주
5876,10060,2018-12-26,0.0675675675675675,111000,103500,-7500,206823,10060.0,OCI보통주
5877,10060,2018-12-12,0.0568720379146919,105500,111500,6000,281241,10060.0,OCI보통주
5878,10060,2018-12-10,0.0414746543778801,108500,104000,-4500,89715,10060.0,OCI보통주
5879,10060,2018-11-28,0.075,100000,107500,7500,252822,10060.0,OCI보통주
5880,10060,2018-11-05,0.0993657505285412,94600,104000,9400,626482,10060.0,OCI보통주
5881,10060,2018-11-02,0.0823798627002288,87400,94600,7200,314662,10060.0,OCI보통주
5882,10060,2018-10-26,0.0753655793025871,88900,82200,-6700,400277,10060.0,OCI보통주
5883,10060,2018-10-18,0.0616161616161616,99000,92900,-6100,329611,10060.0,OCI보통주
5884,10060,2018-10-12,0.0494450050454086,99100,104000,4900,202302,10060.0,OCI보통주
5885,10060,2018-10-11,0.0781395348837209,107500,99100,-8400,403154,10060.0,OCI보통주
5886,10060,2018-10-02,0.0405405405405405,111000,115500,4500,291393,10060.0,OCI보통주
5887,10060,2018-09-12,0.0488888888888888,112500,118000,5500,205571,10060.0,OCI보통주
5888,10060,2018-09-03,0.0432900432900432,115500,120500,5000,367169,10060.0,OCI보통주
5889,10060,2018-08-27,0.0502283105022831,109500,115000,5500,340238,10060.0,OCI보통주
5890,10060,2018-08-20,0.0409090909090909,110000,114500,4500,407815,10060.0,OCI보통주
5891,10060,2018-08-17,0.0576923076923076,104000,110000,6000,600563,10060.0,OCI보통주
5892,10060,2018-08-09,0.0686274509803921,102000,109000,7000,826514,10060.0,OCI보통주
5893,10060,2018-08-02,0.0407766990291262,103000,98800,-4200,286372,10060.0,OCI보통주
5894,10060,2018-08-01,0.0425101214574898,98800,103000,4200,354205,10060.0,OCI보통주
5895,10060,2018-07-27,0.0844017094017094,93600,101500,7900,663209,10060.0,OCI보통주
5896,10060,2018-06-29,0.041860465116279,107500,103000,-4500,318887,10060.0,OCI보통주
5897,10060,2018-06-28,0.048780487804878,102500,107500,5000,454962,10060.0,OCI보통주
5898,10060,2018-06-27,0.0420560747663551,107000,102500,-4500,302579,10060.0,OCI보통주
5899,10060,2018-06-04,0.0839694656488549,131000,120000,-11000,1042181,10060.0,OCI보통주
5900,10060,2018-05-30,0.0642857142857142,140000,131000,-9000,448549,10060.0,OCI보통주
5901,10060,2018-05-24,0.0456026058631921,153500,146500,-7000,313795,10060.0,OCI보통주
5902,10060,2018-05-10,0.0771812080536912,149000,160500,11500,285620,10060.0,OCI보통주
5903,10060,2018-05-04,0.0443037974683544,158000,151000,-7000,204733,10060.0,OCI보통주
5904,10060,2018-04-25,0.0538922155688622,167000,158000,-9000,1348677,10060.0,OCI보통주
5905,10060,2018-04-11,0.0464396284829721,161500,169000,7500,250032,10060.0,OCI보통주
5906,10060,2018-04-05,0.05,160000,168000,8000,413007,10060.0,OCI보통주
5907,10060,2018-03-28,0.0526315789473684,161500,153000,-8500,334475,10060.0,OCI보통주
5908,10060,2018-03-26,0.0536277602523659,158500,167000,8500,411665,10060.0,OCI보통주
5909,10060,2018-03-22,0.1013986013986013,143000,157500,14500,706620,10060.0,OCI보통주
5910,10060,2018-03-13,0.0416666666666666,156000,149500,-6500,391576,10060.0,OCI보통주
5911,10060,2018-03-05,0.073170731707317,164000,152000,-12000,330441,10060.0,OCI보통주
5912,10060,2018-02-07,0.0441640378548895,158500,151500,-7000,489009,10060.0,OCI보통주
5913,10060,2018-02-06,0.0462046204620462,151500,158500,7000,841885,10060.0,OCI보통주
5914,10060,2018-02-01,0.0739644970414201,169000,156500,-12500,665963,10060.0,OCI보통주
5915,10060,2018-01-29,0.0412698412698412,157500,164000,6500,326453,10060.0,OCI보통주
5916,10060,2018-01-24,0.1229050279329608,179000,157000,-22000,934493,10060.0,OCI보통주
5917,10060,2018-01-23,0.0560471976401179,169500,179000,9500,467101,10060.0,OCI보통주
5918,10060,2018-01-11,0.0616621983914209,186500,175000,-11500,830070,10060.0,OCI보통주
5919,10060,2018-01-10,0.1303030303030303,165000,186500,21500,960766,10060.0,OCI보통주
5920,10060,2018-01-04,0.0761245674740484,144500,155500,11000,834460,10060.0,OCI보통주
5921,10060,2018-01-03,0.0625,136000,144500,8500,605301,10060.0,OCI보통주
5922,10060,2017-12-28,0.0542635658914728,129000,136000,7000,369226,10060.0,OCI보통주
5923,10060,2017-11-28,0.0610687022900763,131000,123000,-8000,459412,10060.0,OCI보통주
5924,10060,2017-11-15,0.0433070866141732,127000,121500,-5500,390768,10060.0,OCI보통주
5925,10060,2017-11-01,0.1061946902654867,113000,125000,12000,1151816,10060.0,OCI보통주
5926,10060,2017-10-18,0.045,100000,104500,4500,361108,10060.0,OCI보통주
5927,10060,2017-10-10,0.0526829268292682,102500,97100,-5400,592089,10060.0,OCI보통주
5928,10060,2017-09-14,0.0541871921182266,101500,107000,5500,700930,10060.0,OCI보통주
5929,10060,2017-09-06,0.0483870967741935,99200,104000,4800,665879,10060.0,OCI보통주
5930,10060,2017-07-27,0.0472895040369088,86700,90800,4100,679669,10060.0,OCI보통주
5931,10060,2017-07-12,0.0421892816419612,87700,84000,-3700,418011,10060.0,OCI보통주
5932,10060,2017-05-16,0.0445246690734055,83100,86800,3700,1242280,10060.0,OCI보통주
5933,10060,2017-03-07,0.0459492140266021,82700,86500,3800,221057,10060.0,OCI보통주
5934,10060,2017-02-08,0.0705882352941176,85000,91000,6000,674893,10060.0,OCI보통주
5935,10060,2017-02-01,0.0454545454545454,85800,89700,3900,213840,10060.0,OCI보통주
5936,10060,2017-01-17,0.0883435582822085,81500,88700,7200,904517,10060.0,OCI보통주
5937,10060,2016-12-16,0.0653266331658291,79600,74400,-5200,451290,10060.0,OCI보통주
5938,10060,2016-12-02,0.044041450777202,77200,73800,-3400,168656,10060.0,OCI보통주
5939,10060,2016-12-01,0.0489130434782608,73600,77200,3600,298901,10060.0,OCI보통주
5940,10060,2016-11-24,0.0794223826714801,83100,76500,-6600,529831,10060.0,OCI보통주
5941,10060,2016-11-09,0.1596059113300492,101500,85300,-16200,1755232,10060.0,OCI보통주
5942,10060,2016-11-07,0.0876623376623376,92400,100500,8100,347076,10060.0,OCI보통주
5943,10060,2016-11-03,0.0493273542600896,89200,93600,4400,167280,10060.0,OCI보통주
5944,10060,2016-10-26,0.0607843137254901,102000,95800,-6200,438299,10060.0,OCI보통주
5945,10060,2016-10-14,0.0556745182012847,93400,98600,5200,340577,10060.0,OCI보통주
5946,10060,2016-10-13,0.0594159113796576,99300,93400,-5900,358161,10060.0,OCI보통주
5947,10060,2016-09-29,0.1155192532088681,85700,95600,9900,1238789,10060.0,OCI보통주
5948,10060,2016-09-26,0.0509950248756218,80400,84500,4100,362093,10060.0,OCI보통주
5949,10120,2021-03-09,0.0660550458715596,54500,58100,3600,281046,10120.0,LS ELECTRIC보통주
5950,10120,2021-02-26,0.0400667779632721,59900,57500,-2400,191700,10120.0,LS ELECTRIC보통주
5951,10120,2021-01-29,0.0450310559006211,64400,61500,-2900,363252,10120.0,LS ELECTRIC보통주
5952,10120,2021-01-28,0.0430906389301634,67300,64400,-2900,266697,10120.0,LS ELECTRIC보통주
5953,10120,2021-01-19,0.0442073170731707,65600,68500,2900,219416,10120.0,LS ELECTRIC보통주
5954,10120,2021-01-07,0.1393188854489164,64600,73600,9000,1136816,10120.0,LS ELECTRIC보통주
5955,10120,2020-12-22,0.0640625,64000,59900,-4100,358437,10120.0,LS ELECTRIC보통주
5956,10120,2020-12-21,0.0702341137123745,59800,64000,4200,495405,10120.0,LS ELECTRIC보통주
5957,10120,2020-12-10,0.0522522522522522,55500,58400,2900,650394,10120.0,LS ELECTRIC보통주
5958,10120,2020-12-09,0.0551330798479087,52600,55500,2900,330857,10120.0,LS ELECTRIC보통주
5959,10120,2020-11-23,0.0505415162454873,55400,58200,2800,392966,10120.0,LS ELECTRIC보통주
5960,10120,2020-11-09,0.0525291828793774,51400,54100,2700,262233,10120.0,LS ELECTRIC보통주
5961,10120,2020-11-05,0.04,50000,52000,2000,190472,10120.0,LS ELECTRIC보통주
5962,10120,2020-10-08,0.0532646048109965,58200,61300,3100,403270,10120.0,LS ELECTRIC보통주
5963,10120,2020-10-05,0.047787610619469,56500,59200,2700,211949,10120.0,LS ELECTRIC보통주
5964,10120,2020-09-22,0.0547008547008547,58500,55300,-3200,227533,10120.0,LS ELECTRIC보통주
5965,10120,2020-09-08,0.0883190883190883,70200,64000,-6200,541738,10120.0,LS ELECTRIC보통주
5966,10120,2020-09-04,0.1672297297297297,59200,69100,9900,962836,10120.0,LS ELECTRIC보통주
5967,10120,2020-09-03,0.0459363957597173,56600,59200,2600,202273,10120.0,LS ELECTRIC보통주
5968,10120,2020-09-01,0.0499075785582255,54100,56800,2700,164389,10120.0,LS ELECTRIC보통주
5969,10120,2020-08-25,0.0428849902534113,51300,53500,2200,90711,10120.0,LS ELECTRIC보통주
5970,10120,2020-08-20,0.0401529636711281,52300,50200,-2100,134347,10120.0,LS ELECTRIC보통주
5971,10120,2020-08-18,0.0560578661844484,55300,52200,-3100,113168,10120.0,LS ELECTRIC보통주
5972,10120,2020-07-28,0.0633333333333333,60000,56200,-3800,311409,10120.0,LS ELECTRIC보통주
5973,10120,2020-07-23,0.0476190476190476,58800,61600,2800,251703,10120.0,LS ELECTRIC보통주
5974,10120,2020-07-22,0.0575539568345323,55600,58800,3200,252524,10120.0,LS ELECTRIC보통주
5975,10120,2020-07-13,0.0532663316582914,49750,52400,2650,164874,10120.0,LS ELECTRIC보통주
5976,10120,2020-06-24,0.0531561461794019,45150,47550,2400,204734,10120.0,LS ELECTRIC보통주
5977,10120,2020-06-16,0.0416666666666666,40800,42500,1700,125791,10120.0,LS ELECTRIC보통주
5978,10120,2020-06-15,0.0674285714285714,43750,40800,-2950,132101,10120.0,LS ELECTRIC보통주
5979,10120,2020-06-03,0.0543710021321961,46900,49450,2550,273224,10120.0,LS ELECTRIC보통주
5980,10120,2020-05-26,0.102803738317757,42800,47200,4400,299150,10120.0,LS ELECTRIC보통주
5981,10120,2020-05-21,0.0551282051282051,39000,41150,2150,200690,10120.0,LS ELECTRIC보통주
5982,10120,2020-04-07,0.0698630136986301,36500,39050,2550,152547,10120.0,LS ELECTRIC보통주
5983,10120,2020-04-06,0.0656934306569343,34250,36500,2250,122019,10120.0,LS ELECTRIC보통주
5984,10120,2020-03-31,0.0534351145038167,32750,34500,1750,175572,10120.0,LS ELECTRIC보통주
5985,10120,2020-03-26,0.0505050505050505,29700,31200,1500,262796,10120.0,LS ELECTRIC보통주
5986,10120,2020-03-25,0.0722021660649819,27700,29700,2000,263813,10120.0,LS ELECTRIC보통주
5987,10120,2020-03-24,0.0413533834586466,26600,27700,1100,258515,10120.0,LS ELECTRIC보통주
5988,10120,2020-03-23,0.102866779089376,29650,26600,-3050,193141,10120.0,LS ELECTRIC보통주
5989,10120,2020-03-20,0.1360153256704981,26100,29650,3550,161714,10120.0,LS ELECTRIC보통주
5990,10120,2020-03-19,0.1152542372881356,29500,26100,-3400,204582,10120.0,LS ELECTRIC보통주
5991,10120,2020-03-18,0.0723270440251572,31800,29500,-2300,206515,10120.0,LS ELECTRIC보통주
5992,10120,2020-03-17,0.068814055636896,34150,31800,-2350,210517,10120.0,LS ELECTRIC보통주
5993,10120,2020-03-16,0.0566298342541436,36200,34150,-2050,136240,10120.0,LS ELECTRIC보통주
5994,10120,2020-03-13,0.0717948717948717,39000,36200,-2800,167088,10120.0,LS ELECTRIC보통주
5995,10120,2020-03-12,0.0545454545454545,41250,39000,-2250,141781,10120.0,LS ELECTRIC보통주
5996,10120,2020-03-11,0.0484429065743944,43350,41250,-2100,76592,10120.0,LS ELECTRIC보통주
5997,10120,2020-02-28,0.0417582417582417,45500,43600,-1900,100121,10120.0,LS ELECTRIC보통주
5998,10120,2019-08-19,0.04959630911188,43350,45500,2150,51665,10120.0,LS ELECTRIC보통주
5999,10120,2019-05-28,0.04004329004329,46200,48050,1850,135181,10120.0,LS ELECTRIC보통주
6000,10120,2019-05-27,0.0405405405405405,44400,46200,1800,87820,10120.0,LS ELECTRIC보통주
6001,10120,2019-02-20,0.0477099236641221,52400,54900,2500,289427,10120.0,LS ELECTRIC보통주
6002,10120,2019-01-09,0.0451206715634837,47650,49800,2150,131528,10120.0,LS ELECTRIC보통주
6003,10120,2019-01-07,0.0432432432432432,46250,48250,2000,119444,10120.0,LS ELECTRIC보통주
6004,10120,2018-12-10,0.0522388059701492,53600,50800,-2800,113550,10120.0,LS ELECTRIC보통주
6005,10120,2018-12-07,0.0428015564202334,51400,53600,2200,126946,10120.0,LS ELECTRIC보통주
6006,10120,2018-11-20,0.0409356725146198,51300,49200,-2100,183173,10120.0,LS ELECTRIC보통주
6007,10120,2018-11-07,0.0404339250493096,50700,48650,-2050,200609,10120.0,LS ELECTRIC보통주
6008,10120,2018-11-05,0.0469924812030075,53200,50700,-2500,209527,10120.0,LS ELECTRIC보통주
6009,10120,2018-11-02,0.0451866404715127,50900,53200,2300,198450,10120.0,LS ELECTRIC보통주
6010,10120,2018-10-29,0.1619127516778523,59600,49950,-9650,537235,10120.0,LS ELECTRIC보통주
6011,10120,2018-10-08,0.0409604519774011,70800,67900,-2900,133715,10120.0,LS ELECTRIC보통주
6012,10120,2018-08-06,0.0404312668463611,74200,71200,-3000,102712,10120.0,LS ELECTRIC보통주
6013,10120,2018-07-27,0.0520833333333333,76800,72800,-4000,394065,10120.0,LS ELECTRIC보통주
6014,10120,2018-07-17,0.0461329715061058,73700,77100,3400,231920,10120.0,LS ELECTRIC보통주
6015,10120,2018-06-20,0.0540166204986149,72200,76100,3900,148947,10120.0,LS ELECTRIC보통주
6016,10120,2018-06-14,0.0503778337531486,79400,75400,-4000,158490,10120.0,LS ELECTRIC보통주
6017,10120,2018-05-29,0.0545229244114002,80700,76300,-4400,202445,10120.0,LS ELECTRIC보통주
6018,10120,2018-05-28,0.0994550408719346,73400,80700,7300,408835,10120.0,LS ELECTRIC보통주
6019,10120,2018-05-25,0.0541237113402061,77600,73400,-4200,342505,10120.0,LS ELECTRIC보통주
6020,10120,2018-05-14,0.0494791666666666,76800,80600,3800,409956,10120.0,LS ELECTRIC보통주
6021,10120,2018-05-10,0.0792507204610951,69400,74900,5500,354997,10120.0,LS ELECTRIC보통주
6022,10120,2018-05-08,0.0565275908479138,74300,70100,-4200,267436,10120.0,LS ELECTRIC보통주
6023,10120,2018-05-03,0.0679487179487179,78000,72700,-5300,344538,10120.0,LS ELECTRIC보통주
6024,10120,2018-05-02,0.1370262390670553,68600,78000,9400,768725,10120.0,LS ELECTRIC보통주
6025,10120,2018-04-30,0.0489296636085626,65400,68600,3200,352677,10120.0,LS ELECTRIC보통주
6026,10120,2018-03-12,0.0582010582010582,56700,60000,3300,221172,10120.0,LS ELECTRIC보통주
6027,10120,2018-02-19,0.0622710622710622,54600,58000,3400,239816,10120.0,LS ELECTRIC보통주
6028,10120,2018-02-05,0.040983606557377,61000,58500,-2500,289038,10120.0,LS ELECTRIC보통주
6029,10120,2018-02-02,0.1159420289855072,69000,61000,-8000,639583,10120.0,LS ELECTRIC보통주
6030,10120,2018-01-10,0.0536512667660208,67100,70700,3600,170879,10120.0,LS ELECTRIC보통주
6031,10120,2017-12-15,0.0773109243697479,59500,64100,4600,166447,10120.0,LS ELECTRIC보통주
6032,10120,2017-12-14,0.0525477707006369,62800,59500,-3300,107088,10120.0,LS ELECTRIC보통주
6033,10120,2017-12-13,0.0536912751677852,59600,62800,3200,102663,10120.0,LS ELECTRIC보통주
6034,10120,2017-10-31,0.0490367775831873,57100,59900,2800,233419,10120.0,LS ELECTRIC보통주
6035,10120,2017-07-24,0.0484171322160148,53700,56300,2600,154364,10120.0,LS ELECTRIC보통주
6036,10120,2017-01-31,0.0711562897077509,39350,42150,2800,235783,10120.0,LS ELECTRIC보통주
6037,10120,2016-10-28,0.0691676436107854,42650,39700,-2950,369116,10120.0,LS ELECTRIC보통주
6038,10130,2021-05-18,0.0494505494505494,455000,477500,22500,69019,10130.0,고려아연보통주
6039,10130,2021-05-10,0.0406147091108671,455500,474000,18500,119166,10130.0,고려아연보통주
6040,10130,2021-05-06,0.0462232243517474,443500,464000,20500,125707,10130.0,고려아연보통주
6041,10130,2021-04-29,0.0644028103044496,427000,454500,27500,313326,10130.0,고려아연보통주
6042,10130,2021-04-22,0.0454545454545454,418000,437000,19000,144277,10130.0,고려아연보통주
6043,10130,2021-02-24,0.0404157043879907,433000,415500,-17500,82728,10130.0,고려아연보통주
6044,10130,2021-02-01,0.0677339901477832,406000,433500,27500,182305,10130.0,고려아연보통주
6045,10130,2021-01-11,0.0409556313993174,439500,421500,-18000,198304,10130.0,고려아연보통주
6046,10130,2021-01-05,0.1271820448877805,401000,452000,51000,403605,10130.0,고려아연보통주
6047,10130,2020-12-21,0.0431565967940813,405500,423000,17500,100060,10130.0,고려아연보통주
6048,10130,2020-10-22,0.0418353576248313,370500,386000,15500,104078,10130.0,고려아연보통주
6049,10130,2020-09-28,0.0425240054869684,364500,380000,15500,36852,10130.0,고려아연보통주
6050,10130,2020-08-12,0.0410654827968923,450500,432000,-18500,132334,10130.0,고려아연보통주
6051,10130,2020-08-06,0.0538641686182669,427000,450000,23000,103885,10130.0,고려아연보통주
6052,10130,2020-08-05,0.0401948842874543,410500,427000,16500,99434,10130.0,고려아연보통주
6053,10130,2020-07-27,0.0884955752212389,395500,430500,35000,174593,10130.0,고려아연보통주
6054,10130,2020-07-22,0.0799457994579945,369000,398500,29500,257220,10130.0,고려아연보통주
6055,10130,2020-07-01,0.053731343283582,335000,353000,18000,72220,10130.0,고려아연보통주
6056,10130,2020-06-16,0.0701754385964912,342000,366000,24000,48490,10130.0,고려아연보통주
6057,10130,2020-06-15,0.0668485675306957,366500,342000,-24500,85127,10130.0,고려아연보통주
6058,10130,2020-05-04,0.0453367875647668,386000,368500,-17500,114221,10130.0,고려아연보통주
6059,10130,2020-04-16,0.0564102564102564,390000,412000,22000,78432,10130.0,고려아연보통주
6060,10130,2020-04-02,0.0578871201157742,345500,365500,20000,55880,10130.0,고려아연보통주
6061,10130,2020-03-25,0.0637982195845697,337000,358500,21500,86495,10130.0,고려아연보통주
6062,10130,2020-03-24,0.1423728813559322,295000,337000,42000,73129,10130.0,고려아연보통주
6063,10130,2020-03-19,0.0741324921135646,317000,293500,-23500,90482,10130.0,고려아연보통주
6064,10130,2020-03-18,0.1032531824611032,353500,317000,-36500,113397,10130.0,고려아연보통주
6065,10130,2020-03-09,0.0427350427350427,409500,392000,-17500,67829,10130.0,고려아연보통주
6066,10130,2020-02-19,0.0549199084668192,437000,461000,24000,110265,10130.0,고려아연보통주
6067,10130,2020-02-06,0.0851612903225806,387500,420500,33000,159287,10130.0,고려아연보통주
6068,10130,2019-08-08,0.0505287896592244,425500,447000,21500,57033,10130.0,고려아연보통주
6069,10130,2019-07-26,0.0403930131004366,458000,439500,-18500,60945,10130.0,고려아연보통주
6070,10130,2019-07-01,0.0441176470588235,476000,455000,-21000,67563,10130.0,고려아연보통주
6071,10130,2019-01-03,0.0412735849056603,424000,441500,17500,50422,10130.0,고려아연보통주
6072,10130,2018-11-13,0.0402930402930402,409500,426000,16500,105853,10130.0,고려아연보통주
6073,10130,2018-11-02,0.0547396528704939,374500,395000,20500,36350,10130.0,고려아연보통주
6074,10130,2018-09-13,0.0415617128463476,397000,413500,16500,68033,10130.0,고려아연보통주
6075,10130,2018-07-24,0.0493991989319092,374500,393000,18500,68441,10130.0,고려아연보통주
6076,10130,2018-07-10,0.0430686406460296,371500,387500,16000,39414,10130.0,고려아연보통주
6077,10130,2018-05-14,0.04,437500,455000,17500,54470,10130.0,고려아연보통주
6078,10130,2018-01-09,0.0601202404809619,499000,529000,30000,86740,10130.0,고려아연보통주
6079,10130,2017-10-27,0.0693877551020408,490000,524000,34000,93355,10130.0,고려아연보통주
6080,10130,2017-10-26,0.0613026819923371,522000,490000,-32000,134369,10130.0,고려아연보통주
6081,10130,2017-10-10,0.0494450050454086,495500,520000,24500,77152,10130.0,고려아연보통주
6082,10130,2017-08-17,0.0471204188481675,477500,500000,22500,80097,10130.0,고려아연보통주
6083,10130,2017-07-25,0.0470324748040313,446500,467500,21000,138557,10130.0,고려아연보통주
6084,10130,2017-02-07,0.1057494866529774,487000,435500,-51500,263301,10130.0,고려아연보통주
6085,10130,2017-01-11,0.0594369134515119,479500,508000,28500,85089,10130.0,고려아연보통주
6086,10130,2016-12-05,0.0468583599574014,469500,491500,22000,72929,10130.0,고려아연보통주
6087,10130,2016-11-14,0.0438775510204081,490000,468500,-21500,101756,10130.0,고려아연보통주
6088,10130,2016-10-25,0.0573857598299681,470500,443500,-27000,110352,10130.0,고려아연보통주
6089,10140,2021-06-01,0.052892561983471,6050,6370,320,37838069,10140.0,삼성중공업보통주
6090,10140,2021-05-06,0.1620111731843575,7160,6000,-1160,86311678,10140.0,삼성중공업보통주
6091,10140,2021-04-26,0.0421348314606741,7120,7420,300,11661016,10140.0,삼성중공업보통주
6092,10140,2021-03-31,0.0528455284552845,7380,7770,390,28523314,10140.0,삼성중공업보통주
6093,10140,2021-03-26,0.0600292825768667,6830,7240,410,49173711,10140.0,삼성중공업보통주
6094,10140,2021-03-24,0.0588235294117647,6460,6840,380,18784631,10140.0,삼성중공업보통주
6095,10140,2021-02-01,0.0466988727858293,6210,6500,290,5002573,10140.0,삼성중공업보통주
6096,10140,2021-01-29,0.0431432973805855,6490,6210,-280,6739849,10140.0,삼성중공업보통주
6097,10140,2020-11-23,0.1569282136894824,5990,6930,940,164797515,10140.0,삼성중공업보통주
6098,10140,2020-11-16,0.0582362728785357,6010,6360,350,16357782,10140.0,삼성중공업보통주
6099,10140,2020-11-10,0.05,5600,5880,280,22827650,10140.0,삼성중공업보통주
6100,10140,2020-11-09,0.0831721470019342,5170,5600,430,16670623,10140.0,삼성중공업보통주
6101,10140,2020-09-07,0.0578034682080924,5190,5490,300,11770081,10140.0,삼성중공업보통주
6102,10140,2020-08-25,0.0425531914893617,5170,5390,220,5981996,10140.0,삼성중공업보통주
6103,10140,2020-08-20,0.0607734806629834,5430,5100,-330,6376963,10140.0,삼성중공업보통주
6104,10140,2020-08-18,0.0626086956521739,5750,5390,-360,6106960,10140.0,삼성중공업보통주
6105,10140,2020-08-11,0.0440366972477064,5450,5690,240,9897702,10140.0,삼성중공업보통주
6106,10140,2020-08-03,0.0611888111888111,5720,5370,-350,10302925,10140.0,삼성중공업보통주
6107,10140,2020-07-21,0.0585106382978723,5640,5970,330,28432176,10140.0,삼성중공업보통주
6108,10140,2020-07-10,0.04,5750,5520,-230,5445413,10140.0,삼성중공업보통주
6109,10140,2020-06-16,0.0595041322314049,6050,6410,360,12867859,10140.0,삼성중공업보통주
6110,10140,2020-06-15,0.0983606557377049,6710,6050,-660,19737027,10140.0,삼성중공업보통주
6111,10140,2020-06-03,0.1833616298811545,5890,6970,1080,112218100,10140.0,삼성중공업보통주
6112,10140,2020-06-02,0.1827309236947791,4980,5890,910,65095218,10140.0,삼성중공업보통주
6113,10140,2020-05-27,0.115296803652968,4380,4885,505,46344404,10140.0,삼성중공업보통주
6114,10140,2020-05-25,0.0495767835550181,4135,4340,205,8697158,10140.0,삼성중공업보통주
6115,10140,2020-05-19,0.0493827160493827,4050,4250,200,7491196,10140.0,삼성중공업보통주
6116,10140,2020-04-29,0.0476772616136919,4090,4285,195,10054461,10140.0,삼성중공업보통주
6117,10140,2020-04-13,0.0488888888888888,4500,4280,-220,6749487,10140.0,삼성중공업보통주
6118,10140,2020-04-06,0.045679012345679,4050,4235,185,7587278,10140.0,삼성중공업보통주
6119,10140,2020-04-02,0.0574412532637075,3830,4050,220,6150190,10140.0,삼성중공업보통주
6120,10140,2020-03-25,0.1390532544378698,3380,3850,470,17811521,10140.0,삼성중공업보통주
6121,10140,2020-03-24,0.0850722311396468,3115,3380,265,7976385,10140.0,삼성중공업보통주
6122,10140,2020-03-23,0.1048850574712643,3480,3115,-365,7400603,10140.0,삼성중공업보통주
6123,10140,2020-03-20,0.0481927710843373,3320,3480,160,11535243,10140.0,삼성중공업보통주
6124,10140,2020-03-19,0.1286089238845144,3810,3320,-490,12107486,10140.0,삼성중공업보통주
6125,10140,2020-03-18,0.072992700729927,4110,3810,-300,7340315,10140.0,삼성중공업보통주
6126,10140,2020-03-16,0.0551090700344431,4355,4115,-240,8090165,10140.0,삼성중공업보통주
6127,10140,2020-03-13,0.1255020080321285,4980,4355,-625,18096082,10140.0,삼성중공업보통주
6128,10140,2020-03-12,0.081180811808118,5420,4980,-440,9370399,10140.0,삼성중공업보통주
6129,10140,2020-03-09,0.121311475409836,6100,5360,-740,13781433,10140.0,삼성중공업보통주
6130,10140,2020-02-28,0.0426929392446633,6090,5830,-260,4356891,10140.0,삼성중공업보통주
6131,10140,2020-02-24,0.0546875,6400,6050,-350,4329219,10140.0,삼성중공업보통주
6132,10140,2020-02-06,0.0669781931464174,6420,6850,430,6990985,10140.0,삼성중공업보통주
6133,10140,2020-01-10,0.0448807854137447,7130,7450,320,5772540,10140.0,삼성중공업보통주
6134,10140,2019-11-25,0.0438066465256797,6620,6910,290,5466781,10140.0,삼성중공업보통주
6135,10140,2019-10-30,0.0584415584415584,7700,7250,-450,5817744,10140.0,삼성중공업보통주
6136,10140,2019-08-30,0.0884831460674157,7120,7750,630,6282075,10140.0,삼성중공업보통주
6137,10140,2019-08-20,0.046831955922865,7260,7600,340,5964673,10140.0,삼성중공업보통주
6138,10140,2019-08-19,0.0707964601769911,6780,7260,480,4665524,10140.0,삼성중공업보통주
6139,10140,2019-07-25,0.0551905387647831,7610,7190,-420,5459003,10140.0,삼성중공업보통주
6140,10140,2019-01-31,0.0459770114942528,8700,9100,400,22579819,10140.0,삼성중공업보통주
6141,10140,2019-01-28,0.0500625782227784,7990,8390,400,11925826,10140.0,삼성중공업보통주
6142,10140,2019-01-21,0.0473061760840998,7610,7970,360,6898974,10140.0,삼성중공업보통주
6143,10140,2018-12-27,0.042016806722689,7140,7440,300,3184508,10140.0,삼성중공업보통주
6144,10140,2018-12-26,0.053050397877984,7540,7140,-400,4587872,10140.0,삼성중공업보통주
6145,10140,2018-12-13,0.0770252324037184,7530,8110,580,12004191,10140.0,삼성중공업보통주
6146,10140,2018-11-16,0.0584958217270195,7180,7600,420,5276681,10140.0,삼성중공업보통주
6147,10140,2018-11-14,0.0430686406460296,7430,7110,-320,4358769,10140.0,삼성중공업보통주
6148,10140,2018-11-08,0.0573529411764705,6800,7190,390,4417623,10140.0,삼성중공업보통주
6149,10140,2018-11-02,0.0456692913385826,6350,6640,290,3922156,10140.0,삼성중공업보통주
6150,10140,2018-11-01,0.0876436781609195,6960,6350,-610,11091162,10140.0,삼성중공업보통주
6151,10140,2018-10-08,0.0691358024691358,8100,7540,-560,5832477,10140.0,삼성중공업보통주
6152,10140,2018-08-20,0.0558912386706948,6620,6990,370,7206085,10140.0,삼성중공업보통주
6153,10140,2018-08-14,0.04375,6400,6680,280,3411754,10140.0,삼성중공업보통주
6154,10140,2018-06-22,0.0402298850574712,6960,7240,280,3514880,10140.0,삼성중공업보통주
6155,10140,2018-05-28,0.0449871465295629,7780,7430,-350,9560626,10140.0,삼성중공업보통주
6156,10140,2018-05-08,0.0566037735849056,7420,7840,420,13181057,10140.0,삼성중공업보통주
6157,10140,2018-04-10,0.0571776155717761,8220,7750,-470,7709998,10140.0,삼성중공업보통주
6158,10140,2018-04-09,0.048469387755102,7840,8220,380,8381329,10140.0,삼성중공업보통주
6159,10140,2018-04-05,0.0416107382550335,7450,7760,310,5381441,10140.0,삼성중공업보통주
6160,10140,2018-03-14,0.047457627118644,8850,8430,-420,4778057,10140.0,삼성중공업보통주
6161,10140,2018-03-12,0.0747549019607843,8160,8770,610,7907387,10140.0,삼성중공업보통주
6162,10140,2018-03-08,0.0879265091863517,7620,8290,670,8522230,10140.0,삼성중공업보통주
6163,10140,2018-02-14,0.0521945432977461,8430,8870,440,2703964,10140.0,삼성중공업보통주
6164,10140,2018-02-06,0.0413043478260869,9200,8820,-380,6087551,10140.0,삼성중공업보통주
6165,10140,2018-01-25,0.076837416481069,8980,9670,690,13510266,10140.0,삼성중공업보통주
6166,10140,2018-01-23,0.0551724137931034,8700,9180,480,6340740,10140.0,삼성중공업보통주
6167,10140,2018-01-17,0.0420819490586932,9030,8650,-380,5776107,10140.0,삼성중공업보통주
6168,10140,2018-01-10,0.0811138014527845,8260,8930,670,11546984,10140.0,삼성중공업보통주
6169,10140,2018-01-04,0.0514800514800514,7770,8170,400,11274259,10140.0,삼성중공업보통주
6170,10140,2018-01-02,0.0436562073669849,7330,7650,320,5554598,10140.0,삼성중공업보통주
6171,10140,2017-12-28,0.0471428571428571,7000,7330,330,6911107,10140.0,삼성중공업보통주
6172,10140,2017-12-14,0.0462351387054161,7570,7220,-350,11494408,10140.0,삼성중공업보통주
6173,10140,2017-12-08,0.1116279069767441,8600,7640,-960,24268886,10140.0,삼성중공업보통주
6174,10140,2017-12-07,0.0401785714285714,8960,8600,-360,15384435,10140.0,삼성중공업보통주
6175,10140,2017-12-06,0.2888888888888888,12600,8960,-3640,42091497,10140.0,삼성중공업보통주
6176,10140,2017-11-27,0.0528455284552845,12300,11650,-650,8186195,10140.0,삼성중공업보통주
6177,10140,2017-11-22,0.0416666666666666,12000,12500,500,3649497,10140.0,삼성중공업보통주
6178,10140,2017-11-10,0.0490566037735849,13250,12600,-650,4783532,10140.0,삼성중공업보통주
6179,10140,2017-11-07,0.0532786885245901,12200,12850,650,7789213,10140.0,삼성중공업보통주
6180,10140,2017-11-03,0.0434782608695652,11500,12000,500,4107614,10140.0,삼성중공업보통주
6181,10140,2017-10-27,0.054054054054054,11100,11700,600,3756997,10140.0,삼성중공업보통주
6182,10140,2017-10-11,0.0547945205479452,10950,11550,600,3405093,10140.0,삼성중공업보통주
6183,10140,2017-09-26,0.0980392156862745,10200,11200,1000,5364571,10140.0,삼성중공업보통주
6184,10140,2017-09-22,0.0410958904109589,10950,10500,-450,2458593,10140.0,삼성중공업보통주
6185,10140,2017-09-15,0.0653266331658291,9950,10600,650,5438116,10140.0,삼성중공업보통주
6186,10140,2017-08-23,0.0430622009569378,10450,10900,450,2855796,10140.0,삼성중공업보통주
6187,10140,2017-08-01,0.0401785714285714,11200,11650,450,1897379,10140.0,삼성중공업보통주
6188,10140,2017-07-28,0.0495867768595041,12100,11500,-600,4216562,10140.0,삼성중공업보통주
6189,10140,2017-07-18,0.0416666666666666,12000,11500,-500,3560199,10140.0,삼성중공업보통주
6190,10140,2017-06-23,0.0404858299595141,12350,12850,500,3178325,10140.0,삼성중공업보통주
6191,10140,2017-06-13,0.065040650406504,12300,13100,800,7953616,10140.0,삼성중공업보통주
6192,10140,2017-05-25,0.0672268907563025,11900,12700,800,7548777,10140.0,삼성중공업보통주
6193,10140,2017-03-30,0.0519480519480519,11550,10950,-600,4980342,10140.0,삼성중공업보통주
6194,10140,2017-03-07,0.051063829787234,11750,12350,600,5272415,10140.0,삼성중공업보통주
6195,10140,2017-01-05,0.0535905680600214,9330,9830,500,6078466,10140.0,삼성중공업보통주
6196,10140,2016-12-12,0.0711111111111111,9000,9640,640,3959574,10140.0,삼성중공업보통주
6197,10140,2016-12-01,0.0590361445783132,8300,8790,490,3906321,10140.0,삼성중공업보통주
6198,10140,2016-11-24,0.0404949381327334,8890,8530,-360,2484057,10140.0,삼성중공업보통주
6199,10140,2016-11-14,0.0431415929203539,9040,9430,390,2146021,10140.0,삼성중공업보통주
6200,10140,2016-11-09,0.0432432432432432,9250,8850,-400,2332990,10140.0,삼성중공업보통주
6201,10140,2016-10-21,0.0527426160337552,9480,9980,500,4412671,10140.0,삼성중공업보통주
6202,10140,2016-08-23,0.0408163265306122,9800,10200,400,2509659,10140.0,삼성중공업보통주
6203,10140,2016-08-16,0.0600858369098712,9320,9880,560,4095185,10140.0,삼성중공업보통주
6204,10620,2021-06-01,0.0555555555555555,84600,89300,4700,800614,10620.0,현대미포조선보통주
6205,10620,2021-05-27,0.0669642857142857,89600,83600,-6000,1215693,10620.0,현대미포조선보통주
6206,10620,2021-05-20,0.0489882854100106,93900,89300,-4600,702904,10620.0,현대미포조선보통주
6207,10620,2021-05-06,0.1010830324909747,83100,91500,8400,941305,10620.0,현대미포조선보통주
6208,10620,2021-04-30,0.0929936305732484,78500,85800,7300,1963381,10620.0,현대미포조선보통주
6209,10620,2021-04-29,0.0438829787234042,75200,78500,3300,688625,10620.0,현대미포조선보통주
6210,10620,2021-04-26,0.092814371257485,66800,73000,6200,1010620,10620.0,현대미포조선보통주
6211,10620,2021-04-01,0.0403587443946188,66900,64200,-2700,451189,10620.0,현대미포조선보통주
6212,10620,2021-03-26,0.102076124567474,57800,63700,5900,1384604,10620.0,현대미포조선보통주
6213,10620,2021-03-15,0.0478632478632478,58500,61300,2800,955978,10620.0,현대미포조선보통주
6214,10620,2021-03-09,0.0693430656934306,54800,58600,3800,1217717,10620.0,현대미포조선보통주
6215,10620,2021-03-08,0.0498084291187739,52200,54800,2600,925264,10620.0,현대미포조선보통주
6216,10620,2021-02-15,0.0525252525252525,49500,52100,2600,686831,10620.0,현대미포조선보통주
6217,10620,2021-02-08,0.0584484590860786,47050,49800,2750,993103,10620.0,현대미포조선보통주
6218,10620,2021-02-01,0.0754060324825986,43100,46350,3250,506609,10620.0,현대미포조선보통주
6219,10620,2021-01-28,0.0421166306695464,46300,44350,-1950,477327,10620.0,현대미포조선보통주
6220,10620,2021-01-18,0.0409181636726546,50100,48050,-2050,554307,10620.0,현대미포조선보통주
6221,10620,2021-01-15,0.0402298850574712,52200,50100,-2100,561764,10620.0,현대미포조선보통주
6222,10620,2021-01-05,0.1150259067357512,48250,53800,5550,2122234,10620.0,현대미포조선보통주
6223,10620,2020-12-11,0.0830704521556256,47550,51500,3950,1211662,10620.0,현대미포조선보통주
6224,10620,2020-11-25,0.0527472527472527,45500,47900,2400,1426590,10620.0,현대미포조선보통주
6225,10620,2020-11-23,0.0743801652892562,42350,45500,3150,1938097,10620.0,현대미포조선보통주
6226,10620,2020-11-20,0.0789808917197452,39250,42350,3100,1077882,10620.0,현대미포조선보통주
6227,10620,2020-11-19,0.0438489646772229,41050,39250,-1800,1223764,10620.0,현대미포조선보통주
6228,10620,2020-11-16,0.1019283746556473,36300,40000,3700,1517480,10620.0,현대미포조선보통주
6229,10620,2020-11-09,0.1309328968903437,30550,34550,4000,1599622,10620.0,현대미포조선보통주
6230,10620,2020-10-26,0.0541012216404886,28650,30200,1550,454633,10620.0,현대미포조선보통주
6231,10620,2020-08-18,0.0625931445603576,33550,31450,-2100,313147,10620.0,현대미포조선보통주
6232,10620,2020-07-21,0.0473186119873817,31700,33200,1500,320929,10620.0,현대미포조선보통주
6233,10620,2020-06-16,0.0793650793650793,31500,34000,2500,200505,10620.0,현대미포조선보통주
6234,10620,2020-06-15,0.0856313497822931,34450,31500,-2950,385992,10620.0,현대미포조선보통주
6235,10620,2020-06-12,0.0496551724137931,36250,34450,-1800,383413,10620.0,현대미포조선보통주
6236,10620,2020-06-03,0.0713286713286713,35750,38300,2550,1188427,10620.0,현대미포조선보통주
6237,10620,2020-05-27,0.1166936790923825,30850,34450,3600,1808199,10620.0,현대미포조선보통주
6238,10620,2020-05-19,0.0415224913494809,28900,30100,1200,424125,10620.0,현대미포조선보통주
6239,10620,2020-05-06,0.042087542087542,29700,30950,1250,388023,10620.0,현대미포조선보통주
6240,10620,2020-04-29,0.0658578856152513,28850,30750,1900,690246,10620.0,현대미포조선보통주
6241,10620,2020-04-24,0.0413223140495867,30250,29000,-1250,306384,10620.0,현대미포조선보통주
6242,10620,2020-04-23,0.043103448275862,29000,30250,1250,497137,10620.0,현대미포조선보통주
6243,10620,2020-04-21,0.044189852700491,30550,29200,-1350,423547,10620.0,현대미포조선보통주
6244,10620,2020-04-13,0.0445151033386327,31450,30050,-1400,164053,10620.0,현대미포조선보통주
6245,10620,2020-04-06,0.0456140350877193,28500,29800,1300,242399,10620.0,현대미포조선보통주
6246,10620,2020-04-02,0.0433145009416195,26550,27700,1150,381097,10620.0,현대미포조선보통주
6247,10620,2020-03-31,0.0463320463320463,25900,27100,1200,260914,10620.0,현대미포조선보통주
6248,10620,2020-03-25,0.1488888888888888,22500,25850,3350,501072,10620.0,현대미포조선보통주
6249,10620,2020-03-24,0.0588235294117647,21250,22500,1250,316028,10620.0,현대미포조선보통주
6250,10620,2020-03-23,0.0760869565217391,23000,21250,-1750,207105,10620.0,현대미포조선보통주
6251,10620,2020-03-20,0.1219512195121951,20500,23000,2500,368445,10620.0,현대미포조선보통주
6252,10620,2020-03-19,0.1816367265469061,25050,20500,-4550,596172,10620.0,현대미포조선보통주
6253,10620,2020-03-18,0.0600375234521576,26650,25050,-1600,288182,10620.0,현대미포조선보통주
6254,10620,2020-03-13,0.0823723228995057,30350,27850,-2500,504342,10620.0,현대미포조선보통주
6255,10620,2020-03-12,0.0775075987841945,32900,30350,-2550,344530,10620.0,현대미포조선보통주
6256,10620,2020-03-09,0.1013698630136986,36500,32800,-3700,669264,10620.0,현대미포조선보통주
6257,10620,2020-02-24,0.0547770700636942,39250,37100,-2150,242099,10620.0,현대미포조선보통주
6258,10620,2020-02-06,0.0845771144278607,40200,43600,3400,444664,10620.0,현대미포조선보통주
6259,10620,2020-01-28,0.0451045104510451,45450,43400,-2050,199072,10620.0,현대미포조선보통주
6260,10620,2020-01-10,0.075,44000,47300,3300,436458,10620.0,현대미포조선보통주
6261,10620,2020-01-09,0.051373954599761,41850,44000,2150,201308,10620.0,현대미포조선보통주
6262,10620,2020-01-08,0.0510204081632653,44100,41850,-2250,238641,10620.0,현대미포조선보통주
6263,10620,2019-11-25,0.0422885572139303,40200,41900,1700,156233,10620.0,현대미포조선보통주
6264,10620,2019-10-30,0.0411111111111111,45000,43150,-1850,210145,10620.0,현대미포조선보통주
6265,10620,2019-10-08,0.068649885583524,43700,46700,3000,323891,10620.0,현대미포조선보통주
6266,10620,2019-09-09,0.0573770491803278,42700,45150,2450,367805,10620.0,현대미포조선보통주
6267,10620,2019-08-26,0.0414634146341463,41000,39300,-1700,171878,10620.0,현대미포조선보통주
6268,10620,2019-08-19,0.0673712021136063,37850,40400,2550,291652,10620.0,현대미포조선보통주
6269,10620,2019-08-06,0.041025641025641,39000,37400,-1600,582419,10620.0,현대미포조선보통주
6270,10620,2019-08-02,0.0436320754716981,42400,40550,-1850,309906,10620.0,현대미포조선보통주
6271,10620,2019-07-26,0.055745164960182,43950,41500,-2450,457641,10620.0,현대미포조선보통주
6272,10620,2019-07-25,0.052801724137931,46400,43950,-2450,448955,10620.0,현대미포조선보통주
6273,10620,2019-07-09,0.0486257928118393,47300,45000,-2300,309133,10620.0,현대미포조선보통주
6274,10620,2019-06-12,0.0463709677419354,49600,51900,2300,237227,10620.0,현대미포조선보통주
6275,10620,2019-05-09,0.0457875457875457,54600,52100,-2500,268230,10620.0,현대미포조선보통주
6276,10620,2019-03-26,0.0485611510791366,55600,58300,2700,254572,10620.0,현대미포조선보통주
6277,10620,2019-02-01,0.0557324840764331,62800,59300,-3500,1014744,10620.0,현대미포조선보통주
6278,10620,2019-01-31,0.0499243570347957,66100,62800,-3300,1041953,10620.0,현대미포조선보통주
6279,10620,2018-12-26,0.0505709624796084,61300,58200,-3100,563442,10620.0,현대미포조선보통주
6280,10620,2018-12-24,0.0421875,64000,61300,-2700,201328,10620.0,현대미포조선보통주
6281,10620,2018-12-13,0.0571895424836601,61200,64700,3500,481322,10620.0,현대미포조선보통주
6282,10620,2018-12-12,0.0408163265306122,58800,61200,2400,288977,10620.0,현대미포조선보통주
6283,10620,2018-11-16,0.086734693877551,98000,106500,8500,384572,10620.0,현대미포조선보통주
6284,10620,2018-11-06,0.0549450549450549,91000,96000,5000,228848,10620.0,현대미포조선보통주
6285,10620,2018-11-01,0.0723404255319148,94000,87200,-6800,366471,10620.0,현대미포조선보통주
6286,10620,2018-10-01,0.0434782608695652,103500,108000,4500,218904,10620.0,현대미포조선보통주
6287,10620,2018-09-27,0.0574948665297741,97400,103000,5600,317043,10620.0,현대미포조선보통주
6288,10620,2018-08-28,0.0507936507936507,94500,99300,4800,350826,10620.0,현대미포조선보통주
6289,10620,2018-08-22,0.0439077936333699,91100,95100,4000,393856,10620.0,현대미포조선보통주
6290,10620,2018-08-16,0.0510095642933049,94100,89300,-4800,194941,10620.0,현대미포조선보통주
6291,10620,2018-07-25,0.0416184971098265,86500,90100,3600,270260,10620.0,현대미포조선보통주
6292,10620,2018-07-23,0.0519801980198019,80800,85000,4200,209602,10620.0,현대미포조선보통주
6293,10620,2018-07-11,0.0567129629629629,86400,81500,-4900,325252,10620.0,현대미포조선보통주
6294,10620,2018-06-22,0.04778972520908,83700,87700,4000,177411,10620.0,현대미포조선보통주
6295,10620,2018-06-18,0.0502793296089385,89500,85000,-4500,272050,10620.0,현대미포조선보통주
6296,10620,2018-06-14,0.0422993492407809,92200,88300,-3900,218298,10620.0,현대미포조선보통주
6297,10620,2018-05-28,0.0414507772020725,96500,92500,-4000,256105,10620.0,현대미포조선보통주
6298,10620,2018-05-04,0.0531803962460896,95900,101000,5100,539266,10620.0,현대미포조선보통주
6299,10620,2018-05-03,0.0412595005428881,92100,95900,3800,272774,10620.0,현대미포조선보통주
6300,10620,2018-04-26,0.1058965102286401,83100,91900,8800,477375,10620.0,현대미포조선보통주
6301,10620,2018-04-05,0.0562162162162162,92500,97700,5200,223312,10620.0,현대미포조선보통주
6302,10620,2018-04-02,0.046,100000,95400,-4600,256506,10620.0,현대미포조선보통주
6303,10620,2018-03-21,0.0422535211267605,106500,111000,4500,174403,10620.0,현대미포조선보통주
6304,10620,2018-03-14,0.0530973451327433,113000,107000,-6000,233925,10620.0,현대미포조선보통주
6305,10620,2018-03-12,0.0654205607476635,107000,114000,7000,205453,10620.0,현대미포조선보통주
6306,10620,2018-03-06,0.0536585365853658,102500,108000,5500,146919,10620.0,현대미포조선보통주
6307,10620,2018-02-23,0.0594059405940594,101000,107000,6000,121787,10620.0,현대미포조선보통주
6308,10620,2018-02-13,0.0425120772946859,103500,99100,-4400,137769,10620.0,현대미포조선보통주
6309,10620,2018-02-07,0.0651162790697674,107500,100500,-7000,120823,10620.0,현대미포조선보통주
6310,10620,2018-02-05,0.0619469026548672,113000,106000,-7000,151966,10620.0,현대미포조선보통주
6311,10620,2018-01-23,0.048780487804878,102500,107500,5000,165063,10620.0,현대미포조선보통주
6312,10620,2018-01-10,0.0564853556485355,95600,101000,5400,359789,10620.0,현대미포조선보통주
6313,10620,2018-01-08,0.0544444444444444,90000,94900,4900,202052,10620.0,현대미포조선보통주
6314,10620,2018-01-02,0.0927573062261753,78700,86000,7300,291435,10620.0,현대미포조선보통주
6315,10620,2017-12-27,0.1618122977346278,92700,77700,-15000,861842,10620.0,현대미포조선보통주
6316,10620,2017-12-13,0.0494938132733408,88900,93300,4400,184651,10620.0,현대미포조선보통주
6317,10620,2017-12-08,0.0650054171180931,92300,86300,-6000,339655,10620.0,현대미포조선보통주
6318,10620,2017-12-06,0.0404858299595141,98800,94800,-4000,340908,10620.0,현대미포조선보통주
6319,10620,2017-12-05,0.071583514099783,92200,98800,6600,398332,10620.0,현대미포조선보통주
6320,10620,2017-11-13,0.0857142857142857,105000,96000,-9000,728917,10620.0,현대미포조선보통주
6321,10620,2017-11-10,0.054054054054054,111000,105000,-6000,504896,10620.0,현대미포조선보통주
6322,10620,2017-10-31,0.0742574257425742,101000,108500,7500,518705,10620.0,현대미포조선보통주
6323,10620,2017-10-16,0.0485537190082644,96800,101500,4700,220465,10620.0,현대미포조선보통주
6324,10620,2017-09-26,0.0500544069640914,91900,96500,4600,150294,10620.0,현대미포조선보통주
6325,10620,2017-09-22,0.0436548223350253,98500,94200,-4300,157635,10620.0,현대미포조선보통주
6326,10620,2017-09-19,0.0736842105263157,95000,102000,7000,293935,10620.0,현대미포조선보통주
6327,10620,2017-09-15,0.0553745928338762,92100,97200,5100,158490,10620.0,현대미포조선보통주
6328,10620,2017-09-12,0.0448087431693989,91500,95600,4100,144172,10620.0,현대미포조선보통주
6329,10620,2017-08-25,0.0555555555555555,99000,104500,5500,211969,10620.0,현대미포조선보통주
6330,10620,2017-08-01,0.055813953488372,107500,113500,6000,212601,10620.0,현대미포조선보통주
6331,10620,2017-07-21,0.0422535211267605,106500,111000,4500,236296,10620.0,현대미포조선보통주
6332,10620,2017-07-11,0.0430622009569378,104500,100000,-4500,225568,10620.0,현대미포조선보통주
6333,10620,2017-06-29,0.0485436893203883,103000,108000,5000,274002,10620.0,현대미포조선보통주
6334,10620,2017-06-26,0.0538116591928251,111500,105500,-6000,341794,10620.0,현대미포조선보통주
6335,10620,2017-06-14,0.0619469026548672,113000,120000,7000,476013,10620.0,현대미포조선보통주
6336,10620,2017-06-13,0.0610328638497652,106500,113000,6500,302439,10620.0,현대미포조선보통주
6337,10620,2017-06-09,0.0547263681592039,100500,106000,5500,276914,10620.0,현대미포조선보통주
6338,10620,2017-05-25,0.0572012257405515,97900,103500,5600,451047,10620.0,현대미포조선보통주
6339,10620,2017-04-26,0.0693970420932878,87900,94000,6100,415300,10620.0,현대미포조선보통주
6340,10620,2017-04-24,0.0523186682520808,84100,88500,4400,246269,10620.0,현대미포조선보통주
6341,10620,2017-04-13,0.043173862310385,85700,82000,-3700,287118,10620.0,현대미포조선보통주
6342,10620,2017-03-23,0.0731414868105515,83400,89500,6100,479256,10620.0,현대미포조선보통주
6343,10620,2017-03-16,0.0678851174934725,76600,81800,5200,491718,10620.0,현대미포조선보통주
6344,10620,2017-03-07,0.0551724137931034,72500,76500,4000,512313,10620.0,현대미포조선보통주
6345,10620,2017-02-28,0.0703812316715542,68200,73000,4800,585888,10620.0,현대미포조선보통주
6346,10620,2017-02-21,0.0564784053156146,60200,63600,3400,329349,10620.0,현대미포조선보통주
6347,10620,2017-01-04,0.0409356725146198,68400,65600,-2800,185081,10620.0,현대미포조선보통주
6348,10620,2016-12-12,0.0419790104947526,66700,69500,2800,241451,10620.0,현대미포조선보통주
6349,10620,2016-11-22,0.06,70000,65800,-4200,392919,10620.0,현대미포조선보통주
6350,10620,2016-11-16,0.0488888888888888,67500,70800,3300,524724,10620.0,현대미포조선보통주
6351,10620,2016-11-10,0.0431309904153354,62600,65300,2700,120291,10620.0,현대미포조선보통주
6352,10620,2016-11-09,0.0457317073170731,65600,62600,-3000,291471,10620.0,현대미포조선보통주
6353,10620,2016-11-07,0.0482866043613707,64200,67300,3100,127049,10620.0,현대미포조선보통주
6354,10620,2016-11-01,0.054054054054054,70300,66500,-3800,328489,10620.0,현대미포조선보통주
6355,10620,2016-10-26,0.0683544303797468,79000,73600,-5400,299495,10620.0,현대미포조선보통주
6356,10620,2016-10-07,0.0534045393858478,74900,78900,4000,279235,10620.0,현대미포조선보통주
6357,10620,2016-09-12,0.0593667546174142,75800,71300,-4500,234321,10620.0,현대미포조선보통주
6358,10620,2016-08-22,0.0546780072904009,82300,77800,-4500,191297,10620.0,현대미포조선보통주
6359,10620,2016-08-04,0.0466507177033492,83600,79700,-3900,155637,10620.0,현대미포조선보통주
6360,10780,2021-05-07,0.0560747663551401,64200,67800,3600,131425,10780.0,아이에스동서보통주
6361,10780,2021-04-23,0.0407523510971786,63800,66400,2600,165070,10780.0,아이에스동서보통주
6362,10780,2021-02-24,0.0439367311072056,56900,54400,-2500,141613,10780.0,아이에스동서보통주
6363,10780,2021-01-22,0.0867158671586715,54200,58900,4700,533331,10780.0,아이에스동서보통주
6364,10780,2021-01-19,0.0525291828793774,51400,54100,2700,187248,10780.0,아이에스동서보통주
6365,10780,2020-12-29,0.0470588235294117,51000,53400,2400,513449,10780.0,아이에스동서보통주
6366,10780,2020-12-10,0.0527383367139959,49300,51900,2600,424632,10780.0,아이에스동서보통주
6367,10780,2020-12-02,0.04004329004329,46200,48050,1850,277219,10780.0,아이에스동서보통주
6368,10780,2020-09-28,0.0638297872340425,37600,40000,2400,72789,10780.0,아이에스동서보통주
6369,10780,2020-09-24,0.0489949748743718,39800,37850,-1950,128043,10780.0,아이에스동서보통주
6370,10780,2020-08-20,0.0651162790697674,43000,40200,-2800,171369,10780.0,아이에스동서보통주
6371,10780,2020-08-18,0.1113467656415694,47150,41900,-5250,262613,10780.0,아이에스동서보통주
6372,10780,2020-08-04,0.0476190476190476,44100,46200,2100,212202,10780.0,아이에스동서보통주
6373,10780,2020-07-31,0.0519480519480519,46200,43800,-2400,313129,10780.0,아이에스동서보통주
6374,10780,2020-07-30,0.0454545454545454,48400,46200,-2200,198376,10780.0,아이에스동서보통주
6375,10780,2020-07-29,0.0408602150537634,46500,48400,1900,146507,10780.0,아이에스동서보통주
6376,10780,2020-07-27,0.0691192865105908,44850,47950,3100,285947,10780.0,아이에스동서보통주
6377,10780,2020-07-24,0.0478971962616822,42800,44850,2050,322602,10780.0,아이에스동서보통주
6378,10780,2020-07-22,0.0590500641848523,38950,41250,2300,295162,10780.0,아이에스동서보통주
6379,10780,2020-07-13,0.0520694259012016,37450,39400,1950,263749,10780.0,아이에스동서보통주
6380,10780,2020-07-09,0.0615835777126099,34100,36200,2100,360142,10780.0,아이에스동서보통주
6381,10780,2020-07-03,0.1139455782312925,29400,32750,3350,379384,10780.0,아이에스동서보통주
6382,10780,2020-06-16,0.1059245960502693,27850,30800,2950,194071,10780.0,아이에스동서보통주
6383,10780,2020-06-15,0.0559322033898305,29500,27850,-1650,147010,10780.0,아이에스동서보통주
6384,10780,2020-06-12,0.0544871794871794,31200,29500,-1700,253725,10780.0,아이에스동서보통주
6385,10780,2020-06-01,0.0503246753246753,30800,32350,1550,111668,10780.0,아이에스동서보통주
6386,10780,2020-05-26,0.0907504363001745,28650,31250,2600,344371,10780.0,아이에스동서보통주
6387,10780,2020-05-25,0.0730337078651685,26700,28650,1950,128327,10780.0,아이에스동서보통주
6388,10780,2020-05-19,0.0434782608695652,25300,26400,1100,120959,10780.0,아이에스동서보통주
6389,10780,2020-05-14,0.0402298850574712,26100,25050,-1050,84282,10780.0,아이에스동서보통주
6390,10780,2020-04-21,0.0438413361169102,23950,22900,-1050,117591,10780.0,아이에스동서보통주
6391,10780,2020-04-13,0.0633663366336633,25250,23650,-1600,96422,10780.0,아이에스동서보통주
6392,10780,2020-04-07,0.068230277185501,23450,25050,1600,134765,10780.0,아이에스동서보통주
6393,10780,2020-04-06,0.0515695067264574,22300,23450,1150,95781,10780.0,아이에스동서보통주
6394,10780,2020-04-01,0.042316258351893,22450,21500,-950,101207,10780.0,아이에스동서보통주
6395,10780,2020-03-25,0.1228501228501228,20350,22850,2500,124053,10780.0,아이에스동서보통주
6396,10780,2020-03-24,0.1029810298102981,18450,20350,1900,113576,10780.0,아이에스동서보통주
6397,10780,2020-03-23,0.075187969924812,19950,18450,-1500,151615,10780.0,아이에스동서보통주
6398,10780,2020-03-20,0.2276923076923077,16250,19950,3700,161270,10780.0,아이에스동서보통주
6399,10780,2020-03-19,0.2034313725490196,20400,16250,-4150,284477,10780.0,아이에스동서보통주
6400,10780,2020-03-18,0.0684931506849315,21900,20400,-1500,117408,10780.0,아이에스동서보통주
6401,10780,2020-03-13,0.0785123966942148,24200,22300,-1900,303963,10780.0,아이에스동서보통주
6402,10780,2020-03-12,0.0434782608695652,25300,24200,-1100,190841,10780.0,아이에스동서보통주
6403,10780,2020-03-11,0.0559701492537313,26800,25300,-1500,128801,10780.0,아이에스동서보통주
6404,10780,2020-02-28,0.0462633451957295,28100,26800,-1300,103340,10780.0,아이에스동서보통주
6405,10780,2020-02-25,0.0449438202247191,26700,27900,1200,87964,10780.0,아이에스동서보통주
6406,10780,2020-02-24,0.0498220640569395,28100,26700,-1400,97795,10780.0,아이에스동서보통주
6407,10780,2020-02-11,0.0494880546075085,29300,30750,1450,77135,10780.0,아이에스동서보통주
6408,10780,2020-02-06,0.0404929577464788,28400,29550,1150,74400,10780.0,아이에스동서보통주
6409,10780,2020-01-15,0.0466666666666666,30000,31400,1400,77710,10780.0,아이에스동서보통주
6410,10780,2019-11-04,0.0440251572327044,31800,33200,1400,96450,10780.0,아이에스동서보통주
6411,10780,2019-08-05,0.0495356037151702,32300,30700,-1600,120938,10780.0,아이에스동서보통주
6412,10780,2019-01-03,0.0402684563758389,29800,28600,-1200,50205,10780.0,아이에스동서보통주
6413,10780,2018-10-11,0.0438472418670438,35350,33800,-1550,93977,10780.0,아이에스동서보통주
6414,10780,2018-08-09,0.0578512396694214,30250,32000,1750,266111,10780.0,아이에스동서보통주
6415,10780,2018-06-11,0.0450606585788561,28850,30150,1300,95137,10780.0,아이에스동서보통주
6416,10780,2018-05-29,0.0421393841166936,30850,29550,-1300,91142,10780.0,아이에스동서보통주
6417,10780,2018-05-28,0.0511073253833049,29350,30850,1500,183678,10780.0,아이에스동서보통주
6418,10780,2018-05-16,0.0529595015576324,32100,30400,-1700,112442,10780.0,아이에스동서보통주
6419,10780,2018-05-11,0.053781512605042,29750,31350,1600,136206,10780.0,아이에스동서보통주
6420,10780,2018-05-03,0.0464396284829721,32300,30800,-1500,86776,10780.0,아이에스동서보통주
6421,10780,2018-04-30,0.0827814569536423,30200,32700,2500,229849,10780.0,아이에스동서보통주
6422,10780,2018-03-23,0.0522022838499184,30650,29050,-1600,151117,10780.0,아이에스동서보통주
6423,10780,2018-03-05,0.0493827160493827,32400,30800,-1600,138346,10780.0,아이에스동서보통주
6424,10780,2018-03-02,0.0442477876106194,33900,32400,-1500,102212,10780.0,아이에스동서보통주
6425,10780,2018-01-22,0.0441595441595441,35100,36650,1550,200476,10780.0,아이에스동서보통주
6426,10780,2018-01-19,0.04,33750,35100,1350,126184,10780.0,아이에스동서보통주
6427,10780,2017-12-13,0.0413589364844904,33850,35250,1400,97949,10780.0,아이에스동서보통주
6428,10780,2017-12-08,0.0488826815642458,35800,34050,-1750,129638,10780.0,아이에스동서보통주
6429,10780,2017-11-16,0.0513176144244105,36050,37900,1850,154010,10780.0,아이에스동서보통주
6430,10780,2017-11-03,0.046875,35200,36850,1650,347732,10780.0,아이에스동서보통주
6431,10780,2017-09-25,0.0727272727272727,33000,30600,-2400,265432,10780.0,아이에스동서보통주
6432,10780,2017-09-11,0.047112462006079,32900,34450,1550,118141,10780.0,아이에스동서보통주
6433,10780,2017-08-14,0.0729833546734955,39050,36200,-2850,261844,10780.0,아이에스동서보통주
6434,10780,2017-06-26,0.0422535211267605,46150,44200,-1950,150992,10780.0,아이에스동서보통주
6435,10780,2017-04-24,0.0537142857142857,43750,41400,-2350,232930,10780.0,아이에스동서보통주
6436,10780,2016-11-09,0.0585215605749486,48700,45850,-2850,342394,10780.0,아이에스동서보통주
6437,10780,2016-11-02,0.0402750491159135,50900,48850,-2050,80678,10780.0,아이에스동서보통주
6438,10780,2016-10-31,0.0571428571428571,52500,49500,-3000,121790,10780.0,아이에스동서보통주
6439,10780,2016-08-31,0.0466019417475728,51500,49100,-2400,167786,10780.0,아이에스동서보통주
6440,10780,2016-08-29,0.0538033395176252,53900,51000,-2900,126423,10780.0,아이에스동서보통주
6441,10950,2021-06-01,0.0673076923076923,93600,99900,6300,1053604,10950.0,S-Oil보통주
6442,10950,2021-05-06,0.0414394765539803,91700,95500,3800,1176342,10950.0,S-Oil보통주
6443,10950,2021-04-28,0.0460992907801418,84600,88500,3900,2130496,10950.0,S-Oil보통주
6444,10950,2021-04-26,0.0807692307692307,78000,84300,6300,1853225,10950.0,S-Oil보통주
6445,10950,2021-03-10,0.0443181818181818,88000,84100,-3900,490441,10950.0,S-Oil보통주
6446,10950,2021-02-25,0.051373954599761,83700,88000,4300,691270,10950.0,S-Oil보통주
6447,10950,2021-02-24,0.0720620842572062,90200,83700,-6500,1145734,10950.0,S-Oil보통주
6448,10950,2021-02-23,0.0415704387990762,86600,90200,3600,1473558,10950.0,S-Oil보통주
6449,10950,2021-02-18,0.0522222222222222,90000,85300,-4700,1145797,10950.0,S-Oil보통주
6450,10950,2021-02-15,0.0725513905683192,82700,88700,6000,1647003,10950.0,S-Oil보통주
6451,10950,2021-02-08,0.0750670241286863,74600,80200,5600,2617749,10950.0,S-Oil보통주
6452,10950,2021-01-13,0.0426098535286285,75100,78300,3200,1452058,10950.0,S-Oil보통주
6453,10950,2021-01-06,0.0409604519774011,70800,73700,2900,2229599,10950.0,S-Oil보통주
6454,10950,2020-11-24,0.0676691729323308,66500,71000,4500,2247850,10950.0,S-Oil보통주
6455,10950,2020-11-16,0.0470219435736677,63800,66800,3000,867344,10950.0,S-Oil보통주
6456,10950,2020-11-10,0.1468048359240069,57900,66400,8500,3897879,10950.0,S-Oil보통주
6457,10950,2020-10-07,0.0448598130841121,53500,55900,2400,525364,10950.0,S-Oil보통주
6458,10950,2020-10-05,0.0484496124031007,51600,54100,2500,395165,10950.0,S-Oil보통주
6459,10950,2020-08-11,0.0423452768729641,61400,64000,2600,1738419,10950.0,S-Oil보통주
6460,10950,2020-06-15,0.044862518089725,69100,66000,-3100,679845,10950.0,S-Oil보통주
6461,10950,2020-05-26,0.0537790697674418,68800,72500,3700,1417308,10950.0,S-Oil보통주
6462,10950,2020-05-19,0.0838323353293413,66800,72400,5600,2064535,10950.0,S-Oil보통주
6463,10950,2020-04-23,0.0574374079528718,67900,71800,3900,1505615,10950.0,S-Oil보통주
6464,10950,2020-04-13,0.0407569141193595,68700,65900,-2800,710862,10950.0,S-Oil보통주
6465,10950,2020-04-06,0.0812101910828025,62800,67900,5100,1931543,10950.0,S-Oil보통주
6466,10950,2020-04-03,0.0484848484848484,66000,62800,-3200,3054664,10950.0,S-Oil보통주
6467,10950,2020-04-02,0.2,55000,66000,11000,2752887,10950.0,S-Oil보통주
6468,10950,2020-03-25,0.1322957198443579,51400,58200,6800,1184123,10950.0,S-Oil보통주
6469,10950,2020-03-24,0.0597938144329896,48500,51400,2900,818508,10950.0,S-Oil보통주
6470,10950,2020-03-23,0.079696394686907,52700,48500,-4200,610326,10950.0,S-Oil보통주
6471,10950,2020-03-20,0.0561122244488977,49900,52700,2800,840312,10950.0,S-Oil보통주
6472,10950,2020-03-19,0.1351819757365684,57700,49900,-7800,843521,10950.0,S-Oil보통주
6473,10950,2020-03-12,0.056,62500,59000,-3500,784837,10950.0,S-Oil보통주
6474,10950,2020-03-10,0.0568965517241379,58000,61300,3300,1214591,10950.0,S-Oil보통주
6475,10950,2020-03-09,0.0979782270606531,64300,58000,-6300,1265350,10950.0,S-Oil보통주
6476,10950,2020-03-06,0.051622418879056,67800,64300,-3500,653980,10950.0,S-Oil보통주
6477,10950,2020-01-28,0.0556242274412855,80900,76400,-4500,622315,10950.0,S-Oil보통주
6478,10950,2020-01-08,0.0413492927094668,91900,88100,-3800,444611,10950.0,S-Oil보통주
6479,10950,2019-10-24,0.0445544554455445,101000,105500,4500,581286,10950.0,S-Oil보통주
6480,10950,2019-08-30,0.0638063806380638,90900,96700,5800,697142,10950.0,S-Oil보통주
6481,10950,2019-08-13,0.040586245772266,88700,85100,-3600,458215,10950.0,S-Oil보통주
6482,10950,2019-07-04,0.0432748538011695,85500,89200,3700,550182,10950.0,S-Oil보통주
6483,10950,2019-06-10,0.040391676866585,81700,85000,3300,442514,10950.0,S-Oil보통주
6484,10950,2019-04-15,0.0488599348534201,92100,96600,4500,829793,10950.0,S-Oil보통주
6485,10950,2019-03-11,0.0404984423676012,96300,92400,-3900,969225,10950.0,S-Oil보통주
6486,10950,2019-03-08,0.0558823529411764,102000,96300,-5700,1327758,10950.0,S-Oil보통주
6487,10950,2019-01-29,0.0404040404040404,99000,103000,4000,534198,10950.0,S-Oil보통주
6488,10950,2019-01-02,0.0655066530194472,97700,91300,-6400,665046,10950.0,S-Oil보통주
6489,10950,2018-12-03,0.0407239819004524,110500,115000,4500,389970,10950.0,S-Oil보통주
6490,10950,2018-11-30,0.0424528301886792,106000,110500,4500,554115,10950.0,S-Oil보통주
6491,10950,2018-11-14,0.0530973451327433,113000,107000,-6000,587354,10950.0,S-Oil보통주
6492,10950,2018-11-09,0.0416666666666666,120000,115000,-5000,409974,10950.0,S-Oil보통주
6493,10950,2018-11-01,0.0403225806451612,124000,119000,-5000,294561,10950.0,S-Oil보통주
6494,10950,2018-10-29,0.044,125000,119500,-5500,384974,10950.0,S-Oil보통주
6495,10950,2018-10-26,0.0421455938697318,130500,125000,-5500,376884,10950.0,S-Oil보통주
6496,10950,2018-10-19,0.0485074626865671,134000,127500,-6500,868584,10950.0,S-Oil보통주
6497,10950,2018-10-17,0.0553359683794466,126500,133500,7000,400906,10950.0,S-Oil보통주
6498,10950,2018-09-27,0.0421455938697318,130500,136000,5500,433655,10950.0,S-Oil보통주
6499,10950,2018-07-16,0.0593607305936073,109500,116000,6500,613808,10950.0,S-Oil보통주
6500,10950,2018-07-02,0.0639269406392694,109500,102500,-7000,605343,10950.0,S-Oil보통주
6501,10950,2018-04-25,0.0434782608695652,115000,110000,-5000,742930,10950.0,S-Oil보통주
6502,10950,2018-02-19,0.0619469026548672,113000,120000,7000,228518,10950.0,S-Oil보통주
6503,10950,2018-01-29,0.0692640692640692,115500,123500,8000,875023,10950.0,S-Oil보통주
6504,10950,2018-01-22,0.0442477876106194,113000,118000,5000,587223,10950.0,S-Oil보통주
6505,10950,2017-12-27,0.0522088353413654,124500,118000,-6500,626559,10950.0,S-Oil보통주
6506,10950,2017-09-26,0.0416666666666666,120000,125000,5000,380422,10950.0,S-Oil보통주
6507,10950,2017-08-04,0.0488888888888888,112500,118000,5500,330005,10950.0,S-Oil보통주
6508,10950,2017-07-26,0.0409090909090909,110000,114500,4500,643341,10950.0,S-Oil보통주
6509,10950,2017-07-20,0.0434782608695652,103500,108000,4500,534479,10950.0,S-Oil보통주
6510,10950,2017-05-11,0.0490196078431372,102000,107000,5000,403123,10950.0,S-Oil보통주
6511,10950,2017-03-13,0.0642939150401837,87100,92700,5600,966788,10950.0,S-Oil보통주
6512,10950,2016-11-10,0.0484261501210653,82600,86600,4000,616673,10950.0,S-Oil보통주
6513,10950,2016-10-26,0.0403800475059382,84200,80800,-3400,301998,10950.0,S-Oil보통주
6514,10950,2016-08-23,0.0437665782493368,75400,72100,-3300,858798,10950.0,S-Oil보통주
6515,11070,2021-02-26,0.0432692307692307,208000,199000,-9000,413677,11070.0,LG이노텍보통주
6516,11070,2021-02-24,0.0748299319727891,220500,204000,-16500,489849,11070.0,LG이노텍보통주
6517,11070,2021-02-19,0.0849056603773584,212000,230000,18000,707031,11070.0,LG이노텍보통주
6518,11070,2021-02-10,0.0416666666666666,204000,212500,8500,310647,11070.0,LG이노텍보통주
6519,11070,2021-02-03,0.0592592592592592,202500,214500,12000,441969,11070.0,LG이노텍보통주
6520,11070,2021-01-29,0.0453460620525059,209500,200000,-9500,542741,11070.0,LG이노텍보통주
6521,11070,2021-01-28,0.0477272727272727,220000,209500,-10500,632490,11070.0,LG이노텍보통주
6522,11070,2021-01-26,0.0665083135391924,210500,224500,14000,1625867,11070.0,LG이노텍보통주
6523,11070,2021-01-25,0.0525,200000,210500,10500,461840,11070.0,LG이노텍보통주
6524,11070,2021-01-20,0.0875331564986737,188500,205000,16500,1109736,11070.0,LG이노텍보통주
6525,11070,2021-01-04,0.0547945205479452,182500,192500,10000,464216,11070.0,LG이노텍보통주
6526,11070,2020-12-24,0.0594594594594594,185000,174000,-11000,688721,11070.0,LG이노텍보통주
6527,11070,2020-12-23,0.1280487804878048,164000,185000,21000,3484070,11070.0,LG이노텍보통주
6528,11070,2020-12-04,0.0623052959501557,160500,170500,10000,829883,11070.0,LG이노텍보통주
6529,11070,2020-11-19,0.0488599348534201,153500,161000,7500,360149,11070.0,LG이노텍보통주
6530,11070,2020-10-28,0.0451612903225806,155000,162000,7000,159522,11070.0,LG이노텍보통주
6531,11070,2020-10-19,0.0445859872611464,157000,164000,7000,195739,11070.0,LG이노텍보통주
6532,11070,2020-10-07,0.0573248407643312,157000,166000,9000,261275,11070.0,LG이노텍보통주
6533,11070,2020-09-24,0.0453074433656957,154500,147500,-7000,175012,11070.0,LG이노텍보통주
6534,11070,2020-09-02,0.1009771986970684,153500,169000,15500,818324,11070.0,LG이노텍보통주
6535,11070,2020-09-01,0.0586206896551724,145000,153500,8500,322368,11070.0,LG이노텍보통주
6536,11070,2020-08-24,0.0580204778156996,146500,155000,8500,228720,11070.0,LG이노텍보통주
6537,11070,2020-08-20,0.0614886731391585,154500,145000,-9500,325065,11070.0,LG이노텍보통주
6538,11070,2020-08-18,0.055045871559633,163500,154500,-9000,418830,11070.0,LG이노텍보통주
6539,11070,2020-07-21,0.062111801242236,161000,171000,10000,440261,11070.0,LG이노텍보통주
6540,11070,2020-06-26,0.0553846153846153,162500,171500,9000,296752,11070.0,LG이노텍보통주
6541,11070,2020-06-16,0.059375,160000,169500,9500,217329,11070.0,LG이노텍보통주
6542,11070,2020-06-15,0.0751445086705202,173000,160000,-13000,272176,11070.0,LG이노텍보통주
6543,11070,2020-06-10,0.0444444444444444,157500,164500,7000,339108,11070.0,LG이노텍보통주
6544,11070,2020-05-18,0.0513698630136986,146000,138500,-7500,444203,11070.0,LG이노텍보통주
6545,11070,2020-05-12,0.0441176470588235,136000,142000,6000,379410,11070.0,LG이노텍보통주
6546,11070,2020-04-27,0.0793650793650793,126000,136000,10000,462280,11070.0,LG이노텍보통주
6547,11070,2020-04-17,0.0515873015873015,126000,132500,6500,526932,11070.0,LG이노텍보통주
6548,11070,2020-04-14,0.0468085106382978,117500,123000,5500,253263,11070.0,LG이노텍보통주
6549,11070,2020-04-13,0.0524193548387096,124000,117500,-6500,276368,11070.0,LG이노텍보통주
6550,11070,2020-04-07,0.0532786885245901,122000,128500,6500,573155,11070.0,LG이노텍보통주
6551,11070,2020-04-06,0.109090909090909,110000,122000,12000,575285,11070.0,LG이노텍보통주
6552,11070,2020-04-02,0.0414746543778801,108500,113000,4500,371857,11070.0,LG이노텍보통주
6553,11070,2020-04-01,0.0482456140350877,114000,108500,-5500,421645,11070.0,LG이노텍보통주
6554,11070,2020-03-30,0.0506912442396313,108500,114000,5500,433381,11070.0,LG이노텍보통주
6555,11070,2020-03-26,0.052863436123348,113500,107500,-6000,614784,11070.0,LG이노텍보통주
6556,11070,2020-03-25,0.055813953488372,107500,113500,6000,1082656,11070.0,LG이노텍보통주
6557,11070,2020-03-24,0.1774370208105148,91300,107500,16200,1404434,11070.0,LG이노텍보통주
6558,11070,2020-03-23,0.0787083753784056,99100,91300,-7800,656846,11070.0,LG이노텍보통주
6559,11070,2020-03-20,0.2988204456094364,76300,99100,22800,847968,11070.0,LG이노텍보통주
6560,11070,2020-03-19,0.0829326923076923,83200,76300,-6900,485245,11070.0,LG이노텍보통주
6561,11070,2020-03-18,0.1120597652081109,93700,83200,-10500,579437,11070.0,LG이노텍보통주
6562,11070,2020-03-16,0.0853080568720379,105500,96500,-9000,546732,11070.0,LG이노텍보통주
6563,11070,2020-03-13,0.0663716814159292,113000,105500,-7500,783139,11070.0,LG이노텍보통주
6564,11070,2020-03-12,0.0622406639004149,120500,113000,-7500,468120,11070.0,LG이노텍보통주
6565,11070,2020-03-11,0.0549019607843137,127500,120500,-7000,314863,11070.0,LG이노텍보통주
6566,11070,2020-03-09,0.0735294117647058,136000,126000,-10000,368951,11070.0,LG이노텍보통주
6567,11070,2020-03-02,0.0576923076923076,130000,137500,7500,358597,11070.0,LG이노텍보통주
6568,11070,2020-02-28,0.0940766550522648,143500,130000,-13500,551339,11070.0,LG이노텍보통주
6569,11070,2020-02-18,0.045016077170418,155500,148500,-7000,365652,11070.0,LG이노텍보통주
6570,11070,2020-01-29,0.0429042904290429,151500,158000,6500,388880,11070.0,LG이노텍보통주
6571,11070,2020-01-09,0.0581818181818181,137500,145500,8000,293629,11070.0,LG이노텍보통주
6572,11070,2019-12-27,0.0408921933085501,134500,140000,5500,164555,11070.0,LG이노텍보통주
6573,11070,2019-10-30,0.0513833992094861,126500,120000,-6500,464529,11070.0,LG이노텍보통주
6574,11070,2019-10-16,0.0472103004291845,116500,122000,5500,283425,11070.0,LG이노텍보통주
6575,11070,2019-10-01,0.0482456140350877,114000,119500,5500,284535,11070.0,LG이노텍보통주
6576,11070,2019-09-24,0.0566037735849056,106000,112000,6000,259721,11070.0,LG이노텍보통주
6577,11070,2019-09-04,0.046046046046046,99900,104500,4600,188344,11070.0,LG이노텍보통주
6578,11070,2019-08-26,0.0606965174129353,100500,94400,-6100,418067,11070.0,LG이노텍보통주
6579,11070,2019-08-14,0.0566228513650151,98900,104500,5600,366381,11070.0,LG이노텍보통주
6580,11070,2019-08-05,0.04,100000,96000,-4000,201836,11070.0,LG이노텍보통주
6581,11070,2019-08-02,0.0950226244343891,110500,100000,-10500,445021,11070.0,LG이노텍보통주
6582,11070,2019-07-29,0.0429184549356223,116500,111500,-5000,90797,11070.0,LG이노텍보통주
6583,11070,2019-07-19,0.0601851851851851,108000,114500,6500,185406,11070.0,LG이노텍보통주
6584,11070,2019-07-09,0.045662100456621,109500,104500,-5000,252965,11070.0,LG이노텍보통주
6585,11070,2019-07-04,0.05,110000,115500,5500,164453,11070.0,LG이노텍보통주
6586,11070,2019-07-01,0.0458715596330275,109000,114000,5000,262224,11070.0,LG이노텍보통주
6587,11070,2019-06-27,0.0422535211267605,106500,111000,4500,253028,11070.0,LG이노텍보통주
6588,11070,2019-06-19,0.0497512437810945,100500,105500,5000,443225,11070.0,LG이노텍보통주
6589,11070,2019-05-30,0.0413223140495867,96800,92800,-4000,353303,11070.0,LG이노텍보통주
6590,11070,2019-05-23,0.0666666666666666,103500,96600,-6900,364924,11070.0,LG이노텍보통주
6591,11070,2019-05-16,0.0442477876106194,113000,108000,-5000,139802,11070.0,LG이노텍보통주
6592,11070,2019-04-17,0.0658436213991769,121500,129500,8000,472931,11070.0,LG이노텍보통주
6593,11070,2019-04-09,0.047008547008547,117000,122500,5500,215647,11070.0,LG이노텍보통주
6594,11070,2019-04-03,0.0565217391304347,115000,121500,6500,352158,11070.0,LG이노텍보통주
6595,11070,2019-03-29,0.0444444444444444,112500,117500,5000,367818,11070.0,LG이노텍보통주
6596,11070,2019-03-21,0.0954773869346733,99500,109000,9500,485145,11070.0,LG이노텍보통주
6597,11070,2019-03-18,0.0566037735849056,106000,100000,-6000,319351,11070.0,LG이노텍보통주
6598,11070,2019-02-07,0.050251256281407,99500,104500,5000,363088,11070.0,LG이노텍보통주
6599,11070,2019-01-15,0.0416184971098265,86500,90100,3600,232747,11070.0,LG이노텍보통주
6600,11070,2019-01-07,0.052890528905289,81300,85600,4300,226083,11070.0,LG이노텍보통주
6601,11070,2018-12-27,0.044047619047619,84000,87700,3700,291903,11070.0,LG이노텍보통주
6602,11070,2018-11-26,0.05,94000,98700,4700,327018,11070.0,LG이노텍보통주
6603,11070,2018-11-20,0.0445544554455445,101000,96500,-4500,545796,11070.0,LG이노텍보통주
6604,11070,2018-11-13,0.0547945205479452,109500,103500,-6000,786528,11070.0,LG이노텍보통주
6605,11070,2018-11-07,0.0423728813559322,118000,113000,-5000,477103,11070.0,LG이노텍보통주
6606,11070,2018-11-06,0.0634920634920634,126000,118000,-8000,552490,11070.0,LG이노텍보통주
6607,11070,2018-10-25,0.0699588477366255,121500,130000,8500,449403,11070.0,LG이노텍보통주
6608,11070,2018-10-11,0.056,125000,118000,-7000,342587,11070.0,LG이노텍보통주
6609,11070,2018-10-10,0.0458015267175572,131000,125000,-6000,275063,11070.0,LG이노텍보통주
6610,11070,2018-09-13,0.0474452554744525,137000,130500,-6500,852161,11070.0,LG이노텍보통주
6611,11070,2018-09-05,0.0418006430868167,155500,149000,-6500,229748,11070.0,LG이노텍보통주
6612,11070,2018-09-04,0.0436241610738255,149000,155500,6500,377030,11070.0,LG이노텍보통주
6613,11070,2018-08-10,0.0418006430868167,155500,149000,-6500,205557,11070.0,LG이노텍보통주
6614,11070,2018-07-06,0.0721649484536082,145500,156000,10500,564528,11070.0,LG이노텍보통주
6615,11070,2018-07-05,0.043010752688172,139500,145500,6000,363258,11070.0,LG이노텍보통주
6616,11070,2018-06-25,0.0431654676258992,139000,145000,6000,220431,11070.0,LG이노텍보통주
6617,11070,2018-06-22,0.047945205479452,146000,139000,-7000,439214,11070.0,LG이노텍보통주
6618,11070,2018-06-19,0.0471380471380471,148500,141500,-7000,273473,11070.0,LG이노텍보통주
6619,11070,2018-05-28,0.0547445255474452,137000,144500,7500,736884,11070.0,LG이노텍보통주
6620,11070,2018-05-25,0.0458015267175572,131000,137000,6000,624640,11070.0,LG이노텍보통주
6621,11070,2018-05-08,0.044,125000,130500,5500,352466,11070.0,LG이노텍보통주
6622,11070,2018-05-03,0.0404858299595141,123500,128500,5000,448995,11070.0,LG이노텍보통주
6623,11070,2018-05-02,0.0600858369098712,116500,123500,7000,498629,11070.0,LG이노텍보통주
6624,11070,2018-04-25,0.06,125000,117500,-7500,626155,11070.0,LG이노텍보통주
6625,11070,2018-04-24,0.0421455938697318,130500,125000,-5500,385075,11070.0,LG이노텍보통주
6626,11070,2018-04-17,0.0419847328244274,131000,136500,5500,702301,11070.0,LG이노텍보통주
6627,11070,2018-04-16,0.065040650406504,123000,131000,8000,494828,11070.0,LG이노텍보통주
6628,11070,2018-04-12,0.0541666666666666,120000,126500,6500,451634,11070.0,LG이노텍보통주
6629,11070,2018-04-04,0.0489795918367346,122500,116500,-6000,345967,11070.0,LG이노텍보통주
6630,11070,2018-03-27,0.05,120000,126000,6000,223476,11070.0,LG이노텍보통주
6631,11070,2018-03-23,0.0513833992094861,126500,120000,-6500,503041,11070.0,LG이노텍보통주
6632,11070,2018-03-09,0.0428015564202334,128500,134000,5500,299772,11070.0,LG이노텍보통주
6633,11070,2018-03-07,0.0415094339622641,132500,127000,-5500,211607,11070.0,LG이노텍보통주
6634,11070,2018-03-06,0.0433070866141732,127000,132500,5500,205295,11070.0,LG이노텍보통주
6635,11070,2018-02-08,0.0454545454545454,121000,126500,5500,249516,11070.0,LG이노텍보통주
6636,11070,2018-01-19,0.0535714285714285,140000,132500,-7500,1096410,11070.0,LG이노텍보통주
6637,11070,2018-01-10,0.047923322683706,156500,149000,-7500,603263,11070.0,LG이노텍보통주
6638,11070,2018-01-09,0.102112676056338,142000,156500,14500,1239506,11070.0,LG이노텍보통주
6639,11070,2017-12-26,0.0520833333333333,144000,136500,-7500,504695,11070.0,LG이노텍보통주
6640,11070,2017-12-21,0.0608108108108108,148000,139000,-9000,575472,11070.0,LG이노텍보통주
6641,11070,2017-12-07,0.0510204081632653,147000,154500,7500,598789,11070.0,LG이노텍보통주
6642,11070,2017-12-06,0.0754716981132075,159000,147000,-12000,772501,11070.0,LG이노텍보통주
6643,11070,2017-12-04,0.0526315789473684,161500,153000,-8500,855780,11070.0,LG이노텍보통주
6644,11070,2017-11-30,0.0501474926253687,169500,161000,-8500,499564,11070.0,LG이노텍보통주
6645,11070,2017-11-13,0.0584795321637426,171000,161000,-10000,530564,11070.0,LG이노텍보통주
6646,11070,2017-10-23,0.0666666666666666,157500,168000,10500,334260,11070.0,LG이노텍보통주
6647,11070,2017-10-19,0.043076923076923,162500,155500,-7000,303579,11070.0,LG이노텍보통주
6648,11070,2017-10-11,0.0709677419354838,155000,166000,11000,475518,11070.0,LG이노텍보통주
6649,11070,2017-09-28,0.045016077170418,155500,148500,-7000,439301,11070.0,LG이노텍보통주
6650,11070,2017-09-22,0.0418006430868167,155500,149000,-6500,546461,11070.0,LG이노텍보통주
6651,11070,2017-09-21,0.0489296636085626,163500,155500,-8000,525518,11070.0,LG이노텍보통주
6652,11070,2017-08-29,0.0406976744186046,172000,179000,7000,191035,11070.0,LG이노텍보통주
6653,11070,2017-08-02,0.1036789297658862,149500,165000,15500,520279,11070.0,LG이노텍보통주
6654,11070,2017-07-28,0.0681114551083591,161500,150500,-11000,362399,11070.0,LG이노텍보통주
6655,11070,2017-07-12,0.0407523510971786,159500,153000,-6500,189951,11070.0,LG이노텍보통주
6656,11070,2017-06-28,0.0637681159420289,172500,161500,-11000,459122,11070.0,LG이노텍보통주
6657,11070,2017-06-26,0.0769230769230769,162500,175000,12500,356493,11070.0,LG이노텍보통주
6658,11070,2017-06-19,0.0414012738853503,157000,163500,6500,208984,11070.0,LG이노텍보통주
6659,11070,2017-06-12,0.0546623794212218,155500,147000,-8500,400911,11070.0,LG이노텍보통주
6660,11070,2017-06-08,0.0744680851063829,141000,151500,10500,559166,11070.0,LG이노텍보통주
6661,11070,2017-06-07,0.0444444444444444,135000,141000,6000,224086,11070.0,LG이노텍보통주
6662,11070,2017-05-29,0.0413533834586466,133000,138500,5500,215983,11070.0,LG이노텍보통주
6663,11070,2017-04-27,0.0509090909090909,137500,130500,-7000,358207,11070.0,LG이노텍보통주
6664,11070,2017-04-21,0.0671641791044776,134000,143000,9000,344564,11070.0,LG이노텍보통주
6665,11070,2017-04-10,0.0402930402930402,136500,131000,-5500,100811,11070.0,LG이노텍보통주
6666,11070,2017-03-21,0.0613026819923371,130500,138500,8000,281795,11070.0,LG이노텍보통주
6667,11070,2017-02-23,0.0416666666666666,120000,125000,5000,437588,11070.0,LG이노텍보통주
6668,11070,2017-01-25,0.0806979280261723,91700,99100,7400,972100,11070.0,LG이노텍보통주
6669,11070,2016-11-28,0.0497382198952879,76400,80200,3800,335834,11070.0,LG이노텍보통주
6670,11070,2016-09-19,0.0705128205128205,78000,83500,5500,389751,11070.0,LG이노텍보통주
6671,11070,2016-09-05,0.0449029126213592,82400,86100,3700,320500,11070.0,LG이노텍보통주
6672,11170,2021-05-12,0.043261231281198,300500,287500,-13000,397425,11170.0,롯데케미칼보통주
6673,11170,2021-05-06,0.0537261698440207,288500,304000,15500,373716,11170.0,롯데케미칼보통주
6674,11170,2021-05-03,0.0575657894736842,304000,286500,-17500,481861,11170.0,롯데케미칼보통주
6675,11170,2021-02-25,0.0710743801652892,302500,324000,21500,514784,11170.0,롯데케미칼보통주
6676,11170,2021-02-24,0.0720858895705521,326000,302500,-23500,497132,11170.0,롯데케미칼보통주
6677,11170,2021-02-23,0.0794701986754966,302000,326000,24000,1193010,11170.0,롯데케미칼보통주
6678,11170,2021-02-10,0.0412371134020618,291000,303000,12000,494419,11170.0,롯데케미칼보통주
6679,11170,2021-02-08,0.0492957746478873,284000,298000,14000,617328,11170.0,롯데케미칼보통주
6680,11170,2021-02-05,0.0518518518518518,270000,284000,14000,234939,11170.0,롯데케미칼보통주
6681,11170,2021-01-29,0.0491803278688524,274500,261000,-13500,276795,11170.0,롯데케미칼보통주
6682,11170,2021-01-15,0.0474683544303797,316000,301000,-15000,305414,11170.0,롯데케미칼보통주
6683,11170,2021-01-12,0.088695652173913,287500,313000,25500,1405533,11170.0,롯데케미칼보통주
6684,11170,2021-01-11,0.0448504983388704,301000,287500,-13500,576371,11170.0,롯데케미칼보통주
6685,11170,2021-01-07,0.0742049469964664,283000,304000,21000,711593,11170.0,롯데케미칼보통주
6686,11170,2020-12-30,0.0434782608695652,264500,276000,11500,386964,11170.0,롯데케미칼보통주
6687,11170,2020-11-13,0.0430879712746858,278500,266500,-12000,407336,11170.0,롯데케미칼보통주
6688,11170,2020-11-11,0.0466417910447761,268000,280500,12500,421936,11170.0,롯데케미칼보통주
6689,11170,2020-11-09,0.092,250000,273000,23000,610378,11170.0,롯데케미칼보통주
6690,11170,2020-11-03,0.0552016985138004,235500,248500,13000,334468,11170.0,롯데케미칼보통주
6691,11170,2020-10-28,0.0670995670995671,231000,246500,15500,424322,11170.0,롯데케미칼보통주
6692,11170,2020-10-26,0.0421686746987951,249000,238500,-10500,412612,11170.0,롯데케미칼보통주
6693,11170,2020-10-20,0.0605381165919282,223000,236500,13500,440130,11170.0,롯데케미칼보통주
6694,11170,2020-10-08,0.0528735632183908,217500,229000,11500,608306,11170.0,롯데케미칼보통주
6695,11170,2020-10-05,0.0839694656488549,196500,213000,16500,577344,11170.0,롯데케미칼보통주
6696,11170,2020-09-22,0.0494117647058823,212500,202000,-10500,258209,11170.0,롯데케미칼보통주
6697,11170,2020-09-14,0.0716049382716049,202500,217000,14500,527310,11170.0,롯데케미칼보통주
6698,11170,2020-09-07,0.1202185792349726,183000,205000,22000,926441,11170.0,롯데케미칼보통주
6699,11170,2020-08-20,0.0584958217270195,179500,169000,-10500,239731,11170.0,롯데케미칼보통주
6700,11170,2020-08-18,0.0638297872340425,188000,176000,-12000,232471,11170.0,롯데케미칼보통주
6701,11170,2020-08-10,0.0826210826210826,175500,190000,14500,722396,11170.0,롯데케미칼보통주
6702,11170,2020-08-06,0.0467836257309941,171000,179000,8000,555578,11170.0,롯데케미칼보통주
6703,11170,2020-07-13,0.0507462686567164,167500,176000,8500,207859,11170.0,롯데케미칼보통주
6704,11170,2020-06-19,0.0730994152046783,171000,183500,12500,450459,11170.0,롯데케미칼보통주
6705,11170,2020-06-15,0.065155807365439,176500,165000,-11500,273285,11170.0,롯데케미칼보통주
6706,11170,2020-06-12,0.0407608695652173,184000,176500,-7500,200268,11170.0,롯데케미칼보통주
6707,11170,2020-06-03,0.0473684210526315,190000,199000,9000,468452,11170.0,롯데케미칼보통주
6708,11170,2020-05-11,0.0434782608695652,195500,187000,-8500,317474,11170.0,롯데케미칼보통주
6709,11170,2020-05-04,0.0904872389791183,215500,196000,-19500,477632,11170.0,롯데케미칼보통주
6710,11170,2020-04-27,0.0517647058823529,212500,223500,11000,242427,11170.0,롯데케미칼보통주
6711,11170,2020-04-23,0.0668316831683168,202000,215500,13500,333824,11170.0,롯데케미칼보통주
6712,11170,2020-04-14,0.0694444444444444,180000,192500,12500,379858,11170.0,롯데케미칼보통주
6713,11170,2020-04-10,0.0485714285714285,175000,183500,8500,236744,11170.0,롯데케미칼보통주
6714,11170,2020-04-03,0.0554016620498614,180500,170500,-10000,260421,11170.0,롯데케미칼보통주
6715,11170,2020-04-01,0.0518134715025906,193000,183000,-10000,237629,11170.0,롯데케미칼보통주
6716,11170,2020-03-31,0.0662983425414364,181000,193000,12000,309889,11170.0,롯데케미칼보통주
6717,11170,2020-03-30,0.0432276657060518,173500,181000,7500,214671,11170.0,롯데케미칼보통주
6718,11170,2020-03-27,0.042042042042042,166500,173500,7000,191362,11170.0,롯데케미칼보통주
6719,11170,2020-03-25,0.1006711409395973,149000,164000,15000,259386,11170.0,롯데케미칼보통주
6720,11170,2020-03-24,0.0836363636363636,137500,149000,11500,234454,11170.0,롯데케미칼보통주
6721,11170,2020-03-23,0.0677966101694915,147500,137500,-10000,242745,11170.0,롯데케미칼보통주
6722,11170,2020-03-20,0.2606837606837607,117000,147500,30500,301848,11170.0,롯데케미칼보통주
6723,11170,2020-03-19,0.1552346570397112,138500,117000,-21500,313242,11170.0,롯데케미칼보통주
6724,11170,2020-03-18,0.0673400673400673,148500,138500,-10000,167057,11170.0,롯데케미칼보통주
6725,11170,2020-03-17,0.048076923076923,156000,148500,-7500,253166,11170.0,롯데케미칼보통주
6726,11170,2020-03-16,0.0686567164179104,167500,156000,-11500,204473,11170.0,롯데케미칼보통주
6727,11170,2020-03-13,0.0428571428571428,175000,167500,-7500,342322,11170.0,롯데케미칼보통주
6728,11170,2020-03-12,0.054054054054054,185000,175000,-10000,285394,11170.0,롯데케미칼보통주
6729,11170,2020-03-10,0.0670553935860058,171500,183000,11500,338908,11170.0,롯데케미칼보통주
6730,11170,2020-03-06,0.0408719346049046,183500,176000,-7500,241901,11170.0,롯데케미칼보통주
6731,11170,2020-02-24,0.0402010050251256,199000,191000,-8000,123898,11170.0,롯데케미칼보통주
6732,11170,2020-02-06,0.0784810126582278,197500,213000,15500,339549,11170.0,롯데케미칼보통주
6733,11170,2020-01-28,0.062200956937799,209000,196000,-13000,306075,11170.0,롯데케미칼보통주
6734,11170,2020-01-14,0.0453460620525059,209500,219000,9500,244681,11170.0,롯데케미칼보통주
6735,11170,2019-11-04,0.053763440860215,232500,220000,-12500,351305,11170.0,롯데케미칼보통주
6736,11170,2019-09-25,0.040650406504065,246000,236000,-10000,155164,11170.0,롯데케미칼보통주
6737,11170,2019-09-10,0.0405117270788912,234500,244000,9500,209719,11170.0,롯데케미칼보통주
6738,11170,2019-09-05,0.0538116591928251,223000,235000,12000,244799,11170.0,롯데케미칼보통주
6739,11170,2019-08-26,0.0461538461538461,227500,217000,-10500,123804,11170.0,롯데케미칼보통주
6740,11170,2019-08-05,0.0461538461538461,227500,217000,-10500,199012,11170.0,롯데케미칼보통주
6741,11170,2019-03-07,0.0516129032258064,310000,294000,-16000,265132,11170.0,롯데케미칼보통주
6742,11170,2019-02-18,0.0539629005059021,296500,312500,16000,291907,11170.0,롯데케미칼보통주
6743,11170,2019-02-13,0.0579964850615114,284500,301000,16500,263470,11170.0,롯데케미칼보통주
6744,11170,2019-02-08,0.0559210526315789,304000,287000,-17000,211071,11170.0,롯데케미칼보통주
6745,11170,2019-01-07,0.0623781676413255,256500,272500,16000,224976,11170.0,롯데케미칼보통주
6746,11170,2019-01-04,0.0411214953271028,267500,256500,-11000,261091,11170.0,롯데케미칼보통주
6747,11170,2018-12-27,0.05414551607445,295500,279500,-16000,210430,11170.0,롯데케미칼보통주
6748,11170,2018-12-19,0.0484171322160148,268500,281500,13000,154744,11170.0,롯데케미칼보통주
6749,11170,2018-12-10,0.044883303411131,278500,266000,-12500,188927,11170.0,롯데케미칼보통주
6750,11170,2018-12-03,0.0587155963302752,272500,288500,16000,367898,11170.0,롯데케미칼보통주
6751,11170,2018-11-26,0.0504504504504504,277500,291500,14000,176942,11170.0,롯데케미칼보통주
6752,11170,2018-11-20,0.0428816466552315,291500,279000,-12500,148924,11170.0,롯데케미칼보통주
6753,11170,2018-11-02,0.0773584905660377,265000,285500,20500,364391,11170.0,롯데케미칼보통주
6754,11170,2018-10-29,0.0466417910447761,268000,255500,-12500,188029,11170.0,롯데케미칼보통주
6755,11170,2018-10-26,0.0462633451957295,281000,268000,-13000,189936,11170.0,롯데케미칼보통주
6756,11170,2018-10-24,0.064453125,256000,272500,16500,282081,11170.0,롯데케미칼보통주
6757,11170,2018-10-18,0.0498154981549815,271000,257500,-13500,159115,11170.0,롯데케미칼보통주
6758,11170,2018-10-04,0.0637522768670309,274500,257000,-17500,359452,11170.0,롯데케미칼보통주
6759,11170,2018-09-11,0.0416666666666666,300000,287500,-12500,347855,11170.0,롯데케미칼보통주
6760,11170,2018-08-22,0.0497737556561085,331500,315000,-16500,413988,11170.0,롯데케미칼보통주
6761,11170,2018-08-01,0.0584144645340751,359500,338500,-21000,240735,11170.0,롯데케미칼보통주
6762,11170,2018-07-26,0.0552238805970149,335000,353500,18500,137756,11170.0,롯데케미칼보통주
6763,11170,2018-07-02,0.0517241379310344,348000,330000,-18000,139554,11170.0,롯데케미칼보통주
6764,11170,2018-06-19,0.0419485791610284,369500,354000,-15500,197082,11170.0,롯데케미칼보통주
6765,11170,2018-06-14,0.0459921156373193,380500,363000,-17500,240480,11170.0,롯데케미칼보통주
6766,11170,2018-05-04,0.0517241379310344,406000,385000,-21000,163487,11170.0,롯데케미칼보통주
6767,11170,2018-03-05,0.0474183350895679,474500,452000,-22500,164203,11170.0,롯데케미칼보통주
6768,11170,2018-02-23,0.0418079096045197,442500,461000,18500,159729,11170.0,롯데케미칼보통주
6769,11170,2018-02-09,0.0488721804511278,399000,418500,19500,297735,11170.0,롯데케미칼보통주
6770,11170,2018-02-07,0.0485436893203883,412000,392000,-20000,202328,11170.0,롯데케미칼보통주
6771,11170,2018-01-29,0.041820418204182,406500,423500,17000,163648,11170.0,롯데케미칼보통주
6772,11170,2018-01-08,0.0910384068278805,351500,383500,32000,490208,11170.0,롯데케미칼보통주
6773,11170,2017-11-13,0.0481283422459893,374000,356000,-18000,244307,11170.0,롯데케미칼보통주
6774,11170,2017-10-30,0.047680412371134,388000,369500,-18500,373636,11170.0,롯데케미칼보통주
6775,11170,2017-10-13,0.0463576158940397,377500,395000,17500,202758,11170.0,롯데케미칼보통주
6776,11170,2017-09-15,0.05140758873929,408500,387500,-21000,301246,11170.0,롯데케미칼보통주
6777,11170,2017-08-04,0.047808764940239,376500,394500,18000,249827,11170.0,롯데케미칼보통주
6778,11170,2017-06-30,0.0408472012102874,330500,344000,13500,254326,11170.0,롯데케미칼보통주
6779,11170,2017-05-22,0.0641025641025641,351000,373500,22500,446013,11170.0,롯데케미칼보통주
6780,11170,2017-05-02,0.0453216374269005,342000,357500,15500,235616,11170.0,롯데케미칼보통주
6781,11170,2017-02-24,0.0447957839262187,379500,362500,-17000,278996,11170.0,롯데케미칼보통주
6782,11170,2017-01-31,0.040764331210191,392500,376500,-16000,97755,11170.0,롯데케미칼보통주
6783,11170,2016-12-06,0.0494011976047904,334000,350500,16500,176448,11170.0,롯데케미칼보통주
6784,11170,2016-12-01,0.0575427682737169,321500,340000,18500,177336,11170.0,롯데케미칼보통주
6785,11170,2016-11-10,0.0446735395189003,291000,304000,13000,135512,11170.0,롯데케미칼보통주
6786,11170,2016-10-13,0.0450885668276972,310500,296500,-14000,138911,11170.0,롯데케미칼보통주
6787,11170,2016-08-29,0.0407079646017699,282500,271000,-11500,120921,11170.0,롯데케미칼보통주
6788,11170,2016-08-03,0.0440944881889763,317500,303500,-14000,128855,11170.0,롯데케미칼보통주
6789,11200,2021-05-20,0.0746791131855309,42850,46050,3200,14847741,11200.0,에이치엠엠보통주
6790,11200,2021-05-13,0.0661764705882353,47600,44450,-3150,28785777,11200.0,에이치엠엠보통주
6791,11200,2021-05-12,0.072072072072072,44400,47600,3200,20954229,11200.0,에이치엠엠보통주
6792,11200,2021-05-07,0.0676691729323308,39900,42600,2700,20814694,11200.0,에이치엠엠보통주
6793,11200,2021-05-06,0.1192145862552594,35650,39900,4250,16629073,11200.0,에이치엠엠보통주
6794,11200,2021-05-03,0.0573979591836734,39200,36950,-2250,16483961,11200.0,에이치엠엠보통주
6795,11200,2021-04-28,0.0679347826086956,36800,39300,2500,19976442,11200.0,에이치엠엠보통주
6796,11200,2021-04-26,0.0971168437025796,32950,36150,3200,21050328,11200.0,에이치엠엠보통주
6797,11200,2021-04-19,0.0722311396468699,31150,33400,2250,13334501,11200.0,에이치엠엠보통주
6798,11200,2021-04-16,0.0435510887772194,29850,31150,1300,10454456,11200.0,에이치엠엠보통주
6799,11200,2021-04-07,0.04631217838765,29150,30500,1350,10760811,11200.0,에이치엠엠보통주
6800,11200,2021-04-01,0.0413793103448275,29000,27800,-1200,18982890,11200.0,에이치엠엠보통주
6801,11200,2021-03-30,0.0920840064620355,30950,28100,-2850,26785243,11200.0,에이치엠엠보통주
6802,11200,2021-03-29,0.0937042459736456,34150,30950,-3200,41757002,11200.0,에이치엠엠보통주
6803,11200,2021-03-26,0.1595925297113752,29450,34150,4700,54130619,11200.0,에이치엠엠보통주
6804,11200,2021-03-23,0.071563088512241,26550,28450,1900,26263232,11200.0,에이치엠엠보통주
6805,11200,2021-03-22,0.0858895705521472,24450,26550,2100,17226746,11200.0,에이치엠엠보통주
6806,11200,2021-03-18,0.0535714285714285,22400,23600,1200,9731574,11200.0,에이치엠엠보통주
6807,11200,2021-03-10,0.086848635235732,20150,21900,1750,15519474,11200.0,에이치엠엠보통주
6808,11200,2021-03-09,0.088235294117647,22100,20150,-1950,32684736,11200.0,에이치엠엠보통주
6809,11200,2021-03-05,0.0812807881773399,20300,21950,1650,22893847,11200.0,에이치엠엠보통주
6810,11200,2021-03-03,0.0851063829787234,18800,20400,1600,20737131,11200.0,에이치엠엠보통주
6811,11200,2021-02-25,0.0823529411764705,17000,18400,1400,15246668,11200.0,에이치엠엠보통주
6812,11200,2021-02-22,0.0548780487804878,16400,17300,900,19417433,11200.0,에이치엠엠보통주
6813,11200,2021-02-17,0.0463576158940397,15100,15800,700,11989053,11200.0,에이치엠엠보통주
6814,11200,2021-02-15,0.0586206896551724,14500,15350,850,14405862,11200.0,에이치엠엠보통주
6815,11200,2021-01-19,0.0640569395017793,14050,14950,900,6550934,11200.0,에이치엠엠보통주
6816,11200,2021-01-18,0.0506756756756756,14800,14050,-750,6546762,11200.0,에이치엠엠보통주
6817,11200,2021-01-04,0.1863799283154122,13950,16550,2600,38614102,11200.0,에이치엠엠보통주
6818,11200,2020-12-29,0.065891472868217,12900,13750,850,9298354,11200.0,에이치엠엠보통주
6819,11200,2020-12-22,0.0441176470588235,13600,13000,-600,5611117,11200.0,에이치엠엠보통주
6820,11200,2020-12-17,0.059040590405904,13550,14350,800,18063126,11200.0,에이치엠엠보통주
6821,11200,2020-12-10,0.0736434108527131,12900,13850,950,16972906,11200.0,에이치엠엠보통주
6822,11200,2020-11-23,0.0509803921568627,12750,13400,650,11988135,11200.0,에이치엠엠보통주
6823,11200,2020-11-19,0.0456273764258555,13150,12550,-600,11909306,11200.0,에이치엠엠보통주
6824,11200,2020-11-17,0.0815602836879432,14100,12950,-1150,22165115,11200.0,에이치엠엠보통주
6825,11200,2020-11-12,0.1038461538461538,13000,14350,1350,45128507,11200.0,에이치엠엠보통주
6826,11200,2020-11-11,0.0483870967741935,12400,13000,600,17900430,11200.0,에이치엠엠보통주
6827,11200,2020-11-10,0.042016806722689,11900,12400,500,16861581,11200.0,에이치엠엠보통주
6828,11200,2020-11-09,0.1609756097560975,10250,11900,1650,28455967,11200.0,에이치엠엠보통주
6829,11200,2020-11-05,0.0752118644067796,9440,10150,710,16941269,11200.0,에이치엠엠보통주
6830,11200,2020-10-30,0.0547945205479452,9490,8970,-520,12295144,11200.0,에이치엠엠보통주
6831,11200,2020-10-28,0.0665914221218961,8860,9450,590,15306046,11200.0,에이치엠엠보통주
6832,11200,2020-10-26,0.0929368029739776,8070,8820,750,23200669,11200.0,에이치엠엠보통주
6833,11200,2020-10-23,0.056282722513089,7640,8070,430,12431787,11200.0,에이치엠엠보통주
6834,11200,2020-10-21,0.0780141843971631,7050,7600,550,8678052,11200.0,에이치엠엠보통주
6835,11200,2020-09-28,0.0612244897959183,6860,7280,420,3172491,11200.0,에이치엠엠보통주
6836,11200,2020-09-22,0.0418353576248313,7410,7100,-310,5461917,11200.0,에이치엠엠보통주
6837,11200,2020-09-10,0.0909090909090909,6490,7080,590,24811048,11200.0,에이치엠엠보통주
6838,11200,2020-09-09,0.0434083601286173,6220,6490,270,5515664,11200.0,에이치엠엠보통주
6839,11200,2020-09-02,0.0511073253833049,5870,6170,300,3599181,11200.0,에이치엠엠보통주
6840,11200,2020-08-27,0.043010752688172,5580,5340,-240,4604481,11200.0,에이치엠엠보통주
6841,11200,2020-08-20,0.0511945392491467,5860,5560,-300,5282570,11200.0,에이치엠엠보통주
6842,11200,2020-08-18,0.1123244929797191,6410,5690,-720,9674274,11200.0,에이치엠엠보통주
6843,11200,2020-08-13,0.0423197492163009,6380,6650,270,5754698,11200.0,에이치엠엠보통주
6844,11200,2020-08-12,0.0617647058823529,6800,6380,-420,7911865,11200.0,에이치엠엠보통주
6845,11200,2020-08-06,0.0628099173553719,6050,6430,380,12166054,11200.0,에이치엠엠보통주
6846,11200,2020-07-30,0.0655737704918032,5490,5850,360,6111882,11200.0,에이치엠엠보통주
6847,11200,2020-07-29,0.0618955512572533,5170,5490,320,5385525,11200.0,에이치엠엠보통주
6848,11200,2020-07-21,0.045045045045045,4995,5220,225,4054260,11200.0,에이치엠엠보통주
6849,11200,2020-06-26,0.0787037037037037,4320,4660,340,3049102,11200.0,에이치엠엠보통주
6850,11200,2020-06-25,0.0463576158940397,4530,4320,-210,3123364,11200.0,에이치엠엠보통주
6851,11200,2020-06-15,0.0794573643410852,5160,4750,-410,6954895,11200.0,에이치엠엠보통주
6852,11200,2020-06-12,0.0736086175942549,5570,5160,-410,8613229,11200.0,에이치엠엠보통주
6853,11200,2020-06-04,0.099601593625498,5020,5520,500,16221001,11200.0,에이치엠엠보통주
6854,11200,2020-05-27,0.083986562150056,4465,4840,375,15837049,11200.0,에이치엠엠보통주
6855,11200,2020-05-26,0.0746089049338146,4155,4465,310,7337191,11200.0,에이치엠엠보통주
6856,11200,2020-05-25,0.0400500625782227,3995,4155,160,3007002,11200.0,에이치엠엠보통주
6857,11200,2020-05-22,0.0444444444444444,3825,3995,170,12795608,11200.0,에이치엠엠보통주
6858,11200,2020-04-13,0.0516717325227963,3290,3460,170,2574276,11200.0,에이치엠엠보통주
6859,11200,2020-03-31,0.1051693404634581,2805,3100,295,3365384,11200.0,에이치엠엠보통주
6860,11200,2020-03-30,0.0525328330206379,2665,2805,140,1631441,11200.0,에이치엠엠보통주
6861,11200,2020-03-25,0.1111111111111111,2340,2600,260,2671935,11200.0,에이치엠엠보통주
6862,11200,2020-03-24,0.0684931506849315,2190,2340,150,1740696,11200.0,에이치엠엠보통주
6863,11200,2020-03-23,0.0969072164948453,2425,2190,-235,2438506,11200.0,에이치엠엠보통주
6864,11200,2020-03-20,0.043010752688172,2325,2425,100,3836779,11200.0,에이치엠엠보통주
6865,11200,2020-03-19,0.1769911504424778,2825,2325,-500,4066380,11200.0,에이치엠엠보통주
6866,11200,2020-03-18,0.0583333333333333,3000,2825,-175,1617712,11200.0,에이치엠엠보통주
6867,11200,2020-03-13,0.065648854961832,3275,3060,-215,3964328,11200.0,에이치엠엠보통주
6868,11200,2020-03-12,0.0451895043731778,3430,3275,-155,1790039,11200.0,에이치엠엠보통주
6869,11200,2020-03-09,0.0599455040871934,3670,3450,-220,1951088,11200.0,에이치엠엠보통주
6870,11200,2020-03-05,0.0581560283687943,3525,3730,205,1721638,11200.0,에이치엠엠보통주
6871,11200,2020-02-24,0.0442857142857142,3500,3345,-155,1838543,11200.0,에이치엠엠보통주
6872,11200,2020-02-17,0.0405228758169934,3825,3980,155,2545266,11200.0,에이치엠엠보통주
6873,11200,2020-02-10,0.0524822695035461,3525,3710,185,1144368,11200.0,에이치엠엠보통주
6874,11200,2020-01-28,0.0440165061898211,3635,3475,-160,1518192,11200.0,에이치엠엠보통주
6875,11200,2020-01-02,0.056338028169014,3550,3750,200,1799891,11200.0,에이치엠엠보통주
6876,11200,2019-11-19,0.0594202898550724,3450,3655,205,1855117,11200.0,에이치엠엠보통주
6877,11200,2019-08-08,0.0602409638554216,2905,3080,175,731369,11200.0,에이치엠엠보통주
6878,11200,2019-08-05,0.0739549839228295,3110,2880,-230,1699191,11200.0,에이치엠엠보통주
6879,11200,2019-07-05,0.0494505494505494,3640,3820,180,1458377,11200.0,에이치엠엠보통주
6880,11200,2019-06-21,0.0401106500691562,3615,3760,145,1529794,11200.0,에이치엠엠보통주
6881,11200,2019-04-24,0.0476190476190476,4200,4000,-200,2014615,11200.0,에이치엠엠보통주
6882,11200,2019-04-22,0.1099195710455764,3730,4140,410,9097091,11200.0,에이치엠엠보통주
6883,11200,2019-02-28,0.0929705215419501,4410,4000,-410,4179735,11200.0,에이치엠엠보통주
6884,11200,2019-02-07,0.0495867768595041,4235,4445,210,5705243,11200.0,에이치엠엠보통주
6885,11200,2019-02-01,0.0574282147315855,4005,4235,230,2831296,11200.0,에이치엠엠보통주
6886,11200,2018-11-28,0.0625,4000,3750,-250,4099719,11200.0,에이치엠엠보통주
6887,11200,2018-11-19,0.04625,4000,4185,185,1358652,11200.0,에이치엠엠보통주
6888,11200,2018-11-02,0.0695538057742782,3810,4075,265,1362193,11200.0,에이치엠엠보통주
6889,11200,2018-10-29,0.0569948186528497,3860,3640,-220,1764996,11200.0,에이치엠엠보통주
6890,11200,2018-10-26,0.0515970515970515,4070,3860,-210,2384896,11200.0,에이치엠엠보통주
6891,11200,2018-10-11,0.053763440860215,4650,4400,-250,2130347,11200.0,에이치엠엠보통주
6892,11200,2018-09-19,0.0693391115926327,4615,4935,320,20780887,11200.0,에이치엠엠보통주
6893,11200,2018-08-27,0.0460122699386503,4890,4665,-225,1651224,11200.0,에이치엠엠보통주
6894,11200,2018-07-30,0.0491266375545851,4580,4805,225,2061287,11200.0,에이치엠엠보통주
6895,11200,2018-07-26,0.0408163265306122,4410,4590,180,1385551,11200.0,에이치엠엠보통주
6896,11200,2018-07-09,0.047568710359408,4730,4505,-225,2153415,11200.0,에이치엠엠보통주
6897,11200,2018-07-02,0.0556660039761431,5030,4750,-280,1819063,11200.0,에이치엠엠보통주
6898,11200,2018-06-29,0.041407867494824,4830,5030,200,1637367,11200.0,에이치엠엠보통주
6899,11200,2018-06-21,0.0426716141001855,5390,5160,-230,1653062,11200.0,에이치엠엠보통주
6900,11200,2018-06-20,0.0445736434108527,5160,5390,230,2357346,11200.0,에이치엠엠보통주
6901,11200,2018-06-19,0.0532110091743119,5450,5160,-290,3188721,11200.0,에이치엠엠보통주
6902,11200,2018-06-14,0.0516014234875444,5620,5330,-290,4592129,11200.0,에이치엠엠보통주
6903,11200,2018-06-01,0.0406091370558375,5910,5670,-240,5524909,11200.0,에이치엠엠보통주
6904,11200,2018-05-29,0.0696969696969697,6600,6140,-460,15179916,11200.0,에이치엠엠보통주
6905,11200,2018-05-28,0.2244897959183673,5390,6600,1210,46346415,11200.0,에이치엠엠보통주
6906,11200,2018-05-25,0.0817717206132879,5870,5390,-480,9794335,11200.0,에이치엠엠보통주
6907,11200,2018-05-16,0.0667701863354037,6440,6010,-430,16784297,11200.0,에이치엠엠보통주
6908,11200,2018-05-15,0.0420711974110032,6180,6440,260,23600217,11200.0,에이치엠엠보통주
6909,11200,2018-05-14,0.0692041522491349,5780,6180,400,21392613,11200.0,에이치엠엠보통주
6910,11200,2018-05-08,0.0575296108291032,5910,5570,-340,7503974,11200.0,에이치엠엠보통주
6911,11200,2018-05-03,0.0491803278688524,6100,5800,-300,11688589,11200.0,에이치엠엠보통주
6912,11200,2018-04-30,0.1539923954372623,5260,6070,810,69084199,11200.0,에이치엠엠보통주
6913,11200,2018-04-26,0.0775510204081632,4900,5280,380,17980456,11200.0,에이치엠엠보통주
6914,11200,2018-04-23,0.0602655771195097,4895,5190,295,28778966,11200.0,에이치엠엠보통주
6915,11200,2018-04-18,0.0524590163934426,4575,4815,240,9082223,11200.0,에이치엠엠보통주
6916,11200,2018-04-09,0.0588803088803088,5180,4875,-305,9478692,11200.0,에이치엠엠보통주
6917,11200,2018-04-05,0.1482720178372352,4485,5150,665,71697983,11200.0,에이치엠엠보통주
6918,11200,2018-02-05,0.0604166666666666,4800,4510,-290,4672756,11200.0,에이치엠엠보통주
6919,11200,2018-01-03,0.0439121756487025,5010,4790,-220,9789137,11200.0,에이치엠엠보통주
6920,11200,2017-12-27,0.0441176470588235,4760,4970,210,4053766,11200.0,에이치엠엠보통주
6921,11200,2017-12-21,0.0415821501014198,4930,4725,-205,1705382,11200.0,에이치엠엠보통주
6922,11200,2017-12-01,0.0547008547008547,5850,5530,-320,2380521,11200.0,에이치엠엠보통주
6923,11200,2017-11-30,0.0893854748603352,5370,5850,480,5753422,11200.0,에이치엠엠보통주
6924,11200,2017-11-21,0.0743243243243243,5920,5480,-440,4146677,11200.0,에이치엠엠보통주
6925,11200,2017-10-27,0.0493468795355587,6890,7230,340,1362922,11200.0,에이치엠엠보통주
6926,11200,2017-10-16,0.1442786069651741,8040,6880,-1160,4302237,11200.0,에이치엠엠보통주
6927,11200,2017-07-26,0.0414201183431952,8450,8100,-350,2288568,11200.0,에이치엠엠보통주
6928,11200,2017-01-17,0.0442708333333333,7680,8020,340,3727756,11200.0,에이치엠엠보통주
6929,11200,2017-01-12,0.1066126855600539,7410,8200,790,13654100,11200.0,에이치엠엠보통주
6930,11200,2017-01-04,0.0800582241630276,6870,7420,550,4620366,11200.0,에이치엠엠보통주
6931,11200,2016-12-09,0.0585831062670299,7340,6910,-430,3737504,11200.0,에이치엠엠보통주
6932,11200,2016-12-07,0.0540145985401459,6850,7220,370,1445749,11200.0,에이치엠엠보통주
6933,11200,2016-12-01,0.0555555555555555,7200,6800,-400,6780951,11200.0,에이치엠엠보통주
6934,11200,2016-11-21,0.0537352555701179,7630,7220,-410,1391735,11200.0,에이치엠엠보통주
6935,11200,2016-11-10,0.043859649122807,7980,8330,350,1573394,11200.0,에이치엠엠보통주
6936,11200,2016-11-09,0.0545023696682464,8440,7980,-460,3945399,11200.0,에이치엠엠보통주
6937,11200,2016-10-17,0.0520043336944745,9230,8750,-480,4395880,11200.0,에이치엠엠보통주
6938,11200,2016-10-14,0.1053892215568862,8350,9230,880,14914079,11200.0,에이치엠엠보통주
6939,11200,2016-09-26,0.0596833130328867,8210,8700,490,6447382,11200.0,에이치엠엠보통주
6940,11200,2016-09-21,0.0828877005347593,7480,8100,620,9659520,11200.0,에이치엠엠보통주
6941,11200,2016-09-19,0.0409937888198757,8050,7720,-330,2744034,11200.0,에이치엠엠보통주
6942,11200,2016-09-12,0.0686845168800931,8590,8000,-590,4192507,11200.0,에이치엠엠보통주
6943,11200,2016-09-07,0.07953216374269,8550,9230,680,16856732,11200.0,에이치엠엠보통주
6944,11200,2016-09-06,0.0604395604395604,9100,8550,-550,10742393,11200.0,에이치엠엠보통주
6945,11200,2016-08-31,0.2557200538358008,7430,9330,1900,51168100,11200.0,에이치엠엠보통주
6946,11200,2016-08-30,0.0752532561505065,6910,7430,520,12888443,11200.0,에이치엠엠보통주
6947,11200,2016-08-04,0.0706806282722513,7640,7100,-540,14197313,11200.0,에이치엠엠보통주
6948,11200,2016-08-03,0.2792452830188679,10600,7640,-2960,27047568,11200.0,에이치엠엠보통주
6949,11210,2021-05-28,0.0844327176781002,75800,82200,6400,1229949,11210.0,현대위아보통주
6950,11210,2021-05-21,0.0625814863102998,76700,81500,4800,969352,11210.0,현대위아보통주
6951,11210,2021-05-12,0.0642954856361149,73100,77800,4700,1559659,11210.0,현대위아보통주
6952,11210,2021-05-10,0.0434173669467787,71400,74500,3100,468638,11210.0,현대위아보통주
6953,11210,2021-04-02,0.0644329896907216,77600,82600,5000,849489,11210.0,현대위아보통주
6954,11210,2021-02-24,0.0643203883495145,82400,77100,-5300,586168,11210.0,현대위아보통주
6955,11210,2021-02-22,0.0425287356321839,87000,83300,-3700,426649,11210.0,현대위아보통주
6956,11210,2021-02-10,0.05720823798627,87400,92400,5000,709467,11210.0,현대위아보통주
6957,11210,2021-02-08,0.1190233977619532,98300,86600,-11700,1495947,11210.0,현대위아보통주
6958,11210,2021-02-04,0.0564853556485355,95600,101000,5400,1605112,11210.0,현대위아보통주
6959,11210,2021-02-03,0.0436681222707423,91600,95600,4000,1780767,11210.0,현대위아보통주
6960,11210,2021-01-27,0.049049049049049,99900,95000,-4900,1428676,11210.0,현대위아보통주
6961,11210,2021-01-26,0.0530805687203791,105500,99900,-5600,1101172,11210.0,현대위아보통주
6962,11210,2021-01-21,0.1780673181324647,92100,108500,16400,3863251,11210.0,현대위아보통주
6963,11210,2021-01-19,0.0560190703218116,83900,88600,4700,3599250,11210.0,현대위아보통주
6964,11210,2021-01-18,0.1142098273572377,75300,83900,8600,5609212,11210.0,현대위아보통주
6965,11210,2021-01-15,0.0492424242424242,79200,75300,-3900,848657,11210.0,현대위아보통주
6966,11210,2021-01-14,0.0411622276029055,82600,79200,-3400,898883,11210.0,현대위아보통주
6967,11210,2021-01-08,0.2132768361581921,70800,85900,15100,8843690,11210.0,현대위아보통주
6968,11210,2021-01-06,0.0404463040446304,71700,68800,-2900,1318030,11210.0,현대위아보통주
6969,11210,2021-01-04,0.2990654205607476,53500,69500,16000,4951540,11210.0,현대위아보통주
6970,11210,2020-12-30,0.1192468619246862,47800,53500,5700,1727577,11210.0,현대위아보통주
6971,11210,2020-10-30,0.0564971751412429,44250,41750,-2500,374747,11210.0,현대위아보통주
6972,11210,2020-10-28,0.0442374854481955,42950,44850,1900,598313,11210.0,현대위아보통주
6973,11210,2020-10-05,0.0666666666666666,40500,43200,2700,337815,11210.0,현대위아보통주
6974,11210,2020-09-24,0.0459492140266021,41350,39450,-1900,216719,11210.0,현대위아보통주
6975,11210,2020-09-14,0.0555555555555555,40500,42750,2250,344917,11210.0,현대위아보통주
6976,11210,2020-08-20,0.064516129032258,41850,39150,-2700,388556,11210.0,현대위아보통주
6977,11210,2020-08-18,0.0842696629213483,44500,40750,-3750,495363,11210.0,현대위아보통주
6978,11210,2020-08-12,0.068649885583524,43700,46700,3000,1877843,11210.0,현대위아보통주
6979,11210,2020-08-10,0.0924261874197689,38950,42550,3600,1214628,11210.0,현대위아보통주
6980,11210,2020-08-06,0.0421052631578947,38000,39600,1600,520257,11210.0,현대위아보통주
6981,11210,2020-07-13,0.1288515406162464,35700,40300,4600,670976,11210.0,현대위아보통주
6982,11210,2020-07-06,0.065028901734104,34600,36850,2250,189470,11210.0,현대위아보통주
6983,11210,2020-06-16,0.0789473684210526,34200,36900,2700,153133,11210.0,현대위아보통주
6984,11210,2020-06-15,0.0892143808255659,37550,34200,-3350,261868,11210.0,현대위아보통주
6985,11210,2020-06-05,0.0460947503201024,39050,40850,1800,321145,11210.0,현대위아보통주
6986,11210,2020-05-22,0.0421768707482993,36750,35200,-1550,223346,11210.0,현대위아보통주
6987,11210,2020-05-19,0.1459627329192546,32200,36900,4700,1058186,11210.0,현대위아보통주
6988,11210,2020-05-08,0.0672926447574334,31950,34100,2150,341473,11210.0,현대위아보통주
6989,11210,2020-04-13,0.0558739255014326,34900,32950,-1950,266801,11210.0,현대위아보통주
6990,11210,2020-04-09,0.1393442622950819,30500,34750,4250,644704,11210.0,현대위아보통주
6991,11210,2020-04-07,0.0680628272251308,28650,30600,1950,344802,11210.0,현대위아보통주
6992,11210,2020-04-06,0.0852272727272727,26400,28650,2250,330070,11210.0,현대위아보통주
6993,11210,2020-03-31,0.046875,25600,26800,1200,239403,11210.0,현대위아보통주
6994,11210,2020-03-25,0.1326086956521739,23000,26050,3050,414878,11210.0,현대위아보통주
6995,11210,2020-03-24,0.1219512195121951,20500,23000,2500,252348,11210.0,현대위아보통주
6996,11210,2020-03-23,0.1276595744680851,23500,20500,-3000,264304,11210.0,현대위아보통주
6997,11210,2020-03-20,0.1491442542787286,20450,23500,3050,369544,11210.0,현대위아보통주
6998,11210,2020-03-19,0.1670061099796334,24550,20450,-4100,461642,11210.0,현대위아보통주
6999,11210,2020-03-18,0.0907407407407407,27000,24550,-2450,306466,11210.0,현대위아보통주
7000,11210,2020-03-13,0.0515806988352745,30050,28500,-1550,407060,11210.0,현대위아보통주
7001,11210,2020-03-12,0.071097372488408,32350,30050,-2300,347983,11210.0,현대위아보통주
7002,11210,2020-03-09,0.0616438356164383,36500,34250,-2250,283430,11210.0,현대위아보통주
7003,11210,2020-03-06,0.0544041450777202,38600,36500,-2100,290861,11210.0,현대위아보통주
7004,11210,2020-02-28,0.0435323383084577,40200,38450,-1750,167769,11210.0,현대위아보통주
7005,11210,2020-02-24,0.0439429928741092,42100,40250,-1850,144100,11210.0,현대위아보통주
7006,11210,2020-02-06,0.0480656506447831,42650,44700,2050,230071,11210.0,현대위아보통주
7007,11210,2020-01-31,0.0603070175438596,45600,42850,-2750,540621,11210.0,현대위아보통주
7008,11210,2020-01-30,0.0684371807967313,48950,45600,-3350,470032,11210.0,현대위아보통주
7009,11210,2020-01-29,0.0781544256120527,53100,48950,-4150,699813,11210.0,현대위아보통주
7010,11210,2020-01-22,0.0758196721311475,48800,52500,3700,360963,11210.0,현대위아보통주
7011,11210,2020-01-17,0.0444664031620553,50600,48350,-2250,187344,11210.0,현대위아보통주
7012,11210,2020-01-16,0.060796645702306,47700,50600,2900,220929,11210.0,현대위아보통주
7013,11210,2020-01-09,0.0670391061452514,44750,47750,3000,180348,11210.0,현대위아보통주
7014,11210,2019-12-30,0.0404145077720207,48250,50200,1950,79304,11210.0,현대위아보통주
7015,11210,2019-11-12,0.060665362035225,51100,54200,3100,274654,11210.0,현대위아보통주
7016,11210,2019-10-28,0.0409233997901364,47650,49600,1950,355658,11210.0,현대위아보통주
7017,11210,2019-10-25,0.0804988662131519,44100,47650,3550,329451,11210.0,현대위아보통주
7018,11210,2019-10-04,0.0709146968139773,48650,45200,-3450,286761,11210.0,현대위아보통주
7019,11210,2019-09-04,0.0625,44000,46750,2750,289095,11210.0,현대위아보통주
7020,11210,2019-08-28,0.0503067484662576,40750,42800,2050,258610,11210.0,현대위아보통주
7021,11210,2019-07-29,0.0907194994786235,47950,43600,-4350,460556,11210.0,현대위아보통주
7022,11210,2019-07-26,0.0561023622047244,50800,47950,-2850,450016,11210.0,현대위아보통주
7023,11210,2019-07-04,0.0584415584415584,46200,48900,2700,213303,11210.0,현대위아보통주
7024,11210,2019-06-27,0.0418006430868167,46650,48600,1950,141567,11210.0,현대위아보통주
7025,11210,2019-06-18,0.0400890868596882,44900,46700,1800,124014,11210.0,현대위아보통주
7026,11210,2019-06-10,0.0597889800703399,42650,45200,2550,258965,11210.0,현대위아보통주
7027,11210,2019-06-07,0.04406364749082,40850,42650,1800,202504,11210.0,현대위아보통주
7028,11210,2019-05-31,0.0677764565992865,42050,39200,-2850,400535,11210.0,현대위아보통주
7029,11210,2019-05-03,0.0522088353413654,49800,47200,-2600,275719,11210.0,현대위아보통주
7030,11210,2019-04-29,0.0883620689655172,46400,50500,4100,399501,11210.0,현대위아보통주
7031,11210,2019-04-26,0.0432989690721649,48500,46400,-2100,425750,11210.0,현대위아보통주
7032,11210,2019-04-08,0.0601750547045951,45700,48450,2750,471588,11210.0,현대위아보통주
7033,11210,2019-04-05,0.0590961761297798,43150,45700,2550,273889,11210.0,현대위아보통주
7034,11210,2019-04-01,0.0469135802469135,40500,42400,1900,120629,11210.0,현대위아보통주
7035,11210,2019-03-18,0.0471584038694075,41350,43300,1950,123561,11210.0,현대위아보통주
7036,11210,2019-02-25,0.079656862745098,40800,44050,3250,705201,11210.0,현대위아보통주
7037,11210,2019-01-23,0.0488997555012225,40900,42900,2000,223871,11210.0,현대위아보통주
7038,11210,2019-01-18,0.0495552731893265,39350,41300,1950,214611,11210.0,현대위아보통주
7039,11210,2019-01-04,0.0570236439499304,35950,38000,2050,180810,11210.0,현대위아보통주
7040,11210,2018-12-12,0.0796324655436447,32650,35250,2600,492897,11210.0,현대위아보통주
7041,11210,2018-11-27,0.0648298217179902,30850,32850,2000,271786,11210.0,현대위아보통주
7042,11210,2018-11-22,0.0679012345679012,32400,30200,-2200,221256,11210.0,현대위아보통주
7043,11210,2018-11-07,0.0694864048338368,33100,30800,-2300,341745,11210.0,현대위아보통주
7044,11210,2018-11-06,0.0888157894736842,30400,33100,2700,506172,11210.0,현대위아보통주
7045,11210,2018-10-29,0.1112781954887218,33250,29550,-3700,550028,11210.0,현대위아보통주
7046,11210,2018-10-25,0.0722222222222222,36000,33400,-2600,345702,11210.0,현대위아보통주
7047,11210,2018-10-18,0.0560747663551401,37450,35350,-2100,266428,11210.0,현대위아보통주
7048,11210,2018-10-11,0.0476190476190476,38850,37000,-1850,244864,11210.0,현대위아보통주
7049,11210,2018-10-04,0.0488676996424314,41950,39900,-2050,248910,11210.0,현대위아보통주
7050,11210,2018-08-28,0.0631578947368421,42750,45450,2700,426402,11210.0,현대위아보통주
7051,11210,2018-08-21,0.040169133192389,47300,45400,-1900,192849,11210.0,현대위아보통주
7052,11210,2018-08-06,0.0406593406593406,45500,47350,1850,251287,11210.0,현대위아보통주
7053,11210,2018-07-31,0.0620067643742953,44350,47100,2750,415738,11210.0,현대위아보통주
7054,11210,2018-07-30,0.0534441805225653,42100,44350,2250,241654,11210.0,현대위아보통주
7055,11210,2018-07-27,0.0431818181818181,44000,42100,-1900,608880,11210.0,현대위아보통주
7056,11210,2018-07-26,0.0679611650485436,41200,44000,2800,376082,11210.0,현대위아보통주
7057,11210,2018-07-17,0.0506024096385542,41500,43600,2100,241039,11210.0,현대위아보통주
7058,11210,2018-07-06,0.0651041666666666,38400,40900,2500,334491,11210.0,현대위아보통주
7059,11210,2018-07-04,0.0415617128463476,39700,38050,-1650,236391,11210.0,현대위아보통주
7060,11210,2018-05-03,0.0415879017013232,52900,55100,2200,541668,11210.0,현대위아보통주
7061,11210,2018-04-04,0.0437158469945355,54900,57300,2400,327710,11210.0,현대위아보통주
7062,11210,2018-03-29,0.0517241379310344,58000,55000,-3000,294472,11210.0,현대위아보통주
7063,11210,2018-03-02,0.0430292598967297,58100,55600,-2500,208786,11210.0,현대위아보통주
7064,11210,2018-01-26,0.0619335347432024,66200,62100,-4100,786447,11210.0,현대위아보통주
7065,11210,2017-12-11,0.0460829493087557,65100,62100,-3000,301452,11210.0,현대위아보통주
7066,11210,2017-11-13,0.0601851851851851,64800,68700,3900,483317,11210.0,현대위아보통주
7067,11210,2017-10-30,0.0797101449275362,69000,63500,-5500,601536,11210.0,현대위아보통주
7068,11210,2017-10-26,0.0606980273141122,65900,69900,4000,413445,11210.0,현대위아보통주
7069,11210,2017-09-28,0.0405405405405405,66600,63900,-2700,330006,11210.0,현대위아보통주
7070,11210,2017-09-26,0.0759075907590759,60600,65200,4600,326166,11210.0,현대위아보통주
7071,11210,2017-09-15,0.0470588235294117,59500,62300,2800,336226,11210.0,현대위아보통주
7072,11210,2017-09-08,0.0708898944193061,66300,61600,-4700,742237,11210.0,현대위아보통주
7073,11210,2017-08-04,0.0417827298050139,71800,74800,3000,502071,11210.0,현대위아보통주
7074,11210,2017-06-14,0.0510948905109489,68500,72000,3500,803395,11210.0,현대위아보통주
7075,11210,2017-03-22,0.043010752688172,74400,71200,-3200,396980,11210.0,현대위아보통주
7076,11210,2017-03-21,0.092511013215859,68100,74400,6300,736913,11210.0,현대위아보통주
7077,11210,2017-02-14,0.0429936305732484,62800,65500,2700,390283,11210.0,현대위아보통주
7078,11210,2017-01-31,0.0678210678210678,69300,64600,-4700,619221,11210.0,현대위아보통주
7079,11210,2017-01-18,0.0554821664464993,75700,79900,4200,374969,11210.0,현대위아보통주
7080,11210,2017-01-03,0.0512129380053908,74200,78000,3800,299328,11210.0,현대위아보통주
7081,11210,2016-12-08,0.0689149560117302,68200,72900,4700,242455,11210.0,현대위아보통주
7082,11210,2016-11-10,0.0482573726541554,74600,71000,-3600,395801,11210.0,현대위아보통주
7083,11210,2016-11-09,0.0435897435897435,78000,74600,-3400,255223,11210.0,현대위아보통주
7084,11210,2016-10-31,0.0574850299401197,83500,78700,-4800,339527,11210.0,현대위아보통주
7085,11210,2016-08-30,0.0466439135381114,87900,92000,4100,267965,11210.0,현대위아보통주
7086,11210,2016-08-24,0.0431654676258992,83400,87000,3600,171561,11210.0,현대위아보통주
7087,11780,2021-05-26,0.0419426048565121,226500,236000,9500,440802,11780.0,금호석유화학보통주
7088,11780,2021-05-21,0.0492505353319057,233500,222000,-11500,626952,11780.0,금호석유화학보통주
7089,11780,2021-05-17,0.0676229508196721,244000,227500,-16500,804028,11780.0,금호석유화학보통주
7090,11780,2021-05-13,0.0558882235528942,250500,236500,-14000,1178557,11780.0,금호석유화학보통주
7091,11780,2021-05-12,0.0511363636363636,264000,250500,-13500,925915,11780.0,금호석유화학보통주
7092,11780,2021-05-11,0.0486486486486486,277500,264000,-13500,918965,11780.0,금호석유화학보통주
7093,11780,2021-05-07,0.0506756756756756,296000,281000,-15000,1118955,11780.0,금호석유화학보통주
7094,11780,2021-05-06,0.0962962962962963,270000,296000,26000,2085191,11780.0,금호석유화학보통주
7095,11780,2021-04-28,0.0702702702702702,277500,258000,-19500,935010,11780.0,금호석유화학보통주
7096,11780,2021-04-21,0.0542056074766355,267500,282000,14500,1074273,11780.0,금호석유화학보통주
7097,11780,2021-04-19,0.06,250000,265000,15000,778193,11780.0,금호석유화학보통주
7098,11780,2021-04-05,0.046692607003891,257000,245000,-12000,585049,11780.0,금호석유화학보통주
7099,11780,2021-03-29,0.0878661087866108,239000,260000,21000,2005314,11780.0,금호석유화학보통주
7100,11780,2021-03-26,0.0598669623059867,225500,239000,13500,1296751,11780.0,금호석유화학보통주
7101,11780,2021-03-19,0.0470852017937219,223000,233500,10500,668468,11780.0,금호석유화학보통주
7102,11780,2021-03-15,0.0735930735930736,231000,214000,-17000,648067,11780.0,금호석유화학보통주
7103,11780,2021-03-12,0.0405405405405405,222000,231000,9000,729949,11780.0,금호석유화학보통주
7104,11780,2021-03-11,0.062200956937799,209000,222000,13000,667625,11780.0,금호석유화학보통주
7105,11780,2021-03-09,0.0531177829099307,216500,205000,-11500,614628,11780.0,금호석유화학보통주
7106,11780,2021-03-08,0.0747863247863247,234000,216500,-17500,482484,11780.0,금호석유화학보통주
7107,11780,2021-03-03,0.0837320574162679,209000,226500,17500,848949,11780.0,금호석유화학보통주
7108,11780,2021-02-26,0.0430839002267573,220500,211000,-9500,622167,11780.0,금호석유화학보통주
7109,11780,2021-02-25,0.0475059382422802,210500,220500,10000,538615,11780.0,금호석유화학보통주
7110,11780,2021-02-24,0.0907127429805615,231500,210500,-21000,937047,11780.0,금호석유화학보통주
7111,11780,2021-02-22,0.0701402805611222,249500,232000,-17500,680371,11780.0,금호석유화학보통주
7112,11780,2021-02-08,0.0524412296564195,276500,262000,-14500,713052,11780.0,금호석유화학보통주
7113,11780,2021-02-05,0.0928853754940711,253000,276500,23500,1873503,11780.0,금호석유화학보통주
7114,11780,2021-01-29,0.1064981949458483,277000,247500,-29500,2025982,11780.0,금호석유화학보통주
7115,11780,2021-01-28,0.2311111111111111,225000,277000,52000,3611897,11780.0,금호석유화학보통주
7116,11780,2021-01-26,0.1221374045801526,196500,220500,24000,922812,11780.0,금호석유화학보통주
7117,11780,2021-01-21,0.0813953488372093,172000,186000,14000,835900,11780.0,금호석유화학보통주
7118,11780,2021-01-20,0.0424242424242424,165000,172000,7000,285181,11780.0,금호석유화학보통주
7119,11780,2021-01-14,0.0584615384615384,162500,172000,9500,463623,11780.0,금호석유화학보통주
7120,11780,2021-01-11,0.0477611940298507,167500,159500,-8000,524432,11780.0,금호석유화학보통주
7121,11780,2021-01-07,0.0650154798761609,161500,172000,10500,530278,11780.0,금호석유화학보통주
7122,11780,2021-01-05,0.076158940397351,151000,162500,11500,905999,11780.0,금호석유화학보통주
7123,11780,2021-01-04,0.0413793103448275,145000,151000,6000,360114,11780.0,금호석유화학보통주
7124,11780,2020-12-16,0.0888888888888888,135000,147000,12000,861714,11780.0,금호석유화학보통주
7125,11780,2020-11-24,0.0503355704697986,149000,141500,-7500,640945,11780.0,금호석유화학보통주
7126,11780,2020-11-19,0.0596491228070175,142500,151000,8500,508080,11780.0,금호석유화학보통주
7127,11780,2020-11-18,0.0555555555555555,135000,142500,7500,582475,11780.0,금호석유화학보통주
7128,11780,2020-11-10,0.1111111111111111,153000,136000,-17000,877923,11780.0,금호석유화학보통주
7129,11780,2020-11-05,0.1449814126394052,134500,154000,19500,614061,11780.0,금호석유화학보통주
7130,11780,2020-10-27,0.0528169014084507,142000,134500,-7500,274299,11780.0,금호석유화학보통주
7131,11780,2020-10-16,0.0592334494773519,143500,135000,-8500,323399,11780.0,금호석유화학보통주
7132,11780,2020-10-08,0.1058823529411764,127500,141000,13500,584077,11780.0,금호석유화학보통주
7133,11780,2020-10-07,0.0408163265306122,122500,127500,5000,273734,11780.0,금호석유화학보통주
7134,11780,2020-10-05,0.0772727272727272,110000,118500,8500,346158,11780.0,금호석유화학보통주
7135,11780,2020-09-28,0.1018711018711018,96200,106000,9800,407438,11780.0,금호석유화학보통주
7136,11780,2020-09-14,0.045,100000,104500,4500,235136,11780.0,금호석유화학보통주
7137,11780,2020-09-08,0.1049327354260089,111500,99800,-11700,362556,11780.0,금호석유화학보통주
7138,11780,2020-09-07,0.1365953109072375,98100,111500,13400,448358,11780.0,금호석유화학보통주
7139,11780,2020-08-19,0.04,100000,104000,4000,192293,11780.0,금호석유화학보통주
7140,11780,2020-08-07,0.0704545454545454,88000,94200,6200,463565,11780.0,금호석유화학보통주
7141,11780,2020-08-05,0.0423216444981862,82700,86200,3500,212410,11780.0,금호석유화학보통주
7142,11780,2020-07-15,0.054958183990442,83700,88300,4600,554799,11780.0,금호석유화학보통주
7143,11780,2020-07-14,0.0554854981084489,79300,83700,4400,550286,11780.0,금호석유화학보통주
7144,11780,2020-07-13,0.105997210599721,71700,79300,7600,621466,11780.0,금호석유화학보통주
7145,11780,2020-06-25,0.0425806451612903,77500,74200,-3300,140052,11780.0,금호석유화학보통주
7146,11780,2020-06-19,0.0482573726541554,74600,78200,3600,345894,11780.0,금호석유화학보통주
7147,11780,2020-06-16,0.1159420289855072,69000,77000,8000,417830,11780.0,금호석유화학보통주
7148,11780,2020-06-11,0.0468140442132639,76900,73300,-3600,316903,11780.0,금호석유화학보통주
7149,11780,2020-06-03,0.0450704225352112,71000,74200,3200,490051,11780.0,금호석유화학보통주
7150,11780,2020-05-07,0.0504322766570605,69400,72900,3500,390709,11780.0,금호석유화학보통주
7151,11780,2020-05-04,0.0746073298429319,76400,70700,-5700,368916,11780.0,금호석유화학보통주
7152,11780,2020-04-27,0.077683615819209,70800,76300,5500,394219,11780.0,금호석유화학보통주
7153,11780,2020-04-23,0.0671641791044776,67000,71500,4500,344644,11780.0,금호석유화학보통주
7154,11780,2020-04-01,0.0509259259259259,64800,61500,-3300,183538,11780.0,금호석유화학보통주
7155,11780,2020-03-31,0.0519480519480519,61600,64800,3200,267827,11780.0,금호석유화학보통주
7156,11780,2020-03-30,0.0511945392491467,58600,61600,3000,359271,11780.0,금호석유화학보통주
7157,11780,2020-03-27,0.052064631956912,55700,58600,2900,368634,11780.0,금호석유화학보통주
7158,11780,2020-03-25,0.0439560439560439,54600,57000,2400,233039,11780.0,금호석유화학보통주
7159,11780,2020-03-20,0.2992036405005688,43950,57100,13150,222820,11780.0,금호석유화학보통주
7160,11780,2020-03-19,0.1365422396856581,50900,43950,-6950,198103,11780.0,금호석유화학보통주
7161,11780,2020-03-17,0.04,52500,50400,-2100,153508,11780.0,금호석유화학보통주
7162,11780,2020-03-13,0.0694444444444444,57600,53600,-4000,196782,11780.0,금호석유화학보통주
7163,11780,2020-03-12,0.0754414125200642,62300,57600,-4700,256224,11780.0,금호석유화학보통주
7164,11780,2020-03-09,0.041860465116279,64500,61800,-2700,192663,11780.0,금호석유화학보통주
7165,11780,2020-03-05,0.0662358642972536,61900,66000,4100,226620,11780.0,금호석유화학보통주
7166,11780,2020-03-04,0.0581196581196581,58500,61900,3400,180579,11780.0,금호석유화학보통주
7167,11780,2020-02-28,0.0496794871794871,62400,59300,-3100,220357,11780.0,금호석유화학보통주
7168,11780,2020-02-06,0.0709969788519637,66200,70900,4700,238530,11780.0,금호석유화학보통주
7169,11780,2020-01-31,0.0788732394366197,71000,65400,-5600,479667,11780.0,금호석유화학보통주
7170,11780,2020-01-28,0.0499342969776609,76100,72300,-3800,171215,11780.0,금호석유화학보통주
7171,11780,2020-01-08,0.0490322580645161,77500,73700,-3800,142062,11780.0,금호석유화학보통주
7172,11780,2019-11-25,0.0747531734837799,70900,76200,5300,250017,11780.0,금호석유화학보통주
7173,11780,2019-11-04,0.0409026798307475,70900,73800,2900,357952,11780.0,금호석유화학보통주
7174,11780,2019-08-26,0.0445682451253481,71800,68600,-3200,178761,11780.0,금호석유화학보통주
7175,11780,2019-08-06,0.0448979591836734,73500,70200,-3300,239754,11780.0,금호석유화학보통주
7176,11780,2019-08-05,0.0754716981132075,79500,73500,-6000,229740,11780.0,금호석유화학보통주
7177,11780,2019-06-24,0.042051282051282,97500,93400,-4100,171185,11780.0,금호석유화학보통주
7178,11780,2019-06-10,0.0468583599574014,93900,98300,4400,108300,11780.0,금호석유화학보통주
7179,11780,2019-05-02,0.0620915032679738,91800,97500,5700,320936,11780.0,금호석유화학보통주
7180,11780,2019-04-17,0.0433467741935483,99200,94900,-4300,386798,11780.0,금호석유화학보통주
7181,11780,2019-03-19,0.0404040404040404,99000,95000,-4000,178702,11780.0,금호석유화학보통주
7182,11780,2019-03-15,0.0425311203319502,96400,100500,4100,202474,11780.0,금호석유화학보통주
7183,11780,2019-02-25,0.0407949790794979,95600,99500,3900,233946,11780.0,금호석유화학보통주
7184,11780,2019-02-20,0.0789766407119021,89900,97000,7100,466078,11780.0,금호석유화학보통주
7185,11780,2019-02-07,0.0420819490586932,90300,86500,-3800,203199,11780.0,금호석유화학보통주
7186,11780,2019-01-07,0.1064871481028151,81700,90400,8700,349107,11780.0,금호석유화학보통주
7187,11780,2018-12-10,0.0599547511312217,88400,83100,-5300,188085,11780.0,금호석유화학보통주
7188,11780,2018-11-12,0.0411899313501144,87400,91000,3600,137966,11780.0,금호석유화학보통주
7189,11780,2018-11-06,0.0583941605839416,95900,90300,-5600,189049,11780.0,금호석유화학보통주
7190,11780,2018-11-02,0.0783410138248847,86800,93600,6800,263126,11780.0,금호석유화학보통주
7191,11780,2018-10-31,0.0423728813559322,82600,86100,3500,150418,11780.0,금호석유화학보통주
7192,11780,2018-10-23,0.0492721164613661,89300,84900,-4400,140179,11780.0,금호석유화학보통주
7193,11780,2018-10-22,0.0543093270365997,84700,89300,4600,124410,11780.0,금호석유화학보통주
7194,11780,2018-10-12,0.0428921568627451,81600,85100,3500,165410,11780.0,금호석유화학보통주
7195,11780,2018-10-11,0.0599078341013824,86800,81600,-5200,220892,11780.0,금호석유화학보통주
7196,11780,2018-10-05,0.0478905359179019,87700,83500,-4200,290954,11780.0,금호석유화학보통주
7197,11780,2018-10-01,0.0964467005076142,98500,89000,-9500,363084,11780.0,금호석유화학보통주
7198,11780,2018-09-17,0.0411764705882352,102000,97800,-4200,194237,11780.0,금호석유화학보통주
7199,11780,2018-08-06,0.0769230769230769,110500,102000,-8500,384941,11780.0,금호석유화학보통주
7200,11780,2018-08-03,0.0523809523809523,105000,110500,5500,190338,11780.0,금호석유화학보통주
7201,11780,2018-08-01,0.0663716814159292,113000,105500,-7500,262673,11780.0,금호석유화학보통주
7202,11780,2018-07-16,0.0570175438596491,114000,107500,-6500,183133,11780.0,금호석유화학보통주
7203,11780,2018-06-21,0.062200956937799,104500,111000,6500,257058,11780.0,금호석유화학보통주
7204,11780,2018-06-14,0.0443349753694581,101500,106000,4500,309391,11780.0,금호석유화학보통주
7205,11780,2018-05-25,0.041860465116279,107500,103000,-4500,109801,11780.0,금호석유화학보통주
7206,11780,2018-05-23,0.0495495495495495,111000,105500,-5500,183724,11780.0,금호석유화학보통주
7207,11780,2018-04-30,0.096938775510204,98000,107500,9500,663667,11780.0,금호석유화학보통주
7208,11780,2018-04-27,0.0436634717784877,93900,98000,4100,262147,11780.0,금호석유화학보통주
7209,11780,2018-04-12,0.0518358531317494,92600,97400,4800,197167,11780.0,금호석유화학보통주
7210,11780,2018-04-06,0.0419287211740041,95400,91400,-4000,146214,11780.0,금호석유화학보통주
7211,11780,2018-04-04,0.0620549338758901,98300,92200,-6100,172903,11780.0,금호석유화학보통주
7212,11780,2018-03-21,0.0642002176278563,91900,97800,5900,347310,11780.0,금호석유화학보통주
7213,11780,2018-03-05,0.0670391061452514,89500,83500,-6000,358114,11780.0,금호석유화학보통주
7214,11780,2018-02-26,0.0474040632054176,88600,92800,4200,271427,11780.0,금호석유화학보통주
7215,11780,2018-02-20,0.0431578947368421,95000,90900,-4100,174649,11780.0,금호석유화학보통주
7216,11780,2018-02-19,0.0428100987925356,91100,95000,3900,210828,11780.0,금호석유화학보통주
7217,11780,2018-02-12,0.0408839779005524,90500,86800,-3700,454196,11780.0,금호석유화학보통주
7218,11780,2018-02-07,0.099,100000,90100,-9900,383269,11780.0,금호석유화학보통주
7219,11780,2018-01-30,0.0516431924882629,106500,101000,-5500,199610,11780.0,금호석유화학보통주
7220,11780,2018-01-19,0.065,100000,106500,6500,214735,11780.0,금호석유화학보통주
7221,11780,2018-01-12,0.0460829493087557,108500,103500,-5000,342417,11780.0,금호석유화학보통주
7222,11780,2018-01-02,0.0402010050251256,99500,103500,4000,123963,11780.0,금호석유화학보통주
7223,11780,2017-12-14,0.0447928331466965,89300,93300,4000,309565,11780.0,금호석유화학보통주
7224,11780,2017-12-11,0.0464037122969837,86200,90200,4000,235509,11780.0,금호석유화학보통주
7225,11780,2017-11-29,0.0439306358381502,86500,90300,3800,351924,11780.0,금호석유화학보통주
7226,11780,2017-11-28,0.0535931790499391,82100,86500,4400,756712,11780.0,금호석유화학보통주
7227,11780,2017-11-27,0.044529262086514,78600,82100,3500,573905,11780.0,금호석유화학보통주
7228,11780,2017-11-23,0.0492021276595744,75200,78900,3700,265540,11780.0,금호석유화학보통주
7229,11780,2017-11-01,0.0792507204610951,69400,74900,5500,552428,11780.0,금호석유화학보통주
7230,11780,2017-10-13,0.0509193776520509,70700,67100,-3600,356462,11780.0,금호석유화학보통주
7231,11780,2017-09-22,0.0510471204188481,76400,72500,-3900,211152,11780.0,금호석유화학보통주
7232,11780,2017-07-03,0.0517006802721088,73500,77300,3800,296922,11780.0,금호석유화학보통주
7233,11780,2017-05-22,0.045822102425876,74200,77600,3400,457794,11780.0,금호석유화학보통주
7234,11780,2017-04-26,0.0431848852901484,74100,77300,3200,274329,11780.0,금호석유화학보통주
7235,11780,2017-04-11,0.0466321243523316,77200,80800,3600,332702,11780.0,금호석유화학보통주
7236,11780,2017-03-29,0.0545938748335552,75100,79200,4100,411145,11780.0,금호석유화학보통주
7237,11780,2017-02-03,0.0564042303172738,85100,80300,-4800,565951,11780.0,금호석유화학보통주
7238,11780,2017-01-20,0.0529344073647871,86900,82300,-4600,465813,11780.0,금호석유화학보통주
7239,11780,2017-01-12,0.0500568828213879,87900,92300,4400,302907,11780.0,금호석유화학보통주
7240,11780,2017-01-02,0.0414634146341463,82000,85400,3400,153951,11780.0,금호석유화학보통주
7241,11780,2016-12-20,0.0440251572327044,79500,83000,3500,268354,11780.0,금호석유화학보통주
7242,11780,2016-12-15,0.0868385345997286,73700,80100,6400,403637,11780.0,금호석유화학보통주
7243,11780,2016-12-01,0.047945205479452,73000,76500,3500,214448,11780.0,금호석유화학보통주
7244,11780,2016-11-22,0.0445945945945946,74000,77300,3300,213181,11780.0,금호석유화학보통주
7245,11780,2016-11-15,0.0451527224435591,75300,71900,-3400,161746,11780.0,금호석유화학보통주
7246,11780,2016-11-11,0.0705882352941176,68000,72800,4800,230143,11780.0,금호석유화학보통주
7247,11780,2016-11-07,0.0458015267175572,65500,68500,3000,115698,11780.0,금호석유화학보통주
7248,11780,2016-10-14,0.0528511821974965,71900,75700,3800,295309,11780.0,금호석유화학보통주
7249,11780,2016-10-12,0.0450331125827814,75500,72100,-3400,289863,11780.0,금호석유화학보통주
7250,11780,2016-10-10,0.043175487465181,71800,74900,3100,287300,11780.0,금호석유화학보통주
7251,11780,2016-10-04,0.0486409155937052,69900,73300,3400,322273,11780.0,금호석유화학보통주
7252,11780,2016-09-29,0.0680786686838124,66100,70600,4500,289744,11780.0,금호석유화학보통주
7253,11780,2016-08-17,0.1236306729264475,63900,71800,7900,1098106,11780.0,금호석유화학보통주
7254,11780,2016-08-05,0.0465116279069767,60200,63000,2800,146587,11780.0,금호석유화학보통주
7255,11790,2021-06-01,0.0431372549019607,127500,133000,5500,337279,11790.0,SKC보통주
7256,11790,2021-05-13,0.0586080586080586,136500,128500,-8000,659609,11790.0,SKC보통주
7257,11790,2021-04-30,0.0492957746478873,142000,135000,-7000,538661,11790.0,SKC보통주
7258,11790,2021-04-29,0.047970479704797,135500,142000,6500,471127,11790.0,SKC보통주
7259,11790,2021-04-12,0.0549450549450549,136500,144000,7500,1062066,11790.0,SKC보통주
7260,11790,2021-03-30,0.0530612244897959,122500,129000,6500,407194,11790.0,SKC보통주
7261,11790,2021-03-25,0.0755555555555555,112500,121000,8500,614029,11790.0,SKC보통주
7262,11790,2021-03-24,0.0514018691588785,107000,112500,5500,592142,11790.0,SKC보통주
7263,11790,2021-03-23,0.0614035087719298,114000,107000,-7000,1266374,11790.0,SKC보통주
7264,11790,2021-02-24,0.0511811023622047,127000,120500,-6500,713869,11790.0,SKC보통주
7265,11790,2021-02-22,0.04,137500,132000,-5500,405858,11790.0,SKC보통주
7266,11790,2021-02-15,0.0419847328244274,131000,136500,5500,652023,11790.0,SKC보통주
7267,11790,2021-02-10,0.0564516129032258,124000,131000,7000,680105,11790.0,SKC보통주
7268,11790,2021-02-02,0.0843373493975903,124500,135000,10500,1291196,11790.0,SKC보통주
7269,11790,2021-01-21,0.0627802690582959,111500,118500,7000,613499,11790.0,SKC보통주
7270,11790,2021-01-19,0.0891089108910891,101000,110000,9000,1108463,11790.0,SKC보통주
7271,11790,2021-01-14,0.0574018126888217,99300,105000,5700,435318,11790.0,SKC보통주
7272,11790,2021-01-08,0.0441176470588235,102000,106500,4500,756952,11790.0,SKC보통주
7273,11790,2021-01-04,0.0797872340425532,94000,101500,7500,1004073,11790.0,SKC보통주
7274,11790,2020-11-27,0.0752427184466019,82400,88600,6200,1250995,11790.0,SKC보통주
7275,11790,2020-11-03,0.087956698240866,73900,80400,6500,909163,11790.0,SKC보통주
7276,11790,2020-10-19,0.067774936061381,78200,72900,-5300,647889,11790.0,SKC보통주
7277,11790,2020-09-28,0.0438144329896907,77600,81000,3400,241127,11790.0,SKC보통주
7278,11790,2020-09-24,0.0876168224299065,85600,78100,-7500,707403,11790.0,SKC보통주
7279,11790,2020-08-24,0.0771850170261067,88100,94900,6800,1060520,11790.0,SKC보통주
7280,11790,2020-08-21,0.098503740648379,80200,88100,7900,1079569,11790.0,SKC보통주
7281,11790,2020-08-20,0.0497630331753554,84400,80200,-4200,474352,11790.0,SKC보통주
7282,11790,2020-08-14,0.0558659217877094,89500,84500,-5000,813931,11790.0,SKC보통주
7283,11790,2020-08-07,0.0508474576271186,82600,86800,4200,983407,11790.0,SKC보통주
7284,11790,2020-08-06,0.0468948035487959,78900,82600,3700,743012,11790.0,SKC보통주
7285,11790,2020-08-05,0.046419098143236,75400,78900,3500,716819,11790.0,SKC보통주
7286,11790,2020-08-03,0.1015736766809728,69900,77000,7100,952558,11790.0,SKC보통주
7287,11790,2020-07-23,0.0459940652818991,67400,70500,3100,422996,11790.0,SKC보통주
7288,11790,2020-07-09,0.0674846625766871,65200,69600,4400,751267,11790.0,SKC보통주
7289,11790,2020-07-06,0.0453808752025931,61700,64500,2800,448329,11790.0,SKC보통주
7290,11790,2020-06-22,0.0542372881355932,59000,62200,3200,903177,11790.0,SKC보통주
7291,11790,2020-06-16,0.075187969924812,53200,57200,4000,432090,11790.0,SKC보통주
7292,11790,2020-06-15,0.0859106529209622,58200,53200,-5000,648329,11790.0,SKC보통주
7293,11790,2020-05-26,0.0787545787545787,54600,58900,4300,859136,11790.0,SKC보통주
7294,11790,2020-05-18,0.0431372549019607,51000,53200,2200,519478,11790.0,SKC보통주
7295,11790,2020-05-13,0.051440329218107,48600,51100,2500,758424,11790.0,SKC보통주
7296,11790,2020-04-24,0.047024952015355,52100,49650,-2450,674208,11790.0,SKC보통주
7297,11790,2020-04-21,0.0590551181102362,50800,53800,3000,990195,11790.0,SKC보통주
7298,11790,2020-04-17,0.0784103114930182,46550,50200,3650,745410,11790.0,SKC보통주
7299,11790,2020-04-16,0.064,43750,46550,2800,530645,11790.0,SKC보통주
7300,11790,2020-04-14,0.0644768856447688,41100,43750,2650,464781,11790.0,SKC보통주
7301,11790,2020-04-13,0.0605714285714285,43750,41100,-2650,378340,11790.0,SKC보통주
7302,11790,2020-04-08,0.053231939163498,39450,41550,2100,804422,11790.0,SKC보통주
7303,11790,2020-04-06,0.05420054200542,36900,38900,2000,394806,11790.0,SKC보통주
7304,11790,2020-03-25,0.0816023738872403,33700,36450,2750,611397,11790.0,SKC보통주
7305,11790,2020-03-24,0.1140495867768595,30250,33700,3450,514471,11790.0,SKC보통주
7306,11790,2020-03-23,0.057632398753894,32100,30250,-1850,510875,11790.0,SKC보통주
7307,11790,2020-03-20,0.1443850267379679,28050,32100,4050,725893,11790.0,SKC보통주
7308,11790,2020-03-19,0.1916426512968299,34700,28050,-6650,962144,11790.0,SKC보통주
7309,11790,2020-03-18,0.1170483460559796,39300,34700,-4600,571181,11790.0,SKC보통주
7310,11790,2020-03-16,0.0809248554913294,43250,39750,-3500,339291,11790.0,SKC보통주
7311,11790,2020-03-13,0.0567066521264994,45850,43250,-2600,655249,11790.0,SKC보통주
7312,11790,2020-03-12,0.0614124872057318,48850,45850,-3000,576175,11790.0,SKC보통주
7313,11790,2020-03-09,0.0616822429906542,53500,50200,-3300,387088,11790.0,SKC보통주
7314,11790,2020-02-28,0.0428305400372439,53700,51400,-2300,505688,11790.0,SKC보통주
7315,11790,2020-02-12,0.0458404074702886,58900,56200,-2700,712465,11790.0,SKC보통주
7316,11790,2020-02-11,0.0536672629695885,55900,58900,3000,775403,11790.0,SKC보통주
7317,11790,2020-02-04,0.0760667903525046,53900,58000,4100,815230,11790.0,SKC보통주
7318,11790,2020-01-22,0.0479846449136276,52100,54600,2500,426653,11790.0,SKC보통주
7319,11790,2019-11-08,0.0442176870748299,44100,46050,1950,239015,11790.0,SKC보통주
7320,11790,2019-11-04,0.0525139664804469,44750,47100,2350,367117,11790.0,SKC보통주
7321,11790,2019-10-28,0.0900243309002433,41100,44800,3700,547251,11790.0,SKC보통주
7322,11790,2019-09-25,0.0623529411764705,42500,39850,-2650,717814,11790.0,SKC보통주
7323,11790,2019-09-23,0.0408626560726447,44050,42250,-1800,285822,11790.0,SKC보통주
7324,11790,2019-08-28,0.0410654827968923,45050,46900,1850,440153,11790.0,SKC보통주
7325,11790,2019-08-16,0.0440097799511002,40900,42700,1800,291842,11790.0,SKC보통주
7326,11790,2019-08-12,0.043173862310385,42850,41000,-1850,329159,11790.0,SKC보통주
7327,11790,2019-06-28,0.0760869565217391,36800,39600,2800,513524,11790.0,SKC보통주
7328,11790,2019-06-14,0.0456431535269709,36150,37800,1650,1513448,11790.0,SKC보통주
7329,11790,2019-06-12,0.0682852807283763,32950,35200,2250,504668,11790.0,SKC보통주
7330,11790,2019-05-13,0.0759312320916905,34900,32250,-2650,241494,11790.0,SKC보통주
7331,11790,2019-02-19,0.0593824228028503,42100,39600,-2500,448190,11790.0,SKC보통주
7332,11790,2019-01-07,0.0611664295874822,35150,37300,2150,127528,11790.0,SKC보통주
7333,11790,2018-12-13,0.0450581395348837,34400,35950,1550,157744,11790.0,SKC보통주
7334,11790,2018-11-02,0.05,33000,34650,1650,167238,11790.0,SKC보통주
7335,11790,2018-10-29,0.0444444444444444,33750,32250,-1500,179320,11790.0,SKC보통주
7336,11790,2018-10-23,0.0542328042328042,37800,35750,-2050,201755,11790.0,SKC보통주
7337,11790,2018-10-11,0.0537897310513447,40900,38700,-2200,229665,11790.0,SKC보통주
7338,11790,2018-06-20,0.1011235955056179,40050,44100,4050,544091,11790.0,SKC보통주
7339,11790,2018-06-05,0.0407124681933842,39300,40900,1600,337335,11790.0,SKC보통주
7340,11790,2018-05-04,0.0624169986719787,37650,40000,2350,341699,11790.0,SKC보통주
7341,11790,2018-04-23,0.0401069518716577,37400,38900,1500,189637,11790.0,SKC보통주
7342,11790,2018-04-02,0.0418300653594771,38250,36650,-1600,259054,11790.0,SKC보통주
7343,11790,2018-03-23,0.0561941251596424,39150,36950,-2200,171075,11790.0,SKC보통주
7344,11790,2018-02-07,0.0464824120603015,39800,37950,-1850,453620,11790.0,SKC보통주
7345,11790,2018-02-05,0.048331415420023,43450,41350,-2100,253242,11790.0,SKC보통주
7346,11790,2018-01-09,0.0412371134020618,48500,46500,-2000,323663,11790.0,SKC보통주
7347,11790,2018-01-03,0.053763440860215,46500,49000,2500,416954,11790.0,SKC보통주
7348,11790,2017-12-28,0.0718358038768529,43850,47000,3150,857606,11790.0,SKC보통주
7349,11790,2017-12-19,0.0416197975253093,44450,42600,-1850,235861,11790.0,SKC보통주
7350,11790,2017-12-15,0.0515826494724501,42650,44850,2200,253793,11790.0,SKC보통주
7351,11790,2017-12-11,0.0505548705302096,40550,42600,2050,152480,11790.0,SKC보통주
7352,11790,2017-11-10,0.0460772104607721,40150,42000,1850,336721,11790.0,SKC보통주
7353,11790,2017-10-23,0.042362002567394,38950,40600,1650,194652,11790.0,SKC보통주
7354,11790,2017-09-18,0.0521212121212121,41250,43400,2150,552952,11790.0,SKC보통주
7355,11790,2017-09-06,0.0432960893854748,35800,37350,1550,197572,11790.0,SKC보통주
7356,11790,2017-08-01,0.0413793103448275,36250,37750,1500,301182,11790.0,SKC보통주
7357,11790,2017-07-12,0.0917030567685589,34350,37500,3150,1326254,11790.0,SKC보통주
7358,11790,2017-06-13,0.0885668276972624,31050,33800,2750,1004550,11790.0,SKC보통주
7359,11790,2017-06-09,0.0433333333333333,30000,31300,1300,373150,11790.0,SKC보통주
7360,11790,2017-02-10,0.0657051282051282,31200,33250,2050,401664,11790.0,SKC보통주
7361,11790,2016-11-14,0.0687285223367697,29100,31100,2000,1076972,11790.0,SKC보통주
7362,11790,2016-11-10,0.0513761467889908,27250,28650,1400,305005,11790.0,SKC보통주
7363,11790,2016-08-11,0.04,31250,30000,-1250,441543,11790.0,SKC보통주
7364,11790,2016-08-09,0.0426929392446633,30450,31750,1300,951138,11790.0,SKC보통주
7365,12330,2021-04-08,0.0565723793677204,300500,317500,17000,1037853,12330.0,현대모비스보통주
7366,12330,2021-03-30,0.051056338028169,284000,298500,14500,522238,12330.0,현대모비스보통주
7367,12330,2021-02-24,0.0461538461538461,325000,310000,-15000,707003,12330.0,현대모비스보통주
7368,12330,2021-02-08,0.0865248226950354,352500,322000,-30500,1747047,12330.0,현대모비스보통주
7369,12330,2021-02-01,0.0566929133858267,317500,335500,18000,664246,12330.0,현대모비스보통주
7370,12330,2021-01-29,0.0407854984894259,331000,317500,-13500,905941,12330.0,현대모비스보통주
7371,12330,2021-01-21,0.0555555555555555,342000,361000,19000,1347421,12330.0,현대모비스보통주
7372,12330,2021-01-19,0.0664605873261205,323500,345000,21500,1090041,12330.0,현대모비스보통주
7373,12330,2021-01-12,0.0581560283687943,352500,332000,-20500,1874045,12330.0,현대모비스보통주
7374,12330,2021-01-08,0.180623973727422,304500,359500,55000,5326204,12330.0,현대모비스보통주
7375,12330,2021-01-07,0.074074074074074,283500,304500,21000,1402113,12330.0,현대모비스보통주
7376,12330,2021-01-04,0.1232876712328767,255500,287000,31500,1811364,12330.0,현대모비스보통주
7377,12330,2020-12-14,0.0617283950617283,243000,258000,15000,1235681,12330.0,현대모비스보통주
7378,12330,2020-10-30,0.0525210084033613,238000,225500,-12500,888786,12330.0,현대모비스보통주
7379,12330,2020-10-29,0.0574257425742574,252500,238000,-14500,696270,12330.0,현대모비스보통주
7380,12330,2020-10-20,0.0674157303370786,222500,237500,15000,1301084,12330.0,현대모비스보통주
7381,12330,2020-09-01,0.0647321428571428,224000,238500,14500,915042,12330.0,현대모비스보통주
7382,12330,2020-08-28,0.0414746543778801,217000,226000,9000,778178,12330.0,현대모비스보통주
7383,12330,2020-08-20,0.0576036866359447,217000,204500,-12500,519337,12330.0,현대모비스보통주
7384,12330,2020-08-18,0.0424107142857142,224000,214500,-9500,535693,12330.0,현대모비스보통주
7385,12330,2020-08-10,0.0648769574944071,223500,238000,14500,1265411,12330.0,현대모비스보통주
7386,12330,2020-08-06,0.0470588235294117,212500,222500,10000,831406,12330.0,현대모비스보통주
7387,12330,2020-07-13,0.0623376623376623,192500,204500,12000,416475,12330.0,현대모비스보통주
7388,12330,2020-07-06,0.0460358056265984,195500,204500,9000,336074,12330.0,현대모비스보통주
7389,12330,2020-06-25,0.0536585365853658,205000,194000,-11000,392726,12330.0,현대모비스보통주
7390,12330,2020-06-24,0.0621761658031088,193000,205000,12000,734730,12330.0,현대모비스보통주
7391,12330,2020-06-23,0.0489130434782608,184000,193000,9000,579311,12330.0,현대모비스보통주
7392,12330,2020-06-16,0.0427807486631016,187000,195000,8000,322656,12330.0,현대모비스보통주
7393,12330,2020-06-15,0.0922330097087378,206000,187000,-19000,594810,12330.0,현대모비스보통주
7394,12330,2020-06-03,0.0467289719626168,214000,224000,10000,515118,12330.0,현대모비스보통주
7395,12330,2020-06-01,0.0404040404040404,198000,206000,8000,260640,12330.0,현대모비스보통주
7396,12330,2020-05-26,0.0455764075067024,186500,195000,8500,353343,12330.0,현대모비스보통주
7397,12330,2020-05-19,0.0780346820809248,173000,186500,13500,632454,12330.0,현대모비스보통주
7398,12330,2020-04-24,0.0451977401129943,177000,169000,-8000,440277,12330.0,현대모비스보통주
7399,12330,2020-04-09,0.0470588235294117,170000,178000,8000,607783,12330.0,현대모비스보통주
7400,12330,2020-03-25,0.1730103806228373,144500,169500,25000,810541,12330.0,현대모비스보통주
7401,12330,2020-03-24,0.0823970037453183,133500,144500,11000,464543,12330.0,현대모비스보통주
7402,12330,2020-03-23,0.0498220640569395,140500,133500,-7000,522677,12330.0,현대모비스보통주
7403,12330,2020-03-20,0.0891472868217054,129000,140500,11500,567440,12330.0,현대모비스보통주
7404,12330,2020-03-19,0.0851063829787234,141000,129000,-12000,577742,12330.0,현대모비스보통주
7405,12330,2020-03-18,0.0754098360655737,152500,141000,-11500,438595,12330.0,현대모비스보통주
7406,12330,2020-03-17,0.0557275541795665,161500,152500,-9000,433323,12330.0,현대모비스보통주
7407,12330,2020-03-16,0.0583090379008746,171500,161500,-10000,329732,12330.0,현대모비스보통주
7408,12330,2020-03-13,0.0472222222222222,180000,171500,-8500,623997,12330.0,현대모비스보통주
7409,12330,2020-03-12,0.04,187500,180000,-7500,458209,12330.0,현대모비스보통주
7410,12330,2020-03-09,0.0443349753694581,203000,194000,-9000,237798,12330.0,현대모비스보통주
7411,12330,2020-02-28,0.0410958904109589,219000,210000,-9000,317745,12330.0,현대모비스보통주
7412,12330,2020-02-24,0.0415754923413566,228500,219000,-9500,247956,12330.0,현대모비스보통주
7413,12330,2019-11-15,0.0467479674796747,246000,257500,11500,295646,12330.0,현대모비스보통주
7414,12330,2019-07-25,0.0559139784946236,232500,245500,13000,495994,12330.0,현대모비스보통주
7415,12330,2019-05-09,0.0456521739130434,230000,219500,-10500,287796,12330.0,현대모비스보통주
7416,12330,2019-01-28,0.0431654676258992,208500,217500,9000,460844,12330.0,현대모비스보통주
7417,12330,2019-01-23,0.0462287104622871,205500,215000,9500,321733,12330.0,현대모비스보통주
7418,12330,2019-01-09,0.0492227979274611,193000,202500,9500,277391,12330.0,현대모비스보통주
7419,12330,2018-12-12,0.0901408450704225,177500,193500,16000,485527,12330.0,현대모비스보통주
7420,12330,2018-11-30,0.0403458213256484,173500,180500,7000,435192,12330.0,현대모비스보통주
7421,12330,2018-11-27,0.0449101796407185,167000,174500,7500,396585,12330.0,현대모비스보통주
7422,12330,2018-11-22,0.0864864864864864,185000,169000,-16000,705244,12330.0,현대모비스보통주
7423,12330,2018-10-25,0.0445026178010471,191000,182500,-8500,500682,12330.0,현대모비스보통주
7424,12330,2018-10-23,0.0409207161125319,195500,187500,-8000,436598,12330.0,현대모비스보통주
7425,12330,2018-10-11,0.048661800486618,205500,195500,-10000,358876,12330.0,현대모비스보통주
7426,12330,2018-09-10,0.0421940928270042,237000,227000,-10000,172142,12330.0,현대모비스보통주
7427,12330,2018-04-12,0.0400763358778625,262000,251500,-10500,364527,12330.0,현대모비스보통주
7428,12330,2018-04-03,0.0449897750511247,244500,255500,11000,596146,12330.0,현대모비스보통주
7429,12330,2018-03-30,0.0570866141732283,254000,239500,-14500,744205,12330.0,현대모비스보통주
7430,12330,2018-03-28,0.0673469387755102,245000,261500,16500,1530584,12330.0,현대모비스보통주
7431,12330,2018-03-27,0.053763440860215,232500,245000,12500,586844,12330.0,현대모비스보통주
7432,12330,2018-02-13,0.0405982905982906,234000,224500,-9500,469496,12330.0,현대모비스보통주
7433,12330,2018-01-26,0.0820895522388059,268000,246000,-22000,1337931,12330.0,현대모비스보통주
7434,12330,2018-01-19,0.0470588235294117,255000,267000,12000,241714,12330.0,현대모비스보통주
7435,12330,2017-10-31,0.0492125984251968,254000,266500,12500,464930,12330.0,현대모비스보통주
7436,12330,2017-10-26,0.0711297071129707,239000,256000,17000,311911,12330.0,현대모비스보통주
7437,12330,2017-09-26,0.0522727272727272,220000,231500,11500,437839,12330.0,현대모비스보통주
7438,12330,2017-09-08,0.0466101694915254,236000,225000,-11000,522430,12330.0,현대모비스보통주
7439,12330,2017-05-19,0.05,260000,273000,13000,591545,12330.0,현대모비스보통주
7440,12330,2017-05-08,0.0787746170678337,228500,246500,18000,793349,12330.0,현대모비스보통주
7441,12330,2017-01-31,0.0902255639097744,266000,242000,-24000,815329,12330.0,현대모비스보통주
7442,12330,2016-11-10,0.0588235294117647,263500,248000,-15500,547023,12330.0,현대모비스보통주
7443,12330,2016-09-06,0.0474452554744525,274000,287000,13000,297211,12330.0,현대모비스보통주
7444,12450,2021-05-25,0.125287356321839,43500,48950,5450,5914845,12450.0,한화에어로스페이스보통주
7445,12450,2021-05-06,0.0510067114093959,37250,39150,1900,540969,12450.0,한화에어로스페이스보통주
7446,12450,2021-03-11,0.1133603238866396,37050,41250,4200,1940345,12450.0,한화에어로스페이스보통주
7447,12450,2021-02-26,0.0514138817480719,38900,36900,-2000,1013867,12450.0,한화에어로스페이스보통주
7448,12450,2021-02-24,0.0569306930693069,40400,38100,-2300,1010963,12450.0,한화에어로스페이스보통주
7449,12450,2021-02-10,0.0599755201958384,40850,43300,2450,1351918,12450.0,한화에어로스페이스보통주
7450,12450,2021-02-04,0.0460992907801418,42300,44250,1950,2641000,12450.0,한화에어로스페이스보통주
7451,12450,2021-01-28,0.0481220657276995,42600,40550,-2050,1182716,12450.0,한화에어로스페이스보통주
7452,12450,2021-01-27,0.0448430493273542,44600,42600,-2000,1361488,12450.0,한화에어로스페이스보통주
7453,12450,2021-01-25,0.0789473684210526,39900,43050,3150,1797615,12450.0,한화에어로스페이스보통주
7454,12450,2021-01-22,0.0522565320665083,42100,39900,-2200,1300089,12450.0,한화에어로스페이스보통주
7455,12450,2021-01-20,0.0498084291187739,39150,41100,1950,2832400,12450.0,한화에어로스페이스보통주
7456,12450,2021-01-18,0.0764951321279554,35950,38700,2750,4354287,12450.0,한화에어로스페이스보통주
7457,12450,2021-01-15,0.1061538461538461,32500,35950,3450,3417300,12450.0,한화에어로스페이스보통주
7458,12450,2021-01-12,0.0550314465408805,31800,33550,1750,2251689,12450.0,한화에어로스페이스보통주
7459,12450,2021-01-08,0.0633116883116883,30800,32750,1950,2066290,12450.0,한화에어로스페이스보통주
7460,12450,2021-01-04,0.0456140350877193,28500,29800,1300,908760,12450.0,한화에어로스페이스보통주
7461,12450,2020-11-10,0.0436432637571157,26350,27500,1150,789689,12450.0,한화에어로스페이스보통주
7462,12450,2020-10-23,0.0443159922928709,25950,27100,1150,585770,12450.0,한화에어로스페이스보통주
7463,12450,2020-09-03,0.0914179104477612,26800,29250,2450,2721162,12450.0,한화에어로스페이스보통주
7464,12450,2020-08-18,0.0498154981549815,27100,25750,-1350,659799,12450.0,한화에어로스페이스보통주
7465,12450,2020-08-10,0.0508806262230919,25550,26850,1300,1199916,12450.0,한화에어로스페이스보통주
7466,12450,2020-07-27,0.0460251046025104,23900,25000,1100,1351751,12450.0,한화에어로스페이스보통주
7467,12450,2020-06-26,0.0435684647302904,24100,25150,1050,564237,12450.0,한화에어로스페이스보통주
7468,12450,2020-06-24,0.0555555555555555,26100,24650,-1450,1057966,12450.0,한화에어로스페이스보통주
7469,12450,2020-06-19,0.0873287671232876,29200,26650,-2550,3757564,12450.0,한화에어로스페이스보통주
7470,12450,2020-06-17,0.1371428571428571,26250,29850,3600,11721235,12450.0,한화에어로스페이스보통주
7471,12450,2020-06-15,0.0673469387755102,24500,26150,1650,3745454,12450.0,한화에어로스페이스보통주
7472,12450,2020-05-27,0.0425531914893617,23500,24500,1000,642701,12450.0,한화에어로스페이스보통주
7473,12450,2020-05-14,0.0432098765432098,24300,23250,-1050,495053,12450.0,한화에어로스페이스보통주
7474,12450,2020-05-04,0.0947955390334572,26900,24350,-2550,791292,12450.0,한화에어로스페이스보통주
7475,12450,2020-04-28,0.0518234165067178,26050,27400,1350,2733936,12450.0,한화에어로스페이스보통주
7476,12450,2020-04-24,0.0597938144329896,24250,25700,1450,2860903,12450.0,한화에어로스페이스보통주
7477,12450,2020-04-21,0.0534188034188034,23400,24650,1250,5908661,12450.0,한화에어로스페이스보통주
7478,12450,2020-04-14,0.0455580865603644,21950,22950,1000,317221,12450.0,한화에어로스페이스보통주
7479,12450,2020-04-13,0.0559139784946236,23250,21950,-1300,299188,12450.0,한화에어로스페이스보통주
7480,12450,2020-04-07,0.1066997518610421,20150,22300,2150,837639,12450.0,한화에어로스페이스보통주
7481,12450,2020-03-26,0.0576923076923076,18200,19250,1050,662070,12450.0,한화에어로스페이스보통주
7482,12450,2020-03-25,0.093093093093093,16650,18200,1550,654279,12450.0,한화에어로스페이스보통주
7483,12450,2020-03-24,0.11,15000,16650,1650,465924,12450.0,한화에어로스페이스보통주
7484,12450,2020-03-23,0.1044776119402985,16750,15000,-1750,462930,12450.0,한화에어로스페이스보통주
7485,12450,2020-03-20,0.0668789808917197,15700,16750,1050,717128,12450.0,한화에어로스페이스보통주
7486,12450,2020-03-19,0.1490514905149051,18450,15700,-2750,706180,12450.0,한화에어로스페이스보통주
7487,12450,2020-03-18,0.0866336633663366,20200,18450,-1750,369689,12450.0,한화에어로스페이스보통주
7488,12450,2020-03-16,0.0476190476190476,22050,21000,-1050,326383,12450.0,한화에어로스페이스보통주
7489,12450,2020-03-13,0.0754716981132075,23850,22050,-1800,797717,12450.0,한화에어로스페이스보통주
7490,12450,2020-03-12,0.0647058823529411,25500,23850,-1650,476674,12450.0,한화에어로스페이스보통주
7491,12450,2020-03-09,0.051418439716312,28200,26750,-1450,358557,12450.0,한화에어로스페이스보통주
7492,12450,2020-02-28,0.0549828178694158,29100,27500,-1600,498985,12450.0,한화에어로스페이스보통주
7493,12450,2020-02-24,0.0959752321981424,32300,29200,-3100,680532,12450.0,한화에어로스페이스보통주
7494,12450,2020-01-28,0.0611664295874822,35150,33000,-2150,295585,12450.0,한화에어로스페이스보통주
7495,12450,2019-11-12,0.04,36250,37700,1450,741215,12450.0,한화에어로스페이스보통주
7496,12450,2019-10-08,0.0444444444444444,40500,42300,1800,483555,12450.0,한화에어로스페이스보통주
7497,12450,2019-10-07,0.0537383177570093,42800,40500,-2300,502641,12450.0,한화에어로스페이스보통주
7498,12450,2019-09-27,0.0443407234539089,42850,40950,-1900,349971,12450.0,한화에어로스페이스보통주
7499,12450,2019-09-04,0.0506798516687268,40450,42500,2050,743263,12450.0,한화에어로스페이스보통주
7500,12450,2019-08-13,0.1661237785016286,30700,35800,5100,2869361,12450.0,한화에어로스페이스보통주
7501,12450,2019-05-22,0.0674536256323777,29650,31650,2000,436100,12450.0,한화에어로스페이스보통주
7502,12450,2019-03-18,0.04,33750,35100,1350,576039,12450.0,한화에어로스페이스보통주
7503,12450,2019-01-18,0.0452418096723869,32050,30600,-1450,736861,12450.0,한화에어로스페이스보통주
7504,12450,2018-11-26,0.0559006211180124,32200,34000,1800,344704,12450.0,한화에어로스페이스보통주
7505,12450,2018-11-15,0.069164265129683,34700,32300,-2400,992402,12450.0,한화에어로스페이스보통주
7506,12450,2018-11-14,0.0579268292682926,32800,34700,1900,1125375,12450.0,한화에어로스페이스보통주
7507,12450,2018-11-06,0.0462046204620462,30300,31700,1400,686053,12450.0,한화에어로스페이스보통주
7508,12450,2018-11-05,0.0502599653379549,28850,30300,1450,445425,12450.0,한화에어로스페이스보통주
7509,12450,2018-11-02,0.0606617647058823,27200,28850,1650,354398,12450.0,한화에어로스페이스보통주
7510,12450,2018-11-01,0.0439367311072056,28450,27200,-1250,620250,12450.0,한화에어로스페이스보통주
7511,12450,2018-10-04,0.0646387832699619,26300,28000,1700,618480,12450.0,한화에어로스페이스보통주
7512,12450,2018-10-02,0.0499001996007984,25050,26300,1250,599394,12450.0,한화에어로스페이스보통주
7513,12450,2018-09-28,0.1149825783972125,28700,25400,-3300,1476297,12450.0,한화에어로스페이스보통주
7514,12450,2018-09-27,0.0933333333333333,26250,28700,2450,935114,12450.0,한화에어로스페이스보통주
7515,12450,2018-09-07,0.0549019607843137,25500,26900,1400,562949,12450.0,한화에어로스페이스보통주
7516,12450,2018-08-28,0.0539419087136929,24100,25400,1300,525817,12450.0,한화에어로스페이스보통주
7517,12450,2018-08-14,0.0514541387024608,22350,23500,1150,370767,12450.0,한화에어로스페이스보통주
7518,12450,2018-07-20,0.0588235294117647,22100,23400,1300,613095,12450.0,한화에어로스페이스보통주
7519,12450,2018-07-19,0.0432900432900432,23100,22100,-1000,339881,12450.0,한화에어로스페이스보통주
7520,12450,2018-07-09,0.0406320541760722,22150,23050,900,340864,12450.0,한화에어로스페이스보통주
7521,12450,2018-07-05,0.0442477876106194,22600,21600,-1000,632066,12450.0,한화에어로스페이스보통주
7522,12450,2018-07-02,0.0405117270788912,23450,22500,-950,498775,12450.0,한화에어로스페이스보통주
7523,12450,2018-06-18,0.0588235294117647,30600,28800,-1800,435627,12450.0,한화에어로스페이스보통주
7524,12450,2018-06-14,0.0438311688311688,30800,29450,-1350,607834,12450.0,한화에어로스페이스보통주
7525,12450,2018-06-11,0.0514820592823713,32050,30400,-1650,556540,12450.0,한화에어로스페이스보통주
7526,12450,2018-05-29,0.120954003407155,29350,32900,3550,2925895,12450.0,한화에어로스페이스보통주
7527,12450,2018-05-18,0.0465116279069767,27950,29250,1300,531265,12450.0,한화에어로스페이스보통주
7528,12450,2018-05-09,0.050632911392405,27650,29050,1400,1509889,12450.0,한화에어로스페이스보통주
7529,12450,2018-05-08,0.0655105973025048,25950,27650,1700,1681071,12450.0,한화에어로스페이스보통주
7530,12450,2018-05-04,0.0857740585774058,23900,25950,2050,1440785,12450.0,한화에어로스페이스보통주
7531,12450,2018-04-30,0.0766283524904214,26100,24100,-2000,1121364,12450.0,한화에어로스페이스보통주
7532,12450,2018-04-26,0.0439121756487025,25050,26150,1100,467908,12450.0,한화에어로스페이스보통주
7533,12450,2018-03-21,0.0430292598967297,29050,30300,1250,738960,12450.0,한화에어로스페이스보통주
7534,12450,2018-03-02,0.0428816466552315,29150,27900,-1250,633606,12450.0,한화에어로스페이스보통주
7535,12450,2018-02-26,0.0460176991150442,28250,29550,1300,813890,12450.0,한화에어로스페이스보통주
7536,12450,2018-02-19,0.0415913200723327,27650,28800,1150,378145,12450.0,한화에어로스페이스보통주
7537,12450,2018-02-05,0.047040971168437,32950,31400,-1550,1027684,12450.0,한화에어로스페이스보통주
7538,12450,2017-10-27,0.0551075268817204,37200,39250,2050,1168692,12450.0,한화에어로스페이스보통주
7539,12450,2017-10-19,0.1174743024963289,34050,38050,4000,1461571,12450.0,한화에어로스페이스보통주
7540,12450,2017-09-22,0.0516039051603905,35850,34000,-1850,812491,12450.0,한화에어로스페이스보통주
7541,12450,2017-08-21,0.0563035495716034,40850,38550,-2300,1290666,12450.0,한화에어로스페이스보통주
7542,12450,2017-08-18,0.0460947503201024,39050,40850,1800,1062198,12450.0,한화에어로스페이스보통주
7543,12450,2017-08-04,0.0487465181058495,35900,37650,1750,843214,12450.0,한화에어로스페이스보통주
7544,12450,2017-08-03,0.0651041666666666,38400,35900,-2500,1436086,12450.0,한화에어로스페이스보통주
7545,12450,2017-07-14,0.0640279394644936,42950,40200,-2750,844068,12450.0,한화에어로스페이스보통주
7546,12450,2017-03-23,0.0489130434782608,46000,48250,2250,1064249,12450.0,한화에어로스페이스보통주
7547,12450,2017-02-22,0.056422569027611,41650,44000,2350,1054394,12450.0,한화에어로스페이스보통주
7548,12450,2017-02-01,0.0479616306954436,41700,43700,2000,548913,12450.0,한화에어로스페이스보통주
7549,12450,2017-01-03,0.0491620111731843,44750,46950,2200,977418,12450.0,한화에어로스페이스보통주
7550,12450,2016-12-12,0.0492957746478873,42600,44700,2100,888893,12450.0,한화에어로스페이스보통주
7551,12450,2016-12-02,0.0738327904451683,46050,42650,-3400,2013516,12450.0,한화에어로스페이스보통주
7552,12450,2016-11-30,0.0562130177514792,50700,47850,-2850,4339688,12450.0,한화에어로스페이스보통주
7553,12450,2016-11-24,0.0471698113207547,53000,50500,-2500,959877,12450.0,한화에어로스페이스보통주
7554,12450,2016-11-14,0.0404624277456647,51900,54000,2100,949513,12450.0,한화에어로스페이스보통주
7555,12450,2016-11-10,0.0494845360824742,48500,50900,2400,1741500,12450.0,한화에어로스페이스보통주
7556,12450,2016-11-09,0.0418904403866809,46550,48500,1950,5754038,12450.0,한화에어로스페이스보통주
7557,12450,2016-11-01,0.2115987460815047,63800,50300,-13500,4064546,12450.0,한화에어로스페이스보통주
7558,12450,2016-10-24,0.0401785714285714,67200,64500,-2700,480686,12450.0,한화에어로스페이스보통주
7559,12450,2016-08-29,0.0423280423280423,56700,59100,2400,413749,12450.0,한화에어로스페이스보통주
7560,12510,2021-05-18,0.0456273764258555,78900,82500,3600,279459,12510.0,더존비즈온보통주
7561,12510,2021-04-07,0.0551876379690949,90600,85600,-5000,618984,12510.0,더존비즈온보통주
7562,12510,2021-02-18,0.0410958904109589,109500,105000,-4500,145348,12510.0,더존비즈온보통주
7563,12510,2021-02-02,0.0439024390243902,102500,107000,4500,212437,12510.0,더존비즈온보통주
7564,12510,2021-01-21,0.055793991416309,116500,110000,-6500,178107,12510.0,더존비즈온보통주
7565,12510,2021-01-11,0.0416666666666666,108000,112500,4500,367347,12510.0,더존비즈온보통주
7566,12510,2020-12-15,0.04,100000,104000,4000,153419,12510.0,더존비즈온보통주
7567,12510,2020-11-10,0.0460829493087557,108500,103500,-5000,132034,12510.0,더존비즈온보통주
7568,12510,2020-10-26,0.0518867924528301,106000,100500,-5500,100061,12510.0,더존비즈온보통주
7569,12510,2020-10-13,0.0442477876106194,113000,108000,-5000,107947,12510.0,더존비즈온보통주
7570,12510,2020-10-08,0.0458715596330275,109000,114000,5000,233871,12510.0,더존비즈온보통주
7571,12510,2020-09-14,0.0535714285714285,112000,118000,6000,245936,12510.0,더존비즈온보통주
7572,12510,2020-09-09,0.0416666666666666,120000,115000,-5000,352632,12510.0,더존비즈온보통주
7573,12510,2020-09-04,0.1877934272300469,106500,126500,20000,2501985,12510.0,더존비즈온보통주
7574,12510,2020-09-02,0.055,100000,105500,5500,403669,12510.0,더존비즈온보통주
7575,12510,2020-06-24,0.0440528634361233,113500,108500,-5000,216662,12510.0,더존비즈온보통주
7576,12510,2020-06-23,0.0607476635514018,107000,113500,6500,255660,12510.0,더존비즈온보통주
7577,12510,2020-06-15,0.0526315789473684,114000,108000,-6000,287834,12510.0,더존비즈온보통주
7578,12510,2020-06-10,0.0613207547169811,106000,112500,6500,305281,12510.0,더존비즈온보통주
7579,12510,2020-06-05,0.0409090909090909,110000,105500,-4500,360028,12510.0,더존비즈온보통주
7580,12510,2020-06-03,0.0655737704918032,122000,114000,-8000,506605,12510.0,더존비즈온보통주
7581,12510,2020-05-29,0.0480349344978165,114500,120000,5500,1746783,12510.0,더존비즈온보통주
7582,12510,2020-05-28,0.045662100456621,109500,114500,5000,410991,12510.0,더존비즈온보통주
7583,12510,2020-05-25,0.0643564356435643,101000,107500,6500,311410,12510.0,더존비즈온보통주
7584,12510,2020-05-13,0.0495049504950495,101000,106000,5000,807846,12510.0,더존비즈온보통주
7585,12510,2020-05-08,0.0439330543933054,95600,99800,4200,414818,12510.0,더존비즈온보통주
7586,12510,2020-05-07,0.0681564245810055,89500,95600,6100,577767,12510.0,더존비즈온보통주
7587,12510,2020-04-16,0.1494252873563218,78300,90000,11700,660682,12510.0,더존비즈온보통주
7588,12510,2020-04-13,0.041147132169576,80200,76900,-3300,144562,12510.0,더존비즈온보통주
7589,12510,2020-03-30,0.0714285714285714,77000,82500,5500,241426,12510.0,더존비즈온보통주
7590,12510,2020-03-26,0.0521327014218009,84400,80000,-4400,169994,12510.0,더존비즈온보통주
7591,12510,2020-03-25,0.0616352201257861,79500,84400,4900,321699,12510.0,더존비즈온보통주
7592,12510,2020-03-24,0.1691176470588235,68000,79500,11500,324767,12510.0,더존비즈온보통주
7593,12510,2020-03-20,0.2252252252252252,55500,68000,12500,318875,12510.0,더존비즈온보통주
7594,12510,2020-03-19,0.1526717557251908,65500,55500,-10000,475184,12510.0,더존비즈온보통주
7595,12510,2020-03-18,0.0813464235624123,71300,65500,-5800,258251,12510.0,더존비즈온보통주
7596,12510,2020-03-16,0.0715197956577266,78300,72700,-5600,203830,12510.0,더존비즈온보통주
7597,12510,2020-03-11,0.0458190148911798,87300,83300,-4000,164169,12510.0,더존비즈온보통주
7598,12510,2020-02-28,0.0539053905390539,90900,86000,-4900,305016,12510.0,더존비즈온보통주
7599,12510,2020-02-27,0.0441640378548895,95100,90900,-4200,173124,12510.0,더존비즈온보통주
7600,12510,2020-02-11,0.0414798206278026,89200,92900,3700,122110,12510.0,더존비즈온보통주
7601,12510,2019-11-07,0.062111801242236,80500,75500,-5000,250086,12510.0,더존비즈온보통주
7602,12510,2019-11-06,0.0440985732814526,77100,80500,3400,216824,12510.0,더존비즈온보통주
7603,12510,2019-10-23,0.0967741935483871,62000,68000,6000,364584,12510.0,더존비즈온보통주
7604,12510,2019-09-18,0.0538336052202283,61300,64600,3300,157481,12510.0,더존비즈온보통주
7605,12510,2019-09-04,0.0478632478632478,58500,61300,2800,228715,12510.0,더존비즈온보통주
7606,12510,2019-08-21,0.053763440860215,55800,58800,3000,400317,12510.0,더존비즈온보통주
7607,12510,2019-08-16,0.0692431561996779,62100,57800,-4300,824162,12510.0,더존비즈온보통주
7608,12510,2019-08-14,0.1653225806451612,74400,62100,-12300,1820808,12510.0,더존비즈온보통주
7609,12510,2019-07-26,0.0477707006369426,62800,65800,3000,149446,12510.0,더존비즈온보통주
7610,12510,2019-07-10,0.0701468189233279,61300,65600,4300,230905,12510.0,더존비즈온보통주
7611,12510,2019-06-12,0.0549295774647887,71000,67100,-3900,137321,12510.0,더존비즈온보통주
7612,12510,2019-06-10,0.0422960725075528,66200,69000,2800,147145,12510.0,더존비즈온보통주
7613,12510,2019-04-25,0.044776119402985,53600,56000,2400,247943,12510.0,더존비즈온보통주
7614,12510,2019-04-24,0.0916496945010183,49100,53600,4500,507418,12510.0,더존비즈온보통주
7615,12510,2019-04-23,0.0593311758360302,46350,49100,2750,289318,12510.0,더존비즈온보통주
7616,12510,2019-02-13,0.0573248407643312,39250,41500,2250,292910,12510.0,더존비즈온보통주
7617,12510,2019-01-29,0.0505617977528089,44500,42250,-2250,454412,12510.0,더존비즈온보통주
7618,12510,2018-12-17,0.0424242424242424,49500,47400,-2100,77663,12510.0,더존비즈온보통주
7619,12510,2018-12-14,0.048076923076923,52000,49500,-2500,47170,12510.0,더존비즈온보통주
7620,12510,2018-11-29,0.0714285714285714,46200,49500,3300,195881,12510.0,더존비즈온보통주
7621,12510,2018-11-27,0.0493273542600896,44600,46800,2200,86983,12510.0,더존비즈온보통주
7622,12510,2018-11-12,0.0442105263157894,47500,45400,-2100,83899,12510.0,더존비즈온보통주
7623,12510,2018-11-02,0.0656779661016949,47200,50300,3100,158390,12510.0,더존비즈온보통주
7624,12510,2018-11-01,0.0888119953863898,43350,47200,3850,143087,12510.0,더존비즈온보통주
7625,12510,2018-10-30,0.0483516483516483,45500,43300,-2200,221450,12510.0,더존비즈온보통주
7626,12510,2018-10-26,0.0458715596330275,43600,45600,2000,210504,12510.0,더존비즈온보통주
7627,12510,2018-10-25,0.0663811563169164,46700,43600,-3100,271015,12510.0,더존비즈온보통주
7628,12510,2018-10-24,0.0584677419354838,49600,46700,-2900,141377,12510.0,더존비즈온보통주
7629,12510,2018-10-23,0.0424710424710424,51800,49600,-2200,148715,12510.0,더존비즈온보통주
7630,12510,2018-10-18,0.0506566604127579,53300,50600,-2700,103914,12510.0,더존비즈온보통주
7631,12510,2018-10-11,0.0741379310344827,58000,53700,-4300,85792,12510.0,더존비즈온보통주
7632,12510,2018-09-18,0.0421792618629174,56900,54500,-2400,129903,12510.0,더존비즈온보통주
7633,12510,2018-08-08,0.0415094339622641,53000,55200,2200,120726,12510.0,더존비즈온보통주
7634,12510,2018-07-23,0.0524642289348171,62900,59600,-3300,81347,12510.0,더존비즈온보통주
7635,12510,2018-07-13,0.0556414219474497,64700,61100,-3600,170322,12510.0,더존비즈온보통주
7636,12510,2018-07-12,0.0694214876033057,60500,64700,4200,191521,12510.0,더존비즈온보통주
7637,12510,2018-07-06,0.0430622009569378,62700,60000,-2700,120385,12510.0,더존비즈온보통주
7638,12510,2018-07-02,0.0419354838709677,62000,64600,2600,206879,12510.0,더존비즈온보통주
7639,12510,2018-06-22,0.0437956204379562,54800,57200,2400,179631,12510.0,더존비즈온보통주
7640,12510,2018-06-20,0.0526315789473684,53200,56000,2800,108742,12510.0,더존비즈온보통주
7641,12510,2018-06-18,0.0656303972366148,57900,54100,-3800,99732,12510.0,더존비즈온보통주
7642,12510,2018-06-15,0.0722222222222222,54000,57900,3900,191607,12510.0,더존비즈온보통주
7643,12510,2018-06-07,0.056420233463035,51400,54300,2900,168443,12510.0,더존비즈온보통주
7644,12510,2018-06-04,0.1818181818181818,44000,52000,8000,653071,12510.0,더존비즈온보통주
7645,12510,2018-05-16,0.0527522935779816,43600,45900,2300,185897,12510.0,더존비즈온보통주
7646,12510,2018-05-15,0.0490730643402399,45850,43600,-2250,204400,12510.0,더존비즈온보통주
7647,12510,2018-04-26,0.0626204238921002,51900,48650,-3250,384995,12510.0,더존비즈온보통주
7648,12510,2018-04-20,0.0486111111111111,57600,54800,-2800,114451,12510.0,더존비즈온보통주
7649,12510,2018-04-18,0.0647619047619047,52500,55900,3400,192961,12510.0,더존비즈온보통주
7650,12510,2018-04-17,0.0489130434782608,55200,52500,-2700,244790,12510.0,더존비즈온보통주
7651,12510,2018-03-23,0.045,60000,57300,-2700,107397,12510.0,더존비즈온보통주
7652,12510,2018-03-09,0.0491525423728813,59000,61900,2900,125104,12510.0,더존비즈온보통주
7653,12510,2018-02-26,0.0707635009310986,53700,57500,3800,245139,12510.0,더존비즈온보통주
7654,12510,2018-02-14,0.0402542372881355,47200,49100,1900,132339,12510.0,더존비즈온보통주
7655,12510,2018-02-13,0.1094339622641509,53000,47200,-5800,387324,12510.0,더존비즈온보통주
7656,12510,2018-02-12,0.0816326530612244,49000,53000,4000,373786,12510.0,더존비즈온보통주
7657,12510,2018-01-31,0.0401737242128121,46050,47900,1850,218187,12510.0,더존비즈온보통주
7658,12510,2018-01-26,0.0578231292517006,44100,46650,2550,183274,12510.0,더존비즈온보통주
7659,12510,2018-01-24,0.1125158027812895,39550,44000,4450,449495,12510.0,더존비즈온보통주
7660,12510,2018-01-12,0.0497076023391812,34200,35900,1700,276966,12510.0,더존비즈온보통주
7661,12510,2018-01-11,0.062111801242236,32200,34200,2000,260806,12510.0,더존비즈온보통주
7662,12510,2017-09-27,0.0529010238907849,29300,30850,1550,129871,12510.0,더존비즈온보통주
7663,12510,2017-09-25,0.0523809523809523,31500,29850,-1650,156844,12510.0,더존비즈온보통주
7664,12510,2017-07-20,0.0401188707280832,33650,35000,1350,216856,12510.0,더존비즈온보통주
7665,12510,2017-07-19,0.0499219968798752,32050,33650,1600,220906,12510.0,더존비즈온보통주
7666,12510,2017-06-29,0.0401284109149277,31150,29900,-1250,197169,12510.0,더존비즈온보통주
7667,12510,2017-06-27,0.0528052805280528,30300,31900,1600,161215,12510.0,더존비즈온보통주
7668,12510,2017-05-08,0.0618374558303886,28300,30050,1750,244671,12510.0,더존비즈온보통주
7669,12510,2017-04-18,0.0408560311284046,25700,26750,1050,159280,12510.0,더존비즈온보통주
7670,12510,2017-03-22,0.0412371134020618,24250,23250,-1000,151701,12510.0,더존비즈온보통주
7671,12510,2017-02-02,0.0409482758620689,23200,22250,-950,162263,12510.0,더존비즈온보통주
7672,12510,2016-11-16,0.0482758620689655,21750,22800,1050,122494,12510.0,더존비즈온보통주
7673,12510,2016-11-02,0.0405405405405405,22200,21300,-900,195218,12510.0,더존비즈온보통주
7674,12510,2016-09-13,0.0442708333333333,19200,20050,850,152300,12510.0,더존비즈온보통주
7675,12510,2016-08-23,0.0913705583756345,19700,21500,1800,518239,12510.0,더존비즈온보통주
7676,12510,2016-08-16,0.0413793103448275,21750,20850,-900,212795,12510.0,더존비즈온보통주
7677,12750,2020-08-20,0.043,100000,95700,-4300,67150,12750.0,에스원보통주
7678,12750,2020-08-18,0.0510204081632653,98000,103000,5000,74043,12750.0,에스원보통주
7679,12750,2020-08-11,0.0577136514983351,90100,95300,5200,76888,12750.0,에스원보통주
7680,12750,2020-07-29,0.0769230769230769,85800,92400,6600,172587,12750.0,에스원보통주
7681,12750,2020-06-25,0.0450958286358511,88700,84700,-4000,68787,12750.0,에스원보통주
7682,12750,2020-06-16,0.0661057692307692,83200,88700,5500,51894,12750.0,에스원보통주
7683,12750,2020-06-15,0.0513112884834663,87700,83200,-4500,58438,12750.0,에스원보통주
7684,12750,2020-05-29,0.0602957906712172,87900,93200,5300,111196,12750.0,에스원보통주
7685,12750,2020-05-13,0.0508083140877598,86600,91000,4400,82898,12750.0,에스원보통주
7686,12750,2020-04-06,0.0661577608142493,78600,83800,5200,85470,12750.0,에스원보통주
7687,12750,2020-04-01,0.05375,80000,75700,-4300,85399,12750.0,에스원보통주
7688,12750,2020-03-25,0.0670170827858081,76100,81200,5100,123635,12750.0,에스원보통주
7689,12750,2020-03-23,0.1255924170616113,84400,73800,-10600,103901,12750.0,에스원보통주
7690,12750,2019-05-07,0.04004004004004,99900,95900,-4000,127517,12750.0,에스원보통주
7691,12750,2018-10-31,0.0477741585233441,92100,96500,4400,116126,12750.0,에스원보통주
7692,12750,2018-10-11,0.0435244161358811,94200,90100,-4100,104368,12750.0,에스원보통주
7693,12750,2018-07-27,0.1041237113402061,97000,86900,-10100,234287,12750.0,에스원보통주
7694,12750,2018-06-18,0.0655913978494623,93000,99100,6100,127672,12750.0,에스원보통주
7695,12750,2018-06-01,0.0407239819004524,88400,92000,3600,56267,12750.0,에스원보통주
7696,12750,2018-03-09,0.0400866738894907,92300,96000,3700,99571,12750.0,에스원보통주
7697,12750,2018-01-03,0.0422535211267605,106500,102000,-4500,83000,12750.0,에스원보통주
7698,12750,2017-12-28,0.0594059405940594,101000,107000,6000,126130,12750.0,에스원보통주
7699,12750,2017-12-27,0.0516431924882629,106500,101000,-5500,96767,12750.0,에스원보통주
7700,12750,2017-12-15,0.04,100000,104000,4000,88272,12750.0,에스원보통주
7701,12750,2017-11-28,0.0466321243523316,96500,101000,4500,176688,12750.0,에스원보통주
7702,12750,2017-11-20,0.0485537190082644,96800,101500,4700,157325,12750.0,에스원보통주
7703,12750,2017-11-03,0.050438596491228,91200,95800,4600,148107,12750.0,에스원보통주
7704,12750,2017-07-31,0.0658561296859169,98700,92200,-6500,134899,12750.0,에스원보통주
7705,12750,2017-05-12,0.0430622009569378,104500,100000,-4500,68536,12750.0,에스원보통주
7706,12750,2017-02-10,0.054958183990442,83700,88300,4600,149383,12750.0,에스원보통주
7707,12750,2016-09-27,0.0513078470824949,99400,104500,5100,64831,12750.0,에스원보통주
7708,13890,2021-05-27,0.0427263479145473,98300,102500,4200,240125,13890.0,지누스보통주
7709,13890,2021-05-25,0.061356297093649,92900,98600,5700,167533,13890.0,지누스보통주
7710,13890,2021-05-12,0.1134502923976608,85500,95200,9700,642413,13890.0,지누스보통주
7711,13890,2021-02-24,0.0483042137718396,97300,92600,-4700,78007,13890.0,지누스보통주
7712,13890,2020-12-01,0.0434782608695652,103500,108000,4500,118758,13890.0,지누스보통주
7713,13890,2020-11-20,0.0787139689578714,90200,97300,7100,255756,13890.0,지누스보통주
7714,13890,2020-10-29,0.1085365853658536,82000,90900,8900,742137,13890.0,지누스보통주
7715,13890,2020-08-18,0.0510440835266821,86200,81800,-4400,235174,13890.0,지누스보통주
7716,13890,2020-08-10,0.0659340659340659,81900,87300,5400,387429,13890.0,지누스보통주
7717,13890,2020-07-22,0.0474040632054176,88600,84400,-4200,217350,13890.0,지누스보통주
7718,13890,2020-07-09,0.0532276330690826,88300,93000,4700,338393,13890.0,지누스보통주
7719,13890,2020-07-03,0.0502283105022831,87600,92000,4400,338939,13890.0,지누스보통주
7720,13890,2020-07-02,0.0909090909090909,80300,87600,7300,348895,13890.0,지누스보통주
7721,13890,2020-06-26,0.053177691309987,77100,81200,4100,137368,13890.0,지누스보통주
7722,13890,2020-06-16,0.0842696629213483,71200,77200,6000,114423,13890.0,지누스보통주
7723,13890,2020-06-15,0.0871794871794871,78000,71200,-6800,103522,13890.0,지누스보통주
7724,13890,2020-05-29,0.05,80000,84000,4000,274760,13890.0,지누스보통주
7725,13890,2020-05-28,0.0665110851808634,85700,80000,-5700,575809,13890.0,지누스보통주
7726,13890,2020-05-15,0.0460526315789473,76000,79500,3500,161309,13890.0,지누스보통주
7727,13890,2020-05-06,0.0472727272727272,82500,86400,3900,138272,13890.0,지누스보통주
7728,13890,2020-04-27,0.0635324015247776,78700,83700,5000,190066,13890.0,지누스보통주
7729,13890,2020-04-23,0.0658263305322128,71400,76100,4700,176274,13890.0,지누스보통주
7730,13890,2020-04-16,0.1102236421725239,62600,69500,6900,262669,13890.0,지누스보통주
7731,13890,2020-04-14,0.0468227424749163,59800,62600,2800,141513,13890.0,지누스보통주
7732,13890,2020-04-13,0.0492845786963434,62900,59800,-3100,116034,13890.0,지누스보통주
7733,13890,2020-04-07,0.054673721340388,56700,59800,3100,211771,13890.0,지누스보통주
7734,13890,2020-04-02,0.0933977455716586,62100,56300,-5800,903242,13890.0,지누스보통주
7735,13890,2020-03-25,0.0593368237347294,57300,60700,3400,314056,13890.0,지누스보통주
7736,13890,2020-03-23,0.0697674418604651,51600,55200,3600,425232,13890.0,지누스보통주
7737,13890,2020-03-20,0.2997481108312342,39700,51600,11900,490495,13890.0,지누스보통주
7738,13890,2020-03-19,0.2044088176352705,49900,39700,-10200,474956,13890.0,지누스보통주
7739,13890,2020-03-18,0.1542372881355932,59000,49900,-9100,950896,13890.0,지누스보통주
7740,13890,2020-03-17,0.1386861313868613,68500,59000,-9500,2060223,13890.0,지누스보통주
7741,13890,2020-03-16,0.0406162464985994,71400,68500,-2900,134425,13890.0,지누스보통주
7742,13890,2020-03-10,0.0450070323488045,71100,74300,3200,239030,13890.0,지누스보통주
7743,13890,2020-03-09,0.0669291338582677,76200,71100,-5100,143328,13890.0,지누스보통주
7744,13890,2020-03-02,0.0664335664335664,85800,80100,-5700,309124,13890.0,지누스보통주
7745,13890,2020-02-28,0.092063492063492,94500,85800,-8700,631773,13890.0,지누스보통주
7746,13890,2020-02-25,0.0406417112299465,93500,97300,3800,125797,13890.0,지누스보통주
7747,13890,2020-02-24,0.0696517412935323,100500,93500,-7000,164442,13890.0,지누스보통주
7748,13890,2020-02-21,0.0473933649289099,105500,100500,-5000,134952,13890.0,지누스보통주
7749,13890,2020-01-14,0.0416666666666666,98400,102500,4100,120781,13890.0,지누스보통주
7750,13890,2020-01-07,0.0435729847494553,91800,95800,4000,128353,13890.0,지누스보통주
7751,13890,2019-12-26,0.0431235431235431,85800,89500,3700,136056,13890.0,지누스보통주
7752,13890,2019-12-02,0.040929203539823,90400,86700,-3700,122904,13890.0,지누스보통주
7753,13890,2019-11-22,0.0442678774120317,88100,92000,3900,88420,13890.0,지누스보통주
7754,13890,2019-11-14,0.0551724137931034,87000,91800,4800,196040,13890.0,지누스보통주
7755,13890,2019-11-11,0.0567632850241545,82800,87500,4700,287217,13890.0,지누스보통주
7756,13890,2019-10-30,23.170731707317078,410,83000,82590,1309394,13890.0,지누스보통주
7757,13890,2005-05-16,0.5769230769230769,260,410,150,722024,13890.0,지누스보통주
7758,13890,2005-05-13,0.35,400,260,-140,489703,13890.0,지누스보통주
7759,13890,2005-05-12,0.7391304347826086,230,400,170,547204,13890.0,지누스보통주
7760,13890,2005-05-11,0.2432432432432432,185,230,45,431838,13890.0,지누스보통주
7761,13890,2005-05-10,0.088235294117647,170,185,15,625659,13890.0,지누스보통주
7762,13890,2005-05-09,0.9447154471544716,3075,170,-2905,1321007,13890.0,지누스보통주
7763,13890,2004-03-17,0.1493775933609958,3615,3075,-540,10360,13890.0,지누스보통주
7764,13890,2004-03-16,0.1494117647058823,4250,3615,-635,17164,13890.0,지누스보통주
7765,13890,2004-03-12,0.08008658008658,4620,4250,-370,170150,13890.0,지누스보통주
7766,13890,2004-02-05,0.0468468468468468,5550,5290,-260,200990,13890.0,지누스보통주
7767,13890,2004-02-04,0.0511363636363636,5280,5550,270,108090,13890.0,지누스보통주
7768,13890,2004-01-26,0.0511363636363636,5280,5550,270,366710,13890.0,지누스보통주
7769,13890,2003-12-22,0.0732484076433121,6280,5820,-460,196130,13890.0,지누스보통주
7770,13890,2003-11-24,0.0616113744075829,6330,5940,-390,74810,13890.0,지누스보통주
7771,13890,2003-11-19,0.0554722638680659,6670,6300,-370,123300,13890.0,지누스보통주
7772,13890,2003-11-12,0.0461538461538461,7150,6820,-330,187807,13890.0,지누스보통주
7773,13890,2003-11-11,0.0466666666666666,7500,7150,-350,292190,13890.0,지누스보통주
7774,13890,2003-11-10,0.056338028169014,7100,7500,400,360183,13890.0,지누스보통주
7775,13890,2003-11-06,0.1076923076923077,6500,7200,700,905876,13890.0,지누스보통주
7776,13890,2003-10-27,0.044776119402985,6030,6300,270,95680,13890.0,지누스보통주
7777,13890,2003-10-14,0.0742049469964664,5660,6080,420,291830,13890.0,지누스보통주
7778,13890,2003-10-02,0.0501858736059479,5380,5650,270,122524,13890.0,지누스보통주
7779,13890,2003-09-22,0.0635930047694753,6290,5890,-400,137090,13890.0,지누스보통주
7780,13890,2003-09-15,0.043010752688172,6510,6790,280,183460,13890.0,지누스보통주
7781,13890,2003-09-08,0.0769230769230769,6240,6720,480,403712,13890.0,지누스보통주
7782,13890,2003-08-19,0.0561299852289512,6770,7150,380,326046,13890.0,지누스보통주
7783,13890,2003-07-28,0.0517006802721088,7350,7730,380,106270,13890.0,지누스보통주
7784,13890,2003-07-22,0.0525641025641025,7800,7390,-410,155960,13890.0,지누스보통주
7785,13890,2003-07-15,0.0448275862068965,8700,8310,-390,178460,13890.0,지누스보통주
7786,13890,2003-07-07,0.0773809523809523,8400,9050,650,446707,13890.0,지누스보통주
7787,13890,2003-06-23,0.0638766519823788,9080,8500,-580,199130,13890.0,지누스보통주
7788,13890,2003-06-18,0.045360824742268,9700,9260,-440,198310,13890.0,지누스보통주
7789,13890,2003-05-30,0.0610766045548654,9660,10250,590,653395,13890.0,지누스보통주
7790,13890,2003-05-28,0.0711159737417943,9140,9790,650,491067,13890.0,지누스보통주
7791,13890,2003-05-27,0.0972388955582232,8330,9140,810,1502136,13890.0,지누스보통주
7792,13890,2003-05-22,0.0989010989010989,9100,8200,-900,559857,13890.0,지누스보통주
7793,13890,2003-05-21,0.0459770114942528,8700,9100,400,613266,13890.0,지누스보통주
7794,13890,2003-05-19,0.0575793184488836,8510,9000,490,645313,13890.0,지누스보통주
7795,13890,2003-05-16,0.0506172839506172,8100,8510,410,1353624,13890.0,지누스보통주
7796,13890,2003-05-15,0.1489361702127659,7050,8100,1050,689540,13890.0,지누스보통주
7797,13890,2003-05-13,0.047945205479452,7300,6950,-350,211120,13890.0,지누스보통주
7798,13890,2003-05-07,0.0433526011560693,6920,7220,300,376372,13890.0,지누스보통주
7799,13890,2003-05-06,0.0406015037593985,6650,6920,270,171195,13890.0,지누스보통주
7800,13890,2003-04-29,0.0551181102362204,6350,6700,350,144852,13890.0,지누스보통주
7801,13890,2003-04-25,0.1049645390070922,7050,6310,-740,251380,13890.0,지누스보통주
7802,13890,2003-04-23,0.0474934036939313,7580,7220,-360,290969,13890.0,지누스보통주
7803,13890,2003-04-21,0.043360433604336,7380,7700,320,456570,13890.0,지누스보통주
7804,13890,2003-04-18,0.0453257790368272,7060,7380,320,294150,13890.0,지누스보통주
7805,13890,2003-04-07,0.0484375,6400,6710,310,369891,13890.0,지누스보통주
7806,13890,2003-04-04,0.992248062015504,6450,6400,-50,185340,13890.0,지누스보통주
7807,13890,2003-04-02,0.0592948717948717,6240,6610,370,567120,13890.0,지누스보통주
7808,13890,2003-03-31,0.0453125,6400,6110,-290,198400,13890.0,지누스보통주
7809,13890,2003-03-28,0.0613598673300165,6030,6400,370,446506,13890.0,지누스보통주
7810,13890,2003-03-25,0.0909090909090909,6600,6000,-600,301960,13890.0,지누스보통주
7811,13890,2003-03-20,0.1243611584327086,5870,6600,730,652904,13890.0,지누스보통주
7812,13890,2003-03-19,0.1487279843444227,5110,5870,760,597457,13890.0,지누스보통주
7813,13890,2003-03-18,0.0579710144927536,4830,5110,280,362059,13890.0,지누스보통주
7814,13890,2003-03-17,0.1088560885608856,5420,4830,-590,296720,13890.0,지누스보통주
7815,13890,2003-03-14,0.0796812749003984,5020,5420,400,428640,13890.0,지누스보통주
7816,13890,2003-03-13,0.0703703703703703,5400,5020,-380,177820,13890.0,지누스보통주
7817,13890,2003-03-11,0.1262458471760797,6020,5260,-760,253640,13890.0,지누스보통주
7818,13890,2003-03-07,0.0922619047619047,6720,6100,-620,375099,13890.0,지누스보통주
7819,13890,2003-03-06,0.1493670886075949,7900,6720,-1180,476011,13890.0,지누스보통주
7820,13890,2003-03-05,0.0595238095238095,8400,7900,-500,1142470,13890.0,지누스보통주
7821,13890,2003-03-04,0.0434782608695652,8050,8400,350,480600,13890.0,지누스보통주
7822,13890,2003-02-28,0.0428571428571428,7700,8030,330,171200,13890.0,지누스보통주
7823,13890,2003-02-17,0.04375,8000,8350,350,180630,13890.0,지누스보통주
7824,13890,2003-02-07,0.0452436194895591,8620,8230,-390,122030,13890.0,지누스보통주
7825,13890,2003-02-03,0.0542168674698795,8300,8750,450,310504,13890.0,지누스보통주
7826,13890,2003-01-27,0.0522727272727272,8800,8340,-460,123940,13890.0,지누스보통주
7827,13890,2003-01-24,0.0766002098635886,9530,8800,-730,147445,13890.0,지누스보통주
7828,13890,2003-01-17,0.0633165829145728,9950,9320,-630,145870,13890.0,지누스보통주
7829,13890,2003-01-14,0.0484210526315789,9500,9960,460,648560,13890.0,지누스보통주
7830,13890,2003-01-10,0.0466321243523316,9650,9200,-450,154720,13890.0,지누스보통주
7831,13890,2003-01-07,0.0547210300429184,9320,9830,510,554270,13890.0,지누스보통주
7832,13890,2003-01-02,0.1304347826086956,8050,9100,1050,201550,13890.0,지누스보통주
7833,13890,2002-12-30,0.0529411764705882,8500,8050,-450,133920,13890.0,지누스보통주
7834,13890,2002-12-26,0.0982599795291709,9770,8810,-960,349429,13890.0,지누스보통주
7835,13890,2002-12-24,0.0695238095238095,10500,9770,-730,260320,13890.0,지누스보통주
7836,13890,2002-12-16,0.0427350427350427,11700,11200,-500,216056,13890.0,지누스보통주
7837,13890,2002-12-13,0.04,11250,11700,450,385600,13890.0,지누스보통주
7838,13890,2002-12-09,0.0566801619433198,12350,11650,-700,404206,13890.0,지누스보통주
7839,13890,2002-12-04,0.0780669144981412,13450,12400,-1050,485250,13890.0,지누스보통주
7840,13890,2002-11-29,0.0441767068273092,12450,13000,550,551444,13890.0,지누스보통주
7841,13890,2002-11-26,0.0452674897119341,12150,12700,550,1797694,13890.0,지누스보통주
7842,13890,2002-11-13,0.0896226415094339,10600,11550,950,1573706,13890.0,지누스보통주
7843,13890,2002-11-11,0.0539215686274509,10200,10750,550,558941,13890.0,지누스보통주
7844,13890,2002-10-29,0.0707070707070707,9900,10600,700,1048016,13890.0,지누스보통주
7845,13890,2002-10-28,0.0421052631578947,9500,9900,400,474629,13890.0,지누스보통주
7846,13890,2002-10-22,0.044776119402985,10050,9600,-450,690670,13890.0,지누스보통주
7847,13890,2002-10-21,0.0518867924528301,10600,10050,-550,582224,13890.0,지누스보통주
7848,13890,2002-10-16,0.1457174638487208,8990,10300,1310,1751045,13890.0,지누스보통주
7849,13890,2002-10-14,0.0404624277456647,8650,9000,350,1155498,13890.0,지누스보통주
7850,13890,2002-10-10,0.1469194312796208,10550,9000,-1550,743110,13890.0,지누스보통주
7851,13890,2002-10-07,0.04,10000,10400,400,1311590,13890.0,지누스보통주
7852,13890,2002-10-01,0.0707964601769911,11300,10500,-800,1331143,13890.0,지누스보통주
7853,13890,2002-09-30,0.0775510204081632,12250,11300,-950,1470967,13890.0,지누스보통주
7854,13890,2002-09-27,0.1493055555555555,14400,12250,-2150,1864310,13890.0,지누스보통주
7855,13890,2002-09-23,0.040590405904059,13550,13000,-550,1026892,13890.0,지누스보통주
7856,13890,2002-09-19,0.0669291338582677,12700,13550,850,2753135,13890.0,지누스보통주
7857,13890,2002-09-18,0.0522388059701492,13400,12700,-700,968431,13890.0,지누스보통주
7858,13890,2002-09-17,0.0428571428571428,14000,13400,-600,2425592,13890.0,지누스보통주
7859,13890,2002-09-16,0.09375,12800,14000,1200,2279024,13890.0,지누스보통주
7860,13890,2002-09-11,0.0777027027027027,14800,13650,-1150,2140263,13890.0,지누스보통주
7861,13890,2002-09-06,0.1466165413533834,13300,15250,1950,2115855,13890.0,지누스보통주
7862,13890,2002-09-05,0.146551724137931,11600,13300,1700,58671,13890.0,지누스보통주
7863,13890,2002-09-04,0.1485148514851485,10100,11600,1500,589420,13890.0,지누스보통주
7864,13890,2002-09-03,0.1451247165532879,8820,10100,1280,973330,13890.0,지누스보통주
7865,13890,2002-08-30,0.0745891276864728,7910,8500,590,325640,13890.0,지누스보통주
7866,13890,2002-08-07,0.0514705882352941,6800,7150,350,49240,13890.0,지누스보통주
7867,13890,2002-07-23,0.0503597122302158,6950,7300,350,50310,13890.0,지누스보통주
7868,13890,2002-07-22,0.1078305519897304,7790,6950,-840,76720,13890.0,지누스보통주
7869,13890,2002-07-19,0.05115712545676,8210,7790,-420,57840,13890.0,지누스보통주
7870,13890,2002-07-15,0.0472895040369088,8670,8260,-410,66050,13890.0,지누스보통주
7871,13890,2002-07-11,0.148738379814077,7530,8650,1120,435850,13890.0,지누스보통주
7872,13890,2002-06-28,0.0692307692307692,6500,6950,450,40000,13890.0,지누스보통주
7873,13890,2002-06-26,0.1139240506329113,7110,6300,-810,49340,13890.0,지누스보통주
7874,13890,2002-06-25,0.0657030223390276,7610,7110,-500,36710,13890.0,지누스보통주
7875,13890,2002-06-19,0.065398335315101,8410,7860,-550,52660,13890.0,지누스보통주
7876,13890,2002-06-04,0.0629067245119305,9220,8640,-580,96830,13890.0,지누스보통주
7877,13890,2002-05-21,0.0516746411483253,10450,9910,-540,100090,13890.0,지누스보통주
7878,13890,2002-05-16,0.0896767466110531,9590,10450,860,423810,13890.0,지누스보통주
7879,13890,2002-04-29,0.064039408866995,10150,9500,-650,88662,13890.0,지누스보통주
7880,13890,2002-04-22,0.055045871559633,10900,10300,-600,134639,13890.0,지누스보통주
7881,13890,2002-04-10,0.0517241379310344,11600,11000,-600,164870,13890.0,지누스보통주
7882,13890,2002-04-09,0.0452674897119341,12150,11600,-550,215660,13890.0,지누스보통주
7883,13890,2002-04-03,0.044776119402985,13400,12800,-600,291112,13890.0,지누스보통주
7884,13890,2002-03-26,0.05,14000,13300,-700,325033,13890.0,지누스보통주
7885,13890,2002-03-25,0.1023622047244094,12700,14000,1300,1430067,13890.0,지누스보통주
7886,13890,2002-03-20,0.0413533834586466,13300,12750,-550,303824,13890.0,지누스보통주
7887,13890,2002-03-13,0.0608365019011406,13150,12350,-800,514680,13890.0,지누스보통주
7888,13890,2002-03-06,0.1471861471861472,11550,13250,1700,1700281,13890.0,지누스보통주
7889,13890,2002-02-28,0.0632911392405063,11850,11100,-750,258600,13890.0,지누스보통주
7890,14680,2021-05-14,0.043103448275862,232000,242000,10000,47828,14680.0,한솔케미칼보통주
7891,14680,2021-05-12,0.041407867494824,241500,231500,-10000,87759,14680.0,한솔케미칼보통주
7892,14680,2021-05-11,0.0454545454545454,253000,241500,-11500,102594,14680.0,한솔케미칼보통주
7893,14680,2021-04-01,0.0767634854771784,241000,259500,18500,117502,14680.0,한솔케미칼보통주
7894,14680,2021-03-25,0.0577777777777777,225000,238000,13000,145811,14680.0,한솔케미칼보통주
7895,14680,2021-02-25,0.0489361702127659,235000,246500,11500,73350,14680.0,한솔케미칼보통주
7896,14680,2021-02-15,0.0544217687074829,220500,232500,12000,115693,14680.0,한솔케미칼보통주
7897,14680,2021-02-05,0.0661764705882353,204000,217500,13500,129920,14680.0,한솔케미칼보통주
7898,14680,2021-01-28,0.0432692307692307,208000,199000,-9000,130532,14680.0,한솔케미칼보통주
7899,14680,2021-01-25,0.045,200000,209000,9000,120386,14680.0,한솔케미칼보통주
7900,14680,2021-01-06,0.0454545454545454,198000,189000,-9000,126614,14680.0,한솔케미칼보통주
7901,14680,2020-12-30,0.0621621621621621,185000,196500,11500,116792,14680.0,한솔케미칼보통주
7902,14680,2020-12-24,0.0484330484330484,175500,184000,8500,105717,14680.0,한솔케미칼보통주
7903,14680,2020-12-16,0.048780487804878,164000,172000,8000,131540,14680.0,한솔케미칼보통주
7904,14680,2020-11-18,0.0579710144927536,172500,162500,-10000,138919,14680.0,한솔케미칼보통주
7905,14680,2020-11-16,0.0613496932515337,163000,173000,10000,170030,14680.0,한솔케미칼보통주
7906,14680,2020-11-13,0.0516129032258064,155000,163000,8000,155958,14680.0,한솔케미칼보통주
7907,14680,2020-11-03,0.0462633451957295,140500,147000,6500,57169,14680.0,한솔케미칼보통주
7908,14680,2020-10-26,0.0664451827242525,150500,140500,-10000,65114,14680.0,한솔케미칼보통주
7909,14680,2020-09-29,0.0565371024734982,141500,149500,8000,112537,14680.0,한솔케미칼보통주
7910,14680,2020-09-24,0.0454545454545454,143000,136500,-6500,86622,14680.0,한솔케미칼보통주
7911,14680,2020-09-21,0.04,150000,144000,-6000,73575,14680.0,한솔케미칼보통주
7912,14680,2020-08-27,0.0612903225806451,155000,164500,9500,288010,14680.0,한솔케미칼보통주
7913,14680,2020-08-24,0.0404040404040404,148500,154500,6000,228085,14680.0,한솔케미칼보통주
7914,14680,2020-08-20,0.0636942675159235,157000,147000,-10000,183823,14680.0,한솔케미칼보통주
7915,14680,2020-08-12,0.063400576368876,173500,162500,-11000,246881,14680.0,한솔케미칼보통주
7916,14680,2020-08-07,0.0552147239263803,163000,172000,9000,214842,14680.0,한솔케미칼보통주
7917,14680,2020-08-03,0.0627062706270627,151500,161000,9500,125074,14680.0,한솔케미칼보통주
7918,14680,2020-07-24,0.0453074433656957,154500,147500,-7000,91066,14680.0,한솔케미칼보통주
7919,14680,2020-07-21,0.0625,144000,153000,9000,135004,14680.0,한솔케미칼보통주
7920,14680,2020-07-15,0.0494699646643109,141500,148500,7000,114745,14680.0,한솔케미칼보통주
7921,14680,2020-07-09,0.0498084291187739,130500,137000,6500,71654,14680.0,한솔케미칼보통주
7922,14680,2020-06-18,0.0611353711790393,114500,121500,7000,217041,14680.0,한솔케미칼보통주
7923,14680,2020-06-15,0.0759493670886076,118500,109500,-9000,93956,14680.0,한솔케미칼보통주
7924,14680,2020-06-11,0.0458333333333333,120000,114500,-5500,102088,14680.0,한솔케미칼보통주
7925,14680,2020-06-10,0.0619469026548672,113000,120000,7000,166822,14680.0,한솔케미칼보통주
7926,14680,2020-06-04,0.0502283105022831,109500,115000,5500,295431,14680.0,한솔케미칼보통주
7927,14680,2020-06-02,0.0833333333333333,102000,110500,8500,206099,14680.0,한솔케미칼보통주
7928,14680,2020-06-01,0.0461538461538461,97500,102000,4500,76507,14680.0,한솔케미칼보통주
7929,14680,2020-05-27,0.0516431924882629,106500,101000,-5500,61337,14680.0,한솔케미칼보통주
7930,14680,2020-05-26,0.0492610837438423,101500,106500,5000,63031,14680.0,한솔케미칼보통주
7931,14680,2020-05-15,0.1163055872291904,87700,97900,10200,276929,14680.0,한솔케미칼보통주
7932,14680,2020-05-08,0.0684273709483793,83300,89000,5700,84344,14680.0,한솔케미칼보통주
7933,14680,2020-05-04,0.0407925407925407,85800,82300,-3500,55687,14680.0,한솔케미칼보통주
7934,14680,2020-04-29,0.0476190476190476,81900,85800,3900,108071,14680.0,한솔케미칼보통주
7935,14680,2020-04-17,0.078720787207872,81300,87700,6400,97219,14680.0,한솔케미칼보통주
7936,14680,2020-04-07,0.0502577319587628,77600,81500,3900,101469,14680.0,한솔케미칼보통주
7937,14680,2020-04-06,0.0472334682860998,74100,77600,3500,46888,14680.0,한솔케미칼보통주
7938,14680,2020-04-01,0.0430925221799746,78900,75500,-3400,54768,14680.0,한솔케미칼보통주
7939,14680,2020-03-31,0.0408970976253298,75800,78900,3100,54303,14680.0,한솔케미칼보통주
7940,14680,2020-03-25,0.047945205479452,73000,76500,3500,98027,14680.0,한솔케미칼보통주
7941,14680,2020-03-24,0.0473457675753228,69700,73000,3300,88531,14680.0,한솔케미칼보통주
7942,14680,2020-03-23,0.0593792172739541,74100,69700,-4400,85191,14680.0,한솔케미칼보통주
7943,14680,2020-03-20,0.1193353474320241,66200,74100,7900,64592,14680.0,한솔케미칼보통주
7944,14680,2020-03-19,0.1173333333333333,75000,66200,-8800,124313,14680.0,한솔케미칼보통주
7945,14680,2020-03-18,0.0636704119850187,80100,75000,-5100,59036,14680.0,한솔케미칼보통주
7946,14680,2020-03-13,0.0493119266055045,87200,82900,-4300,90890,14680.0,한솔케미칼보통주
7947,14680,2020-03-12,0.0417582417582417,91000,87200,-3800,77363,14680.0,한솔케미칼보통주
7948,14680,2020-02-24,0.0425120772946859,103500,99100,-4400,120924,14680.0,한솔케미칼보통주
7949,14680,2020-01-16,0.0414746543778801,108500,113000,4500,91684,14680.0,한솔케미칼보통주
7950,14680,2019-10-11,0.0403422982885085,81800,85100,3300,71643,14680.0,한솔케미칼보통주
7951,14680,2019-07-08,0.0405727923627685,83800,80400,-3400,44037,14680.0,한솔케미칼보통주
7952,14680,2019-04-09,0.0609756097560975,82000,87000,5000,75716,14680.0,한솔케미칼보통주
7953,14680,2019-01-28,0.0567200986436498,81100,85700,4600,69329,14680.0,한솔케미칼보통주
7954,14680,2018-10-12,0.0442600276625172,72300,75500,3200,56502,14680.0,한솔케미칼보통주
7955,14680,2018-10-11,0.065891472868217,77400,72300,-5100,89064,14680.0,한솔케미칼보통주
7956,14680,2018-08-07,0.0639386189258312,78200,83200,5000,176787,14680.0,한솔케미칼보통주
7957,14680,2018-05-23,0.0420757363253856,71300,74300,3000,139708,14680.0,한솔케미칼보통주
7958,14680,2018-04-12,0.0497803806734992,68300,71700,3400,93488,14680.0,한솔케미칼보통주
7959,14680,2018-02-21,0.0866035182679296,73900,80300,6400,259758,14680.0,한솔케미칼보통주
7960,14680,2018-02-12,0.040650406504065,73800,76800,3000,170855,14680.0,한솔케미칼보통주
7961,14680,2018-02-08,0.0557142857142857,70000,73900,3900,247082,14680.0,한솔케미칼보통주
7962,14680,2017-11-24,0.044328552803129,76700,80100,3400,245215,14680.0,한솔케미칼보통주
7963,14680,2017-09-07,0.0429530201342281,74500,77700,3200,161439,14680.0,한솔케미칼보통주
7964,14680,2017-07-13,0.0465444287729196,70900,74200,3300,150444,14680.0,한솔케미칼보통주
7965,14680,2017-06-16,0.0481586402266288,70600,74000,3400,176622,14680.0,한솔케미칼보통주
7966,14680,2017-04-05,0.0431372549019607,76500,79800,3300,42100,14680.0,한솔케미칼보통주
7967,14680,2017-01-02,0.0408163265306122,83300,86700,3400,91957,14680.0,한솔케미칼보통주
7968,14680,2016-12-29,0.059796437659033,78600,83300,4700,78651,14680.0,한솔케미칼보통주
7969,14680,2016-11-04,0.0437956204379562,82200,85800,3600,57615,14680.0,한솔케미칼보통주
7970,14680,2016-10-13,0.0494117647058823,85000,80800,-4200,86197,14680.0,한솔케미칼보통주
7971,14680,2016-09-12,0.0404761904761904,84000,80600,-3400,75101,14680.0,한솔케미칼보통주
7972,14680,2016-08-30,0.0465116279069767,86000,90000,4000,105197,14680.0,한솔케미칼보통주
7973,14680,2016-08-19,0.0630202140309155,84100,89400,5300,185130,14680.0,한솔케미칼보통주
7974,14680,2016-08-09,0.0925925925925925,81000,88500,7500,213835,14680.0,한솔케미칼보통주
7975,15760,2021-05-26,0.0542168674698795,24900,26250,1350,13694345,15760.0,한국전력공사보통주
7976,15760,2021-05-24,0.0528541226215644,23650,24900,1250,11452950,15760.0,한국전력공사보통주
7977,15760,2021-03-22,0.0476190476190476,24150,23000,-1150,9591472,15760.0,한국전력공사보통주
7978,15760,2021-03-16,0.064516129032258,23250,24750,1500,11037032,15760.0,한국전력공사보통주
7979,15760,2020-12-22,0.0445632798573975,28050,26800,-1250,10254371,15760.0,한국전력공사보통주
7980,15760,2020-12-18,0.0884615384615384,26000,28300,2300,45727935,15760.0,한국전력공사보통주
7981,15760,2020-12-17,0.1016949152542373,23600,26000,2400,20413429,15760.0,한국전력공사보통주
7982,15760,2020-12-10,0.0625,22400,23800,1400,22910345,15760.0,한국전력공사보통주
7983,15760,2020-12-09,0.041860465116279,21500,22400,900,5821012,15760.0,한국전력공사보통주
7984,15760,2020-11-24,0.0464037122969837,21550,22550,1000,13150194,15760.0,한국전력공사보통주
7985,15760,2020-08-25,0.0526315789473684,19950,21000,1050,6875039,15760.0,한국전력공사보통주
7986,15760,2020-08-20,0.0408653846153846,20800,19950,-850,5547124,15760.0,한국전력공사보통주
7987,15760,2020-08-18,0.0637813211845102,21950,20550,-1400,7925993,15760.0,한국전력공사보통주
7988,15760,2020-08-13,0.0410628019323671,20700,21550,850,12573404,15760.0,한국전력공사보통주
7989,15760,2020-08-11,0.0796915167095115,19450,21000,1550,18946719,15760.0,한국전력공사보통주
7990,15760,2020-07-13,0.0695187165775401,18700,20000,1300,7671410,15760.0,한국전력공사보통주
7991,15760,2020-06-16,0.0477386934673366,19900,20850,950,2156035,15760.0,한국전력공사보통주
7992,15760,2020-06-15,0.0591016548463357,21150,19900,-1250,3684568,15760.0,한국전력공사보통주
7993,15760,2020-05-15,0.0496760259179265,23150,22000,-1150,6091140,15760.0,한국전력공사보통주
7994,15760,2020-05-14,0.0522727272727272,22000,23150,1150,6104579,15760.0,한국전력공사보통주
7995,15760,2020-05-04,0.0440251572327044,23850,22800,-1050,3220563,15760.0,한국전력공사보통주
7996,15760,2020-04-27,0.0576496674057649,22550,23850,1300,4919955,15760.0,한국전력공사보통주
7997,15760,2020-04-22,0.041860465116279,21500,22400,900,5593049,15760.0,한국전력공사보통주
7998,15760,2020-04-16,0.0448113207547169,21200,20250,-950,4168986,15760.0,한국전력공사보통주
7999,15760,2020-04-10,0.0469973890339425,19150,20050,900,5388823,15760.0,한국전력공사보통주
8000,15760,2020-03-24,0.0780346820809248,17300,18650,1350,3570950,15760.0,한국전력공사보통주
8001,15760,2020-03-20,0.0646153846153846,16250,17300,1050,3694677,15760.0,한국전력공사보통주
8002,15760,2020-03-19,0.0497076023391812,17100,16250,-850,4836755,15760.0,한국전력공사보통주
8003,15760,2020-03-18,0.0526315789473684,18050,17100,-950,3598889,15760.0,한국전력공사보통주
8004,15760,2020-03-17,0.05,19000,18050,-950,5782189,15760.0,한국전력공사보통주
8005,15760,2020-03-13,0.048661800486618,20550,19550,-1000,5709867,15760.0,한국전력공사보통주
8006,15760,2020-03-11,0.0545454545454545,22000,20800,-1200,5941894,15760.0,한국전력공사보통주
8007,15760,2020-03-09,0.0805687203791469,21100,22800,1700,10031547,15760.0,한국전력공사보통주
8008,15760,2020-02-28,0.0779220779220779,23100,21300,-1800,7589705,15760.0,한국전력공사보통주
8009,15760,2019-11-06,0.0613861386138613,25250,26800,1550,7144202,15760.0,한국전력공사보통주
8010,15760,2019-08-19,0.0404858299595141,24700,25700,1000,1043295,15760.0,한국전력공사보통주
8011,15760,2019-08-01,0.0448028673835125,27900,26650,-1250,1743468,15760.0,한국전력공사보통주
8012,15760,2019-07-23,0.048076923076923,26000,27250,1250,3452971,15760.0,한국전력공사보통주
8013,15760,2019-05-31,0.0420841683366733,24950,26000,1050,3100087,15760.0,한국전력공사보통주
8014,15760,2019-01-09,0.0535966149506347,35450,33550,-1900,2794012,15760.0,한국전력공사보통주
8015,15760,2018-11-26,0.0615942028985507,27600,29300,1700,2250623,15760.0,한국전력공사보통주
8016,15760,2018-11-14,0.0457038391224862,27350,28600,1250,2815013,15760.0,한국전력공사보통주
8017,15760,2018-10-24,0.0418250950570342,26300,27400,1100,2845565,15760.0,한국전력공사보통주
8018,15760,2018-10-23,0.0453720508166969,27550,26300,-1250,1510227,15760.0,한국전력공사보통주
8019,15760,2018-10-11,0.0573122529644268,25300,23850,-1450,3191957,15760.0,한국전력공사보통주
8020,15760,2018-06-27,0.0420289855072463,34500,33050,-1450,2261762,15760.0,한국전력공사보통주
8021,15760,2018-06-22,0.060790273556231,32900,34900,2000,2668943,15760.0,한국전력공사보통주
8022,15760,2018-05-14,0.0433566433566433,35750,37300,1550,2129346,15760.0,한국전력공사보통주
8023,15760,2018-04-03,0.0511278195488721,33250,34950,1700,4540936,15760.0,한국전력공사보통주
8024,15760,2017-05-10,0.0578602620087336,45800,43150,-2650,5973723,15760.0,한국전력공사보통주
8025,15760,2017-02-20,0.0603448275862069,40600,43050,2450,3577876,15760.0,한국전력공사보통주
8026,15760,2016-12-28,0.0414893617021276,47000,45050,-1950,1870429,15760.0,한국전력공사보통주
8027,15760,2016-12-01,0.043010752688172,46500,44500,-2000,2557351,15760.0,한국전력공사보통주
8028,15760,2016-11-15,0.0459016393442622,45750,47850,2100,2433736,15760.0,한국전력공사보통주
8029,16360,2021-05-10,0.067816091954023,43500,46450,2950,1975873,16360.0,삼성증권보통주
8030,16360,2021-01-29,0.050314465408805,39750,37750,-2000,908488,16360.0,삼성증권보통주
8031,16360,2020-12-29,0.0567786790266512,43150,40700,-2450,1383425,16360.0,삼성증권보통주
8032,16360,2020-11-23,0.0405228758169934,38250,39800,1550,874201,16360.0,삼성증권보통주
8033,16360,2020-11-16,0.0851063829787234,35250,38250,3000,1591487,16360.0,삼성증권보통주
8034,16360,2020-11-11,0.0530191458026509,33950,35750,1800,1014117,16360.0,삼성증권보통주
8035,16360,2020-09-02,0.0436187399030694,30950,32300,1350,1407330,16360.0,삼성증권보통주
8036,16360,2020-08-25,0.0571428571428571,29750,31450,1700,735176,16360.0,삼성증권보통주
8037,16360,2020-08-18,0.0516431924882629,31950,30300,-1650,1017382,16360.0,삼성증권보통주
8038,16360,2020-08-10,0.0610932475884244,31100,33000,1900,1479089,16360.0,삼성증권보통주
8039,16360,2020-07-13,0.0411985018726591,26700,27800,1100,524846,16360.0,삼성증권보통주
8040,16360,2020-06-16,0.0510948905109489,27400,28800,1400,532143,16360.0,삼성증권보통주
8041,16360,2020-06-15,0.0486111111111111,28800,27400,-1400,807920,16360.0,삼성증권보통주
8042,16360,2020-06-03,0.0607082630691399,29650,31450,1800,2022916,16360.0,삼성증권보통주
8043,16360,2020-06-02,0.0421792618629174,28450,29650,1200,1489653,16360.0,삼성증권보통주
8044,16360,2020-04-29,0.0598591549295774,28400,30100,1700,1420001,16360.0,삼성증권보통주
8045,16360,2020-04-17,0.0510018214936247,27450,28850,1400,1078805,16360.0,삼성증권보통주
8046,16360,2020-04-06,0.0512820512820512,27300,28700,1400,611532,16360.0,삼성증권보통주
8047,16360,2020-04-01,0.0715502555366269,29350,27250,-2100,676657,16360.0,삼성증권보통주
8048,16360,2020-03-25,0.1734475374732334,23350,27400,4050,1109536,16360.0,삼성증권보통주
8049,16360,2020-03-24,0.1225961538461538,20800,23350,2550,1006296,16360.0,삼성증권보통주
8050,16360,2020-03-23,0.1297071129707113,23900,20800,-3100,1010313,16360.0,삼성증권보통주
8051,16360,2020-03-19,0.143859649122807,28500,24400,-4100,789228,16360.0,삼성증권보통주
8052,16360,2020-03-16,0.0429936305732484,31400,30050,-1350,563171,16360.0,삼성증권보통주
8053,16360,2020-01-28,0.0459317585301837,38100,36350,-1750,390860,16360.0,삼성증권보통주
8054,16360,2019-08-08,0.0422740524781341,34300,35750,1450,387890,16360.0,삼성증권보통주
8055,16360,2019-07-03,0.0421994884910485,39100,37450,-1650,358240,16360.0,삼성증권보통주
8056,16360,2019-01-24,0.0454545454545454,33000,34500,1500,641456,16360.0,삼성증권보통주
8057,16360,2018-11-02,0.0811320754716981,26500,28650,2150,651365,16360.0,삼성증권보통주
8058,16360,2018-10-11,0.0594059405940594,30300,28500,-1800,734021,16360.0,삼성증권보통주
8059,16360,2018-04-10,0.0443548387096774,37200,35550,-1650,3379449,16360.0,삼성증권보통주
8060,16360,2018-03-23,0.0601684717208182,41550,39050,-2500,651041,16360.0,삼성증권보통주
8061,16360,2018-03-12,0.0423940149625935,40100,41800,1700,424952,16360.0,삼성증권보통주
8062,16360,2018-02-12,0.04,40000,41600,1600,453043,16360.0,삼성증권보통주
8063,16360,2018-01-23,0.0549313358302122,40050,42250,2200,1195687,16360.0,삼성증권보통주
8064,16360,2018-01-12,0.0411140583554376,37700,39250,1550,933490,16360.0,삼성증권보통주
8065,16360,2017-10-12,0.0572246065808297,34950,36950,2000,841801,16360.0,삼성증권보통주
8066,16360,2017-01-26,0.0504731861198738,31700,33300,1600,509266,16360.0,삼성증권보통주
8067,16360,2016-12-21,0.0491071428571428,33600,31950,-1650,1103709,16360.0,삼성증권보통주
8068,16380,2021-05-27,0.0486486486486486,18500,19400,900,659996,16380.0,KG동부제철보통주
8069,16380,2021-05-26,0.0561224489795918,19600,18500,-1100,651499,16380.0,KG동부제철보통주
8070,16380,2021-05-21,0.0443349753694581,20300,19400,-900,1028843,16380.0,KG동부제철보통주
8071,16380,2021-05-20,0.0601851851851851,21600,20300,-1300,746918,16380.0,KG동부제철보통주
8072,16380,2021-05-18,0.0510948905109489,20550,21600,1050,900791,16380.0,KG동부제철보통주
8073,16380,2021-05-14,0.0653153153153153,22200,20750,-1450,1310458,16380.0,KG동부제철보통주
8074,16380,2021-05-13,0.0769230769230769,24050,22200,-1850,1284523,16380.0,KG동부제철보통주
8075,16380,2021-05-11,0.1166666666666666,21000,23450,2450,4568010,16380.0,KG동부제철보통주
8076,16380,2021-05-06,0.0439276485788113,19350,20200,850,830167,16380.0,KG동부제철보통주
8077,16380,2021-05-03,0.0525,20000,18950,-1050,1008541,16380.0,KG동부제철보통주
8078,16380,2021-04-30,0.0430622009569378,20900,20000,-900,1377732,16380.0,KG동부제철보통주
8079,16380,2021-04-27,0.1703296703296703,18200,21300,3100,8046407,16380.0,KG동부제철보통주
8080,16380,2021-04-23,0.0903614457831325,16600,18100,1500,4260267,16380.0,KG동부제철보통주
8081,16380,2021-04-22,0.1178451178451178,14850,16600,1750,2381169,16380.0,KG동부제철보통주
8082,16380,2021-04-07,0.0972222222222222,14400,15800,1400,1226570,16380.0,KG동부제철보통주
8083,16380,2021-04-01,0.0490196078431372,15300,14550,-750,1040368,16380.0,KG동부제철보통주
8084,16380,2021-03-30,0.0486111111111111,14400,15100,700,2286494,16380.0,KG동부제철보통주
8085,16380,2021-03-29,0.1034482758620689,13050,14400,1350,7043929,16380.0,KG동부제철보통주
8086,16380,2021-03-10,0.046692607003891,12850,12250,-600,340117,16380.0,KG동부제철보통주
8087,16380,2021-02-24,0.0445344129554655,12350,11800,-550,544861,16380.0,KG동부제철보통주
8088,16380,2021-02-01,0.0424528301886792,10600,11050,450,199511,16380.0,KG동부제철보통주
8089,16380,2021-01-29,0.0407239819004524,11050,10600,-450,255148,16380.0,KG동부제철보통주
8090,16380,2021-01-11,0.067193675889328,12650,11800,-850,694118,16380.0,KG동부제철보통주
8091,16380,2021-01-05,0.0658436213991769,12150,12950,800,1654864,16380.0,KG동부제철보통주
8092,16380,2021-01-04,0.0474137931034482,11600,12150,550,607266,16380.0,KG동부제철보통주
8093,16380,2020-12-24,0.056338028169014,10650,11250,600,293499,16380.0,KG동부제철보통주
8094,16380,2020-12-22,0.0611353711790393,11450,10750,-700,307638,16380.0,KG동부제철보통주
8095,16380,2020-12-15,0.0416666666666666,12000,11500,-500,358059,16380.0,KG동부제철보통주
8096,16380,2020-12-14,0.04,12500,12000,-500,463608,16380.0,KG동부제철보통주
8097,16380,2020-12-10,0.0466101694915254,11800,12350,550,854048,16380.0,KG동부제철보통주
8098,16380,2020-12-09,0.0535714285714285,11200,11800,600,567694,16380.0,KG동부제철보통주
8099,16380,2020-12-08,0.0468085106382978,11750,11200,-550,460951,16380.0,KG동부제철보통주
8100,16380,2020-12-04,0.0748898678414096,11350,12200,850,1664221,16380.0,KG동부제철보통주
8101,16380,2020-12-03,0.0509259259259259,10800,11350,550,2046023,16380.0,KG동부제철보통주
8102,16380,2020-12-02,0.0484581497797356,11350,10800,-550,1895772,16380.0,KG동부제철보통주
8103,16380,2020-12-01,0.2971428571428571,8750,11350,2600,6219710,16380.0,KG동부제철보통주
8104,16380,2020-11-13,0.0509413067552602,9030,8570,-460,207883,16380.0,KG동부제철보통주
8105,16380,2020-10-16,0.0439189189189189,8880,8490,-390,330965,16380.0,KG동부제철보통주
8106,16380,2020-10-14,0.0606435643564356,8080,8570,490,671004,16380.0,KG동부제철보통주
8107,16380,2020-09-25,0.0759911894273127,9080,8390,-690,339736,16380.0,KG동부제철보통주
8108,16380,2020-09-24,0.092,10000,9080,-920,331518,16380.0,KG동부제철보통주
8109,16380,2020-09-23,0.1031390134529148,11150,10000,-1150,322021,16380.0,KG동부제철보통주
8110,16380,2020-09-22,0.0785123966942148,12100,11150,-950,323009,16380.0,KG동부제철보통주
8111,16380,2020-09-21,0.0970149253731343,13400,12100,-1300,295707,16380.0,KG동부제철보통주
8112,16380,2020-09-14,0.064516129032258,12400,13200,800,116169,16380.0,KG동부제철보통주
8113,16380,2020-09-10,0.0672268907563025,11900,12700,800,280295,16380.0,KG동부제철보통주
8114,16380,2020-09-01,0.0458333333333333,12000,12550,550,72028,16380.0,KG동부제철보통주
8115,16380,2020-08-20,0.0452830188679245,13250,12650,-600,120148,16380.0,KG동부제철보통주
8116,16380,2020-08-14,0.0753424657534246,14600,13500,-1100,113781,16380.0,KG동부제철보통주
8117,16380,2020-08-11,0.1461538461538461,13000,14900,1900,1103577,16380.0,KG동부제철보통주
8118,16380,2020-08-10,0.0441176470588235,13600,13000,-600,94277,16380.0,KG동부제철보통주
8119,16380,2020-08-07,0.0836653386454183,12550,13600,1050,131741,16380.0,KG동부제철보통주
8120,16380,2020-07-10,0.054054054054054,12950,12250,-700,86106,16380.0,KG동부제철보통주
8121,16380,2020-07-03,0.0878661087866108,11950,13000,1050,270032,16380.0,KG동부제철보통주
8122,16380,2020-06-25,0.0538461538461538,13000,12300,-700,94253,16380.0,KG동부제철보통주
8123,16380,2020-06-22,0.0441176470588235,13600,13000,-600,90263,16380.0,KG동부제철보통주
8124,16380,2020-06-15,0.1515151515151515,16500,14000,-2500,301587,16380.0,KG동부제철보통주
8125,16380,2020-06-12,0.1560102301790281,19550,16500,-3050,696213,16380.0,KG동부제철보통주
8126,16380,2020-06-11,0.0454545454545454,18700,19550,850,1024388,16380.0,KG동부제철보통주
8127,16380,2020-06-10,0.1265060240963855,16600,18700,2100,1281804,16380.0,KG동부제철보통주
8128,16380,2020-06-03,0.0798722044728434,15650,16900,1250,616074,16380.0,KG동부제철보통주
8129,16380,2020-05-29,0.2076923076923077,13000,15700,2700,1165423,16380.0,KG동부제철보통주
8130,16380,2020-05-28,0.1016949152542373,11800,13000,1200,2037610,16380.0,KG동부제철보통주
8131,16380,2020-05-15,0.0454545454545454,12100,12650,550,80251,16380.0,KG동부제철보통주
8132,16380,2020-05-14,0.0434782608695652,12650,12100,-550,66450,16380.0,KG동부제철보통주
8133,16380,2020-05-06,0.0995850622406639,12050,13250,1200,496879,16380.0,KG동부제철보통주
8134,16380,2020-05-04,0.0478260869565217,11500,12050,550,235089,16380.0,KG동부제철보통주
8135,16380,2020-04-28,0.0816326530612244,12250,11250,-1000,308527,16380.0,KG동부제철보통주
8136,16380,2020-04-27,0.1312056737588652,14100,12250,-1850,478916,16380.0,KG동부제철보통주
8137,16380,2020-04-24,0.0440677966101694,14750,14100,-650,114031,16380.0,KG동부제철보통주
8138,16380,2020-04-22,0.1343283582089552,16750,14500,-2250,180125,16380.0,KG동부제철보통주
8139,16380,2020-04-21,0.046875,16000,16750,750,216332,16380.0,KG동부제철보통주
8140,16380,2020-04-20,0.2121212121212121,13200,16000,2800,187109,16380.0,KG동부제철보통주
8141,16380,2020-04-17,0.0954356846473029,12050,13200,1150,148599,16380.0,KG동부제철보통주
8142,16380,2020-04-16,0.0855855855855855,11100,12050,950,674462,16380.0,KG동부제철보통주
8143,16380,2020-04-14,0.2333333333333333,9000,11100,2100,864304,16380.0,KG동부제철보통주
8144,16380,2020-04-13,0.1111111111111111,8100,9000,900,202121,16380.0,KG동부제철보통주
8145,16380,2020-04-07,0.0471428571428571,7000,7330,330,33258,16380.0,KG동부제철보통주
8146,16380,2020-03-30,0.0576,6250,6610,360,15417,16380.0,KG동부제철보통주
8147,16380,2020-03-25,0.0771929824561403,5700,6140,440,21201,16380.0,KG동부제철보통주
8148,16380,2020-03-23,0.05414551607445,5910,5590,-320,7471,16380.0,KG동부제철보통주
8149,16380,2020-03-20,0.1109022556390977,5320,5910,590,12571,16380.0,KG동부제철보통주
8150,16380,2020-03-19,0.16875,6400,5320,-1080,41302,16380.0,KG동부제철보통주
8151,16380,2020-03-13,0.0583941605839416,6850,6450,-400,17159,16380.0,KG동부제철보통주
8152,16380,2019-12-30,0.0684931506849315,7300,7800,500,384404,16380.0,KG동부제철보통주
8153,16380,2019-11-25,0.0696378830083565,7180,7680,500,79158,16380.0,KG동부제철보통주
8154,16380,2019-10-02,0.0469483568075117,10650,10150,-500,26146,16380.0,KG동부제철보통주
8155,16380,2019-09-30,0.0752212389380531,11300,10450,-850,55296,16380.0,KG동부제철보통주
8156,16380,2019-09-27,0.0543933054393305,11950,11300,-650,33574,16380.0,KG동부제철보통주
8157,16380,2019-09-25,0.0689655172413793,13050,12150,-900,89440,16380.0,KG동부제철보통주
8158,16380,2019-09-24,0.1061643835616438,14600,13050,-1550,307604,16380.0,KG동부제철보통주
8159,16380,2019-09-23,0.106060606060606,13200,14600,1400,863940,16380.0,KG동부제철보통주
8160,16380,2019-09-20,0.2048192771084337,16600,13200,-3400,216936,16380.0,KG동부제철보통주
8161,16380,2019-09-19,0.5666666666666667,6000,16600,10600,68869,16380.0,KG동부제철보통주
8162,16380,2019-08-12,0.04,6000,6240,240,24957,16380.0,KG동부제철보통주
8163,16380,2019-08-05,0.0846153846153846,6500,5950,-550,18571,16380.0,KG동부제철보통주
8164,16380,2019-07-11,0.1264916467780429,8380,7320,-1060,454187,16380.0,KG동부제철보통주
8165,16380,2019-07-10,0.2992248062015504,6450,8380,1930,235824,16380.0,KG동부제철보통주
8166,16380,2019-06-07,0.044776119402985,8040,7680,-360,64331,16380.0,KG동부제철보통주
8167,16380,2019-05-29,0.0721040189125295,8460,7850,-610,108372,16380.0,KG동부제철보통주
8168,16380,2019-05-28,0.154,10000,8460,-1540,176884,16380.0,KG동부제철보통주
8169,16380,2019-05-27,0.0476190476190476,10500,10000,-500,43013,16380.0,KG동부제철보통주
8170,16380,2019-05-16,0.0599078341013824,10850,10200,-650,467087,16380.0,KG동부제철보통주
8171,16380,2019-05-15,0.0483091787439613,10350,10850,500,1190141,16380.0,KG동부제철보통주
8172,16380,2019-05-09,0.0599078341013824,10850,10200,-650,43318,16380.0,KG동부제철보통주
8173,16380,2019-05-08,0.0585365853658536,10250,10850,600,181300,16380.0,KG동부제철보통주
8174,16380,2019-04-29,0.0476190476190476,10500,10000,-500,86904,16380.0,KG동부제철보통주
8175,16380,2019-04-26,0.0552763819095477,9950,10500,550,125890,16380.0,KG동부제철보통주
8176,16380,2019-04-24,0.0610328638497652,10650,10000,-650,86869,16380.0,KG동부제철보통주
8177,16380,2019-04-22,0.1038306451612903,9920,10950,1030,511766,16380.0,KG동부제철보통주
8178,16380,2019-04-17,0.0411392405063291,9480,9870,390,690242,16380.0,KG동부제철보통주
8179,16380,2019-04-09,0.0939289805269186,8730,9550,820,352517,16380.0,KG동부제철보통주
8180,16380,2019-04-08,0.0438116100766703,9130,8730,-400,54613,16380.0,KG동부제철보통주
8181,16380,2019-04-05,0.087,10000,9130,-870,160920,16380.0,KG동부제철보통주
8182,16380,2019-04-03,0.2061349693251533,8150,9830,1680,760123,16380.0,KG동부제철보통주
8183,16380,2019-04-02,0.0408684546615581,7830,8150,320,49903,16380.0,KG동부제철보통주
8184,16380,2019-03-29,0.1444759206798866,7060,8080,1020,602619,16380.0,KG동부제철보통주
8185,16380,2019-03-28,0.0710526315789473,7600,7060,-540,143159,16380.0,KG동부제철보통주
8186,16380,2019-03-25,0.0424164524421593,7780,7450,-330,40069,16380.0,KG동부제철보통주
8187,16380,2019-03-19,0.0727673649393605,9070,8410,-660,131651,16380.0,KG동부제철보통주
8188,16380,2019-03-13,0.062200956937799,10450,9800,-650,182715,16380.0,KG동부제철보통주
8189,16380,2019-03-04,0.0492610837438423,10150,10650,500,124352,16380.0,KG동부제철보통주
8190,16380,2019-02-28,0.0772727272727272,11000,10150,-850,121264,16380.0,KG동부제철보통주
8191,16380,2019-02-27,0.1446409989594172,9610,11000,1390,695829,16380.0,KG동부제철보통주
8192,16380,2019-02-11,0.1,12000,10800,-1200,618676,16380.0,KG동부제철보통주
8193,16380,2019-02-08,0.2958963282937365,9260,12000,2740,343162,16380.0,KG동부제철보통주
8194,16380,2019-01-29,0.0488565488565488,9620,9150,-470,73639,16380.0,KG동부제철보통주
8195,16380,2019-01-28,0.0427860696517412,10050,9620,-430,74118,16380.0,KG동부제철보통주
8196,16380,2019-01-23,0.090497737556561,11050,10050,-1000,225499,16380.0,KG동부제철보통주
8197,16380,2019-01-21,0.0751173708920187,10650,11450,800,346690,16380.0,KG동부제철보통주
8198,16380,2019-01-18,0.0657894736842105,11400,10650,-750,243141,16380.0,KG동부제철보통주
8199,16380,2019-01-17,0.0555555555555555,10800,11400,600,208849,16380.0,KG동부제철보통주
8200,16380,2019-01-11,0.0458333333333333,12000,11450,-550,392000,16380.0,KG동부제철보통주
8201,16380,2019-01-10,0.0839694656488549,13100,12000,-1100,710290,16380.0,KG동부제철보통주
8202,16380,2019-01-08,0.2990936555891239,9930,12900,2970,99896,16380.0,KG동부제철보통주
8203,16380,2019-01-07,0.299738219895288,7640,9930,2290,59375,16380.0,KG동부제철보통주
8204,16380,2019-01-04,0.1402985074626865,6700,7640,940,76558,16380.0,KG동부제철보통주
8205,16380,2018-12-18,0.0419906687402799,6430,6700,270,36914,16380.0,KG동부제철보통주
8206,16380,2018-10-31,0.0455882352941176,6800,7110,310,3696,16380.0,KG동부제철보통주
8207,16380,2018-10-25,0.0833333333333333,7800,7150,-650,24127,16380.0,KG동부제철보통주
8208,16380,2018-10-24,0.0556900726392251,8260,7800,-460,7670,16380.0,KG동부제철보통주
8209,16380,2018-09-13,0.0925925925925925,8100,8850,750,117285,16380.0,KG동부제철보통주
8210,16380,2018-09-06,0.0426829268292682,8200,7850,-350,15356,16380.0,KG동부제철보통주
8211,16380,2018-07-02,0.0406091370558375,7880,7560,-320,10097,16380.0,KG동부제철보통주
8212,16380,2018-06-19,0.0477178423236514,9640,9180,-460,6229,16380.0,KG동부제철보통주
8213,16380,2018-05-28,0.0681114551083591,9690,10350,660,24656,16380.0,KG동부제철보통주
8214,16380,2018-05-24,0.0413461538461538,10400,9970,-430,34600,16380.0,KG동부제철보통주
8215,16380,2018-05-23,0.0414746543778801,10850,10400,-450,22582,16380.0,KG동부제철보통주
8216,16380,2018-05-08,0.0516431924882629,10650,11200,550,287441,16380.0,KG동부제철보통주
8217,16380,2018-04-18,0.1,12000,10800,-1200,67180,16380.0,KG동부제철보통주
8218,16380,2018-04-13,0.0533333333333333,11250,11850,600,59618,16380.0,KG동부제철보통주
8219,16380,2018-04-11,0.0414746543778801,10850,11300,450,179192,16380.0,KG동부제철보통주
8220,16380,2018-04-10,0.0533980582524271,10300,10850,550,40882,16380.0,KG동부제철보통주
8221,16380,2018-03-28,0.0524017467248908,11450,10850,-600,47065,16380.0,KG동부제철보통주
8222,16380,2018-03-26,0.0694444444444444,10800,11550,750,277312,16380.0,KG동부제철보통주
8223,16380,2018-03-23,0.0608695652173913,11500,10800,-700,657750,16380.0,KG동부제철보통주
8224,16380,2018-03-22,0.068825910931174,12350,11500,-850,122685,16380.0,KG동부제철보통주
8225,16380,2018-03-21,0.0851851851851851,13500,12350,-1150,553394,16380.0,KG동부제철보통주
8226,16380,2018-03-20,0.2980769230769231,10400,13500,3100,410957,16380.0,KG동부제철보통주
8227,16380,2018-03-19,0.0590631364562118,9820,10400,580,29876,16380.0,KG동부제철보통주
8228,16380,2018-01-31,0.0493273542600896,11150,10600,-550,53252,16380.0,KG동부제철보통주
8229,16380,2018-01-18,0.0493273542600896,11150,10600,-550,66146,16380.0,KG동부제철보통주
8230,16380,2018-01-17,0.0825242718446602,10300,11150,850,330674,16380.0,KG동부제철보통주
8231,16380,2018-01-11,0.0701754385964912,11400,10600,-800,68579,16380.0,KG동부제철보통주
8232,16380,2018-01-09,0.0413223140495867,12100,11600,-500,81600,16380.0,KG동부제철보통주
8233,16380,2018-01-03,0.2966804979253112,9640,12500,2860,576528,16380.0,KG동부제철보통주
8234,16380,2018-01-02,0.2991913746630728,7420,9640,2220,73816,16380.0,KG동부제철보통주
8235,16380,2017-12-26,0.0569536423841059,7550,7120,-430,59010,16380.0,KG동부제철보통주
8236,16380,2017-12-22,0.0644361833952912,8070,7550,-520,64664,16380.0,KG동부제철보통주
8237,16380,2017-12-21,0.0846774193548387,7440,8070,630,238256,16380.0,KG동부제철보통주
8238,16380,2017-12-20,0.0498084291187739,7830,7440,-390,59402,16380.0,KG동부제철보통주
8239,16380,2017-12-18,0.0423940149625935,8020,7680,-340,58379,16380.0,KG동부제철보통주
8240,16380,2017-12-15,0.0469973890339425,7660,8020,360,199718,16380.0,KG동부제철보통주
8241,16380,2017-12-13,0.0799536500579374,8630,7940,-690,191682,16380.0,KG동부제철보통주
8242,16380,2017-12-12,0.0537280701754386,9120,8630,-490,684792,16380.0,KG동부제철보통주
8243,16380,2017-12-11,0.2991452991452991,7020,9120,2100,939412,16380.0,KG동부제철보통주
8244,16380,2017-12-08,0.1741176470588235,8500,7020,-1480,180439,16380.0,KG동부제철보통주
8245,16380,2017-12-07,0.178743961352657,10350,8500,-1850,411299,16380.0,KG동부제철보통주
8246,16380,2017-12-06,0.2969924812030075,7980,10350,2370,425365,16380.0,KG동부제철보통주
8247,16380,2017-12-05,0.2996742671009772,6140,7980,1840,450215,16380.0,KG동부제철보통주
8248,16380,2017-11-17,0.0427631578947368,6080,6340,260,12006,16380.0,KG동부제철보통주
8249,16380,2017-11-15,0.0556390977443609,6650,6280,-370,39396,16380.0,KG동부제철보통주
8250,16380,2017-09-29,0.0521861777150916,7090,7460,370,13915,16380.0,KG동부제철보통주
8251,16380,2017-09-22,0.0638569604086845,7830,7330,-500,20976,16380.0,KG동부제철보통주
8252,16380,2017-09-19,0.041025641025641,7800,8120,320,11564,16380.0,KG동부제철보통주
8253,16380,2017-09-15,0.0776699029126213,8240,7600,-640,67839,16380.0,KG동부제철보통주
8254,16380,2017-09-12,0.085037674919268,9290,8500,-790,93129,16380.0,KG동부제철보통주
8255,16380,2017-09-04,0.0540284360189573,10550,9980,-570,35139,16380.0,KG동부제철보통주
8256,16380,2017-08-28,0.043859649122807,11400,10900,-500,30568,16380.0,KG동부제철보통주
8257,16380,2017-07-20,0.0423728813559322,11800,12300,500,14207,16380.0,KG동부제철보통주
8258,16380,2017-06-08,0.0566666666666666,15000,14150,-850,94448,16380.0,KG동부제철보통주
8259,16380,2017-05-23,0.0410958904109589,14600,15200,600,47655,16380.0,KG동부제철보통주
8260,16380,2017-04-24,0.0599250936329588,13350,14150,800,71029,16380.0,KG동부제철보통주
8261,16380,2017-01-10,0.0798722044728434,15650,14400,-1250,62882,16380.0,KG동부제철보통주
8262,16380,2016-11-09,0.0488721804511278,13300,13950,650,18223,16380.0,KG동부제철보통주
8263,16380,2016-11-07,0.0826771653543307,12700,13750,1050,61919,16380.0,KG동부제철보통주
8264,16380,2016-11-04,0.0583333333333333,12000,12700,700,14925,16380.0,KG동부제철보통주
8265,16380,2016-11-02,0.0472440944881889,12700,12100,-600,13009,16380.0,KG동부제철보통주
8266,16380,2016-10-31,0.044776119402985,13400,12800,-600,10895,16380.0,KG동부제철보통주
8267,16380,2016-10-07,0.0477815699658703,14650,13950,-700,10009,16380.0,KG동부제철보통주
8268,16380,2016-09-19,0.0673076923076923,15600,14550,-1050,41512,16380.0,KG동부제철보통주
8269,16380,2016-08-25,0.0526315789473684,16150,17000,850,208411,16380.0,KG동부제철보통주
8270,16380,2016-08-12,0.0488599348534201,15350,16100,750,13611,16380.0,KG동부제철보통주
8271,17670,2021-04-13,0.0600706713780918,283000,300000,17000,640853,17670.0,SK텔레콤보통주
8272,17670,2021-03-26,0.0808678500986193,253500,274000,20500,1101946,17670.0,SK텔레콤보통주
8273,17670,2021-02-05,0.0465587044534413,247000,258500,11500,744401,17670.0,SK텔레콤보통주
8274,17670,2021-01-07,0.0778443113772455,250500,270000,19500,1358231,17670.0,SK텔레콤보통주
8275,17670,2020-10-14,0.0494845360824742,242500,230500,-12000,860420,17670.0,SK텔레콤보통주
8276,17670,2020-07-01,0.0521327014218009,211000,222000,11000,872553,17670.0,SK텔레콤보통주
8277,17670,2020-04-06,0.040983606557377,183000,190500,7500,417491,17670.0,SK텔레콤보통주
8278,17670,2020-04-02,0.04,175000,182000,7000,458271,17670.0,SK텔레콤보통주
8279,17670,2020-03-23,0.0542857142857142,175000,165500,-9500,341417,17670.0,SK텔레콤보통주
8280,17670,2020-03-18,0.04,187500,180000,-7500,278157,17670.0,SK텔레콤보통주
8281,17670,2020-03-13,0.0685579196217494,211500,197000,-14500,670552,17670.0,SK텔레콤보통주
8282,17670,2020-03-04,0.0603864734299516,207000,219500,12500,353005,17670.0,SK텔레콤보통주
8283,17670,2018-11-16,0.0449438202247191,267000,279000,12000,175679,17670.0,SK텔레콤보통주
8284,17670,2018-10-11,0.0526315789473684,285000,270000,-15000,234179,17670.0,SK텔레콤보통주
8285,17670,2018-06-11,0.0478260869565217,230000,241000,11000,493788,17670.0,SK텔레콤보통주
8286,17670,2018-01-18,0.0431519699812382,266500,278000,11500,289341,17670.0,SK텔레콤보통주
8287,17670,2017-10-10,0.0490196078431372,255000,267500,12500,385055,17670.0,SK텔레콤보통주
8288,17670,2017-09-15,0.0454545454545454,242000,253000,11000,262637,17670.0,SK텔레콤보통주
8289,17670,2017-03-15,0.0488798370672097,245500,257500,12000,436849,17670.0,SK텔레콤보통주
8290,17670,2017-03-08,0.0432900432900432,231000,241000,10000,565790,17670.0,SK텔레콤보통주
8291,17800,2021-06-01,0.0461254612546125,54200,56700,2500,1136357,17800.0,현대엘리베이터보통주
8292,17800,2021-05-07,0.052127659574468,47000,49450,2450,1592058,17800.0,현대엘리베이터보통주
8293,17800,2021-02-16,0.0449943757030371,44450,46450,2000,1122919,17800.0,현대엘리베이터보통주
8294,17800,2021-01-11,0.047457627118644,44250,42150,-2100,1199677,17800.0,현대엘리베이터보통주
8295,17800,2021-01-07,0.0512514898688915,41950,44100,2150,1692915,17800.0,현대엘리베이터보통주
8296,17800,2020-11-04,0.0407894736842105,38000,39550,1550,1070604,17800.0,현대엘리베이터보통주
8297,17800,2020-08-20,0.0574052812858783,43550,41050,-2500,412362,17800.0,현대엘리베이터보통주
8298,17800,2020-08-18,0.0685224839400428,46700,43500,-3200,475007,17800.0,현대엘리베이터보통주
8299,17800,2020-07-03,0.0630816959669079,48350,51400,3050,457887,17800.0,현대엘리베이터보통주
8300,17800,2020-06-19,0.0684931506849315,73000,68000,-5000,2294635,17800.0,현대엘리베이터보통주
8301,17800,2020-06-18,0.2807017543859649,57000,73000,16000,5583799,17800.0,현대엘리베이터보통주
8302,17800,2020-06-16,0.086080586080586,54600,59300,4700,274620,17800.0,현대엘리베이터보통주
8303,17800,2020-06-15,0.0975206611570247,60500,54600,-5900,457743,17800.0,현대엘리베이터보통주
8304,17800,2020-04-21,0.0469696969696969,66000,62900,-3100,1931381,17800.0,현대엘리베이터보통주
8305,17800,2020-04-16,0.0693069306930693,60600,64800,4200,1149875,17800.0,현대엘리베이터보통주
8306,17800,2020-04-01,0.0507880910683012,57100,54200,-2900,477452,17800.0,현대엘리베이터보통주
8307,17800,2020-03-31,0.0917782026768642,52300,57100,4800,1559841,17800.0,현대엘리베이터보통주
8308,17800,2020-03-27,0.0528455284552845,49200,51800,2600,403031,17800.0,현대엘리베이터보통주
8309,17800,2020-03-25,0.0431499460625674,46350,48350,2000,409765,17800.0,현대엘리베이터보통주
8310,17800,2020-03-24,0.1182147165259348,41450,46350,4900,378727,17800.0,현대엘리베이터보통주
8311,17800,2020-03-20,0.1072902338376891,36350,40250,3900,531140,17800.0,현대엘리베이터보통주
8312,17800,2020-03-19,0.1681922196796338,43700,36350,-7350,721864,17800.0,현대엘리베이터보통주
8313,17800,2020-03-13,0.087378640776699,51500,47000,-4500,817976,17800.0,현대엘리베이터보통주
8314,17800,2020-03-12,0.0703971119133574,55400,51500,-3900,502084,17800.0,현대엘리베이터보통주
8315,17800,2020-02-25,0.0595009596928982,52100,55200,3100,429127,17800.0,현대엘리베이터보통주
8316,17800,2020-02-24,0.0729537366548042,56200,52100,-4100,516063,17800.0,현대엘리베이터보통주
8317,17800,2020-01-28,0.0643274853801169,68400,64000,-4400,360297,17800.0,현대엘리베이터보통주
8318,17800,2020-01-13,0.0541353383458646,66500,70100,3600,615219,17800.0,현대엘리베이터보통주
8319,17800,2020-01-09,0.0709677419354838,62000,66400,4400,360961,17800.0,현대엘리베이터보통주
8320,17800,2020-01-08,0.0534351145038167,65500,62000,-3500,407894,17800.0,현대엘리베이터보통주
8321,17800,2019-10-23,0.0746268656716417,80400,74400,-6000,1197886,17800.0,현대엘리베이터보통주
8322,17800,2019-10-07,0.1103526734926052,87900,78200,-9700,913837,17800.0,현대엘리베이터보통주
8323,17800,2019-09-25,0.0569892473118279,93000,87700,-5300,560111,17800.0,현대엘리베이터보통주
8324,17800,2019-09-16,0.0445205479452054,87600,91500,3900,603595,17800.0,현대엘리베이터보통주
8325,17800,2019-09-10,0.0853503184713375,78500,85200,6700,628960,17800.0,현대엘리베이터보통주
8326,17800,2019-08-19,0.0430247718383311,76700,80000,3300,364351,17800.0,현대엘리베이터보통주
8327,17800,2019-08-05,0.0877419354838709,77500,70700,-6800,506403,17800.0,현대엘리베이터보통주
8328,17800,2019-07-29,0.0465116279069767,81700,77900,-3800,340237,17800.0,현대엘리베이터보통주
8329,17800,2019-07-11,0.0734055354993983,83100,89200,6100,520856,17800.0,현대엘리베이터보통주
8330,17800,2019-07-09,0.0416184971098265,86500,82900,-3600,458641,17800.0,현대엘리베이터보통주
8331,17800,2019-07-08,0.0718884120171673,93200,86500,-6700,588792,17800.0,현대엘리베이터보통주
8332,17800,2019-07-03,0.0509355509355509,96200,91300,-4900,621927,17800.0,현대엘리베이터보통주
8333,17800,2019-07-01,0.0848952590959206,90700,98400,7700,1401054,17800.0,현대엘리베이터보통주
8334,17800,2019-06-19,0.0436241610738255,89400,93300,3900,453512,17800.0,현대엘리베이터보통주
8335,17800,2019-06-10,0.050179211469534,83700,87900,4200,422009,17800.0,현대엘리베이터보통주
8336,17800,2019-05-17,0.0414572864321608,79600,82900,3300,453254,17800.0,현대엘리베이터보통주
8337,17800,2019-03-29,0.1050679851668726,80900,89400,8500,1813826,17800.0,현대엘리베이터보통주
8338,17800,2019-03-18,0.053639846743295,78300,82500,4200,683262,17800.0,현대엘리베이터보통주
8339,17800,2019-03-15,0.0689655172413793,84100,78300,-5800,1741611,17800.0,현대엘리베이터보통주
8340,17800,2019-03-06,0.0464088397790055,90500,86300,-4200,1312794,17800.0,현대엘리베이터보통주
8341,17800,2019-03-04,0.0535152151101783,95300,90200,-5100,2516424,17800.0,현대엘리베이터보통주
8342,17800,2019-02-28,0.1854700854700854,117000,95300,-21700,2931794,17800.0,현대엘리베이터보통주
8343,17800,2019-02-25,0.0625,120000,112500,-7500,1669520,17800.0,현대엘리베이터보통주
8344,17800,2019-02-21,0.0408163265306122,122500,117500,-5000,940891,17800.0,현대엘리베이터보통주
8345,17800,2019-02-01,0.0675675675675675,111000,118500,7500,1016758,17800.0,현대엘리베이터보통주
8346,17800,2019-01-29,0.0521739130434782,115000,109000,-6000,780313,17800.0,현대엘리베이터보통주
8347,17800,2019-01-14,0.0480349344978165,114500,120000,5500,1071630,17800.0,현대엘리베이터보통주
8348,17800,2019-01-11,0.045662100456621,109500,114500,5000,819900,17800.0,현대엘리베이터보통주
8349,17800,2018-12-27,0.0696008188331627,97700,104500,6800,1147423,17800.0,현대엘리베이터보통주
8350,17800,2018-12-26,0.0560386473429951,103500,97700,-5800,1088673,17800.0,현대엘리베이터보통주
8351,17800,2018-12-20,0.064034151547492,93700,99700,6000,910460,17800.0,현대엘리베이터보통주
8352,17800,2018-12-17,0.0505154639175257,97000,92100,-4900,716082,17800.0,현대엘리베이터보통주
8353,17800,2018-12-12,0.0422960725075528,99300,95100,-4200,874160,17800.0,현대엘리베이터보통주
8354,17800,2018-12-10,0.0521327014218009,105500,100000,-5500,941954,17800.0,현대엘리베이터보통주
8355,17800,2018-12-03,0.0629669156883671,93700,99600,5900,1021304,17800.0,현대엘리베이터보통주
8356,17800,2018-11-19,0.0578420467185761,89900,95100,5200,917813,17800.0,현대엘리베이터보통주
8357,17800,2018-11-15,0.0929951690821256,82800,90500,7700,958346,17800.0,현대엘리베이터보통주
8358,17800,2018-11-08,0.0449574726609963,82300,86000,3700,793373,17800.0,현대엘리베이터보통주
8359,17800,2018-11-07,0.0783874580067189,89300,82300,-7000,2065398,17800.0,현대엘리베이터보통주
8360,17800,2018-11-02,0.0898203592814371,83500,91000,7500,739981,17800.0,현대엘리베이터보통주
8361,17800,2018-11-01,0.0476787954830614,79700,83500,3800,610390,17800.0,현대엘리베이터보통주
8362,17800,2018-10-30,0.0799475753604194,76300,82400,6100,1048517,17800.0,현대엘리베이터보통주
8363,17800,2018-10-29,0.0740291262135922,82400,76300,-6100,819090,17800.0,현대엘리베이터보통주
8364,17800,2018-10-26,0.0429732868757259,86100,82400,-3700,685808,17800.0,현대엘리베이터보통주
8365,17800,2018-10-24,0.048087431693989,91500,87100,-4400,834021,17800.0,현대엘리베이터보통주
8366,17800,2018-10-22,0.073170731707317,102500,95000,-7500,894028,17800.0,현대엘리베이터보통주
8367,17800,2018-10-15,0.0545454545454545,99000,93600,-5400,1195279,17800.0,현대엘리베이터보통주
8368,17800,2018-10-12,0.0454065469904963,94700,99000,4300,1135781,17800.0,현대엘리베이터보통주
8369,17800,2018-10-11,0.0805825242718446,103000,94700,-8300,2124497,17800.0,현대엘리베이터보통주
8370,17800,2018-10-10,0.1792828685258964,125500,103000,-22500,2307574,17800.0,현대엘리베이터보통주
8371,17800,2018-10-04,0.1048034934497816,114500,126500,12000,1656604,17800.0,현대엘리베이터보통주
8372,17800,2018-09-21,0.1162790697674418,107500,120000,12500,2268709,17800.0,현대엘리베이터보통주
8373,17800,2018-09-19,0.0704845814977973,113500,105500,-8000,2004320,17800.0,현대엘리베이터보통주
8374,17800,2018-09-10,0.0825242718446602,103000,111500,8500,1108621,17800.0,현대엘리베이터보통주
8375,17800,2018-09-07,0.1016042780748663,93500,103000,9500,1230105,17800.0,현대엘리베이터보통주
8376,17800,2018-08-27,0.1182692307692307,104000,91700,-12300,1832149,17800.0,현대엘리베이터보통주
8377,17800,2018-08-14,0.0518134715025906,96500,101500,5000,958500,17800.0,현대엘리베이터보통주
8378,17800,2018-08-13,0.0539215686274509,102000,96500,-5500,1346799,17800.0,현대엘리베이터보통주
8379,17800,2018-08-10,0.0851063829787234,94000,102000,8000,1464303,17800.0,현대엘리베이터보통주
8380,17800,2018-07-31,0.040084388185654,94800,91000,-3800,1020919,17800.0,현대엘리베이터보통주
8381,17800,2018-07-26,0.0745192307692307,83200,89400,6200,1159961,17800.0,현대엘리베이터보통주
8382,17800,2018-07-24,0.121418826739427,73300,82200,8900,1827285,17800.0,현대엘리베이터보통주
8383,17800,2018-07-23,0.0492866407263294,77100,73300,-3800,493644,17800.0,현대엘리베이터보통주
8384,17800,2018-07-18,0.0508054522924411,80700,76600,-4100,561368,17800.0,현대엘리베이터보통주
8385,17800,2018-07-13,0.044080604534005,79400,82900,3500,681129,17800.0,현대엘리베이터보통주
8386,17800,2018-07-11,0.0490716180371352,75400,79100,3700,939180,17800.0,현대엘리베이터보통주
8387,17800,2018-07-09,0.1318289786223277,84200,73100,-11100,1533986,17800.0,현대엘리베이터보통주
8388,17800,2018-07-06,0.0564617314930991,79700,84200,4500,906705,17800.0,현대엘리베이터보통주
8389,17800,2018-07-05,0.048926014319809,83800,79700,-4100,1070288,17800.0,현대엘리베이터보통주
8390,17800,2018-07-02,0.0825892857142857,89600,82200,-7400,962950,17800.0,현대엘리베이터보통주
8391,17800,2018-06-29,0.0491803278688524,85400,89600,4200,1115807,17800.0,현대엘리베이터보통주
8392,17800,2018-06-28,0.0511111111111111,90000,85400,-4600,1097918,17800.0,현대엘리베이터보통주
8393,17800,2018-06-26,0.0841584158415841,101000,92500,-8500,1199742,17800.0,현대엘리베이터보통주
8394,17800,2018-06-19,0.045662100456621,109500,104500,-5000,743195,17800.0,현대엘리베이터보통주
8395,17800,2018-06-14,0.1422594142259414,119500,102500,-17000,2285482,17800.0,현대엘리베이터보통주
8396,17800,2018-06-11,0.0643776824034334,116500,124000,7500,1249508,17800.0,현대엘리베이터보통주
8397,17800,2018-06-08,0.0489795918367346,122500,116500,-6000,1227743,17800.0,현대엘리베이터보통주
8398,17800,2018-06-01,0.0636704119850187,133500,125000,-8500,2042739,17800.0,현대엘리베이터보통주
8399,17800,2018-05-30,0.1266375545851528,114500,129000,14500,3873218,17800.0,현대엘리베이터보통주
8400,17800,2018-05-28,0.2945914844649022,86900,112500,25600,2883716,17800.0,현대엘리베이터보통주
8401,17800,2018-05-25,0.1684210526315789,104500,86900,-17600,4512494,17800.0,현대엘리베이터보통주
8402,17800,2018-05-17,0.0414746543778801,108500,104000,-4500,2664794,17800.0,현대엘리베이터보통주
8403,17800,2018-05-16,0.1033057851239669,121000,108500,-12500,3197960,17800.0,현대엘리베이터보통주
8404,17800,2018-05-15,0.056768558951965,114500,121000,6500,1694259,17800.0,현대엘리베이터보통주
8405,17800,2018-05-11,0.0469483568075117,106500,111500,5000,2048831,17800.0,현대엘리베이터보통주
8406,17800,2018-05-09,0.1139630390143737,97400,108500,11100,2098580,17800.0,현대엘리베이터보통주
8407,17800,2018-05-04,0.0811688311688311,92400,99900,7500,1151534,17800.0,현대엘리베이터보통주
8408,17800,2018-05-03,0.0704225352112676,99400,92400,-7000,1066672,17800.0,현대엘리베이터보통주
8409,17800,2018-05-02,0.0442307692307692,104000,99400,-4600,1787574,17800.0,현대엘리베이터보통주
8410,17800,2018-04-30,0.1075612353567625,93900,104000,10100,2937539,17800.0,현대엘리베이터보통주
8411,17800,2018-04-23,0.0475728155339805,103000,98100,-4900,2192213,17800.0,현대엘리베이터보통주
8412,17800,2018-04-19,0.16331096196868,89400,104000,14600,3455161,17800.0,현대엘리베이터보통주
8413,17800,2018-04-18,0.0530035335689045,84900,89400,4500,1272875,17800.0,현대엘리베이터보통주
8414,17800,2018-04-13,0.0482398956975228,76700,80400,3700,834721,17800.0,현대엘리베이터보통주
8415,17800,2018-03-20,0.050887573964497,84500,80200,-4300,795582,17800.0,현대엘리베이터보통주
8416,17800,2018-03-19,0.1311914323962516,74700,84500,9800,1766991,17800.0,현대엘리베이터보통주
8417,17800,2018-03-09,0.2262090483619344,64100,78600,14500,3150138,17800.0,현대엘리베이터보통주
8418,17800,2018-03-07,0.0944055944055944,57200,62600,5400,1585083,17800.0,현대엘리베이터보통주
8419,17800,2018-02-13,0.0456942003514938,56900,59500,2600,161112,17800.0,현대엘리베이터보통주
8420,17800,2018-01-25,0.0801393728222996,57400,62000,4600,678319,17800.0,현대엘리베이터보통주
8421,17800,2017-09-26,0.0519911504424778,45200,47550,2350,146903,17800.0,현대엘리베이터보통주
8422,17800,2017-09-25,0.0641821946169772,48300,45200,-3100,203058,17800.0,현대엘리베이터보통주
8423,17800,2017-07-31,0.0529100529100529,56700,53700,-3000,324167,17800.0,현대엘리베이터보통주
8424,17800,2017-05-16,0.0479876160990712,64600,61500,-3100,352318,17800.0,현대엘리베이터보통주
8425,17800,2017-05-04,0.045016077170418,62200,65000,2800,249854,17800.0,현대엘리베이터보통주
8426,17800,2017-04-26,0.043261231281198,60100,62700,2600,324180,17800.0,현대엘리베이터보통주
8427,17800,2017-03-24,0.0404721753794266,59300,61700,2400,460861,17800.0,현대엘리베이터보통주
8428,17800,2017-02-10,0.043859649122807,57000,59500,2500,300322,17800.0,현대엘리베이터보통주
8429,17800,2017-02-03,0.0419463087248322,59600,57100,-2500,120240,17800.0,현대엘리베이터보통주
8430,17800,2016-12-29,0.0850661625708884,52900,57400,4500,489098,17800.0,현대엘리베이터보통주
8431,17800,2016-12-26,0.0434782608695652,55200,52800,-2400,266629,17800.0,현대엘리베이터보통주
8432,17800,2016-11-30,0.0414593698175787,60300,57800,-2500,145899,17800.0,현대엘리베이터보통주
8433,17800,2016-11-10,0.043103448275862,58000,60500,2500,155323,17800.0,현대엘리베이터보통주
8434,17800,2016-11-02,0.0694444444444444,57600,53600,-4000,210798,17800.0,현대엘리베이터보통주
8435,17800,2016-10-31,0.0572390572390572,59400,56000,-3400,208138,17800.0,현대엘리베이터보통주
8436,17800,2016-10-10,0.0417310664605873,64700,67400,2700,99119,17800.0,현대엘리베이터보통주
8437,17800,2016-08-17,0.0511695906432748,68400,71900,3500,393504,17800.0,현대엘리베이터보통주
8438,17800,2016-08-12,0.0787401574803149,63500,68500,5000,460056,17800.0,현대엘리베이터보통주
8439,17800,2016-08-11,0.0618729096989966,59800,63500,3700,326893,17800.0,현대엘리베이터보통주
8440,18260,2021-03-30,0.04,187500,195000,7500,256528,18260.0,삼성에스디에스보통주
8441,18260,2021-02-16,0.0434782608695652,195500,204000,8500,490477,18260.0,삼성에스디에스보통주
8442,18260,2021-01-29,0.0600961538461538,208000,195500,-12500,501538,18260.0,삼성에스디에스보통주
8443,18260,2021-01-27,0.0469135802469135,202500,212000,9500,520549,18260.0,삼성에스디에스보통주
8444,18260,2021-01-11,0.0478359908883826,219500,209000,-10500,1085192,18260.0,삼성에스디에스보통주
8445,18260,2021-01-08,0.0707317073170731,205000,219500,14500,1543681,18260.0,삼성에스디에스보통주
8446,18260,2021-01-06,0.0447058823529411,212500,203000,-9500,1101423,18260.0,삼성에스디에스보통주
8447,18260,2021-01-05,0.1424731182795699,186000,212500,26500,1688082,18260.0,삼성에스디에스보통주
8448,18260,2021-01-04,0.042016806722689,178500,186000,7500,542371,18260.0,삼성에스디에스보통주
8449,18260,2020-10-26,0.0550724637681159,172500,182000,9500,1128886,18260.0,삼성에스디에스보통주
8450,18260,2020-09-22,0.0535211267605633,177500,168000,-9500,216101,18260.0,삼성에스디에스보통주
8451,18260,2020-09-09,0.0662650602409638,166000,177000,11000,952329,18260.0,삼성에스디에스보통주
8452,18260,2020-09-08,0.0473186119873817,158500,166000,7500,496328,18260.0,삼성에스디에스보통주
8453,18260,2020-08-20,0.0421686746987951,166000,159000,-7000,198717,18260.0,삼성에스디에스보통주
8454,18260,2020-08-12,0.0422960725075528,165500,172500,7000,291858,18260.0,삼성에스디에스보통주
8455,18260,2020-06-16,0.0648967551622418,169500,180500,11000,194884,18260.0,삼성에스디에스보통주
8456,18260,2020-06-15,0.053072625698324,179000,169500,-9500,258685,18260.0,삼성에스디에스보통주
8457,18260,2020-05-25,0.0659025787965616,174500,186000,11500,396017,18260.0,삼성에스디에스보통주
8458,18260,2020-05-07,0.0925925925925925,162000,177000,15000,742642,18260.0,삼성에스디에스보통주
8459,18260,2020-04-06,0.0692041522491349,144500,154500,10000,261338,18260.0,삼성에스디에스보통주
8460,18260,2020-04-01,0.0568561872909698,149500,141000,-8500,181130,18260.0,삼성에스디에스보통주
8461,18260,2020-03-24,0.0656934306569343,137000,146000,9000,201754,18260.0,삼성에스디에스보통주
8462,18260,2020-03-23,0.0551724137931034,145000,137000,-8000,196608,18260.0,삼성에스디에스보통주
8463,18260,2020-03-20,0.0431654676258992,139000,145000,6000,243413,18260.0,삼성에스디에스보통주
8464,18260,2020-03-12,0.051051051051051,166500,158000,-8500,281229,18260.0,삼성에스디에스보통주
8465,18260,2020-03-09,0.0505617977528089,178000,169000,-9000,192115,18260.0,삼성에스디에스보통주
8466,18260,2020-03-04,0.0589970501474926,169500,179500,10000,217843,18260.0,삼성에스디에스보통주
8467,18260,2020-02-24,0.0496083550913838,191500,182000,-9500,177689,18260.0,삼성에스디에스보통주
8468,18260,2020-01-28,0.048780487804878,205000,195000,-10000,130785,18260.0,삼성에스디에스보통주
8469,18260,2019-08-05,0.0454545454545454,209000,199500,-9500,112592,18260.0,삼성에스디에스보통주
8470,18260,2019-05-09,0.0517647058823529,212500,201500,-11000,169929,18260.0,삼성에스디에스보통주
8471,18260,2019-01-11,0.0414634146341463,205000,213500,8500,158863,18260.0,삼성에스디에스보통주
8472,18260,2018-11-29,0.0727762803234501,185500,199000,13500,259842,18260.0,삼성에스디에스보통주
8473,18260,2018-11-02,0.0509383378016085,186500,196000,9500,104764,18260.0,삼성에스디에스보통주
8474,18260,2018-10-26,0.0643564356435643,202000,189000,-13000,219034,18260.0,삼성에스디에스보통주
8475,18260,2018-08-08,0.0582750582750582,214500,227000,12500,353202,18260.0,삼성에스디에스보통주
8476,18260,2018-07-09,0.041343669250646,193500,201500,8000,140713,18260.0,삼성에스디에스보통주
8477,18260,2018-06-19,0.0537084398976982,195500,206000,10500,384185,18260.0,삼성에스디에스보통주
8478,18260,2018-06-15,0.1400437636761488,228500,196500,-32000,897131,18260.0,삼성에스디에스보통주
8479,18260,2018-06-01,0.0616113744075829,211000,224000,13000,145063,18260.0,삼성에스디에스보통주
8480,18260,2018-05-09,0.0479616306954436,208500,218500,10000,191035,18260.0,삼성에스디에스보통주
8481,18260,2018-05-08,0.045766590389016,218500,208500,-10000,265570,18260.0,삼성에스디에스보통주
8482,18260,2018-05-04,0.0662393162393162,234000,218500,-15500,246681,18260.0,삼성에스디에스보통주
8483,18260,2018-05-02,0.0591836734693877,245000,230500,-14500,236708,18260.0,삼성에스디에스보통주
8484,18260,2018-04-20,0.054229934924078,230500,243000,12500,230598,18260.0,삼성에스디에스보통주
8485,18260,2018-03-08,0.040169133192389,236500,246000,9500,202467,18260.0,삼성에스디에스보통주
8486,18260,2018-02-23,0.0479166666666666,240000,251500,11500,242628,18260.0,삼성에스디에스보통주
8487,18260,2018-01-23,0.0451745379876796,243500,254500,11000,251627,18260.0,삼성에스디에스보통주
8488,18260,2018-01-22,0.043222003929273,254500,243500,-11000,330445,18260.0,삼성에스디에스보통주
8489,18260,2018-01-17,0.0434782608695652,253000,264000,11000,580449,18260.0,삼성에스디에스보통주
8490,18260,2018-01-08,0.092511013215859,227000,248000,21000,686437,18260.0,삼성에스디에스보통주
8491,18260,2018-01-04,0.0982800982800982,203500,223500,20000,671048,18260.0,삼성에스디에스보통주
8492,18260,2017-12-21,0.0461165048543689,206000,196500,-9500,145387,18260.0,삼성에스디에스보통주
8493,18260,2017-11-30,0.0456852791878172,197000,188000,-9000,188701,18260.0,삼성에스디에스보통주
8494,18260,2017-10-30,0.0642673521850899,194500,207000,12500,332607,18260.0,삼성에스디에스보통주
8495,18260,2017-10-20,0.0454545454545454,187000,195500,8500,307816,18260.0,삼성에스디에스보통주
8496,18260,2017-10-11,0.0410557184750733,170500,177500,7000,204116,18260.0,삼성에스디에스보통주
8497,18260,2017-07-26,0.0894736842105263,190000,173000,-17000,521931,18260.0,삼성에스디에스보통주
8498,18260,2017-07-17,0.0410958904109589,182500,190000,7500,215559,18260.0,삼성에스디에스보통주
8499,18260,2017-06-26,0.057471264367816,174000,184000,10000,500035,18260.0,삼성에스디에스보통주
8500,18260,2017-06-22,0.0434782608695652,161000,168000,7000,213951,18260.0,삼성에스디에스보통주
8501,18260,2017-06-12,0.0403458213256484,173500,166500,-7000,152538,18260.0,삼성에스디에스보통주
8502,18260,2017-05-19,0.0506756756756756,148000,155500,7500,303009,18260.0,삼성에스디에스보통주
8503,18260,2017-04-27,0.0648464163822525,146500,137000,-9500,498807,18260.0,삼성에스디에스보통주
8504,18260,2017-03-24,0.0847457627118644,147500,135000,-12500,486742,18260.0,삼성에스디에스보통주
8505,18260,2017-03-14,0.0509803921568627,127500,134000,6500,359686,18260.0,삼성에스디에스보통주
8506,18260,2016-12-21,0.0568181818181818,132000,139500,7500,227943,18260.0,삼성에스디에스보통주
8507,18260,2016-11-24,0.0421052631578947,142500,136500,-6000,159533,18260.0,삼성에스디에스보통주
8508,18260,2016-10-05,0.076158940397351,151000,162500,11500,232836,18260.0,삼성에스디에스보통주
8509,18260,2016-09-29,0.0899653979238754,144500,157500,13000,274077,18260.0,삼성에스디에스보통주
8510,18260,2016-08-04,0.0440251572327044,159000,166000,7000,197768,18260.0,삼성에스디에스보통주
8511,18880,2021-04-21,0.0414364640883977,18100,17350,-750,1793444,18880.0,한온시스템보통주
8512,18880,2021-03-29,0.04,18750,18000,-750,1638484,18880.0,한온시스템보통주
8513,18880,2021-03-26,0.0683760683760683,17550,18750,1200,6069802,18880.0,한온시스템보통주
8514,18880,2021-03-22,0.0571428571428571,17500,18500,1000,9910868,18880.0,한온시스템보통주
8515,18880,2021-03-11,0.0646153846153846,16250,17300,1050,1959396,18880.0,한온시스템보통주
8516,18880,2021-03-02,0.1197411003236245,15450,17300,1850,7906802,18880.0,한온시스템보통주
8517,18880,2021-02-26,0.0403726708074534,16100,15450,-650,1746909,18880.0,한온시스템보통주
8518,18880,2021-02-24,0.0426829268292682,16400,15700,-700,1907399,18880.0,한온시스템보통주
8519,18880,2021-02-03,0.053072625698324,17900,18850,950,2654476,18880.0,한온시스템보통주
8520,18880,2021-02-01,0.0538922155688622,16700,17600,900,1346258,18880.0,한온시스템보통주
8521,18880,2021-01-29,0.0670391061452514,17900,16700,-1200,1891019,18880.0,한온시스템보통주
8522,18880,2021-01-11,0.046070460704607,18450,17600,-850,5087049,18880.0,한온시스템보통주
8523,18880,2021-01-08,0.128440366972477,16350,18450,2100,14542365,18880.0,한온시스템보통주
8524,18880,2020-12-23,0.0555555555555555,15300,16150,850,6344971,18880.0,한온시스템보통주
8525,18880,2020-12-09,0.0447284345047923,15650,16350,700,1449354,18880.0,한온시스템보통주
8526,18880,2020-12-04,0.0483383685800604,16550,15750,-800,2453853,18880.0,한온시스템보통주
8527,18880,2020-12-01,0.0930232558139534,15050,16450,1400,6908505,18880.0,한온시스템보통주
8528,18880,2020-11-19,0.1439114391143911,13550,15500,1950,14470064,18880.0,한온시스템보통주
8529,18880,2020-11-11,0.0717131474103585,12550,13450,900,3400160,18880.0,한온시스템보통주
8530,18880,2020-10-30,0.0468085106382978,11750,11200,-550,985190,18880.0,한온시스템보통주
8531,18880,2020-10-05,0.0404858299595141,12350,12850,500,1961813,18880.0,한온시스템보통주
8532,18880,2020-09-22,0.0719696969696969,13200,12250,-950,2444827,18880.0,한온시스템보통주
8533,18880,2020-09-21,0.0434782608695652,12650,13200,550,4218262,18880.0,한온시스템보통주
8534,18880,2020-09-18,0.0594795539033457,13450,12650,-800,2688406,18880.0,한온시스템보통주
8535,18880,2020-09-17,0.0674603174603174,12600,13450,850,6616191,18880.0,한온시스템보통주
8536,18880,2020-08-24,0.0719424460431654,13900,12900,-1000,2691768,18880.0,한온시스템보통주
8537,18880,2020-08-21,0.1031746031746031,12600,13900,1300,5206182,18880.0,한온시스템보통주
8538,18880,2020-08-19,0.0481927710843373,12450,13050,600,2656469,18880.0,한온시스템보통주
8539,18880,2020-08-18,0.0423076923076923,13000,12450,-550,2234228,18880.0,한온시스템보통주
8540,18880,2020-08-13,0.0625,12000,12750,750,16273756,18880.0,한온시스템보통주
8541,18880,2020-08-12,0.1009174311926605,10900,12000,1100,22226342,18880.0,한온시스템보통주
8542,18880,2020-08-10,0.0426540284360189,10550,11000,450,2420751,18880.0,한온시스템보통주
8543,18880,2020-07-30,0.056782334384858,9510,10050,540,2627301,18880.0,한온시스템보통주
8544,18880,2020-07-27,0.04052573932092,9130,9500,370,1641089,18880.0,한온시스템보통주
8545,18880,2020-07-10,0.044776119402985,10050,9600,-450,1087812,18880.0,한온시스템보통주
8546,18880,2020-06-16,0.0668789808917197,9420,10050,630,1141655,18880.0,한온시스템보통주
8547,18880,2020-06-15,0.0764705882352941,10200,9420,-780,1325247,18880.0,한온시스템보통주
8548,18880,2020-06-12,0.0467289719626168,10700,10200,-500,1653938,18880.0,한온시스템보통주
8549,18880,2020-05-29,0.0691547749725576,9110,9740,630,3099166,18880.0,한온시스템보통주
8550,18880,2020-04-07,0.0490867579908675,8760,9190,430,1545811,18880.0,한온시스템보통주
8551,18880,2020-04-06,0.0618181818181818,8250,8760,510,1155301,18880.0,한온시스템보통주
8552,18880,2020-04-01,0.040586245772266,8870,8510,-360,1577583,18880.0,한온시스템보통주
8553,18880,2020-03-26,0.0422077922077922,9240,8850,-390,1775609,18880.0,한온시스템보통주
8554,18880,2020-03-24,0.0442374854481955,8590,8970,380,1465510,18880.0,한온시스템보통주
8555,18880,2020-03-23,0.0783261802575107,9320,8590,-730,1377405,18880.0,한온시스템보통주
8556,18880,2020-03-18,0.0630914826498422,9510,8910,-600,1534667,18880.0,한온시스템보통주
8557,18880,2020-03-16,0.0402173913043478,9200,9570,370,1550192,18880.0,한온시스템보통주
8558,18880,2020-03-12,0.0914285714285714,10500,9540,-960,2159971,18880.0,한온시스템보통주
8559,18880,2020-02-24,0.0458715596330275,10900,10400,-500,935132,18880.0,한온시스템보통주
8560,18880,2020-02-11,0.0465116279069767,10750,11250,500,1721541,18880.0,한온시스템보통주
8561,18880,2019-07-17,0.056768558951965,11450,12100,650,2067404,18880.0,한온시스템보통주
8562,18880,2019-06-26,0.0408163265306122,12250,11750,-500,950888,18880.0,한온시스템보통주
8563,18880,2019-06-10,0.0432900432900432,11550,12050,500,683434,18880.0,한온시스템보통주
8564,18880,2019-05-27,0.0440528634361233,11350,11850,500,821774,18880.0,한온시스템보통주
8565,18880,2019-05-21,0.0440528634361233,11350,10850,-500,1348362,18880.0,한온시스템보통주
8566,18880,2019-05-09,0.0413223140495867,12100,11600,-500,1074428,18880.0,한온시스템보통주
8567,18880,2019-04-29,0.0452674897119341,12150,12700,550,1005969,18880.0,한온시스템보통주
8568,18880,2019-04-17,0.0462184873949579,11900,12450,550,1598418,18880.0,한온시스템보통주
8569,18880,2019-01-23,0.040983606557377,12200,12700,500,1531311,18880.0,한온시스템보통주
8570,18880,2019-01-18,0.0627615062761506,11950,12700,750,3209379,18880.0,한온시스템보통주
8571,18880,2019-01-15,0.0486725663716814,11300,11850,550,1911623,18880.0,한온시스템보통주
8572,18880,2019-01-09,0.0523809523809523,10500,11050,550,1843464,18880.0,한온시스템보통주
8573,18880,2019-01-08,0.0497737556561085,11050,10500,-550,981257,18880.0,한온시스템보통주
8574,18880,2019-01-04,0.0471698113207547,10600,11100,500,1193747,18880.0,한온시스템보통주
8575,18880,2018-12-21,0.0448430493273542,11150,10650,-500,1541442,18880.0,한온시스템보통주
8576,18880,2018-12-19,0.0467289719626168,10700,11200,500,2087257,18880.0,한온시스템보통주
8577,18880,2018-12-12,0.0450819672131147,9760,10200,440,1381726,18880.0,한온시스템보통주
8578,18880,2018-12-05,0.0666666666666666,10650,9940,-710,3719500,18880.0,한온시스템보통주
8579,18880,2018-11-22,0.0509259259259259,10800,10250,-550,1310932,18880.0,한온시스템보통주
8580,18880,2018-11-13,0.0536585365853658,10250,10800,550,2424092,18880.0,한온시스템보통주
8581,18880,2018-11-12,0.0509259259259259,10800,10250,-550,962540,18880.0,한온시스템보통주
8582,18880,2018-10-29,0.0420560747663551,10700,10250,-450,1032145,18880.0,한온시스템보통주
8583,18880,2018-10-23,0.0677966101694915,11800,11000,-800,1478116,18880.0,한온시스템보통주
8584,18880,2018-10-10,0.0441767068273092,12450,11900,-550,1867244,18880.0,한온시스템보통주
8585,18880,2018-09-27,0.060377358490566,13250,12450,-800,2204708,18880.0,한온시스템보통주
8586,18880,2018-09-21,0.0474308300395256,12650,13250,600,4909947,18880.0,한온시스템보통주
8587,18880,2018-09-18,0.0595744680851063,11750,12450,700,1038622,18880.0,한온시스템보통주
8588,18880,2018-08-10,0.054054054054054,11100,11700,600,1839634,18880.0,한온시스템보통주
8589,18880,2018-07-13,0.058252427184466,10300,10900,600,1079626,18880.0,한온시스템보통주
8590,18880,2018-07-05,0.0502049180327868,9760,10250,490,1800109,18880.0,한온시스템보통주
8591,18880,2018-07-04,0.0570048309178743,10350,9760,-590,2538915,18880.0,한온시스템보통주
8592,18880,2018-06-04,0.0985221674876847,10150,11150,1000,2186728,18880.0,한온시스템보통주
8593,18880,2018-05-23,0.0691244239631336,10850,10100,-750,3284937,18880.0,한온시스템보통주
8594,18880,2018-05-17,0.0542986425339366,11050,11650,600,1360776,18880.0,한온시스템보통주
8595,18880,2018-04-25,0.0515021459227467,11650,11050,-600,1139547,18880.0,한온시스템보통주
8596,18880,2018-04-06,0.0517241379310344,11600,11000,-600,1446068,18880.0,한온시스템보통주
8597,18880,2018-03-07,0.056910569105691,12300,11600,-700,1447896,18880.0,한온시스템보통주
8598,18880,2018-02-23,0.040983606557377,12200,12700,500,783586,18880.0,한온시스템보통주
8599,18880,2018-02-12,0.0546875,12800,12100,-700,1944076,18880.0,한온시스템보통주
8600,18880,2018-01-16,0.0448979591836734,12250,12800,550,1300719,18880.0,한온시스템보통주
8601,18880,2017-12-19,0.057347670250896,13950,13150,-800,1641619,18880.0,한온시스템보통주
8602,18880,2017-12-18,0.0449438202247191,13350,13950,600,1308877,18880.0,한온시스템보통주
8603,18880,2017-12-01,0.0416666666666666,13200,13750,550,1189243,18880.0,한온시스템보통주
8604,18880,2017-11-24,0.0559701492537313,13400,14150,750,1969513,18880.0,한온시스템보통주
8605,18880,2017-11-22,0.046692607003891,12850,13450,600,1819482,18880.0,한온시스템보통주
8606,18880,2017-11-09,0.052,12500,13150,650,2084467,18880.0,한온시스템보통주
8607,18880,2017-10-24,0.0859106529209622,14550,13300,-1250,3940166,18880.0,한온시스템보통주
8608,18880,2017-10-23,0.0698529411764705,13600,14550,950,3329782,18880.0,한온시스템보통주
8609,18880,2017-10-18,0.0590551181102362,12700,13450,750,2086732,18880.0,한온시스템보통주
8610,18880,2017-10-11,0.0570342205323193,13150,12400,-750,2542884,18880.0,한온시스템보통주
8611,18880,2017-10-10,0.0436507936507936,12600,13150,550,1902485,18880.0,한온시스템보통주
8612,18880,2017-09-25,0.0576131687242798,12150,12850,700,2587056,18880.0,한온시스템보통주
8613,18880,2017-09-15,0.0448979591836734,12250,12800,550,2499102,18880.0,한온시스템보통주
8614,18880,2017-09-12,0.0478260869565217,11500,12050,550,2586020,18880.0,한온시스템보통주
8615,18880,2017-09-11,0.0502283105022831,10950,11500,550,2645258,18880.0,한온시스템보통주
8616,18880,2017-08-24,0.0519480519480519,11550,12150,600,4638415,18880.0,한온시스템보통주
8617,18880,2017-08-18,0.091743119266055,10900,11900,1000,5134820,18880.0,한온시스템보통주
8618,18880,2017-08-07,0.0582959641255605,11150,10500,-650,1659050,18880.0,한온시스템보통주
8619,18880,2017-08-03,0.0469483568075117,10650,11150,500,2478188,18880.0,한온시스템보통주
8620,18880,2017-08-02,0.0544554455445544,10100,10650,550,1270831,18880.0,한온시스템보통주
8621,18880,2017-07-31,0.0420560747663551,10700,10250,-450,1047737,18880.0,한온시스템보통주
8622,18880,2017-07-03,0.0533980582524271,10300,10850,550,1051927,18880.0,한온시스템보통주
8623,18880,2017-06-20,0.0524017467248908,11450,10850,-600,1657624,18880.0,한온시스템보통주
8624,18880,2017-06-16,0.0414746543778801,10850,11300,450,3390142,18880.0,한온시스템보통주
8625,18880,2017-06-08,0.0585365853658536,10250,10850,600,1511723,18880.0,한온시스템보통주
8626,18880,2017-05-22,0.042094455852156,9740,10150,410,2009344,18880.0,한온시스템보통주
8627,18880,2017-05-11,0.0416666666666666,9120,9500,380,1996788,18880.0,한온시스템보통주
8628,18880,2017-05-08,0.0457209847596717,8530,8920,390,1500732,18880.0,한온시스템보통주
8629,18880,2017-03-17,0.0429184549356223,9320,9720,400,2964673,18880.0,한온시스템보통주
8630,18880,2017-03-14,0.081081081081081,8510,9200,690,3810584,18880.0,한온시스템보통주
8631,18880,2017-03-03,0.052812858783008,8710,8250,-460,2796654,18880.0,한온시스템보통주
8632,18880,2017-03-02,0.0491266375545851,9160,8710,-450,1935673,18880.0,한온시스템보통주
8633,18880,2017-02-15,0.0539374325782092,9270,8770,-500,2746441,18880.0,한온시스템보통주
8634,18880,2017-01-31,0.0431578947368421,9500,9090,-410,1747981,18880.0,한온시스템보통주
8635,18880,2017-01-13,0.0403726708074534,9660,10050,390,1656368,18880.0,한온시스템보통주
8636,18880,2017-01-10,0.0507462686567164,10050,9540,-510,3311399,18880.0,한온시스템보통주
8637,18880,2016-12-29,0.0456852791878172,9850,10300,450,1248764,18880.0,한온시스템보통주
8638,18880,2016-12-08,0.047008547008547,9360,9800,440,1286112,18880.0,한온시스템보통주
8639,18880,2016-11-10,0.041860465116279,10750,10300,-450,4638720,18880.0,한온시스템보통주
8640,18880,2016-11-09,0.0486725663716814,11300,10750,-550,1610859,18880.0,한온시스템보통주
8641,18880,2016-11-07,0.0412844036697247,10900,11350,450,1148169,18880.0,한온시스템보통주
8642,18880,2016-10-26,0.0425531914893617,11750,11250,-500,807317,18880.0,한온시스템보통주
8643,18880,2016-10-13,0.0416666666666666,12000,11500,-500,1560055,18880.0,한온시스템보통주
8644,18880,2016-10-10,0.0464135021097046,11850,12400,550,829214,18880.0,한온시스템보통주
8645,18880,2016-09-27,0.0766129032258064,12400,13350,950,2115158,18880.0,한온시스템보통주
8646,18880,2016-09-09,0.0436507936507936,12600,12050,-550,1118881,18880.0,한온시스템보통주
8647,18880,2016-09-07,0.0495867768595041,12100,12700,600,2881557,18880.0,한온시스템보통주
8648,18880,2016-08-30,0.0403587443946188,11150,11600,450,880921,18880.0,한온시스템보통주
8649,18880,2016-08-10,0.0444444444444444,11250,11750,500,1736901,18880.0,한온시스템보통주
8650,18880,2016-08-05,0.04,11250,11700,450,1447004,18880.0,한온시스템보통주
8651,19170,2021-05-20,0.0505780346820809,69200,65700,-3500,1443701,19170.0,신풍제약보통주
8652,19170,2021-05-12,0.0410764872521246,70600,67700,-2900,2606220,19170.0,신풍제약보통주
8653,19170,2021-05-11,0.0599201065246338,75100,70600,-4500,3563256,19170.0,신풍제약보통주
8654,19170,2021-05-10,0.1679626749611197,64300,75100,10800,8286373,19170.0,신풍제약보통주
8655,19170,2021-05-06,0.0465116279069767,60200,63000,2800,2363933,19170.0,신풍제약보통주
8656,19170,2021-05-03,0.1217765042979942,69800,61300,-8500,3508651,19170.0,신풍제약보통주
8657,19170,2021-04-30,0.059299191374663,74200,69800,-4400,3267387,19170.0,신풍제약보통주
8658,19170,2021-04-29,0.0725,80000,74200,-5800,2654793,19170.0,신풍제약보통주
8659,19170,2021-04-27,0.1472457627118644,94400,80500,-13900,7166189,19170.0,신풍제약보통주
8660,19170,2021-04-26,0.055055055055055,99900,94400,-5500,1575125,19170.0,신풍제약보통주
8661,19170,2021-04-19,0.1247216035634743,89800,101000,11200,4817452,19170.0,신풍제약보통주
8662,19170,2021-04-05,0.04920049200492,81300,85300,4000,1006960,19170.0,신풍제약보통주
8663,19170,2021-03-31,0.0699453551912568,91500,85100,-6400,2573586,19170.0,신풍제약보통주
8664,19170,2021-03-25,0.0567164179104477,100500,94800,-5700,1999576,19170.0,신풍제약보통주
8665,19170,2021-03-23,0.0833333333333333,114000,104500,-9500,2953578,19170.0,신풍제약보통주
8666,19170,2021-03-19,0.0521327014218009,105500,111000,5500,3816352,19170.0,신풍제약보통주
8667,19170,2021-03-17,0.059090909090909,110000,103500,-6500,2162121,19170.0,신풍제약보통주
8668,19170,2021-03-16,0.1578947368421052,95000,110000,15000,2955453,19170.0,신풍제약보통주
8669,19170,2021-03-05,0.0488888888888888,90000,94400,4400,2573876,19170.0,신풍제약보통주
8670,19170,2021-03-04,0.0425531914893617,94000,90000,-4000,878351,19170.0,신풍제약보통주
8671,19170,2021-03-02,0.08472553699284,83800,90900,7100,3331367,19170.0,신풍제약보통주
8672,19170,2021-02-25,0.06826801517067,79100,84500,5400,1116319,19170.0,신풍제약보통주
8673,19170,2021-02-24,0.0435308343409915,82700,79100,-3600,1231354,19170.0,신풍제약보통주
8674,19170,2021-02-22,0.0531645569620253,79000,83200,4200,3901049,19170.0,신풍제약보통주
8675,19170,2021-02-19,0.0463576158940397,75500,79000,3500,1377883,19170.0,신풍제약보통주
8676,19170,2021-02-15,0.0421455938697318,78300,81600,3300,1413783,19170.0,신풍제약보통주
8677,19170,2021-02-04,0.083986562150056,89300,81800,-7500,1795234,19170.0,신풍제약보통주
8678,19170,2021-02-03,0.0407925407925407,85800,89300,3500,1342443,19170.0,신풍제약보통주
8679,19170,2021-02-01,0.0506172839506172,81000,85100,4100,2689053,19170.0,신풍제약보통주
8680,19170,2021-01-29,0.0678941311852704,86900,81000,-5900,3615085,19170.0,신풍제약보통주
8681,19170,2021-01-26,0.0731462925851703,99800,92500,-7300,1881531,19170.0,신풍제약보통주
8682,19170,2021-01-21,0.0408163265306122,98000,102000,4000,2475707,19170.0,신풍제약보통주
8683,19170,2021-01-19,0.0415841584158415,101000,96800,-4200,5384870,19170.0,신풍제약보통주
8684,19170,2021-01-18,0.1330472103004291,116500,101000,-15500,2863343,19170.0,신풍제약보통주
8685,19170,2021-01-11,0.0874524714828897,131500,120000,-11500,2001170,19170.0,신풍제약보통주
8686,19170,2021-01-07,0.0823045267489712,121500,131500,10000,5279009,19170.0,신풍제약보통주
8687,19170,2020-12-29,0.0711111111111111,112500,120500,8000,3562985,19170.0,신풍제약보통주
8688,19170,2020-12-28,0.0546218487394958,119000,112500,-6500,5033466,19170.0,신풍제약보통주
8689,19170,2020-12-24,0.0484581497797356,113500,119000,5500,10565072,19170.0,신풍제약보통주
8690,19170,2020-12-23,0.0580912863070539,120500,113500,-7000,3154452,19170.0,신풍제약보통주
8691,19170,2020-12-21,0.1806020066889632,149500,122500,-27000,8958344,19170.0,신풍제약보통주
8692,19170,2020-12-15,0.0754716981132075,159000,147000,-12000,3487935,19170.0,신풍제약보통주
8693,19170,2020-12-11,0.1758530183727034,190500,157000,-33500,7420883,19170.0,신풍제약보통주
8694,19170,2020-12-04,0.053072625698324,179000,188500,9500,3616479,19170.0,신풍제약보통주
8695,19170,2020-12-02,0.2326388888888889,144000,177500,33500,10464643,19170.0,신풍제약보통주
8696,19170,2020-12-01,0.0909090909090909,132000,144000,12000,3395342,19170.0,신풍제약보통주
8697,19170,2020-11-26,0.0798319327731092,119000,128500,9500,3357638,19170.0,신풍제약보통주
8698,19170,2020-11-18,0.0436507936507936,126000,120500,-5500,1246035,19170.0,신풍제약보통주
8699,19170,2020-11-13,0.2,105000,126000,21000,10987113,19170.0,신풍제약보통주
8700,19170,2020-11-12,0.1497975708502024,123500,105000,-18500,3541236,19170.0,신풍제약보통주
8701,19170,2020-11-10,0.0410447761194029,134000,128500,-5500,979177,19170.0,신풍제약보통주
8702,19170,2020-11-03,0.0674603174603174,126000,134500,8500,1452688,19170.0,신풍제약보통주
8703,19170,2020-10-27,0.0695970695970696,136500,127000,-9500,2104948,19170.0,신풍제약보통주
8704,19170,2020-10-21,0.0796812749003984,125500,135500,10000,3452509,19170.0,신풍제약보통주
8705,19170,2020-10-19,0.0798319327731092,119000,128500,9500,3029185,19170.0,신풍제약보통주
8706,19170,2020-10-16,0.048,125000,119000,-6000,1106753,19170.0,신풍제약보통주
8707,19170,2020-10-13,0.0823970037453183,133500,122500,-11000,2159439,19170.0,신풍제약보통주
8708,19170,2020-10-12,0.0464285714285714,140000,133500,-6500,1235415,19170.0,신풍제약보통주
8709,19170,2020-10-06,0.0551181102362204,127000,134000,7000,2832451,19170.0,신풍제약보통주
8710,19170,2020-09-29,0.0524344569288389,133500,126500,-7000,3151057,19170.0,신풍제약보통주
8711,19170,2020-09-25,0.0933333333333333,150000,136000,-14000,3873628,19170.0,신풍제약보통주
8712,19170,2020-09-24,0.0909090909090909,165000,150000,-15000,3130738,19170.0,신풍제약보통주
8713,19170,2020-09-22,0.1421188630490956,193500,166000,-27500,13709460,19170.0,신풍제약보통주
8714,19170,2020-09-18,0.2983606557377049,152500,198000,45500,11151883,19170.0,신풍제약보통주
8715,19170,2020-09-16,0.0511945392491467,146500,154000,7500,1613973,19170.0,신풍제약보통주
8716,19170,2020-09-14,0.0456026058631921,153500,146500,-7000,1454336,19170.0,신풍제약보통주
8717,19170,2020-09-11,0.0886524822695035,141000,153500,12500,4196887,19170.0,신풍제약보통주
8718,19170,2020-09-08,0.0572390572390572,148500,140000,-8500,1896434,19170.0,신풍제약보통주
8719,19170,2020-09-04,0.0670926517571885,156500,146000,-10500,3207785,19170.0,신풍제약보통주
8720,19170,2020-09-02,0.0748299319727891,147000,158000,11000,5227173,19170.0,신풍제약보통주
8721,19170,2020-09-01,0.0769230769230769,136500,147000,10500,8457244,19170.0,신풍제약보통주
8722,19170,2020-08-31,0.2297297297297297,111000,136500,25500,8923037,19170.0,신풍제약보통주
8723,19170,2020-08-25,0.1343283582089552,100500,114000,13500,8298145,19170.0,신풍제약보통주
8724,19170,2020-08-24,0.1043956043956044,91000,100500,9500,6447748,19170.0,신풍제약보통주
8725,19170,2020-08-20,0.1161676646706586,83500,93200,9700,7406541,19170.0,신풍제약보통주
8726,19170,2020-08-18,0.1118508655126498,75100,83500,8400,8167164,19170.0,신풍제약보통주
8727,19170,2020-08-13,0.0459610027855153,71800,75100,3300,2849271,19170.0,신풍제약보통주
8728,19170,2020-08-12,0.0663198959687906,76900,71800,-5100,2147793,19170.0,신풍제약보통주
8729,19170,2020-08-05,0.0493333333333333,75000,78700,3700,4779936,19170.0,신풍제약보통주
8730,19170,2020-08-03,0.0652173913043478,69000,73500,4500,5853424,19170.0,신풍제약보통주
8731,19170,2020-07-31,0.1976744186046511,86000,69000,-17000,9550127,19170.0,신풍제약보통주
8732,19170,2020-07-30,0.1466666666666666,75000,86000,11000,16135343,19170.0,신풍제약보통주
8733,19170,2020-07-29,0.047486033519553,71600,75000,3400,13369199,19170.0,신풍제약보통주
8734,19170,2020-07-27,0.3,105000,73500,-31500,17014592,19170.0,신풍제약보통주
8735,19170,2020-07-24,0.1463414634146341,123000,105000,-18000,7202366,19170.0,신풍제약보통주
8736,19170,2020-07-22,0.2961011591148577,94900,123000,28100,8513185,19170.0,신풍제약보통주
8737,19170,2020-07-20,0.3,73000,94900,21900,8684128,19170.0,신풍제약보통주
8738,19170,2020-07-17,0.1568938193343898,63100,73000,9900,10346334,19170.0,신풍제약보통주
8739,19170,2020-07-13,0.2394655704008222,48650,60300,11650,13164176,19170.0,신풍제약보통주
8740,19170,2020-07-10,0.1822600243013366,41150,48650,7500,21832615,19170.0,신풍제약보통주
8741,19170,2020-07-09,0.0444162436548223,39400,41150,1750,8047240,19170.0,신풍제약보통주
8742,19170,2020-07-07,0.2222222222222222,31050,37950,6900,28716072,19170.0,신풍제약보통주
8743,19170,2020-07-06,0.0507614213197969,29550,31050,1500,5148966,19170.0,신풍제약보통주
8744,19170,2020-06-30,0.0522648083623693,28700,30200,1500,12042952,19170.0,신풍제약보통주
8745,19170,2020-06-18,0.0512820512820512,29250,30750,1500,11117553,19170.0,신풍제약보통주
8746,19170,2020-06-17,0.0772870662460567,31700,29250,-2450,6505157,19170.0,신풍제약보통주
8747,19170,2020-06-16,0.075801749271137,34300,31700,-2600,12590696,19170.0,신풍제약보통주
8748,19170,2020-06-15,0.1245901639344262,30500,34300,3800,28085389,19170.0,신풍제약보통주
8749,19170,2020-06-11,0.0543293718166383,29450,31050,1600,15894953,19170.0,신풍제약보통주
8750,19170,2020-06-10,0.0827205882352941,27200,29450,2250,33420484,19170.0,신풍제약보통주
8751,19170,2020-06-09,0.2983293556085918,20950,27200,6250,25754237,19170.0,신풍제약보통주
8752,19170,2020-05-29,0.0611246943765281,20450,21700,1250,8590829,19170.0,신풍제약보통주
8753,19170,2020-05-15,0.0896860986547085,22300,20300,-2000,4715851,19170.0,신풍제약보통주
8754,19170,2020-05-14,0.1094527363184079,20100,22300,2200,12918593,19170.0,신풍제약보통주
8755,19170,2020-05-04,0.1526946107784431,16700,19250,2550,17744790,19170.0,신풍제약보통주
8756,19170,2020-04-28,0.0554016620498614,18050,17050,-1000,4185905,19170.0,신풍제약보통주
8757,19170,2020-04-20,0.1661538461538461,16250,18950,2700,35260557,19170.0,신풍제약보통주
8758,19170,2020-04-16,0.1770833333333333,19200,15800,-3400,11720117,19170.0,신풍제약보통주
8759,19170,2020-04-14,0.1272727272727272,22000,19200,-2800,14978862,19170.0,신풍제약보통주
8760,19170,2020-04-13,0.0736842105263157,23750,22000,-1750,12886870,19170.0,신풍제약보통주
8761,19170,2020-04-10,0.1613691931540342,20450,23750,3300,23427263,19170.0,신풍제약보통주
8762,19170,2020-04-06,0.2987012987012987,15400,20000,4600,3994971,19170.0,신풍제약보통주
8763,19170,2020-04-03,0.2995780590717299,11850,15400,3550,21410786,19170.0,신풍제약보통주
8764,19170,2020-04-01,0.15625,14400,12150,-2250,9571806,19170.0,신풍제약보통주
8765,19170,2020-03-30,0.1346153846153846,13000,14750,1750,28078381,19170.0,신풍제약보통주
8766,19170,2020-03-27,0.0441767068273092,12450,13000,550,60560513,19170.0,신풍제약보통주
8767,19170,2020-03-26,0.295525494276795,9610,12450,2840,45953613,19170.0,신풍제약보통주
8768,19170,2020-03-25,0.1239766081871345,8550,9610,1060,30547156,19170.0,신풍제약보통주
8769,19170,2020-03-23,0.0583756345177665,7880,8340,460,29900733,19170.0,신풍제약보통주
8770,19170,2020-03-20,0.1921331316187594,6610,7880,1270,23789010,19170.0,신풍제약보통주
8771,19170,2020-03-19,0.1525641025641025,7800,6610,-1190,6210653,19170.0,신풍제약보통주
8772,19170,2020-03-13,0.0546967895362663,8410,7950,-460,43159438,19170.0,신풍제약보통주
8773,19170,2020-03-12,0.043424317617866,8060,8410,350,12175871,19170.0,신풍제약보통주
8774,19170,2020-03-10,0.0437956204379562,8220,7860,-360,7649332,19170.0,신풍제약보통주
8775,19170,2020-03-04,0.0738177623990772,8670,8030,-640,13231425,19170.0,신풍제약보통주
8776,19170,2020-03-03,0.1991701244813278,7230,8670,1440,36558831,19170.0,신풍제약보통주
8777,19170,2020-02-27,0.0505689001264222,7910,7510,-400,9295152,19170.0,신풍제약보통주
8778,19170,2020-02-25,0.1129943502824858,8850,7850,-1000,12061702,19170.0,신풍제약보통주
8779,19170,2020-02-21,0.1056511056511056,8140,9000,860,39241653,19170.0,신풍제약보통주
8780,19170,2020-02-20,0.111353711790393,9160,8140,-1020,25453076,19170.0,신풍제약보통주
8781,19170,2020-02-19,0.1130012150668286,8230,9160,930,53340093,19170.0,신풍제약보통주
8782,19170,2020-02-18,0.1494413407821229,7160,8230,1070,53332630,19170.0,신풍제약보통주
8783,19170,2020-02-12,0.0758988015978695,7510,6940,-570,6817712,19170.0,신풍제약보통주
8784,19170,2020-02-11,0.0469543147208121,7880,7510,-370,15066138,19170.0,신풍제약보통주
8785,19170,2020-02-10,0.1045454545454545,8800,7880,-920,11438334,19170.0,신풍제약보통주
8786,19170,2020-02-07,0.1173520561685055,9970,8800,-1170,36655616,19170.0,신풍제약보통주
8787,19170,2020-02-06,0.1660818713450292,8550,9970,1420,48735427,19170.0,신풍제약보통주
8788,19170,2020-02-05,0.2993920972644377,6580,8550,1970,27487133,19170.0,신풍제약보통주
8789,19170,2020-01-31,0.0542082738944365,7010,6630,-380,1289446,19170.0,신풍제약보통주
8790,19170,2020-01-29,0.0752269779507133,7710,7130,-580,2197885,19170.0,신풍제약보통주
8791,19170,2020-01-08,0.0648275862068965,7250,6780,-470,831279,19170.0,신풍제약보통주
8792,19170,2020-01-07,0.0431654676258992,6950,7250,300,3214624,19170.0,신풍제약보통주
8793,19170,2019-12-06,0.0466165413533834,6650,6960,310,1261923,19170.0,신풍제약보통주
8794,19170,2019-11-19,0.0401146131805157,6980,6700,-280,706489,19170.0,신풍제약보통주
8795,19170,2019-11-08,0.0409276944065484,7330,7030,-300,1200843,19170.0,신풍제약보통주
8796,19170,2019-11-06,0.0546583850931677,8050,7610,-440,5316376,19170.0,신풍제약보통주
8797,19170,2019-11-05,0.1227336122733612,7170,8050,880,6533414,19170.0,신풍제약보통주
8798,19170,2019-11-04,0.0606508875739644,6760,7170,410,6669599,19170.0,신풍제약보통주
8799,19170,2019-10-28,0.0472312703583061,6140,6430,290,932363,19170.0,신풍제약보통주
8800,19170,2019-10-24,0.044753086419753,6480,6190,-290,613984,19170.0,신풍제약보통주
8801,19170,2019-10-23,0.0657894736842105,6080,6480,400,3154438,19170.0,신풍제약보통주
8802,19170,2019-08-26,0.0511463844797178,5670,5380,-290,132853,19170.0,신풍제약보통주
8803,19170,2019-08-07,0.0438247011952191,5020,5240,220,352614,19170.0,신풍제약보통주
8804,19170,2019-08-06,0.07380073800738,5420,5020,-400,683949,19170.0,신풍제약보통주
8805,19170,2019-08-05,0.1143790849673202,6120,5420,-700,596476,19170.0,신풍제약보통주
8806,19170,2019-07-29,0.06396255850234,6410,6000,-410,368507,19170.0,신풍제약보통주
8807,19170,2019-07-08,0.0445103857566765,6740,6440,-300,223145,19170.0,신풍제약보통주
8808,19170,2019-05-28,0.0431547619047619,6720,7010,290,324009,19170.0,신풍제약보통주
8809,19170,2019-05-13,0.0431266846361186,7420,7100,-320,584999,19170.0,신풍제약보통주
8810,19170,2019-04-30,0.0564304461942257,7620,8050,430,4787042,19170.0,신풍제약보통주
8811,19170,2019-04-10,0.048051948051948,7700,8070,370,1599160,19170.0,신풍제약보통주
8812,19170,2019-04-01,0.0559345156889495,7330,7740,410,4925023,19170.0,신풍제약보통주
8813,19170,2019-03-04,0.0896464646464646,7920,8630,710,1909844,19170.0,신풍제약보통주
8814,19170,2019-02-11,0.0416124837451235,7690,8010,320,4784465,19170.0,신풍제약보통주
8815,19170,2019-02-07,0.0502793296089385,7160,7520,360,1423624,19170.0,신풍제약보통주
8816,19170,2019-01-18,0.0445103857566765,6740,7040,300,648865,19170.0,신풍제약보통주
8817,19170,2019-01-07,0.0833333333333333,6840,7410,570,2745330,19170.0,신풍제약보통주
8818,19170,2019-01-04,0.1085899513776337,6170,6840,670,1526914,19170.0,신풍제약보통주
8819,19170,2018-12-10,0.0571428571428571,7000,6600,-400,833339,19170.0,신풍제약보통주
8820,19170,2018-11-27,0.0441595441595441,7020,7330,310,736433,19170.0,신풍제약보통주
8821,19170,2018-11-05,0.0527859237536656,6820,7180,360,1267878,19170.0,신풍제약보통주
8822,19170,2018-11-02,0.0428134556574923,6540,6820,280,280496,19170.0,신풍제약보통주
8823,19170,2018-10-30,0.0475409836065573,6100,6390,290,608259,19170.0,신풍제약보통주
8824,19170,2018-10-29,0.0813253012048192,6640,6100,-540,593283,19170.0,신풍제약보통주
8825,19170,2018-10-26,0.0527817403708987,7010,6640,-370,501619,19170.0,신풍제약보통주
8826,19170,2018-10-23,0.0544747081712062,7710,7290,-420,446768,19170.0,신풍제약보통주
8827,19170,2018-10-16,0.0446685878962536,6940,7250,310,623264,19170.0,신풍제약보통주
8828,19170,2018-10-11,0.0652173913043478,7360,6880,-480,1131355,19170.0,신풍제약보통주
8829,19170,2018-10-08,0.0419847328244274,7860,7530,-330,934794,19170.0,신풍제약보통주
8830,19170,2018-10-05,0.0437956204379562,8220,7860,-360,1770981,19170.0,신풍제약보통주
8831,19170,2018-10-04,0.0475086906141367,8630,8220,-410,2297480,19170.0,신풍제약보통주
8832,19170,2018-10-02,0.0568306010928961,9150,8630,-520,4871591,19170.0,신풍제약보통주
8833,19170,2018-10-01,0.0714285714285714,8540,9150,610,24116130,19170.0,신풍제약보통주
8834,19170,2018-08-17,0.0589123867069486,6620,7010,390,568877,19170.0,신풍제약보통주
8835,19170,2018-08-13,0.0508474576271186,7080,6720,-360,407039,19170.0,신풍제약보통주
8836,19170,2018-07-26,0.0448,6250,6530,280,173757,19170.0,신풍제약보통주
8837,19170,2018-07-25,0.0428790199081163,6530,6250,-280,256124,19170.0,신풍제약보통주
8838,19170,2018-07-23,0.0559646539027982,6790,6410,-380,318384,19170.0,신풍제약보통주
8839,19170,2018-07-03,0.0534124629080118,6740,7100,360,698392,19170.0,신풍제약보통주
8840,19170,2018-07-02,0.0493653032440056,7090,6740,-350,381402,19170.0,신풍제약보통주
8841,19170,2018-06-28,0.0596026490066225,7550,7100,-450,329513,19170.0,신풍제약보통주
8842,19170,2018-06-19,0.0664160401002506,7980,7450,-530,627467,19170.0,신풍제약보통주
8843,19170,2018-06-07,0.0507075471698113,8480,8910,430,1219139,19170.0,신풍제약보통주
8844,19170,2018-06-01,0.0462850182704019,8210,8590,380,522111,19170.0,신풍제약보통주
8845,19170,2018-05-24,0.0501138952164009,8780,8340,-440,1494535,19170.0,신풍제약보통주
8846,19170,2018-05-23,0.0738396624472573,9480,8780,-700,1426735,19170.0,신풍제약보통주
8847,19170,2018-05-21,0.0613861386138613,10100,9480,-620,1458161,19170.0,신풍제약보통주
8848,19170,2018-05-18,0.073394495412844,10900,10100,-800,3718064,19170.0,신풍제약보통주
8849,19170,2018-05-15,0.0493273542600896,11150,10600,-550,841688,19170.0,신풍제약보통주
8850,19170,2018-05-04,0.0885045778229908,9830,10700,870,1863145,19170.0,신풍제약보통주
8851,19170,2018-04-30,0.0561224489795918,9800,10350,550,877743,19170.0,신풍제약보통주
8852,19170,2018-04-19,0.0506912442396313,10850,10300,-550,1359521,19170.0,신풍제약보통주
8853,19170,2018-04-18,0.076595744680851,11750,10850,-900,1630860,19170.0,신풍제약보통주
8854,19170,2018-04-13,0.0442477876106194,11300,11800,500,2884073,19170.0,신풍제약보통주
8855,19170,2018-04-11,0.1783439490445859,9420,11100,1680,7739495,19170.0,신풍제약보통주
8856,19170,2018-04-09,0.0580865603644646,8780,9290,510,830990,19170.0,신풍제약보통주
8857,19170,2018-03-23,0.0801354401805869,8860,8150,-710,1469892,19170.0,신풍제약보통주
8858,19170,2018-03-19,0.0525252525252525,9900,9380,-520,1147604,19170.0,신풍제약보통주
8859,19170,2018-03-15,0.0767567567567567,9250,9960,710,2934240,19170.0,신풍제약보통주
8860,19170,2018-03-12,0.0546075085324232,8790,9270,480,1887643,19170.0,신풍제약보통주
8861,19170,2018-02-22,0.043979057591623,9550,9130,-420,1103728,19170.0,신풍제약보통주
8862,19170,2018-02-20,0.0670454545454545,8800,9390,590,5188066,19170.0,신풍제약보통주
8863,19170,2018-02-14,0.0403800475059382,8420,8760,340,779625,19170.0,신풍제약보통주
8864,19170,2018-02-13,0.0485875706214689,8850,8420,-430,3634690,19170.0,신풍제약보통주
8865,19170,2018-02-12,0.0792682926829268,8200,8850,650,2929934,19170.0,신풍제약보통주
8866,19170,2018-02-06,0.0402366863905325,8450,8110,-340,1191030,19170.0,신풍제약보통주
8867,19170,2018-02-05,0.0484234234234234,8880,8450,-430,5357089,19170.0,신풍제약보통주
8868,19170,2018-02-02,0.0496453900709219,8460,8880,420,764237,19170.0,신풍제약보통주
8869,19170,2018-01-26,0.0505747126436781,8700,9140,440,891678,19170.0,신풍제약보통주
8870,19170,2018-01-18,0.0630202140309155,8410,8940,530,512695,19170.0,신풍제약보통주
8871,19170,2018-01-11,0.0669800235017626,8510,9080,570,672258,19170.0,신풍제약보통주
8872,19170,2018-01-09,0.05,8800,8360,-440,586124,19170.0,신풍제약보통주
8873,19170,2018-01-05,0.0592417061611374,8440,8940,500,647279,19170.0,신풍제약보통주
8874,19170,2018-01-03,0.0742138364779874,7950,8540,590,2617845,19170.0,신풍제약보통주
8875,19170,2017-12-11,0.0418410041841004,7170,7470,300,214007,19170.0,신풍제약보통주
8876,19170,2017-12-07,0.0426098535286285,7510,7190,-320,541086,19170.0,신풍제약보통주
8877,19170,2017-11-20,0.0641562064156206,7170,7630,460,3120891,19170.0,신풍제약보통주
8878,19170,2017-11-10,0.0607661822985469,7570,7110,-460,2706796,19170.0,신풍제약보통주
8879,19170,2017-11-09,0.1557251908396946,6550,7570,1020,8236195,19170.0,신풍제약보통주
8880,19170,2017-11-01,0.0424836601307189,6120,6380,260,218365,19170.0,신풍제약보통주
8881,19170,2017-08-28,0.0520134228187919,5960,6270,310,172149,19170.0,신풍제약보통주
8882,19170,2017-04-27,0.072992700729927,6850,6350,-500,824411,19170.0,신풍제약보통주
8883,19170,2017-04-24,0.1114754098360655,6100,6780,680,5601021,19170.0,신풍제약보통주
8884,19170,2017-04-07,0.0456852791878172,5910,6180,270,197365,19170.0,신풍제약보통주
8885,19170,2017-03-27,0.0592734225621414,5230,5540,310,675698,19170.0,신풍제약보통주
8886,19170,2017-03-03,0.0424778761061946,5650,5410,-240,138689,19170.0,신풍제약보통주
8887,19170,2016-12-28,0.0460176991150442,5650,5910,260,155125,19170.0,신풍제약보통주
8888,19170,2016-12-15,0.0628465804066543,5410,5750,340,235601,19170.0,신풍제약보통주
8889,19170,2016-12-12,0.0483558994197292,5170,5420,250,127021,19170.0,신풍제약보통주
8890,19170,2016-11-23,0.0406360424028268,5660,5430,-230,137231,19170.0,신풍제약보통주
8891,19170,2016-11-10,0.1028571428571428,5250,5790,540,294685,19170.0,신풍제약보통주
8892,19170,2016-11-09,0.0821678321678321,5720,5250,-470,466283,19170.0,신풍제약보통주
8893,19170,2016-11-02,0.0808580858085808,6060,5570,-490,342874,19170.0,신풍제약보통주
8894,19170,2016-09-30,0.0693568726355611,7930,7380,-550,851543,19170.0,신풍제약보통주
8895,19170,2016-09-28,0.0747051114023591,7630,8200,570,2791232,19170.0,신풍제약보통주
8896,19170,2016-09-27,0.0509641873278236,7260,7630,370,762025,19170.0,신풍제약보통주
8897,19170,2016-09-08,0.0457142857142857,7000,7320,320,1029481,19170.0,신풍제약보통주
8898,19170,2016-08-31,0.0448430493273542,6690,6990,300,476429,19170.0,신풍제약보통주
8899,19170,2016-08-29,0.0704419889502762,7240,6730,-510,776181,19170.0,신풍제약보통주
8900,19170,2016-08-23,0.1087570621468926,7080,7850,770,1896442,19170.0,신풍제약보통주
8901,20150,2021-04-09,0.043010752688172,74400,77600,3200,469161,20150.0,일진머티리얼즈보통주
8902,20150,2021-03-26,0.0453125,64000,66900,2900,398818,20150.0,일진머티리얼즈보통주
8903,20150,2021-03-11,0.04,62500,65000,2500,797481,20150.0,일진머티리얼즈보통주
8904,20150,2021-03-08,0.0564635958395245,67300,63500,-3800,435472,20150.0,일진머티리얼즈보통주
8905,20150,2021-03-04,0.0414878397711015,69900,67000,-2900,427609,20150.0,일진머티리얼즈보통주
8906,20150,2021-02-26,0.0424657534246575,73000,69900,-3100,817974,20150.0,일진머티리얼즈보통주
8907,20150,2021-02-24,0.0535248041775456,76600,72500,-4100,679201,20150.0,일진머티리얼즈보통주
8908,20150,2021-02-23,0.0425,80000,76600,-3400,621823,20150.0,일진머티리얼즈보통주
8909,20150,2021-02-03,0.0463576158940397,75500,79000,3500,1205920,20150.0,일진머티리얼즈보통주
8910,20150,2021-02-02,0.0678925035360678,70700,75500,4800,903917,20150.0,일진머티리얼즈보통주
8911,20150,2021-01-22,0.0488599348534201,61400,64400,3000,1061737,20150.0,일진머티리얼즈보통주
8912,20150,2021-01-19,0.0544815465729349,56900,60000,3100,727055,20150.0,일진머티리얼즈보통주
8913,20150,2021-01-08,0.0722433460076045,52600,56400,3800,1681455,20150.0,일진머티리얼즈보통주
8914,20150,2020-12-11,0.0464864864864864,46250,48400,2150,988388,20150.0,일진머티리얼즈보통주
8915,20150,2020-11-27,0.0434298440979955,44900,46850,1950,729144,20150.0,일진머티리얼즈보통주
8916,20150,2020-09-28,0.0403321470937129,42150,43850,1700,215853,20150.0,일진머티리얼즈보통주
8917,20150,2020-09-24,0.0819848975188781,46350,42550,-3800,528297,20150.0,일진머티리얼즈보통주
8918,20150,2020-08-24,0.0442655935613682,49700,51900,2200,446970,20150.0,일진머티리얼즈보통주
8919,20150,2020-08-20,0.0667938931297709,52400,48900,-3500,757945,20150.0,일진머티리얼즈보통주
8920,20150,2020-08-18,0.0574074074074074,54000,50900,-3100,713134,20150.0,일진머티리얼즈보통주
8921,20150,2020-08-03,0.0887573964497041,50700,55200,4500,2490868,20150.0,일진머티리얼즈보통주
8922,20150,2020-06-25,0.0894141829393627,48650,53000,4350,4541445,20150.0,일진머티리얼즈보통주
8923,20150,2020-06-16,0.0808080808080808,44550,48150,3600,677575,20150.0,일진머티리얼즈보통주
8924,20150,2020-06-15,0.0460385438972162,46700,44550,-2150,852438,20150.0,일진머티리얼즈보통주
8925,20150,2020-05-27,0.0481927710843373,49800,47400,-2400,948717,20150.0,일진머티리얼즈보통주
8926,20150,2020-05-20,0.0598870056497175,44250,46900,2650,813567,20150.0,일진머티리얼즈보통주
8927,20150,2020-05-13,0.0800508259212198,39350,42500,3150,1925740,20150.0,일진머티리얼즈보통주
8928,20150,2020-04-17,0.0613577023498694,38300,40650,2350,1577286,20150.0,일진머티리얼즈보통주
8929,20150,2020-04-16,0.0758426966292134,35600,38300,2700,1314387,20150.0,일진머티리얼즈보통주
8930,20150,2020-04-14,0.0455212922173274,34050,35600,1550,641833,20150.0,일진머티리얼즈보통주
8931,20150,2020-04-13,0.0593922651933701,36200,34050,-2150,713305,20150.0,일진머티리얼즈보통주
8932,20150,2020-04-08,0.0569715142428785,33350,35250,1900,1962604,20150.0,일진머티리얼즈보통주
8933,20150,2020-03-25,0.1169064748201438,27800,31050,3250,1734685,20150.0,일진머티리얼즈보통주
8934,20150,2020-03-24,0.1631799163179916,23900,27800,3900,1691246,20150.0,일진머티리얼즈보통주
8935,20150,2020-03-23,0.0459081836327345,25050,23900,-1150,1085539,20150.0,일진머티리얼즈보통주
8936,20150,2020-03-20,0.1108647450110864,22550,25050,2500,1569859,20150.0,일진머티리얼즈보통주
8937,20150,2020-03-19,0.2142857142857142,28700,22550,-6150,2306945,20150.0,일진머티리얼즈보통주
8938,20150,2020-03-18,0.1394302848575712,33350,28700,-4650,1267427,20150.0,일진머티리얼즈보통주
8939,20150,2020-03-16,0.0685871056241426,36450,33950,-2500,808511,20150.0,일진머티리얼즈보통주
8940,20150,2020-03-13,0.0760456273764258,39450,36450,-3000,1431418,20150.0,일진머티리얼즈보통주
8941,20150,2020-03-12,0.058472553699284,41900,39450,-2450,1095180,20150.0,일진머티리얼즈보통주
8942,20150,2020-03-11,0.0477272727272727,44000,41900,-2100,701605,20150.0,일진머티리얼즈보통주
8943,20150,2020-03-09,0.0631691648822269,46700,43750,-2950,731563,20150.0,일진머티리얼즈보통주
8944,20150,2020-02-28,0.0521472392638036,48900,46350,-2550,709456,20150.0,일진머티리얼즈보통주
8945,20150,2020-02-03,0.0479166666666666,48000,50300,2300,796443,20150.0,일진머티리얼즈보통주
8946,20150,2020-01-10,0.0618436406067677,42850,45500,2650,1123255,20150.0,일진머티리얼즈보통주
8947,20150,2020-01-09,0.0515337423312883,40750,42850,2100,601337,20150.0,일진머티리얼즈보통주
8948,20150,2019-12-04,0.0694444444444444,39600,36850,-2750,727280,20150.0,일진머티리얼즈보통주
8949,20150,2019-11-19,0.0405228758169934,38250,39800,1550,425398,20150.0,일진머티리얼즈보통주
8950,20150,2019-11-08,0.0659767141009055,38650,41200,2550,902548,20150.0,일진머티리얼즈보통주
8951,20150,2019-10-28,0.0681502086230876,35950,38400,2450,753308,20150.0,일진머티리얼즈보통주
8952,20150,2019-09-25,0.0685785536159601,40100,37350,-2750,993179,20150.0,일진머티리얼즈보통주
8953,20150,2019-09-16,0.0411985018726591,40050,41700,1650,419941,20150.0,일진머티리얼즈보통주
8954,20150,2019-09-09,0.0452920143027413,41950,40050,-1900,595121,20150.0,일진머티리얼즈보통주
8955,20150,2019-08-08,0.0603085553997194,35650,37800,2150,408375,20150.0,일진머티리얼즈보통주
8956,20150,2019-07-25,0.0426599749058971,39850,38150,-1700,548726,20150.0,일진머티리얼즈보통주
8957,20150,2019-07-01,0.0455153949129852,37350,39050,1700,693773,20150.0,일진머티리얼즈보통주
8958,20150,2019-06-03,0.0532374100719424,34750,36600,1850,534878,20150.0,일진머티리얼즈보통주
8959,20150,2019-05-30,0.0856697819314641,32100,34850,2750,953582,20150.0,일진머티리얼즈보통주
8960,20150,2019-05-09,0.0786206896551724,36250,33400,-2850,827363,20150.0,일진머티리얼즈보통주
8961,20150,2019-03-28,0.0501285347043701,38900,36950,-1950,553025,20150.0,일진머티리얼즈보통주
8962,20150,2019-03-25,0.0465686274509803,40800,38900,-1900,450679,20150.0,일진머티리얼즈보통주
8963,20150,2019-03-21,0.0613026819923371,39150,41550,2400,1281314,20150.0,일진머티리얼즈보통주
8964,20150,2019-02-07,0.0521844660194174,41200,43350,2150,686054,20150.0,일진머티리얼즈보통주
8965,20150,2019-01-25,0.074025974025974,38500,41350,2850,1175167,20150.0,일진머티리얼즈보통주
8966,20150,2019-01-17,0.0583126550868486,40300,37950,-2350,706940,20150.0,일진머티리얼즈보통주
8967,20150,2019-01-07,0.0587449933244325,37450,39650,2200,569644,20150.0,일진머티리얼즈보통주
8968,20150,2018-12-21,0.0444726810673443,39350,41100,1750,975757,20150.0,일진머티리얼즈보통주
8969,20150,2018-12-19,0.0698924731182795,37200,39800,2600,1097628,20150.0,일진머티리얼즈보통주
8970,20150,2018-12-14,0.04177545691906,38300,36700,-1600,415555,20150.0,일진머티리얼즈보통주
8971,20150,2018-12-12,0.0670391061452514,35800,38200,2400,643683,20150.0,일진머티리얼즈보통주
8972,20150,2018-12-10,0.0685640362225097,38650,36000,-2650,659456,20150.0,일진머티리얼즈보통주
8973,20150,2018-11-28,0.0857487922705314,41400,37850,-3550,2514559,20150.0,일진머티리얼즈보통주
8974,20150,2018-11-23,0.1039387308533916,45700,40950,-4750,3009075,20150.0,일진머티리얼즈보통주
8975,20150,2018-11-13,0.0517241379310344,46400,48800,2400,503206,20150.0,일진머티리얼즈보통주
8976,20150,2018-10-30,0.0525700934579439,42800,45050,2250,623534,20150.0,일진머티리얼즈보통주
8977,20150,2018-10-29,0.0541436464088397,45250,42800,-2450,638612,20150.0,일진머티리얼즈보통주
8978,20150,2018-10-26,0.0443505807814149,47350,45250,-2100,588648,20150.0,일진머티리얼즈보통주
8979,20150,2018-10-23,0.0614035087719298,51300,48150,-3150,653061,20150.0,일진머티리얼즈보통주
8980,20150,2018-10-22,0.0555555555555555,48600,51300,2700,551826,20150.0,일진머티리얼즈보통주
8981,20150,2018-10-12,0.0700218818380744,45700,48900,3200,672473,20150.0,일진머티리얼즈보통주
8982,20150,2018-10-11,0.0538302277432712,48300,45700,-2600,555407,20150.0,일진머티리얼즈보통주
8983,20150,2018-10-05,0.0423076923076923,52000,49800,-2200,615349,20150.0,일진머티리얼즈보통주
8984,20150,2018-09-04,0.0585009140767824,54700,57900,3200,1365634,20150.0,일진머티리얼즈보통주
8985,20150,2018-08-31,0.0448275862068965,58000,55400,-2600,3975818,20150.0,일진머티리얼즈보통주
8986,20150,2018-08-27,0.0711678832116788,54800,58700,3900,1328341,20150.0,일진머티리얼즈보통주
8987,20150,2018-08-24,0.0418250950570342,52600,54800,2200,1628869,20150.0,일진머티리얼즈보통주
8988,20150,2018-08-16,0.0698151950718685,48700,52100,3400,698581,20150.0,일진머티리얼즈보통주
8989,20150,2018-08-06,0.044280442804428,54200,51800,-2400,394624,20150.0,일진머티리얼즈보통주
8990,20150,2018-07-26,0.0402298850574712,52200,54300,2100,587701,20150.0,일진머티리얼즈보통주
8991,20150,2018-07-23,0.0507518796992481,53200,50500,-2700,867404,20150.0,일진머티리얼즈보통주
8992,20150,2018-07-19,0.0769230769230769,49400,53200,3800,1826315,20150.0,일진머티리얼즈보통주
8993,20150,2018-07-12,0.069593147751606,46700,49950,3250,1456020,20150.0,일진머티리얼즈보통주
8994,20150,2018-07-11,0.0698739977090492,43650,46700,3050,1366214,20150.0,일진머티리얼즈보통주
8995,20150,2018-07-06,0.0428396572827417,40850,42600,1750,443946,20150.0,일진머티리얼즈보통주
8996,20150,2018-06-26,0.062200956937799,41800,44400,2600,919747,20150.0,일진머티리얼즈보통주
8997,20150,2018-06-20,0.0886571056062581,38350,41750,3400,777967,20150.0,일진머티리얼즈보통주
8998,20150,2018-06-19,0.0448318804483188,40150,38350,-1800,575564,20150.0,일진머티리얼즈보통주
8999,20150,2018-06-18,0.0508274231678487,42300,40150,-2150,914715,20150.0,일진머티리얼즈보통주
9000,20150,2018-06-07,0.0495436766623207,38350,40250,1900,986997,20150.0,일진머티리얼즈보통주
9001,20150,2018-06-04,0.0460081190798376,36950,38650,1700,1329804,20150.0,일진머티리얼즈보통주
9002,20150,2018-06-01,0.0663780663780663,34650,36950,2300,865379,20150.0,일진머티리얼즈보통주
9003,20150,2018-05-09,0.067398119122257,31900,34050,2150,407762,20150.0,일진머티리얼즈보통주
9004,20150,2018-04-04,0.0520547945205479,36500,34600,-1900,485930,20150.0,일진머티리얼즈보통주
9005,20150,2018-03-26,0.048780487804878,36900,38700,1800,522918,20150.0,일진머티리얼즈보통주
9006,20150,2018-03-14,0.0607344632768361,35400,37550,2150,814312,20150.0,일진머티리얼즈보통주
9007,20150,2018-03-06,0.0808709175738724,32150,34750,2600,654988,20150.0,일진머티리얼즈보통주
9008,20150,2018-02-07,0.0414878397711015,34950,33500,-1450,424947,20150.0,일진머티리얼즈보통주
9009,20150,2018-02-05,0.0431848852901484,37050,35450,-1600,534040,20150.0,일진머티리얼즈보통주
9010,20150,2018-02-02,0.0463320463320463,38850,37050,-1800,576359,20150.0,일진머티리얼즈보통주
9011,20150,2018-01-19,0.0419313850063532,39350,37700,-1650,844140,20150.0,일진머티리얼즈보통주
9012,20150,2018-01-16,0.0633245382585752,37900,40300,2400,1923143,20150.0,일진머티리얼즈보통주
9013,20150,2017-12-27,0.0612813370473537,35900,38100,2200,731996,20150.0,일진머티리얼즈보통주
9014,20150,2017-12-22,0.0494186046511627,34400,36100,1700,471425,20150.0,일진머티리얼즈보통주
9015,20150,2017-12-04,0.0583016476552598,39450,37150,-2300,750347,20150.0,일진머티리얼즈보통주
9016,20150,2017-11-28,0.0559610705596107,41100,38800,-2300,1209530,20150.0,일진머티리얼즈보통주
9017,20150,2017-11-22,0.0574412532637075,38300,40500,2200,2272059,20150.0,일진머티리얼즈보통주
9018,20150,2017-11-16,0.046831955922865,36300,38000,1700,1631541,20150.0,일진머티리얼즈보통주
9019,20150,2017-11-09,0.1439280359820089,33350,38150,4800,3742627,20150.0,일진머티리얼즈보통주
9020,20150,2017-11-08,0.0470957613814756,31850,33350,1500,1003664,20150.0,일진머티리얼즈보통주
9021,20150,2017-11-06,0.0414110429447852,32600,31250,-1350,717752,20150.0,일진머티리얼즈보통주
9022,20150,2017-11-03,0.0509461426491994,34350,32600,-1750,1318484,20150.0,일진머티리얼즈보통주
9023,20150,2017-10-30,0.0555555555555555,33300,31450,-1850,805507,20150.0,일진머티리얼즈보통주
9024,20150,2017-09-27,0.0457142857142857,35000,36600,1600,803448,20150.0,일진머티리얼즈보통주
9025,20150,2017-09-22,0.0773333333333333,37500,34600,-2900,1930316,20150.0,일진머티리얼즈보통주
9026,20150,2017-09-21,0.0458015267175572,39300,37500,-1800,1695731,20150.0,일진머티리얼즈보통주
9027,20150,2017-09-20,0.0676156583629893,42150,39300,-2850,1408858,20150.0,일진머티리얼즈보통주
9028,20150,2017-09-15,0.0458190148911798,43650,41650,-2000,3016896,20150.0,일진머티리얼즈보통주
9029,20150,2017-09-13,0.0858895705521472,40750,44250,3500,2598597,20150.0,일진머티리얼즈보통주
9030,20150,2017-09-11,0.0685640362225097,38650,41300,2650,1660406,20150.0,일진머티리얼즈보통주
9031,20150,2017-08-23,0.1113989637305699,38600,42900,4300,2811847,20150.0,일진머티리얼즈보통주
9032,20150,2017-08-16,0.0821917808219178,36500,39500,3000,1231625,20150.0,일진머티리얼즈보통주
9033,20150,2017-08-09,0.0735873850197109,38050,35250,-2800,857060,20150.0,일진머티리얼즈보통주
9034,20150,2017-08-02,0.048582995951417,37050,38850,1800,765726,20150.0,일진머티리얼즈보통주
9035,20150,2017-07-26,0.054054054054054,38850,36750,-2100,1420978,20150.0,일진머티리얼즈보통주
9036,20150,2017-07-25,0.0407407407407407,40500,38850,-1650,935346,20150.0,일진머티리얼즈보통주
9037,20150,2017-07-24,0.1061007957559681,37700,40500,2800,2256640,20150.0,일진머티리얼즈보통주
9038,20150,2017-07-18,0.0517038777908343,42550,40350,-2200,2729812,20150.0,일진머티리얼즈보통주
9039,20150,2017-07-17,0.15,37000,42550,5550,1641281,20150.0,일진머티리얼즈보통주
9040,20150,2017-07-10,0.0419681620839363,34550,36000,1450,1964820,20150.0,일진머티리얼즈보통주
9041,20150,2017-07-07,0.1056,31250,34550,3300,1824348,20150.0,일진머티리얼즈보통주
9042,20150,2017-06-26,0.1202090592334494,28700,32150,3450,1622406,20150.0,일진머티리얼즈보통주
9043,20150,2017-06-21,0.0769230769230769,26650,28700,2050,880059,20150.0,일진머티리얼즈보통주
9044,20150,2017-06-16,0.04,26250,27300,1050,1507530,20150.0,일진머티리얼즈보통주
9045,20150,2017-06-15,0.0758196721311475,24400,26250,1850,1221799,20150.0,일진머티리얼즈보통주
9046,20150,2017-06-14,0.0941704035874439,22300,24400,2100,984190,20150.0,일진머티리얼즈보통주
9047,20150,2017-06-12,0.0413943355119825,22950,22000,-950,447074,20150.0,일진머티리얼즈보통주
9048,20150,2017-06-07,0.0627802690582959,22300,23700,1400,575368,20150.0,일진머티리얼즈보통주
9049,20150,2017-05-16,0.0648379052369077,20050,21350,1300,1160911,20150.0,일진머티리얼즈보통주
9050,20150,2017-05-10,0.0611111111111111,18000,19100,1100,1501803,20150.0,일진머티리얼즈보통주
9051,20150,2017-03-17,0.0841750841750841,14850,16100,1250,1468654,20150.0,일진머티리얼즈보통주
9052,20150,2017-03-03,0.0526315789473684,15200,14400,-800,431675,20150.0,일진머티리얼즈보통주
9053,20150,2017-02-17,0.0405405405405405,14800,15400,600,857182,20150.0,일진머티리얼즈보통주
9054,20150,2017-02-01,0.1349206349206349,12600,14300,1700,1520311,20150.0,일진머티리얼즈보통주
9055,20150,2017-01-18,0.0576131687242798,12150,12850,700,583574,20150.0,일진머티리얼즈보통주
9056,20150,2017-01-02,0.082437275985663,13950,12800,-1150,646882,20150.0,일진머티리얼즈보통주
9057,20150,2016-12-15,0.0418250950570342,13150,13700,550,792653,20150.0,일진머티리얼즈보통주
9058,20150,2016-12-12,0.0513833992094861,12650,13300,650,479045,20150.0,일진머티리얼즈보통주
9059,20150,2016-12-08,0.0769230769230769,11700,12600,900,496890,20150.0,일진머티리얼즈보통주
9060,20150,2016-12-06,0.0484581497797356,11350,11900,550,328763,20150.0,일진머티리얼즈보통주
9061,20150,2016-11-25,0.0521739130434782,11500,12100,600,384318,20150.0,일진머티리얼즈보통주
9062,20150,2016-11-22,0.0524193548387096,12400,11750,-650,588935,20150.0,일진머티리얼즈보통주
9063,20150,2016-11-21,0.0424710424710424,12950,12400,-550,237877,20150.0,일진머티리얼즈보통주
9064,20150,2016-11-17,0.0511811023622047,12700,13350,650,575587,20150.0,일진머티리얼즈보통주
9065,20150,2016-11-10,0.0818505338078291,14050,12900,-1150,1649435,20150.0,일진머티리얼즈보통주
9066,20150,2016-11-09,0.0846905537459283,15350,14050,-1300,897039,20150.0,일진머티리얼즈보통주
9067,20150,2016-11-08,0.0640243902439024,16400,15350,-1050,590212,20150.0,일진머티리얼즈보통주
9068,20150,2016-11-07,0.0445859872611464,15700,16400,700,213620,20150.0,일진머티리얼즈보통주
9069,20150,2016-11-02,0.0611620795107033,16350,15350,-1000,324227,20150.0,일진머티리얼즈보통주
9070,20150,2016-10-04,0.0940438871473354,15950,17450,1500,790944,20150.0,일진머티리얼즈보통주
9071,20150,2016-09-12,0.0458715596330275,16350,15600,-750,230769,20150.0,일진머티리얼즈보통주
9072,20150,2016-08-30,0.0465116279069767,17200,18000,800,396183,20150.0,일진머티리얼즈보통주
9073,20150,2016-08-29,0.0417827298050139,17950,17200,-750,294390,20150.0,일진머티리얼즈보통주
9074,20150,2016-08-08,0.04,16250,16900,650,529380,20150.0,일진머티리얼즈보통주
9075,20560,2021-05-26,0.0716510903426791,16050,17200,1150,4198700,20560.0,아시아나항공 보통주
9076,20560,2021-05-25,0.0524590163934426,15250,16050,800,2241836,20560.0,아시아나항공 보통주
9077,20560,2021-03-16,0.0564784053156146,15050,15900,850,2155327,20560.0,아시아나항공 보통주
9078,20560,2021-01-18,0.1166666666666666,18000,15900,-2100,6423570,20560.0,아시아나항공 보통주
9079,20560,2020-12-14,0.1095617529880478,5020,4470,-550,25411398,20560.0,아시아나항공 보통주
9080,20560,2020-12-07,0.0451127819548872,5320,5080,-240,6808967,20560.0,아시아나항공 보통주
9081,20560,2020-12-02,0.0506993006993006,5720,5430,-290,27687521,20560.0,아시아나항공 보통주
9082,20560,2020-12-01,0.1106796116504854,5150,5720,570,66225152,20560.0,아시아나항공 보통주
9083,20560,2020-11-24,0.0412060301507537,4975,5180,205,14568304,20560.0,아시아나항공 보통주
9084,20560,2020-11-19,0.0593869731800766,5220,4910,-310,26297052,20560.0,아시아나항공 보통주
9085,20560,2020-11-18,0.1,5800,5220,-580,41532094,20560.0,아시아나항공 보통주
9086,20560,2020-11-17,0.0412926391382405,5570,5800,230,143068482,20560.0,아시아나항공 보통주
9087,20560,2020-11-16,0.2983682983682983,4290,5570,1280,141613627,20560.0,아시아나항공 보통주
9088,20560,2020-11-13,0.0778894472361809,3980,4290,310,77785080,20560.0,아시아나항공 보통주
9089,20560,2020-11-11,0.101283880171184,3505,3860,355,25443639,20560.0,아시아나항공 보통주
9090,20560,2020-11-09,0.0725308641975308,3240,3475,235,7173687,20560.0,아시아나항공 보통주
9091,20560,2020-11-04,0.1317614424410541,3605,3130,-475,25152276,20560.0,아시아나항공 보통주
9092,20560,2020-10-23,0.0868516284680337,4145,3785,-360,12170828,20560.0,아시아나항공 보통주
9093,20560,2020-10-06,0.0580964153275649,4045,4280,235,8359599,20560.0,아시아나항공 보통주
9094,20560,2020-09-07,0.0408163265306122,4165,3995,-170,5788276,20560.0,아시아나항공 보통주
9095,20560,2020-09-04,0.0534090909090909,4400,4165,-235,6699768,20560.0,아시아나항공 보통주
9096,20560,2020-08-26,0.0704738760631834,4115,4405,290,18570721,20560.0,아시아나항공 보통주
9097,20560,2020-08-18,0.0597189695550351,4270,4015,-255,3349500,20560.0,아시아나항공 보통주
9098,20560,2020-08-07,0.050122249388753,4090,4295,205,16011018,20560.0,아시아나항공 보통주
9099,20560,2020-07-30,0.05,4300,4085,-215,13719192,20560.0,아시아나항공 보통주
9100,20560,2020-07-28,0.2064606741573033,3560,4295,735,75616105,20560.0,아시아나항공 보통주
9101,20560,2020-06-15,0.0759193357058125,4215,3895,-320,4235320,20560.0,아시아나항공 보통주
9102,20560,2020-06-12,0.0496054114994363,4435,4215,-220,3715166,20560.0,아시아나항공 보통주
9103,20560,2020-06-05,0.048661800486618,4110,4310,200,14279383,20560.0,아시아나항공 보통주
9104,20560,2020-05-19,0.0508021390374331,3740,3930,190,9841359,20560.0,아시아나항공 보통주
9105,20560,2020-05-04,0.0431654676258992,4170,3990,-180,3335957,20560.0,아시아나항공 보통주
9106,20560,2020-04-22,0.0454545454545454,4070,4255,185,23848067,20560.0,아시아나항공 보통주
9107,20560,2020-04-17,0.0422163588390501,3790,3950,160,7641100,20560.0,아시아나항공 보통주
9108,20560,2020-04-10,0.0585831062670299,3670,3885,215,8636976,20560.0,아시아나항공 보통주
9109,20560,2020-04-09,0.0470756062767475,3505,3670,165,14862204,20560.0,아시아나항공 보통주
9110,20560,2020-03-26,0.060126582278481,3160,3350,190,7064621,20560.0,아시아나항공 보통주
9111,20560,2020-03-25,0.1225577264653641,2815,3160,345,7830678,20560.0,아시아나항공 보통주
9112,20560,2020-03-24,0.0543071161048689,2670,2815,145,3628319,20560.0,아시아나항공 보통주
9113,20560,2020-03-20,0.2048458149779735,2270,2735,465,6931246,20560.0,아시아나항공 보통주
9114,20560,2020-03-19,0.2993827160493827,3240,2270,-970,6821641,20560.0,아시아나항공 보통주
9115,20560,2020-03-18,0.0526315789473684,3420,3240,-180,1466336,20560.0,아시아나항공 보통주
9116,20560,2020-03-13,0.0553306342780027,3705,3500,-205,2677600,20560.0,아시아나항공 보통주
9117,20560,2020-03-12,0.0655737704918032,3965,3705,-260,1853096,20560.0,아시아나항공 보통주
9118,20560,2020-03-09,0.0504694835680751,4260,4045,-215,1436140,20560.0,아시아나항공 보통주
9119,20560,2020-03-05,0.0603864734299516,4140,4390,250,2124854,20560.0,아시아나항공 보통주
9120,20560,2020-02-28,0.0435294117647058,4250,4065,-185,1440028,20560.0,아시아나항공 보통주
9121,20560,2020-02-25,0.0400943396226415,4240,4410,170,1628587,20560.0,아시아나항공 보통주
9122,20560,2020-02-24,0.0609080841638981,4515,4240,-275,1907018,20560.0,아시아나항공 보통주
9123,20560,2020-02-04,0.0414394765539803,4585,4775,190,943069,20560.0,아시아나항공 보통주
9124,20560,2020-01-28,0.0523665659617321,4965,4705,-260,2387108,20560.0,아시아나항공 보통주
9125,20560,2019-11-14,0.0621019108280254,6280,5890,-390,10942376,20560.0,아시아나항공 보통주
9126,20560,2019-11-13,0.0455927051671732,6580,6280,-300,28833672,20560.0,아시아나항공 보통주
9127,20560,2019-11-12,0.1286449399656946,5830,6580,750,91250005,20560.0,아시아나항공 보통주
9128,20560,2019-11-08,0.096045197740113,5310,5820,510,34700232,20560.0,아시아나항공 보통주
9129,20560,2019-11-07,0.0517857142857142,5600,5310,-290,15227775,20560.0,아시아나항공 보통주
9130,20560,2019-11-04,0.0527272727272727,5500,5790,290,5963696,20560.0,아시아나항공 보통주
9131,20560,2019-09-04,0.0451263537906137,5540,5290,-250,4748118,20560.0,아시아나항공 보통주
9132,20560,2019-08-30,0.0434782608695652,5520,5760,240,3450572,20560.0,아시아나항공 보통주
9133,20560,2019-08-19,0.1088709677419354,4960,5500,540,14815143,20560.0,아시아나항공 보통주
9134,20560,2019-08-05,0.0697674418604651,5590,5200,-390,2991373,20560.0,아시아나항공 보통주
9135,20560,2019-07-25,0.0598159509202454,6520,6130,-390,6002841,20560.0,아시아나항공 보통주
9136,20560,2019-07-24,0.0601626016260162,6150,6520,370,7667096,20560.0,아시아나항공 보통주
9137,20560,2019-07-05,0.0586206896551724,5800,6140,340,5390999,20560.0,아시아나항공 보통주
9138,20560,2019-06-26,0.0600343053173241,5830,5480,-350,5217327,20560.0,아시아나항공 보통주
9139,20560,2019-05-31,0.1058122205663189,6710,6000,-710,13324824,20560.0,아시아나항공 보통주
9140,20560,2019-05-30,0.1353637901861252,5910,6710,800,27916220,20560.0,아시아나항공 보통주
9141,20560,2019-05-28,0.047451669595782,5690,5960,270,8234275,20560.0,아시아나항공 보통주
9142,20560,2019-05-21,0.0430292598967297,5810,5560,-250,4033738,20560.0,아시아나항공 보통주
9143,20560,2019-04-30,0.0644122383252818,6210,6610,400,17883895,20560.0,아시아나항공 보통주
9144,20560,2019-04-29,0.0504587155963302,6540,6210,-330,6466468,20560.0,아시아나항공 보통주
9145,20560,2019-04-24,0.1360103626943005,7720,6670,-1050,26253025,20560.0,아시아나항공 보통주
9146,20560,2019-04-23,0.0596833130328867,8210,7720,-490,14507114,20560.0,아시아나항공 보통주
9147,20560,2019-04-19,0.111869031377899,7330,8150,820,9236916,20560.0,아시아나항공 보통주
9148,20560,2019-04-17,0.157396449704142,8450,7120,-1330,14941605,20560.0,아시아나항공 보통주
9149,20560,2019-04-16,0.1607142857142857,7280,8450,1170,103645799,20560.0,아시아나항공 보통주
9150,20560,2019-04-15,0.3,5600,7280,1680,27666326,20560.0,아시아나항공 보통주
9151,20560,2019-04-12,0.2933025404157043,4330,5600,1270,64607109,20560.0,아시아나항공 보통주
9152,20560,2019-04-11,0.1305483028720626,3830,4330,500,33786832,20560.0,아시아나항공 보통주
9153,20560,2019-03-26,0.1497524752475247,4040,3435,-605,19990131,20560.0,아시아나항공 보통주
9154,20560,2018-11-26,0.0422039859320046,4265,4445,180,1975242,20560.0,아시아나항공 보통주
9155,20560,2018-11-02,0.0477489768076398,3665,3840,175,818157,20560.0,아시아나항공 보통주
9156,20560,2018-10-31,0.0735294117647058,3400,3650,250,830711,20560.0,아시아나항공 보통주
9157,20560,2018-10-29,0.0469416785206258,3515,3350,-165,940383,20560.0,아시아나항공 보통주
9158,20560,2018-10-11,0.0591133004926108,4060,3820,-240,2046991,20560.0,아시아나항공 보통주
9159,20560,2018-06-15,0.0654761904761904,5040,4710,-330,2921426,20560.0,아시아나항공 보통주
9160,20560,2018-04-16,0.041041041041041,4995,5200,205,3152665,20560.0,아시아나항공 보통주
9161,20560,2018-03-27,0.0409745293466223,4515,4700,185,929589,20560.0,아시아나항공 보통주
9162,20560,2018-03-09,0.0487540628385698,4615,4840,225,2101722,20560.0,아시아나항공 보통주
9163,20560,2018-03-02,0.0595238095238095,5040,4740,-300,2544165,20560.0,아시아나항공 보통주
9164,20560,2018-02-19,0.0470588235294117,5100,5340,240,1676748,20560.0,아시아나항공 보통주
9165,20560,2018-02-07,0.0442307692307692,5200,4970,-230,2423513,20560.0,아시아나항공 보통주
9166,20560,2018-01-15,0.077077077077077,4995,5380,385,9909738,20560.0,아시아나항공 보통주
9167,20560,2018-01-12,0.0673076923076923,4680,4995,315,11468901,20560.0,아시아나항공 보통주
9168,20560,2017-11-17,0.1126436781609195,4350,4840,490,15568336,20560.0,아시아나항공 보통주
9169,20560,2017-10-26,0.0995145631067961,4120,4530,410,6842358,20560.0,아시아나항공 보통주
9170,20560,2017-08-11,0.0685714285714285,5250,4890,-360,17284751,20560.0,아시아나항공 보통주
9171,20560,2017-07-26,0.0454545454545454,5280,5040,-240,3733962,20560.0,아시아나항공 보통주
9172,20560,2017-07-25,0.0417422867513611,5510,5280,-230,1888038,20560.0,아시아나항공 보통주
9173,20560,2017-07-14,0.0431778929188255,5790,5540,-250,2083783,20560.0,아시아나항공 보통주
9174,20560,2017-07-04,0.0622950819672131,6100,5720,-380,4497890,20560.0,아시아나항공 보통주
9175,20560,2017-06-02,0.0450980392156862,5100,5330,230,3025484,20560.0,아시아나항공 보통주
9176,20560,2017-03-23,0.0404949381327334,4445,4625,180,1862202,20560.0,아시아나항공 보통주
9177,20560,2017-03-03,0.0640608034744842,4605,4310,-295,2669278,20560.0,아시아나항공 보통주
9178,20560,2017-02-23,0.0482204362801377,4355,4565,210,2855423,20560.0,아시아나항공 보통주
9179,20560,2016-09-12,0.1153846153846153,5200,4600,-600,6154917,20560.0,아시아나항공 보통주
9180,20560,2016-08-10,0.0727272727272727,5500,5900,400,6358298,20560.0,아시아나항공 보통주
9181,20560,2016-08-08,0.0438931297709923,5240,5470,230,3789523,20560.0,아시아나항공 보통주
9182,20560,2016-08-02,0.0510204081632653,4900,5150,250,6750237,20560.0,아시아나항공 보통주
9183,21240,2021-05-18,0.0477419354838709,77500,81200,3700,575384,21240.0,코웨이보통주
9184,21240,2021-05-13,0.0958512160228898,69900,76600,6700,1755822,21240.0,코웨이보통주
9185,21240,2021-02-01,0.0416068866571018,69700,72600,2900,284341,21240.0,코웨이보통주
9186,21240,2020-11-05,0.0612535612535612,70200,74500,4300,390774,21240.0,코웨이보통주
9187,21240,2020-10-12,0.0523038605230386,80300,84500,4200,344566,21240.0,코웨이보통주
9188,21240,2020-09-24,0.0424710424710424,77700,74400,-3300,187041,21240.0,코웨이보통주
9189,21240,2020-08-20,0.0452488687782805,88400,84400,-4000,230565,21240.0,코웨이보통주
9190,21240,2020-08-19,0.0663449939686369,82900,88400,5500,346343,21240.0,코웨이보통주
9191,21240,2020-08-11,0.1055276381909547,79600,88000,8400,738135,21240.0,코웨이보통주
9192,21240,2020-08-06,0.0714285714285714,74200,79500,5300,523107,21240.0,코웨이보통주
9193,21240,2020-07-20,0.0484293193717277,76400,80100,3700,409778,21240.0,코웨이보통주
9194,21240,2020-07-16,0.0437235543018335,70900,74000,3100,261003,21240.0,코웨이보통주
9195,21240,2020-06-19,0.0418300653594771,76500,73300,-3200,376655,21240.0,코웨이보통주
9196,21240,2020-06-16,0.0550724637681159,69000,72800,3800,274916,21240.0,코웨이보통주
9197,21240,2020-06-15,0.0675675675675675,74000,69000,-5000,251930,21240.0,코웨이보통주
9198,21240,2020-06-10,0.0425824175824175,72800,75900,3100,337950,21240.0,코웨이보통주
9199,21240,2020-06-04,0.0475524475524475,71500,74900,3400,363201,21240.0,코웨이보통주
9200,21240,2020-05-28,0.0457142857142857,70000,66800,-3200,422884,21240.0,코웨이보통주
9201,21240,2020-05-26,0.11198738170347,63400,70500,7100,720117,21240.0,코웨이보통주
9202,21240,2020-05-21,0.0462519936204146,62700,65600,2900,432406,21240.0,코웨이보통주
9203,21240,2020-05-12,0.0543478260869565,64400,60900,-3500,421301,21240.0,코웨이보통주
9204,21240,2020-05-11,0.0420711974110032,61800,64400,2600,545127,21240.0,코웨이보통주
9205,21240,2020-04-07,0.0437601296596434,61700,64400,2700,270638,21240.0,코웨이보통주
9206,21240,2020-04-06,0.097864768683274,56200,61700,5500,210629,21240.0,코웨이보통주
9207,21240,2020-04-02,0.0434782608695652,55200,57600,2400,235015,21240.0,코웨이보통주
9208,21240,2020-04-01,0.0449826989619377,57800,55200,-2600,260432,21240.0,코웨이보통주
9209,21240,2020-03-25,0.11,50000,55500,5500,483541,21240.0,코웨이보통주
9210,21240,2020-03-23,0.1163003663003663,54600,48250,-6350,376051,21240.0,코웨이보통주
9211,21240,2020-03-18,0.0686274509803921,61200,57000,-4200,469298,21240.0,코웨이보통주
9212,21240,2020-03-13,0.0723589001447178,69100,64100,-5000,476301,21240.0,코웨이보통주
9213,21240,2020-02-17,0.1814159292035398,90400,74000,-16400,1357393,21240.0,코웨이보통주
9214,21240,2019-11-25,0.040992448759439,92700,96500,3800,310251,21240.0,코웨이보통주
9215,21240,2019-11-13,0.0452099031216361,92900,88700,-4200,164677,21240.0,코웨이보통주
9216,21240,2019-10-08,0.0494699646643109,84900,80700,-4200,282392,21240.0,코웨이보통주
9217,21240,2019-08-07,0.0411764705882352,85000,81500,-3500,180374,21240.0,코웨이보통주
9218,21240,2019-08-01,0.0619785458879618,83900,89100,5200,345188,21240.0,코웨이보통주
9219,21240,2019-07-16,0.0432242990654205,85600,81900,-3700,234690,21240.0,코웨이보통주
9220,21240,2019-07-15,0.0554870530209617,81100,85600,4500,265333,21240.0,코웨이보통주
9221,21240,2019-06-28,0.0774731823599523,83900,77400,-6500,478310,21240.0,코웨이보통주
9222,21240,2019-05-14,0.0434227330779054,78300,74900,-3400,294415,21240.0,코웨이보통주
9223,21240,2019-05-09,0.052890528905289,81300,77000,-4300,294257,21240.0,코웨이보통주
9224,21240,2019-05-02,0.0728929384965831,87800,81400,-6400,515135,21240.0,코웨이보통주
9225,21240,2018-11-14,0.0458579881656804,67600,70700,3100,257951,21240.0,코웨이보통주
9226,21240,2018-11-01,0.0554765291607396,70300,66400,-3900,361478,21240.0,코웨이보통주
9227,21240,2018-10-30,0.0793650793650793,63000,68000,5000,1471273,21240.0,코웨이보통주
9228,21240,2018-10-29,0.2491060786650774,83900,63000,-20900,1429342,21240.0,코웨이보통주
9229,21240,2018-10-11,0.0460448642266824,84700,80800,-3900,302068,21240.0,코웨이보통주
9230,21240,2018-09-19,0.0814977973568281,90800,83400,-7400,4809464,21240.0,코웨이보통주
9231,21240,2018-07-09,0.0470183486238532,87200,91300,4100,182186,21240.0,코웨이보통주
9232,21240,2018-07-06,0.0518697225572979,82900,87200,4300,281392,21240.0,코웨이보통주
9233,21240,2018-05-02,0.064,87500,93100,5600,312840,21240.0,코웨이보통주
9234,21240,2018-03-23,0.0487540628385698,92300,87800,-4500,174919,21240.0,코웨이보통주
9235,21240,2018-03-22,0.0560640732265446,87400,92300,4900,280389,21240.0,코웨이보통주
9236,21240,2018-02-21,0.0452436194895591,86200,90100,3900,245783,21240.0,코웨이보통주
9237,21240,2018-02-13,0.0594170403587443,89200,83900,-5300,431512,21240.0,코웨이보통주
9238,21240,2017-12-20,0.0612440191387559,104500,98100,-6400,382925,21240.0,코웨이보통주
9239,21240,2017-12-19,0.0412844036697247,109000,104500,-4500,307326,21240.0,코웨이보통주
9240,21240,2017-12-11,0.0728155339805825,103000,110500,7500,197726,21240.0,코웨이보통주
9241,21240,2017-12-01,0.0479666319082377,95900,100500,4600,150699,21240.0,코웨이보통주
9242,21240,2017-11-30,0.041,100000,95900,-4100,360535,21240.0,코웨이보통주
9243,21240,2017-07-19,0.0598039215686274,102000,95900,-6100,431608,21240.0,코웨이보통주
9244,21240,2017-07-17,0.0512820512820512,97500,102500,5000,225209,21240.0,코웨이보통주
9245,21240,2017-05-16,0.0561904761904761,105000,99100,-5900,4689306,21240.0,코웨이보통주
9246,21240,2017-05-12,0.0407239819004524,110500,106000,-4500,225125,21240.0,코웨이보통주
9247,21240,2017-05-10,0.0405405405405405,111000,106500,-4500,397810,21240.0,코웨이보통주
9248,21240,2017-05-08,0.0471698113207547,106000,111000,5000,398277,21240.0,코웨이보통주
9249,21240,2017-05-04,0.067472306143001,99300,106000,6700,330340,21240.0,코웨이보통주
9250,21240,2017-03-24,0.0429042904290429,90900,94800,3900,223537,21240.0,코웨이보통주
9251,21240,2016-11-15,0.0406593406593406,91000,87300,-3700,228250,21240.0,코웨이보통주
9252,21240,2016-09-19,0.0514469453376205,93300,98100,4800,490852,21240.0,코웨이보통주
9253,21240,2016-09-12,0.0653442240373395,85700,91300,5600,347982,21240.0,코웨이보통주
9254,21240,2016-09-07,0.0475059382422802,84200,88200,4000,292993,21240.0,코웨이보통주
9255,21240,2016-08-25,0.040590405904059,81300,84600,3300,302682,21240.0,코웨이보통주
9256,21240,2016-08-16,0.0538542766631467,94700,89600,-5100,556256,21240.0,코웨이보통주
9257,23530,2021-05-11,0.0656370656370656,129500,121000,-8500,667395,23530.0,롯데쇼핑 보통주
9258,23530,2021-03-23,0.04296875,128000,122500,-5500,266529,23530.0,롯데쇼핑 보통주
9259,23530,2021-03-10,0.0418250950570342,131500,126000,-5500,192339,23530.0,롯데쇼핑 보통주
9260,23530,2021-03-03,0.0576131687242798,121500,128500,7000,422277,23530.0,롯데쇼핑 보통주
9261,23530,2021-02-24,0.0441767068273092,124500,119000,-5500,282217,23530.0,롯데쇼핑 보통주
9262,23530,2021-02-08,0.0497737556561085,110500,116000,5500,236573,23530.0,롯데쇼핑 보통주
9263,23530,2021-01-18,0.0627615062761506,119500,112000,-7500,260063,23530.0,롯데쇼핑 보통주
9264,23530,2021-01-12,0.091324200913242,109500,119500,10000,717104,23530.0,롯데쇼핑 보통주
9265,23530,2021-01-08,0.0657276995305164,106500,113500,7000,511602,23530.0,롯데쇼핑 보통주
9266,23530,2020-11-20,0.0444674250258531,96700,101000,4300,304035,23530.0,롯데쇼핑 보통주
9267,23530,2020-11-10,0.04,90000,93600,3600,367877,23530.0,롯데쇼핑 보통주
9268,23530,2020-11-09,0.0489510489510489,85800,90000,4200,322993,23530.0,롯데쇼핑 보통주
9269,23530,2020-10-19,0.0694288913773796,89300,95500,6200,588516,23530.0,롯데쇼핑 보통주
9270,23530,2020-10-13,0.0412371134020618,87300,90900,3600,380493,23530.0,롯데쇼핑 보통주
9271,23530,2020-10-12,0.0581818181818181,82500,87300,4800,453748,23530.0,롯데쇼핑 보통주
9272,23530,2020-08-18,0.0641330166270783,84200,78800,-5400,239963,23530.0,롯데쇼핑 보통주
9273,23530,2020-08-12,0.0435323383084577,80400,83900,3500,363305,23530.0,롯데쇼핑 보통주
9274,23530,2020-06-30,0.0446780551905387,76100,79500,3400,204835,23530.0,롯데쇼핑 보통주
9275,23530,2020-06-16,0.048689138576779,80100,84000,3900,87295,23530.0,롯데쇼핑 보통주
9276,23530,2020-06-15,0.0598591549295774,85200,80100,-5100,163098,23530.0,롯데쇼핑 보통주
9277,23530,2020-06-12,0.0512249443207126,89800,85200,-4600,211358,23530.0,롯데쇼핑 보통주
9278,23530,2020-04-29,0.0403846153846153,104000,99800,-4200,327951,23530.0,롯데쇼핑 보통주
9279,23530,2020-04-28,0.0766045548654244,96600,104000,7400,660292,23530.0,롯데쇼핑 보통주
9280,23530,2020-04-27,0.140495867768595,84700,96600,11900,496867,23530.0,롯데쇼핑 보통주
9281,23530,2020-04-08,0.094147582697201,78600,86000,7400,364161,23530.0,롯데쇼핑 보통주
9282,23530,2020-04-02,0.0505617977528089,71200,74800,3600,137747,23530.0,롯데쇼핑 보통주
9283,23530,2020-04-01,0.0506666666666666,75000,71200,-3800,115342,23530.0,롯데쇼핑 보통주
9284,23530,2020-03-25,0.1338709677419355,62000,70300,8300,542774,23530.0,롯데쇼핑 보통주
9285,23530,2020-03-24,0.0634648370497427,58300,62000,3700,228180,23530.0,롯데쇼핑 보통주
9286,23530,2020-03-23,0.0804416403785489,63400,58300,-5100,188896,23530.0,롯데쇼핑 보통주
9287,23530,2020-03-20,0.0479338842975206,60500,63400,2900,255489,23530.0,롯데쇼핑 보통주
9288,23530,2020-03-19,0.1357142857142857,70000,60500,-9500,321396,23530.0,롯데쇼핑 보통주
9289,23530,2020-03-18,0.0591397849462365,74400,70000,-4400,176478,23530.0,롯데쇼핑 보통주
9290,23530,2020-03-13,0.0512195121951219,82000,77800,-4200,331997,23530.0,롯데쇼핑 보통주
9291,23530,2020-03-12,0.0827740492170022,89400,82000,-7400,377755,23530.0,롯데쇼핑 보통주
9292,23530,2020-03-06,0.0434782608695652,98900,94600,-4300,192281,23530.0,롯데쇼핑 보통주
9293,23530,2020-02-24,0.0516746411483253,104500,99100,-5400,268506,23530.0,롯데쇼핑 보통주
9294,23530,2020-02-20,0.0446428571428571,112000,107000,-5000,193999,23530.0,롯데쇼핑 보통주
9295,23530,2020-02-14,0.0411522633744856,121500,116500,-5000,224033,23530.0,롯데쇼핑 보통주
9296,23530,2020-01-28,0.073076923076923,130000,120500,-9500,243214,23530.0,롯데쇼핑 보통주
9297,23530,2020-01-13,0.0505836575875486,128500,135000,6500,169220,23530.0,롯데쇼핑 보통주
9298,23530,2019-11-28,0.0463320463320463,129500,135500,6000,144894,23530.0,롯데쇼핑 보통주
9299,23530,2019-11-06,0.0459770114942528,130500,136500,6000,189803,23530.0,롯데쇼핑 보통주
9300,23530,2019-11-04,0.0612244897959183,122500,130000,7500,178989,23530.0,롯데쇼핑 보통주
9301,23530,2019-09-27,0.0512820512820512,136500,129500,-7000,161883,23530.0,롯데쇼핑 보통주
9302,23530,2019-08-28,0.0416666666666666,132000,137500,5500,140746,23530.0,롯데쇼핑 보통주
9303,23530,2019-08-19,0.0456431535269709,120500,126000,5500,90160,23530.0,롯데쇼핑 보통주
9304,23530,2019-08-05,0.0413533834586466,133000,127500,-5500,177101,23530.0,롯데쇼핑 보통주
9305,23530,2019-07-15,0.0476190476190476,147000,140000,-7000,224319,23530.0,롯데쇼핑 보통주
9306,23530,2019-07-09,0.0412698412698412,157500,151000,-6500,148883,23530.0,롯데쇼핑 보통주
9307,23530,2019-01-02,0.0402843601895734,211000,202500,-8500,96043,23530.0,롯데쇼핑 보통주
9308,23530,2018-11-19,0.0412844036697247,218000,227000,9000,139499,23530.0,롯데쇼핑 보통주
9309,23530,2018-09-20,0.0403022670025188,198500,206500,8000,189262,23530.0,롯데쇼핑 보통주
9310,23530,2018-09-13,0.0614973262032085,187000,198500,11500,291810,23530.0,롯데쇼핑 보통주
9311,23530,2018-08-16,0.0471204188481675,191000,182000,-9000,213952,23530.0,롯데쇼핑 보통주
9312,23530,2018-08-13,0.0709046454767726,204500,190000,-14500,303251,23530.0,롯데쇼핑 보통주
9313,23530,2018-07-06,0.0463414634146341,205000,214500,9500,105502,23530.0,롯데쇼핑 보통주
9314,23530,2018-05-03,0.0511811023622047,254000,241000,-13000,119180,23530.0,롯데쇼핑 보통주
9315,23530,2018-04-02,0.0660980810234541,234500,250000,15500,347397,23530.0,롯데쇼핑 보통주
9316,23530,2018-03-09,0.0709219858156028,211500,226500,15000,333207,23530.0,롯데쇼핑 보통주
9317,23530,2018-03-08,0.0628140703517587,199000,211500,12500,170712,23530.0,롯데쇼핑 보통주
9318,23530,2018-02-13,0.0415754923413566,228500,219000,-9500,151094,23530.0,롯데쇼핑 보통주
9319,23530,2018-02-09,0.078,250000,230500,-19500,333896,23530.0,롯데쇼핑 보통주
9320,23530,2018-02-08,0.0416666666666666,240000,250000,10000,152505,23530.0,롯데쇼핑 보통주
9321,23530,2018-02-07,0.060665362035225,255500,240000,-15500,196133,23530.0,롯데쇼핑 보통주
9322,23530,2018-01-26,0.0550660792951541,227000,239500,12500,246252,23530.0,롯데쇼핑 보통주
9323,23530,2018-01-04,0.0611246943765281,204500,217000,12500,367139,23530.0,롯데쇼핑 보통주
9324,23530,2017-11-22,0.0444444444444444,225000,215000,-10000,659011,23530.0,롯데쇼핑 보통주
9325,23530,2017-11-20,0.0402684563758389,223500,232500,9000,157374,23530.0,롯데쇼핑 보통주
9326,23530,2017-11-03,0.0434782608695652,218500,228000,9500,133209,23530.0,롯데쇼핑 보통주
9327,23530,2017-10-31,0.0714285714285714,210000,225000,15000,608422,23530.0,롯데쇼핑 보통주
9328,23530,2017-10-30,0.0649087221095334,246500,210000,-36500,860328,23530.0,롯데쇼핑 보통주
9329,23530,2017-09-26,0.0835214446952596,221500,240000,18500,321780,23530.0,롯데쇼핑 보통주
9330,23530,2017-09-20,0.0454545454545454,231000,220500,-10500,227991,23530.0,롯데쇼핑 보통주
9331,23530,2017-09-15,0.084090909090909,220000,238500,18500,542868,23530.0,롯데쇼핑 보통주
9332,23530,2017-09-01,0.0525291828793774,257000,243500,-13500,260659,23530.0,롯데쇼핑 보통주
9333,23530,2017-08-30,0.0424354243542435,271000,259500,-11500,141980,23530.0,롯데쇼핑 보통주
9334,23530,2017-08-21,0.0429906542056074,267500,256000,-11500,92616,23530.0,롯데쇼핑 보통주
9335,23530,2017-08-17,0.0920245398773006,244500,267000,22500,200423,23530.0,롯데쇼핑 보통주
9336,23530,2017-08-14,0.0406189555125725,258500,248000,-10500,115619,23530.0,롯데쇼핑 보통주
9337,23530,2017-07-31,0.0852173913043478,287500,263000,-24500,315387,23530.0,롯데쇼핑 보통주
9338,23530,2017-06-27,0.0545144804088586,293500,309500,16000,107378,23530.0,롯데쇼핑 보통주
9339,23530,2017-06-08,0.0422297297297297,296000,308500,12500,191370,23530.0,롯데쇼핑 보통주
9340,23530,2017-06-02,0.0436300174520069,286500,299000,12500,135212,23530.0,롯데쇼핑 보통주
9341,23530,2017-05-15,0.049618320610687,262000,275000,13000,229290,23530.0,롯데쇼핑 보통주
9342,23530,2017-04-27,0.0530451866404715,254500,268000,13500,580374,23530.0,롯데쇼핑 보통주
9343,23530,2017-04-21,0.044776119402985,234500,245000,10500,366929,23530.0,롯데쇼핑 보통주
9344,23530,2017-04-20,0.0445434298440979,224500,234500,10000,204953,23530.0,롯데쇼핑 보통주
9345,23530,2017-03-02,0.0735930735930736,231000,214000,-17000,407547,23530.0,롯데쇼핑 보통주
9346,23530,2017-02-17,0.0610236220472441,254000,238500,-15500,2679038,23530.0,롯데쇼핑 보통주
9347,23530,2017-02-10,0.0607375271149674,230500,244500,14000,165488,23530.0,롯데쇼핑 보통주
9348,23530,2017-01-20,0.0508083140877598,216500,227500,11000,253840,23530.0,롯데쇼핑 보통주
9349,23530,2016-12-15,0.041002277904328,219500,228500,9000,75276,23530.0,롯데쇼핑 보통주
9350,23530,2016-11-07,0.0525114155251141,219000,230500,11500,116370,23530.0,롯데쇼핑 보통주
9351,23530,2016-08-16,0.053030303030303,198000,208500,10500,206716,23530.0,롯데쇼핑 보통주
9352,23590,2021-05-13,0.0492091388400703,28450,27050,-1400,299273,23590.0,다우기술보통주
9353,23590,2021-05-10,0.048780487804878,26650,27950,1300,561052,23590.0,다우기술보통주
9354,23590,2021-02-25,0.0505836575875486,25700,27000,1300,440997,23590.0,다우기술보통주
9355,23590,2021-01-29,0.0533807829181494,28100,26600,-1500,1305537,23590.0,다우기술보통주
9356,23590,2021-01-27,0.0493358633776091,26350,27650,1300,4030735,23590.0,다우기술보통주
9357,23590,2021-01-26,0.0979166666666666,24000,26350,2350,4413622,23590.0,다우기술보통주
9358,23590,2020-12-01,0.0533642691415313,21550,22700,1150,793024,23590.0,다우기술보통주
9359,23590,2020-11-26,0.0452380952380952,21000,21950,950,542375,23590.0,다우기술보통주
9360,23590,2020-11-23,0.0412621359223301,20600,21450,850,385245,23590.0,다우기술보통주
9361,23590,2020-11-16,0.050251256281407,19900,20900,1000,572391,23590.0,다우기술보통주
9362,23590,2020-10-26,0.0422885572139303,20100,19250,-850,293093,23590.0,다우기술보통주
9363,23590,2020-09-24,0.0604026845637583,22350,21000,-1350,343333,23590.0,다우기술보통주
9364,23590,2020-09-21,0.0446808510638297,23500,22450,-1050,481937,23590.0,다우기술보통주
9365,23590,2020-09-15,0.0558882235528942,25050,23650,-1400,987342,23590.0,다우기술보통주
9366,23590,2020-09-11,0.0956521739130434,23000,25200,2200,5575521,23590.0,다우기술보통주
9367,23590,2020-09-08,0.1321695760598503,20050,22700,2650,5439309,23590.0,다우기술보통주
9368,23590,2020-08-24,0.0445026178010471,19100,19950,850,139050,23590.0,다우기술보통주
9369,23590,2020-08-20,0.0597014925373134,20100,18900,-1200,278407,23590.0,다우기술보통주
9370,23590,2020-07-14,0.0421052631578947,23750,22750,-1000,443021,23590.0,다우기술보통주
9371,23590,2020-07-10,0.1148325358851674,20900,23300,2400,4139965,23590.0,다우기술보통주
9372,23590,2020-06-22,0.0421836228287841,20150,21000,850,1576174,23590.0,다우기술보통주
9373,23590,2020-06-18,0.0775401069518716,18700,20150,1450,1703857,23590.0,다우기술보통주
9374,23590,2020-06-16,0.0457142857142857,17500,18300,800,313976,23590.0,다우기술보통주
9375,23590,2020-06-15,0.0641711229946524,18700,17500,-1200,348577,23590.0,다우기술보통주
9376,23590,2020-05-25,0.050531914893617,18800,19750,950,487220,23590.0,다우기술보통주
9377,23590,2020-05-15,0.0440097799511002,20450,19550,-900,1987427,23590.0,다우기술보통주
9378,23590,2020-05-12,0.088,18750,20400,1650,4874771,23590.0,다우기술보통주
9379,23590,2020-05-08,0.0539845758354755,19450,18400,-1050,3699908,23590.0,다우기술보통주
9380,23590,2020-05-07,0.1932515337423312,16300,19450,3150,8024188,23590.0,다우기술보통주
9381,23590,2020-04-17,0.0485436893203883,15450,16200,750,236051,23590.0,다우기술보통주
9382,23590,2020-03-31,0.0422535211267605,14200,14800,600,201911,23590.0,다우기술보통주
9383,23590,2020-03-25,0.0766129032258064,12400,13350,950,214541,23590.0,다우기술보통주
9384,23590,2020-03-24,0.0508474576271186,11800,12400,600,181339,23590.0,다우기술보통주
9385,23590,2020-03-23,0.099236641221374,13100,11800,-1300,256047,23590.0,다우기술보통주
9386,23590,2020-03-20,0.0916666666666666,12000,13100,1100,271398,23590.0,다우기술보통주
9387,23590,2020-03-19,0.1335740072202166,13850,12000,-1850,277811,23590.0,다우기술보통주
9388,23590,2020-03-13,0.0803858520900321,15550,14300,-1250,452257,23590.0,다우기술보통주
9389,23590,2020-03-12,0.0518292682926829,16400,15550,-850,140232,23590.0,다우기술보통주
9390,23590,2020-02-28,0.044776119402985,16750,16000,-750,374688,23590.0,다우기술보통주
9391,23590,2020-01-28,0.0474934036939313,18950,18050,-900,166553,23590.0,다우기술보통주
9392,23590,2019-08-16,0.0448877805486284,20050,19150,-900,115970,23590.0,다우기술보통주
9393,23590,2019-08-02,0.0479616306954436,20850,19850,-1000,283362,23590.0,다우기술보통주
9394,23590,2019-07-17,0.0411899313501144,21850,20950,-900,98250,23590.0,다우기술보통주
9395,23590,2019-07-16,0.0581113801452784,20650,21850,1200,146393,23590.0,다우기술보통주
9396,23590,2019-06-03,0.0462287104622871,20550,21500,950,164856,23590.0,다우기술보통주
9397,23590,2019-05-27,0.1741803278688524,24400,20150,-4250,992065,23590.0,다우기술보통주
9398,23590,2019-05-23,0.0623655913978494,23250,24700,1450,535895,23590.0,다우기술보통주
9399,23590,2019-04-04,0.0559284116331096,22350,23600,1250,218956,23590.0,다우기술보통주
9400,23590,2019-03-25,0.0444444444444444,22500,21500,-1000,75929,23590.0,다우기술보통주
9401,23590,2019-03-15,0.0413793103448275,21750,22650,900,125519,23590.0,다우기술보통주
9402,23590,2019-01-24,0.1028277634961439,19450,21450,2000,849224,23590.0,다우기술보통주
9403,23590,2018-12-10,0.0492227979274611,19300,18350,-950,198747,23590.0,다우기술보통주
9404,23590,2018-10-31,0.0554089709762532,18950,20000,1050,80020,23590.0,다우기술보통주
9405,23590,2018-10-29,0.0446650124069478,20150,19250,-900,90741,23590.0,다우기술보통주
9406,23590,2018-10-23,0.0467289719626168,21400,20400,-1000,47372,23590.0,다우기술보통주
9407,23590,2018-10-11,0.068235294117647,21250,19800,-1450,231001,23590.0,다우기술보통주
9408,23590,2018-08-13,0.048582995951417,24700,23500,-1200,141705,23590.0,다우기술보통주
9409,23590,2018-08-08,0.0428265524625267,23350,24350,1000,326180,23590.0,다우기술보통주
9410,23590,2018-07-24,0.0426008968609865,22300,23250,950,133586,23590.0,다우기술보통주
9411,23590,2018-06-15,0.0423387096774193,24800,23750,-1050,186451,23590.0,다우기술보통주
9412,23590,2018-06-07,0.0522088353413654,24900,26200,1300,414449,23590.0,다우기술보통주
9413,23590,2018-05-28,0.0610997963340122,24550,26050,1500,189105,23590.0,다우기술보통주
9414,23590,2018-05-15,0.0485074626865671,26800,25500,-1300,401923,23590.0,다우기술보통주
9415,23590,2018-05-11,0.0638722554890219,25050,26650,1600,435374,23590.0,다우기술보통주
9416,23590,2018-05-04,0.0454545454545454,24200,25300,1100,445334,23590.0,다우기술보통주
9417,23590,2018-04-27,0.0575221238938053,22600,23900,1300,429729,23590.0,다우기술보통주
9418,23590,2018-04-13,0.0514541387024608,22350,23500,1150,355822,23590.0,다우기술보통주
9419,23590,2018-03-28,0.0638766519823788,22700,21250,-1450,388582,23590.0,다우기술보통주
9420,23590,2018-03-23,0.0403397027600849,23550,22600,-950,289709,23590.0,다우기술보통주
9421,23590,2018-03-13,0.0450819672131147,24400,23300,-1100,253222,23590.0,다우기술보통주
9422,23590,2018-03-09,0.0453563714902807,23150,24200,1050,210453,23590.0,다우기술보통주
9423,23590,2018-02-07,0.0406976744186046,25800,24750,-1050,376610,23590.0,다우기술보통주
9424,23590,2018-02-01,0.0658682634730539,25050,26700,1650,468720,23590.0,다우기술보통주
9425,23590,2018-01-24,0.0479166666666666,24000,25150,1150,827594,23590.0,다우기술보통주
9426,23590,2018-01-11,0.0892857142857142,22400,20400,-2000,1695447,23590.0,다우기술보통주
9427,23590,2018-01-08,0.0519187358916478,22150,23300,1150,1249347,23590.0,다우기술보통주
9428,23590,2018-01-05,0.1627296587926509,19050,22150,3100,2216327,23590.0,다우기술보통주
9429,23590,2017-12-15,0.0524934383202099,19050,20050,1000,226449,23590.0,다우기술보통주
9430,23590,2017-11-09,0.05420054200542,18450,19450,1000,682187,23590.0,다우기술보통주
9431,23590,2017-08-03,0.0452488687782805,22100,21100,-1000,248907,23590.0,다우기술보통주
9432,23590,2017-07-13,0.0465116279069767,21500,22500,1000,583612,23590.0,다우기술보통주
9433,23590,2017-06-20,0.0407673860911271,20850,21700,850,431107,23590.0,다우기술보통주
9434,23590,2017-05-25,0.0613810741687979,19550,20750,1200,728757,23590.0,다우기술보통주
9435,23590,2017-04-21,0.0507614213197969,19700,20700,1000,665341,23590.0,다우기술보통주
9436,23590,2017-04-13,0.0419947506561679,19050,19850,800,185739,23590.0,다우기술보통주
9437,23590,2017-03-16,0.0849858356940509,17650,19150,1500,502067,23590.0,다우기술보통주
9438,23590,2017-02-01,0.0422535211267605,17750,18500,750,348934,23590.0,다우기술보통주
9439,23590,2017-01-03,0.0480225988700565,17700,18550,850,254400,23590.0,다우기술보통주
9440,23590,2016-12-08,0.0493827160493827,16200,17000,800,489190,23590.0,다우기술보통주
9441,23590,2016-12-05,0.0623145400593471,16850,15800,-1050,1009342,23590.0,다우기술보통주
9442,23590,2016-12-02,0.0664819944598338,18050,16850,-1200,810933,23590.0,다우기술보통주
9443,23590,2016-11-16,0.0497512437810945,20100,21100,1000,368062,23590.0,다우기술보통주
9444,23590,2016-11-09,0.0448877805486284,20050,19150,-900,267281,23590.0,다우기술보통주
9445,23590,2016-11-02,0.064039408866995,20300,19000,-1300,231947,23590.0,다우기술보통주
9446,23590,2016-10-27,0.0614250614250614,20350,21600,1250,163651,23590.0,다우기술보통주
9447,23590,2016-09-26,0.0432801822323462,21950,22900,950,341792,23590.0,다우기술보통주
9448,23590,2016-09-23,0.0402843601895734,21100,21950,850,575437,23590.0,다우기술보통주
9449,23590,2016-08-31,0.0453514739229024,22050,21050,-1000,478282,23590.0,다우기술보통주
9450,23590,2016-08-17,0.0560928433268858,25850,24400,-1450,258293,23590.0,다우기술보통주
9451,24110,2021-05-06,0.0661764705882353,9520,10150,630,8653675,24110.0,중소기업은행보통주
9452,24110,2021-02-01,0.0421455938697318,7830,8160,330,2696592,24110.0,중소기업은행보통주
9453,24110,2020-12-29,0.0632911392405063,9480,8880,-600,6722586,24110.0,중소기업은행보통주
9454,24110,2020-11-11,0.0440180586907449,8860,9250,390,5795663,24110.0,중소기업은행보통주
9455,24110,2020-08-18,0.0459770114942528,8700,8300,-400,2600765,24110.0,중소기업은행보통주
9456,24110,2020-06-16,0.0709987966305655,8310,8900,590,2692428,24110.0,중소기업은행보통주
9457,24110,2020-06-11,0.0474137931034482,9280,8840,-440,6190796,24110.0,중소기업은행보통주
9458,24110,2020-06-03,0.0811111111111111,9000,9730,730,8315050,24110.0,중소기업은행보통주
9459,24110,2020-06-02,0.0613207547169811,8480,9000,520,5549703,24110.0,중소기업은행보통주
9460,24110,2020-04-27,0.0583333333333333,7200,7620,420,4822565,24110.0,중소기업은행보통주
9461,24110,2020-04-10,0.0412782956058588,7510,7820,310,3715056,24110.0,중소기업은행보통주
9462,24110,2020-04-01,0.0453333333333333,7500,7160,-340,2277600,24110.0,중소기업은행보통주
9463,24110,2020-03-25,0.1032934131736526,6680,7370,690,3811848,24110.0,중소기업은행보통주
9464,24110,2020-03-24,0.0897226753670473,6130,6680,550,2411046,24110.0,중소기업은행보통주
9465,24110,2020-03-23,0.0740181268882175,6620,6130,-490,2587895,24110.0,중소기업은행보통주
9466,24110,2020-03-20,0.1277683134582623,5870,6620,750,3698474,24110.0,중소기업은행보통주
9467,24110,2020-03-19,0.0983102918586789,6510,5870,-640,4156109,24110.0,중소기업은행보통주
9468,24110,2020-03-17,0.0549295774647887,7100,6710,-390,3685283,24110.0,중소기업은행보통주
9469,24110,2020-03-16,0.046979865771812,7450,7100,-350,3104062,24110.0,중소기업은행보통주
9470,24110,2020-03-13,0.0581542351453855,7910,7450,-460,4868340,24110.0,중소기업은행보통주
9471,24110,2020-03-12,0.0605700712589073,8420,7910,-510,4060421,24110.0,중소기업은행보통주
9472,24110,2020-03-09,0.0554323725055432,9020,8520,-500,2732695,24110.0,중소기업은행보통주
9473,24110,2020-02-24,0.0424242424242424,9900,9480,-420,2460837,24110.0,중소기업은행보통주
9474,24110,2019-12-27,0.048,12500,11900,-600,3927328,24110.0,중소기업은행보통주
9475,24110,2019-10-28,0.0472440944881889,12700,12100,-600,3066015,24110.0,중소기업은행보통주
9476,24110,2019-09-27,0.0410447761194029,13400,12850,-550,1332146,24110.0,중소기업은행보통주
9477,24110,2018-12-27,0.0570469798657718,14900,14050,-850,2245045,24110.0,중소기업은행보통주
9478,24110,2018-10-11,0.0529801324503311,15100,14300,-800,1756133,24110.0,중소기업은행보통주
9479,24110,2018-05-30,0.0402476780185758,16150,15500,-650,1242527,24110.0,중소기업은행보통주
9480,24110,2018-03-28,0.04,16250,15600,-650,1584396,24110.0,중소기업은행보통주
9481,24110,2018-03-23,0.044776119402985,16750,16000,-750,1118913,24110.0,중소기업은행보통주
9482,24110,2018-02-12,0.0477707006369426,15700,16450,750,1044690,24110.0,중소기업은행보통주
9483,24110,2018-02-06,0.0467836257309941,17100,16300,-800,1704529,24110.0,중소기업은행보통주
9484,24110,2017-09-05,0.0477815699658703,14650,13950,-700,2874363,24110.0,중소기업은행보통주
9485,24110,2017-07-10,0.0424028268551236,14150,14750,600,2138936,24110.0,중소기업은행보통주
9486,24110,2017-02-15,0.0413533834586466,13300,12750,-550,4712661,24110.0,중소기업은행보통주
9487,26960,2021-05-03,0.0445151033386327,31450,30050,-1400,293999,26960.0,동서보통주
9488,26960,2021-04-20,0.0453125,32000,33450,1450,288184,26960.0,동서보통주
9489,26960,2021-03-29,0.0425531914893617,32900,31500,-1400,304956,26960.0,동서보통주
9490,26960,2021-03-25,0.0566572237960339,35300,33300,-2000,427117,26960.0,동서보통주
9491,26960,2021-03-18,0.0910493827160493,32400,35350,2950,431078,26960.0,동서보통주
9492,26960,2021-03-12,0.0769230769230769,29250,31500,2250,600734,26960.0,동서보통주
9493,26960,2021-03-08,0.0774962742175856,33550,30950,-2600,1192002,26960.0,동서보통주
9494,26960,2021-03-05,0.1746617466174661,40650,33550,-7100,2281358,26960.0,동서보통주
9495,26960,2021-02-19,0.0616352201257861,39750,42200,2450,495177,26960.0,동서보통주
9496,26960,2021-02-15,0.0623529411764705,42500,39850,-2650,639048,26960.0,동서보통주
9497,26960,2021-02-10,0.0897435897435897,39000,42500,3500,933572,26960.0,동서보통주
9498,26960,2021-02-05,0.1273792093704246,34150,38500,4350,1620250,26960.0,동서보통주
9499,26960,2021-02-04,0.0427480916030534,32750,34150,1400,428672,26960.0,동서보통주
9500,26960,2021-01-26,0.0576631259484066,32950,31050,-1900,396943,26960.0,동서보통주
9501,26960,2020-12-16,0.040650406504065,30750,32000,1250,241265,26960.0,동서보통주
9502,26960,2020-11-30,0.0461538461538461,32500,34000,1500,695527,26960.0,동서보통주
9503,26960,2020-11-27,0.1304347826086956,28750,32500,3750,1044627,26960.0,동서보통주
9504,26960,2020-10-06,0.0604026845637583,29800,28000,-1800,437285,26960.0,동서보통주
9505,26960,2020-09-21,0.0471204188481675,28650,30000,1350,320271,26960.0,동서보통주
9506,26960,2020-09-18,0.0418181818181818,27500,28650,1150,161745,26960.0,동서보통주
9507,26960,2020-09-14,0.0425925925925925,27000,28150,1150,230229,26960.0,동서보통주
9508,26960,2020-09-08,0.0638722554890219,25050,26650,1600,407389,26960.0,동서보통주
9509,26960,2020-08-21,0.048832271762208,23550,24700,1150,332931,26960.0,동서보통주
9510,26960,2020-08-20,0.074656188605108,25450,23550,-1900,498899,26960.0,동서보통주
9511,26960,2020-08-19,0.0604166666666666,24000,25450,1450,377721,26960.0,동서보통주
9512,26960,2020-08-14,0.047191011235955,22250,23300,1050,278620,26960.0,동서보통주
9513,26960,2020-07-27,0.0833333333333333,19200,20800,1600,476676,26960.0,동서보통주
9514,26960,2020-07-16,0.0835913312693498,16150,17500,1350,583298,26960.0,동서보통주
9515,26960,2020-06-01,0.0419161676646706,16700,17400,700,90773,26960.0,동서보통주
9516,26960,2020-03-19,0.0490196078431372,15300,14550,-750,180011,26960.0,동서보통주
9517,26960,2020-03-18,0.0407523510971786,15950,15300,-650,94104,26960.0,동서보통주
9518,26960,2019-12-27,0.0435967302452316,18350,17550,-800,120262,26960.0,동서보통주
9519,26960,2019-05-29,0.0537897310513447,20450,19350,-1100,215735,26960.0,동서보통주
9520,26960,2019-05-10,0.0633245382585752,18950,20150,1200,209514,26960.0,동서보통주
9521,26960,2019-03-14,0.0554216867469879,20750,21900,1150,482684,26960.0,동서보통주
9522,26960,2019-02-28,0.0595238095238095,21000,19750,-1250,361975,26960.0,동서보통주
9523,26960,2019-02-27,0.1170212765957446,18800,21000,2200,696154,26960.0,동서보통주
9524,26960,2019-01-04,0.0401146131805157,17450,18150,700,142643,26960.0,동서보통주
9525,26960,2018-11-20,0.0610465116279069,17200,18250,1050,310881,26960.0,동서보통주
9526,26960,2018-11-14,0.0644257703081232,17850,16700,-1150,785522,26960.0,동서보통주
9527,26960,2018-10-31,0.0418994413407821,17900,18650,750,147437,26960.0,동서보통주
9528,26960,2018-09-20,0.0679611650485436,20600,22000,1400,308189,26960.0,동서보통주
9529,26960,2017-12-15,0.0451263537906137,27700,28950,1250,188725,26960.0,동서보통주
9530,26960,2017-11-20,0.0415944540727903,28850,30050,1200,217031,26960.0,동서보통주
9531,26960,2017-05-24,0.0502354788069073,31850,33450,1600,292051,26960.0,동서보통주
9532,26960,2017-04-05,0.0433333333333333,30000,31300,1300,180116,26960.0,동서보통주
9533,26960,2017-03-21,0.0520231213872832,25950,27300,1350,268108,26960.0,동서보통주
9534,28050,2021-06-02,0.0529100529100529,18900,19900,1000,5243489,28050.0,삼성엔지니어링보통주
9535,28050,2021-05-26,0.0434782608695652,19550,18700,-850,4437406,28050.0,삼성엔지니어링보통주
9536,28050,2021-05-18,0.0426666666666666,18750,19550,800,3978098,28050.0,삼성엔지니어링보통주
9537,28050,2021-05-11,0.0726256983240223,17900,19200,1300,7301175,28050.0,삼성엔지니어링보통주
9538,28050,2021-05-06,0.0650887573964497,16900,18000,1100,4995155,28050.0,삼성엔지니어링보통주
9539,28050,2021-05-04,0.0532212885154061,17850,16900,-950,6579569,28050.0,삼성엔지니어링보통주
9540,28050,2021-04-26,0.0638977635782747,15650,16650,1000,6167997,28050.0,삼성엔지니어링보통주
9541,28050,2021-04-15,0.064516129032258,13950,14850,900,14510847,28050.0,삼성엔지니어링보통주
9542,28050,2021-03-23,0.0425531914893617,14100,13500,-600,3140131,28050.0,삼성엔지니어링보통주
9543,28050,2021-03-08,0.05859375,12800,13550,750,6204871,28050.0,삼성엔지니어링보통주
9544,28050,2021-02-24,0.040590405904059,13550,13000,-550,1660158,28050.0,삼성엔지니어링보통주
9545,28050,2021-02-23,0.0423076923076923,13000,13550,550,2999903,28050.0,삼성엔지니어링보통주
9546,28050,2021-01-29,0.053639846743295,13050,12350,-700,2893642,28050.0,삼성엔지니어링보통주
9547,28050,2020-11-16,0.0836820083682008,11950,12950,1000,7529222,28050.0,삼성엔지니어링보통주
9548,28050,2020-11-10,0.0611353711790393,11450,12150,700,9164978,28050.0,삼성엔지니어링보통주
9549,28050,2020-10-30,0.1298076923076923,10400,11750,1350,30355537,28050.0,삼성엔지니어링보통주
9550,28050,2020-10-16,0.058252427184466,10300,10900,600,2133466,28050.0,삼성엔지니어링보통주
9551,28050,2020-08-20,0.0460251046025104,11950,11400,-550,1856984,28050.0,삼성엔지니어링보통주
9552,28050,2020-08-18,0.0443548387096774,12400,11850,-550,1702325,28050.0,삼성엔지니어링보통주
9553,28050,2020-07-15,0.0541666666666666,12000,12650,650,3717863,28050.0,삼성엔지니어링보통주
9554,28050,2020-07-06,0.0413223140495867,12100,12600,500,1329656,28050.0,삼성엔지니어링보통주
9555,28050,2020-06-30,0.047008547008547,11700,12250,550,1689659,28050.0,삼성엔지니어링보통주
9556,28050,2020-06-25,0.040650406504065,12300,11800,-500,1317534,28050.0,삼성엔지니어링보통주
9557,28050,2020-06-16,0.0565217391304347,11500,12150,650,1485493,28050.0,삼성엔지니어링보통주
9558,28050,2020-06-15,0.0763052208835341,12450,11500,-950,2312235,28050.0,삼성엔지니어링보통주
9559,28050,2020-06-12,0.0459770114942528,13050,12450,-600,2470115,28050.0,삼성엔지니어링보통주
9560,28050,2020-06-03,0.0927419354838709,12400,13550,1150,8146839,28050.0,삼성엔지니어링보통주
9561,28050,2020-05-28,0.0411522633744856,12150,11650,-500,3675531,28050.0,삼성엔지니어링보통주
9562,28050,2020-05-27,0.0611353711790393,11450,12150,700,5313934,28050.0,삼성엔지니어링보통주
9563,28050,2020-05-19,0.0495495495495495,11100,11650,550,3301584,28050.0,삼성엔지니어링보통주
9564,28050,2020-05-06,0.072072072072072,11100,11900,800,3456511,28050.0,삼성엔지니어링보통주
9565,28050,2020-04-29,0.0407239819004524,11050,11500,450,3139442,28050.0,삼성엔지니어링보통주
9566,28050,2020-04-17,0.0409090909090909,11000,11450,450,2764096,28050.0,삼성엔지니어링보통주
9567,28050,2020-04-02,0.0486322188449848,9870,10350,480,3355276,28050.0,삼성엔지니어링보통주
9568,28050,2020-03-26,0.0733262486716259,9410,10100,690,7857943,28050.0,삼성엔지니어링보통주
9569,28050,2020-03-25,0.2079589216944801,7790,9410,1620,6919451,28050.0,삼성엔지니어링보통주
9570,28050,2020-03-24,0.1018387553041018,7070,7790,720,2771615,28050.0,삼성엔지니어링보통주
9571,28050,2020-03-23,0.073394495412844,7630,7070,-560,2523898,28050.0,삼성엔지니어링보통주
9572,28050,2020-03-20,0.0792079207920792,7070,7630,560,3918606,28050.0,삼성엔지니어링보통주
9573,28050,2020-03-19,0.1228287841191067,8060,7070,-990,6956184,28050.0,삼성엔지니어링보통주
9574,28050,2020-03-18,0.1825557809330628,9860,8060,-1800,7548719,28050.0,삼성엔지니어링보통주
9575,28050,2020-03-17,0.0741784037558685,10650,9860,-790,4370610,28050.0,삼성엔지니어링보통주
9576,28050,2020-03-16,0.0405405405405405,11100,10650,-450,1731143,28050.0,삼성엔지니어링보통주
9577,28050,2020-03-13,0.0672268907563025,11900,11100,-800,3387922,28050.0,삼성엔지니어링보통주
9578,28050,2020-03-12,0.0517928286852589,12550,11900,-650,2013921,28050.0,삼성엔지니어링보통주
9579,28050,2020-03-09,0.086021505376344,13950,12750,-1200,2783576,28050.0,삼성엔지니어링보통주
9580,28050,2020-02-24,0.0521172638436482,15350,14550,-800,1630190,28050.0,삼성엔지니어링보통주
9581,28050,2020-02-06,0.0489296636085626,16350,17150,800,1755947,28050.0,삼성엔지니어링보통주
9582,28050,2020-02-03,0.0405797101449275,17250,16550,-700,1801090,28050.0,삼성엔지니어링보통주
9583,28050,2019-11-04,0.047486033519553,17900,18750,850,1977773,28050.0,삼성엔지니어링보통주
9584,28050,2019-10-30,0.056547619047619,16800,17750,950,2966313,28050.0,삼성엔지니어링보통주
9585,28050,2019-09-16,0.060790273556231,16450,17450,1000,2261619,28050.0,삼성엔지니어링보통주
9586,28050,2019-07-29,0.0420711974110032,15450,16100,650,1467653,28050.0,삼성엔지니어링보통주
9587,28050,2019-06-03,0.0988023952095808,16700,15050,-1650,5741163,28050.0,삼성엔지니어링보통주
9588,28050,2019-04-23,0.0407523510971786,15950,16600,650,1565886,28050.0,삼성엔지니어링보통주
9589,28050,2019-02-01,0.0686567164179104,16750,15600,-1150,6061856,28050.0,삼성엔지니어링보통주
9590,28050,2018-12-27,0.0542168674698795,16600,17500,900,1341636,28050.0,삼성엔지니어링보통주
9591,28050,2018-12-19,0.0404312668463611,18550,17800,-750,2904711,28050.0,삼성엔지니어링보통주
9592,28050,2018-11-28,0.0616246498599439,17850,18950,1100,2453256,28050.0,삼성엔지니어링보통주
9593,28050,2018-11-14,0.0630136986301369,18250,17100,-1150,3059170,28050.0,삼성엔지니어링보통주
9594,28050,2018-11-01,0.0410958904109589,18250,17500,-750,1470488,28050.0,삼성엔지니어링보통주
9595,28050,2018-10-30,0.0406976744186046,17200,17900,700,1666375,28050.0,삼성엔지니어링보통주
9596,28050,2018-10-29,0.0617283950617283,16200,17200,1000,2821508,28050.0,삼성엔지니어링보통주
9597,28050,2018-10-26,0.0470588235294117,17000,16200,-800,1520051,28050.0,삼성엔지니어링보통주
9598,28050,2018-10-11,0.0690537084398976,19550,18200,-1350,2602240,28050.0,삼성엔지니어링보통주
9599,28050,2018-09-28,0.0575342465753424,18250,19300,1050,4141605,28050.0,삼성엔지니어링보통주
9600,28050,2018-09-13,0.042042042042042,16650,17350,700,2419127,28050.0,삼성엔지니어링보통주
9601,28050,2018-09-10,0.04,16250,16900,650,1448697,28050.0,삼성엔지니어링보통주
9602,28050,2018-07-23,0.0436241610738255,14900,15550,650,1513961,28050.0,삼성엔지니어링보통주
9603,28050,2018-07-02,0.0447284345047923,15650,14950,-700,1056619,28050.0,삼성엔지니어링보통주
9604,28050,2018-06-20,0.0620689655172413,14500,15400,900,1951293,28050.0,삼성엔지니어링보통주
9605,28050,2018-06-01,0.062330623306233,18450,17300,-1150,5870197,28050.0,삼성엔지니어링보통주
9606,28050,2018-05-21,0.0668316831683168,20200,18850,-1350,20435332,28050.0,삼성엔지니어링보통주
9607,28050,2018-05-14,0.0647887323943662,17750,18900,1150,5004824,28050.0,삼성엔지니어링보통주
9608,28050,2018-04-30,0.0466472303206997,17150,17950,800,2093324,28050.0,삼성엔지니어링보통주
9609,28050,2018-04-05,0.0462427745664739,17300,18100,800,2562080,28050.0,삼성엔지니어링보통주
9610,28050,2018-03-13,0.05,18000,17100,-900,5989833,28050.0,삼성엔지니어링보통주
9611,28050,2018-03-12,0.081081081081081,16650,18000,1350,5866300,28050.0,삼성엔지니어링보통주
9612,28050,2018-03-06,0.0622950819672131,15250,16200,950,1936892,28050.0,삼성엔지니어링보통주
9613,28050,2018-02-19,0.0453074433656957,15450,16150,700,2554651,28050.0,삼성엔지니어링보통주
9614,28050,2018-02-14,0.0582191780821917,14600,15450,850,2389281,28050.0,삼성엔지니어링보통주
9615,28050,2018-02-09,0.0429042904290429,15150,14500,-650,3548290,28050.0,삼성엔지니어링보통주
9616,28050,2018-02-07,0.0881458966565349,16450,15000,-1450,4458353,28050.0,삼성엔지니어링보통주
9617,28050,2018-02-05,0.0402298850574712,17400,16700,-700,4085643,28050.0,삼성엔지니어링보통주
9618,28050,2018-01-25,0.0630914826498422,15850,16850,1000,5358116,28050.0,삼성엔지니어링보통주
9619,28050,2018-01-23,0.0498338870431893,15050,15800,750,2652586,28050.0,삼성엔지니어링보통주
9620,28050,2018-01-16,0.0516129032258064,15500,14700,-800,4264456,28050.0,삼성엔지니어링보통주
9621,28050,2018-01-10,0.0839160839160839,14300,15500,1200,9631405,28050.0,삼성엔지니어링보통주
9622,28050,2018-01-04,0.0656370656370656,12950,13800,850,5006285,28050.0,삼성엔지니어링보통주
9623,28050,2018-01-02,0.0524193548387096,12400,13050,650,2031799,28050.0,삼성엔지니어링보통주
9624,28050,2017-12-13,0.040983606557377,12200,12700,500,2186857,28050.0,삼성엔지니어링보통주
9625,28050,2017-12-11,0.0426356589147286,12900,12350,-550,4011839,28050.0,삼성엔지니어링보통주
9626,28050,2017-12-06,0.0699300699300699,14300,13300,-1000,7137402,28050.0,삼성엔지니어링보통주
9627,28050,2017-12-04,0.0687022900763358,13100,14000,900,8506647,28050.0,삼성엔지니어링보통주
9628,28050,2017-11-27,0.0419847328244274,13100,12550,-550,2759739,28050.0,삼성엔지니어링보통주
9629,28050,2017-11-07,0.0470588235294117,12750,13350,600,6701641,28050.0,삼성엔지니어링보통주
9630,28050,2017-11-06,0.0408163265306122,12250,12750,500,3238490,28050.0,삼성엔지니어링보통주
9631,28050,2017-10-27,0.0460251046025104,11950,12500,550,6592235,28050.0,삼성엔지니어링보통주
9632,28050,2017-09-26,0.0533980582524271,10300,10850,550,1703675,28050.0,삼성엔지니어링보통주
9633,28050,2017-09-19,0.062200956937799,10450,11100,650,4846630,28050.0,삼성엔지니어링보통주
9634,28050,2017-08-25,0.0492610837438423,10150,10650,500,6318166,28050.0,삼성엔지니어링보통주
9635,28050,2017-08-07,0.0812182741116751,9850,10650,800,5723736,28050.0,삼성엔지니어링보통주
9636,28050,2017-07-31,0.0642201834862385,10900,10200,-700,4707638,28050.0,삼성엔지니어링보통주
9637,28050,2017-06-23,0.043103448275862,11600,12100,500,1530707,28050.0,삼성엔지니어링보통주
9638,28050,2017-05-16,0.0450819672131147,12200,12750,550,3567760,28050.0,삼성엔지니어링보통주
9639,28050,2017-04-27,0.060377358490566,13250,12450,-800,5282669,28050.0,삼성엔지니어링보통주
9640,28050,2017-03-16,0.0483870967741935,12400,13000,600,3882266,28050.0,삼성엔지니어링보통주
9641,28050,2017-03-09,0.0639097744360902,13300,12450,-850,6871629,28050.0,삼성엔지니어링보통주
9642,28050,2017-02-20,0.0530612244897959,12250,11600,-650,4174380,28050.0,삼성엔지니어링보통주
9643,28050,2017-02-09,0.0448979591836734,12250,12800,550,2768805,28050.0,삼성엔지니어링보통주
9644,28050,2017-01-31,0.05,12000,12600,600,3914402,28050.0,삼성엔지니어링보통주
9645,28050,2017-01-23,0.0790697674418604,10750,11600,850,4088563,28050.0,삼성엔지니어링보통주
9646,28050,2017-01-17,0.04,11250,10800,-450,3640437,28050.0,삼성엔지니어링보통주
9647,28050,2016-12-21,0.0495049504950495,10100,10600,500,2469477,28050.0,삼성엔지니어링보통주
9648,28050,2016-12-12,0.066017316017316,9240,9850,610,2508641,28050.0,삼성엔지니어링보통주
9649,28050,2016-11-10,0.0568306010928961,9150,9670,520,1568619,28050.0,삼성엔지니어링보통주
9650,28050,2016-11-09,0.0498442367601246,9630,9150,-480,2790432,28050.0,삼성엔지니어링보통주
9651,28050,2016-10-31,0.0715686274509803,10200,9470,-730,3603933,28050.0,삼성엔지니어링보통주
9652,28050,2016-09-01,0.04,11250,11700,450,2442359,28050.0,삼성엔지니어링보통주
9653,28050,2016-08-29,0.0429184549356223,11650,11150,-500,3812778,28050.0,삼성엔지니어링보통주
9654,28050,2016-08-22,0.0440528634361233,11350,11850,500,7844241,28050.0,삼성엔지니어링보통주
9655,28050,2016-08-19,0.0758293838862559,10550,11350,800,5769897,28050.0,삼성엔지니어링보통주
9656,28260,2021-05-14,0.0566037735849056,132500,140000,7500,1000628,28260.0,삼성물산보통주
9657,28260,2021-04-29,0.0526315789473684,133000,140000,7000,2039950,28260.0,삼성물산보통주
9658,28260,2021-04-13,0.0463320463320463,129500,135500,6000,1964722,28260.0,삼성물산보통주
9659,28260,2021-03-25,0.0421940928270042,118500,123500,5000,666583,28260.0,삼성물산보통주
9660,28260,2021-01-28,0.056338028169014,142000,134000,-8000,1951990,28260.0,삼성물산보통주
9661,28260,2021-01-21,0.0633802816901408,142000,151000,9000,1594368,28260.0,삼성물산보통주
9662,28260,2021-01-18,0.0684039087947882,153500,143000,-10500,2364849,28260.0,삼성물산보통주
9663,28260,2021-01-14,0.0445205479452054,146000,152500,6500,1851446,28260.0,삼성물산보통주
9664,28260,2021-01-08,0.0413793103448275,145000,151000,6000,2268977,28260.0,삼성물산보통주
9665,28260,2021-01-04,0.0434782608695652,138000,144000,6000,1369767,28260.0,삼성물산보통주
9666,28260,2020-12-11,0.052,125000,131500,6500,1591465,28260.0,삼성물산보통주
9667,28260,2020-11-11,0.055793991416309,116500,123000,6500,1551092,28260.0,삼성물산보통주
9668,28260,2020-10-26,0.1346153846153846,104000,118000,14000,9493136,28260.0,삼성물산보통주
9669,28260,2020-09-11,0.0414746543778801,108500,113000,4500,1495263,28260.0,삼성물산보통주
9670,28260,2020-08-31,0.04,112500,108000,-4500,1059470,28260.0,삼성물산보통주
9671,28260,2020-08-20,0.0497925311203319,120500,114500,-6000,978030,28260.0,삼성물산보통주
9672,28260,2020-08-18,0.0604838709677419,124000,116500,-7500,1289969,28260.0,삼성물산보통주
9673,28260,2020-08-13,0.0585774058577405,119500,126500,7000,3201899,28260.0,삼성물산보통주
9674,28260,2020-08-12,0.0814479638009049,110500,119500,9000,1779300,28260.0,삼성물산보통주
9675,28260,2020-06-16,0.1071428571428571,112000,124000,12000,2696960,28260.0,삼성물산보통주
9676,28260,2020-06-05,0.0467289719626168,107000,112000,5000,901377,28260.0,삼성물산보통주
9677,28260,2020-05-06,0.066066066066066,99900,106500,6600,792744,28260.0,삼성물산보통주
9678,28260,2020-05-04,0.0575471698113207,106000,99900,-6100,625651,28260.0,삼성물산보통주
9679,28260,2020-04-10,0.0596175478065241,88900,94200,5300,1392526,28260.0,삼성물산보통주
9680,28260,2020-04-01,0.0524553571428571,89600,84900,-4700,483939,28260.0,삼성물산보통주
9681,28260,2020-03-25,0.075268817204301,83700,90000,6300,765916,28260.0,삼성물산보통주
9682,28260,2020-03-24,0.123489932885906,74500,83700,9200,684986,28260.0,삼성물산보통주
9683,28260,2020-03-23,0.0745341614906832,80500,74500,-6000,501217,28260.0,삼성물산보통주
9684,28260,2020-03-20,0.0536649214659685,76400,80500,4100,690277,28260.0,삼성물산보통주
9685,28260,2020-03-19,0.0806257521058965,83100,76400,-6700,896134,28260.0,삼성물산보통주
9686,28260,2020-03-18,0.0578231292517006,88200,83100,-5100,517037,28260.0,삼성물산보통주
9687,28260,2020-03-16,0.0426894343649946,93700,89700,-4000,472425,28260.0,삼성물산보통주
9688,28260,2020-03-12,0.0413793103448275,101500,97300,-4200,871598,28260.0,삼성물산보통주
9689,28260,2020-03-09,0.0416666666666666,108000,103500,-4500,502867,28260.0,삼성물산보통주
9690,28260,2020-02-06,0.0452488687782805,110500,115500,5000,608944,28260.0,삼성물산보통주
9691,28260,2020-01-28,0.0427350427350427,117000,112000,-5000,706005,28260.0,삼성물산보통주
9692,28260,2020-01-23,0.0446428571428571,112000,117000,5000,1290170,28260.0,삼성물산보통주
9693,28260,2020-01-20,0.041860465116279,107500,112000,4500,544608,28260.0,삼성물산보통주
9694,28260,2019-12-19,0.0436893203883495,103000,107500,4500,494970,28260.0,삼성물산보통주
9695,28260,2019-08-29,0.04052573932092,91300,87600,-3700,1116682,28260.0,삼성물산보통주
9696,28260,2019-08-12,0.0421545667447306,85400,89000,3600,364139,28260.0,삼성물산보통주
9697,28260,2019-04-25,0.0497737556561085,110500,105000,-5500,748703,28260.0,삼성물산보통주
9698,28260,2019-01-18,0.0448430493273542,111500,116500,5000,461442,28260.0,삼성물산보통주
9699,28260,2018-11-22,0.0595121951219512,102500,96400,-6100,1017852,28260.0,삼성물산보통주
9700,28260,2018-10-11,0.065040650406504,123000,115000,-8000,964966,28260.0,삼성물산보통주
9701,28260,2018-09-20,0.0404858299595141,123500,128500,5000,780620,28260.0,삼성물산보통주
9702,28260,2018-05-02,0.0571428571428571,140000,132000,-8000,1595770,28260.0,삼성물산보통주
9703,28260,2018-03-29,0.0418250950570342,131500,137000,5500,1160541,28260.0,삼성물산보통주
9704,28260,2018-01-29,0.0402930402930402,136500,142000,5500,933019,28260.0,삼성물산보통주
9705,28260,2017-09-18,0.0705882352941176,127500,136500,9000,1233411,28260.0,삼성물산보통주
9706,28260,2017-06-22,0.0416666666666666,132000,137500,5500,589549,28260.0,삼성물산보통주
9707,28260,2017-04-27,0.0684410646387832,131500,122500,-9000,2296586,28260.0,삼성물산보통주
9708,28260,2017-03-24,0.0727272727272727,137500,127500,-10000,1834793,28260.0,삼성물산보통주
9709,28260,2017-03-14,0.0909090909090909,121000,132000,11000,1858384,28260.0,삼성물산보통주
9710,28260,2016-11-29,0.0863309352517985,139000,127000,-12000,2457320,28260.0,삼성물산보통주
9711,28260,2016-10-24,0.043613707165109,160500,167500,7000,798465,28260.0,삼성물산보통주
9712,28260,2016-10-11,0.0401234567901234,162000,155500,-6500,1079849,28260.0,삼성물산보통주
9713,28260,2016-10-06,0.0789473684210526,152000,164000,12000,2175637,28260.0,삼성물산보통주
9714,28260,2016-08-18,0.0457746478873239,142000,148500,6500,1037609,28260.0,삼성물산보통주
9715,28670,2021-05-25,0.0579494799405646,6730,7120,390,8899890,28670.0,팬오션보통주
9716,28670,2021-05-14,0.0458333333333333,7200,6870,-330,13412185,28670.0,팬오션보통주
9717,28670,2021-05-06,0.0754189944134078,7160,7700,540,17992669,28670.0,팬오션보통주
9718,28670,2021-05-03,0.0435967302452316,7340,7020,-320,12069658,28670.0,팬오션보통주
9719,28670,2021-04-26,0.0614285714285714,7000,7430,430,36006283,28670.0,팬오션보통주
9720,28670,2021-04-22,0.1098726114649681,6280,6970,690,38969920,28670.0,팬오션보통주
9721,28670,2021-04-16,0.0619765494137353,5970,6340,370,18422951,28670.0,팬오션보통주
9722,28670,2021-03-29,0.0541727672035139,6830,6460,-370,16221937,28670.0,팬오션보통주
9723,28670,2021-03-26,0.0411585365853658,6560,6830,270,28542317,28670.0,팬오션보통주
9724,28670,2021-03-22,0.1045958795562599,6310,6970,660,46661593,28670.0,팬오션보통주
9725,28670,2021-03-12,0.0424143556280587,6130,6390,260,14127850,28670.0,팬오션보통주
9726,28670,2021-03-10,0.0430292598967297,5810,6060,250,15506261,28670.0,팬오션보통주
9727,28670,2021-03-09,0.103395061728395,6480,5810,-670,62881613,28670.0,팬오션보통주
9728,28670,2021-03-05,0.0954003407155025,5870,6430,560,82365221,28670.0,팬오션보통주
9729,28670,2021-03-03,0.0603907637655417,5630,5970,340,17122253,28670.0,팬오션보통주
9730,28670,2021-02-22,0.0772128060263653,5310,5720,410,39269272,28670.0,팬오션보통주
9731,28670,2021-02-19,0.059880239520958,5010,5310,300,13747214,28670.0,팬오션보통주
9732,28670,2021-02-16,0.0447154471544715,4920,5140,220,5957883,28670.0,팬오션보통주
9733,28670,2021-01-26,0.0415860735009671,5170,4955,-215,3831840,28670.0,팬오션보통주
9734,28670,2021-01-21,0.0855949895615866,4790,5200,410,14724150,28670.0,팬오션보통주
9735,28670,2021-01-19,0.0489130434782608,4600,4825,225,3558090,28670.0,팬오션보통주
9736,28670,2021-01-15,0.0432595573440643,4970,4755,-215,3423194,28670.0,팬오션보통주
9737,28670,2021-01-06,0.0570902394106814,5430,5120,-310,8510216,28670.0,팬오션보통주
9738,28670,2021-01-04,0.0697211155378486,5020,5370,350,12120901,28670.0,팬오션보통주
9739,28670,2020-12-24,0.0419426048565121,4530,4720,190,16312399,28670.0,팬오션보통주
9740,28670,2020-12-18,0.0491803278688524,4270,4480,210,15654713,28670.0,팬오션보통주
9741,28670,2020-11-23,0.0604938271604938,4050,4295,245,19395948,28670.0,팬오션보통주
9742,28670,2020-11-13,0.0631929046563192,4510,4225,-285,13104956,28670.0,팬오션보통주
9743,28670,2020-11-12,0.0674556213017751,4225,4510,285,72851138,28670.0,팬오션보통주
9744,28670,2020-11-09,0.2109038737446198,3485,4220,735,64203949,28670.0,팬오션보통주
9745,28670,2020-10-16,0.04,3750,3600,-150,2083578,28670.0,팬오션보통주
9746,28670,2020-10-14,0.048469387755102,3920,3730,-190,3301215,28670.0,팬오션보통주
9747,28670,2020-10-05,0.1169590643274853,3420,3820,400,10765337,28670.0,팬오션보통주
9748,28670,2020-08-20,0.054719562243502,3655,3455,-200,2463083,28670.0,팬오션보통주
9749,28670,2020-08-18,0.0511811023622047,3810,3615,-195,2591779,28670.0,팬오션보통주
9750,28670,2020-07-10,0.0486555697823303,3905,3715,-190,3630422,28670.0,팬오션보통주
9751,28670,2020-07-07,0.0419847328244274,3930,4095,165,5286821,28670.0,팬오션보통주
9752,28670,2020-06-29,0.0525,4000,3790,-210,3177143,28670.0,팬오션보통주
9753,28670,2020-06-26,0.0610079575596817,3770,4000,230,15478400,28670.0,팬오션보통주
9754,28670,2020-06-18,0.0758226037195994,3495,3760,265,4204989,28670.0,팬오션보통주
9755,28670,2020-06-16,0.0608308605341246,3370,3575,205,1323947,28670.0,팬오션보통주
9756,28670,2020-06-15,0.0703448275862069,3625,3370,-255,2137855,28670.0,팬오션보통주
9757,28670,2020-06-05,0.0546666666666666,3750,3955,205,5099984,28670.0,팬오션보통주
9758,28670,2020-06-03,0.0648275862068965,3625,3860,235,14668938,28670.0,팬오션보통주
9759,28670,2020-05-29,0.0422740524781341,3430,3575,145,2419546,28670.0,팬오션보통주
9760,28670,2020-05-28,0.0405594405594405,3575,3430,-145,2327394,28670.0,팬오션보통주
9761,28670,2020-05-22,0.0526315789473684,3610,3420,-190,2095658,28670.0,팬오션보통주
9762,28670,2020-05-19,0.0637329286798179,3295,3505,210,7211281,28670.0,팬오션보통주
9763,28670,2020-05-04,0.0537010159651669,3445,3260,-185,2550541,28670.0,팬오션보통주
9764,28670,2020-04-23,0.0702028081123244,3205,3430,225,2883022,28670.0,팬오션보통주
9765,28670,2020-04-17,0.0415335463258785,3130,3260,130,2417820,28670.0,팬오션보통주
9766,28670,2020-04-14,0.0408496732026143,3060,3185,125,1422268,28670.0,팬오션보통주
9767,28670,2020-04-06,0.0793918918918918,2960,3195,235,2338816,28670.0,팬오션보통주
9768,28670,2020-04-03,0.0459363957597173,2830,2960,130,1730221,28670.0,팬오션보통주
9769,28670,2020-04-01,0.0558375634517766,2955,2790,-165,2148438,28670.0,팬오션보통주
9770,28670,2020-03-25,0.0557692307692307,2600,2745,145,2614664,28670.0,팬오션보통주
9771,28670,2020-03-24,0.0526315789473684,2470,2600,130,2494947,28670.0,팬오션보통주
9772,28670,2020-03-23,0.0783582089552238,2680,2470,-210,3154139,28670.0,팬오션보통주
9773,28670,2020-03-20,0.2853717026378897,2085,2680,595,5822590,28670.0,팬오션보통주
9774,28670,2020-03-19,0.2697022767075306,2855,2085,-770,4853706,28670.0,팬오션보통주
9775,28670,2020-03-18,0.0530679933665008,3015,2855,-160,1639843,28670.0,팬오션보통주
9776,28670,2020-03-17,0.0413354531001589,3145,3015,-130,1895019,28670.0,팬오션보통주
9777,28670,2020-03-13,0.113573407202216,3610,3200,-410,3802691,28670.0,팬오션보통주
9778,28670,2020-03-12,0.0411686586985391,3765,3610,-155,2428023,28670.0,팬오션보통주
9779,28670,2020-02-27,0.042407660738714,3655,3810,155,2634592,28670.0,팬오션보통주
9780,28670,2020-02-24,0.061437908496732,3825,3590,-235,2087505,28670.0,팬오션보통주
9781,28670,2020-02-06,0.0560509554140127,3925,4145,220,1554940,28670.0,팬오션보통주
9782,28670,2020-01-28,0.0608187134502924,4275,4015,-260,1865123,28670.0,팬오션보통주
9783,28670,2019-11-08,0.0443181818181818,4400,4595,195,2880661,28670.0,팬오션보통주
9784,28670,2019-10-14,0.0715909090909091,4400,4715,315,2857466,28670.0,팬오션보통주
9785,28670,2019-08-30,0.0496760259179265,4630,4860,230,2509767,28670.0,팬오션보통주
9786,28670,2019-08-14,0.040137614678899,4360,4535,175,2848260,28670.0,팬오션보통주
9787,28670,2019-08-05,0.0483870967741935,4650,4425,-225,1911900,28670.0,팬오션보통주
9788,28670,2019-07-17,0.0436590436590436,4810,5020,210,4466672,28670.0,팬오션보통주
9789,28670,2019-05-15,0.0427446569178852,4445,4635,190,1268584,28670.0,팬오션보통주
9790,28670,2019-05-09,0.0519480519480519,4620,4380,-240,2486426,28670.0,팬오션보통주
9791,28670,2018-12-27,0.0565583634175691,4155,4390,235,1261107,28670.0,팬오션보통주
9792,28670,2018-11-26,0.0507075471698113,4240,4455,215,1898557,28670.0,팬오션보통주
9793,28670,2018-11-12,0.0768421052631578,4750,4385,-365,4393477,28670.0,팬오션보통주
9794,28670,2018-11-02,0.0521739130434782,4600,4840,240,1429291,28670.0,팬오션보통주
9795,28670,2018-10-26,0.0435233160621761,4825,4615,-210,1389993,28670.0,팬오션보통주
9796,28670,2018-10-11,0.0425531914893617,4935,4725,-210,1930906,28670.0,팬오션보통주
9797,28670,2018-09-21,0.0412060301507537,4975,5180,205,2176899,28670.0,팬오션보통주
9798,28670,2018-08-20,0.04296875,5120,5340,220,3563209,28670.0,팬오션보통주
9799,28670,2018-08-14,0.0438328236493374,4905,5120,215,2016323,28670.0,팬오션보통주
9800,28670,2018-07-23,0.0458333333333333,4800,5020,220,3778810,28670.0,팬오션보통주
9801,28670,2018-07-06,0.0434322033898305,4720,4925,205,3440835,28670.0,팬오션보통주
9802,28670,2018-07-02,0.0542476970317297,4885,4620,-265,2042678,28670.0,팬오션보통주
9803,28670,2018-05-10,0.0662768031189083,5130,5470,340,6315630,28670.0,팬오션보통주
9804,28670,2018-05-02,0.0454545454545454,5500,5250,-250,3115165,28670.0,팬오션보통주
9805,28670,2018-04-04,0.0861742424242424,5280,4825,-455,9154847,28670.0,팬오션보통주
9806,28670,2018-03-26,0.0433070866141732,5080,5300,220,2196103,28670.0,팬오션보통주
9807,28670,2018-02-14,0.0511882998171846,5470,5750,280,2835096,28670.0,팬오션보통주
9808,28670,2018-01-25,0.0494699646643109,5660,5940,280,6421414,28670.0,팬오션보통주
9809,28670,2018-01-15,0.0522648083623693,5740,5440,-300,5446612,28670.0,팬오션보통주
9810,28670,2018-01-10,0.0532859680284191,5630,5930,300,7032718,28670.0,팬오션보통주
9811,28670,2018-01-04,0.0626185958254269,5270,5600,330,5099980,28670.0,팬오션보통주
9812,28670,2017-12-27,0.0559511698880976,4915,5190,275,3518686,28670.0,팬오션보통주
9813,28670,2017-12-22,0.0525812619502868,5230,4955,-275,8626040,28670.0,팬오션보통주
9814,28670,2017-12-18,0.0451388888888888,5760,5500,-260,4926909,28670.0,팬오션보통주
9815,28670,2017-12-15,0.04,6000,5760,-240,3890961,28670.0,팬오션보통주
9816,28670,2017-12-04,0.0684210526315789,5700,6090,390,10654391,28670.0,팬오션보통주
9817,28670,2017-11-24,0.0597014925373134,5360,5680,320,7137342,28670.0,팬오션보통주
9818,28670,2017-11-17,0.0621242484969939,4990,5300,310,7062032,28670.0,팬오션보통주
9819,28670,2017-11-14,0.0646153846153846,4875,5190,315,6494241,28670.0,팬오션보통주
9820,28670,2017-10-26,0.06,5500,5170,-330,7981274,28670.0,팬오션보통주
9821,28670,2017-10-23,0.0419580419580419,5720,5480,-240,3719868,28670.0,팬오션보통주
9822,28670,2017-10-17,0.0621572212065813,5470,5810,340,6646126,28670.0,팬오션보통주
9823,28670,2017-09-25,0.0507518796992481,5320,5590,270,6065381,28670.0,팬오션보통주
9824,28670,2017-09-22,0.0650263620386643,5690,5320,-370,8983494,28670.0,팬오션보통주
9825,28670,2017-09-21,0.0579470198675496,6040,5690,-350,9491101,28670.0,팬오션보통주
9826,28670,2017-09-14,0.0806697108066971,6570,6040,-530,45913072,28670.0,팬오션보통주
9827,28670,2017-08-18,0.0539215686274509,6120,6450,330,6293224,28670.0,팬오션보통주
9828,28670,2017-08-14,0.0481927710843373,5810,6090,280,4579387,28670.0,팬오션보통주
9829,28670,2017-07-25,0.0629032258064516,6200,5810,-390,7063183,28670.0,팬오션보통주
9830,28670,2017-07-24,0.0402684563758389,5960,6200,240,5221779,28670.0,팬오션보통주
9831,28670,2017-07-18,0.0598290598290598,5850,6200,350,8779797,28670.0,팬오션보통주
9832,28670,2017-07-12,0.0400728597449908,5490,5710,220,11984483,28670.0,팬오션보통주
9833,28670,2017-06-08,0.0457038391224862,5470,5220,-250,14011890,28670.0,팬오션보통주
9834,28670,2017-05-31,0.0436432637571157,5270,5500,230,21127467,28670.0,팬오션보통주
9835,28670,2017-05-12,0.0641821946169772,4830,5140,310,5534979,28670.0,팬오션보통주
9836,28670,2017-04-19,0.0449438202247191,5340,5100,-240,8221523,28670.0,팬오션보통주
9837,28670,2017-04-12,0.0546875,5120,5400,280,5454399,28670.0,팬오션보통주
9838,28670,2017-04-03,0.0836363636363636,5500,5040,-460,8580849,28670.0,팬오션보통주
9839,28670,2017-03-16,0.088235294117647,5100,5550,450,8292798,28670.0,팬오션보통주
9840,28670,2017-02-28,0.0748440748440748,4810,5170,360,11504136,28670.0,팬오션보통주
9841,28670,2017-02-23,0.0495780590717299,4740,4975,235,5423099,28670.0,팬오션보통주
9842,28670,2017-02-21,0.0617551462621885,4615,4900,285,8845181,28670.0,팬오션보통주
9843,28670,2016-11-15,0.0429447852760736,4075,3900,-175,2491616,28670.0,팬오션보통주
9844,28670,2016-11-10,0.1024182076813655,3515,3875,360,2928373,28670.0,팬오션보통주
9845,28670,2016-11-09,0.0435374149659863,3675,3515,-160,4271499,28670.0,팬오션보통주
9846,28670,2016-11-02,0.0426409903713892,3635,3480,-155,1878264,28670.0,팬오션보통주
9847,28670,2016-10-11,0.0517464424320828,3865,4065,200,3245369,28670.0,팬오션보통주
9848,28670,2016-09-30,0.0469715698393077,4045,3855,-190,3614846,28670.0,팬오션보통주
9849,28670,2016-09-26,0.0405092592592592,4320,4145,-175,3429729,28670.0,팬오션보통주
9850,28670,2016-09-22,0.0753768844221105,3980,4280,300,13596412,28670.0,팬오션보통주
9851,28670,2016-09-07,0.0618131868131868,3640,3865,225,4785881,28670.0,팬오션보통주
9852,28670,2016-09-06,0.0533159947984395,3845,3640,-205,3683760,28670.0,팬오션보통주
9853,28670,2016-09-02,0.0453938584779706,3745,3915,170,15511290,28670.0,팬오션보통주
9854,28670,2016-08-31,0.0455192034139402,3515,3675,160,6205096,28670.0,팬오션보통주
9855,29780,2021-05-12,0.0553191489361702,35250,33300,-1950,625267,29780.0,삼성카드 보통주
9856,29780,2021-05-03,0.046742209631728,35300,33650,-1650,278369,29780.0,삼성카드 보통주
9857,29780,2021-02-01,0.0404040404040404,29700,30900,1200,187508,29780.0,삼성카드 보통주
9858,29780,2020-12-29,0.0556348074179743,35050,33100,-1950,325446,29780.0,삼성카드 보통주
9859,29780,2020-11-19,0.0578386605783866,32850,34750,1900,416655,29780.0,삼성카드 보통주
9860,29780,2020-11-02,0.0629251700680272,29400,31250,1850,385524,29780.0,삼성카드 보통주
9861,29780,2020-06-16,0.0422018348623853,27250,28400,1150,259846,29780.0,삼성카드 보통주
9862,29780,2020-06-15,0.0455341506129597,28550,27250,-1300,275456,29780.0,삼성카드 보통주
9863,29780,2020-06-03,0.0434782608695652,29900,31200,1300,739069,29780.0,삼성카드 보통주
9864,29780,2020-04-29,0.0507880910683012,28550,30000,1450,365982,29780.0,삼성카드 보통주
9865,29780,2020-04-01,0.0635451505016722,29900,28000,-1900,146956,29780.0,삼성카드 보통주
9866,29780,2020-03-30,0.0674740484429065,28900,30850,1950,123892,29780.0,삼성카드 보통주
9867,29780,2020-03-27,0.0823970037453183,26700,28900,2200,212279,29780.0,삼성카드 보통주
9868,29780,2020-03-25,0.0462427745664739,25950,27150,1200,169395,29780.0,삼성카드 보통주
9869,29780,2020-03-23,0.0787545787545787,27300,25150,-2150,181905,29780.0,삼성카드 보통주
9870,29780,2020-03-20,0.1567796610169491,23600,27300,3700,222603,29780.0,삼성카드 보통주
9871,29780,2020-03-19,0.1616341030195381,28150,23600,-4550,223211,29780.0,삼성카드 보통주
9872,29780,2020-03-18,0.053781512605042,29750,28150,-1600,145562,29780.0,삼성카드 보통주
9873,29780,2020-03-17,0.0418679549114331,31050,29750,-1300,132261,29780.0,삼성카드 보통주
9874,29780,2020-02-06,0.0682451253481894,35900,38350,2450,171331,29780.0,삼성카드 보통주
9875,29780,2019-11-11,0.0657142857142857,35000,37300,2300,208719,29780.0,삼성카드 보통주
9876,29780,2019-09-30,0.0476900149031296,33550,35150,1600,92591,29780.0,삼성카드 보통주
9877,29780,2019-04-23,0.0416068866571018,34850,36300,1450,80522,29780.0,삼성카드 보통주
9878,29780,2018-10-30,0.0450581395348837,34400,32850,-1550,122854,29780.0,삼성카드 보통주
9879,29780,2018-06-15,0.0721518987341772,39500,36650,-2850,326483,29780.0,삼성카드 보통주
9880,29780,2018-05-02,0.0576407506702412,37300,39450,2150,534961,29780.0,삼성카드 보통주
9881,29780,2017-12-27,0.0459492140266021,41350,39450,-1900,284737,29780.0,삼성카드 보통주
9882,29780,2017-05-26,0.0410447761194029,40200,41850,1650,274269,29780.0,삼성카드 보통주
9883,29780,2016-12-28,0.0451911935110081,43150,41200,-1950,194358,29780.0,삼성카드 보통주
9884,29780,2016-09-01,0.1502824858757062,44250,50900,6650,1421011,29780.0,삼성카드 보통주
9885,30000,2021-05-31,0.0769230769230769,24050,25900,1850,1335610,30000.0,제일기획보통주
9886,30000,2021-05-03,0.0660592255125284,21950,23400,1450,1640418,30000.0,제일기획보통주
9887,30000,2021-03-08,0.0438144329896907,19400,20250,850,898405,30000.0,제일기획보통주
9888,30000,2020-10-14,0.041860465116279,21500,22400,900,645707,30000.0,제일기획보통주
9889,30000,2020-09-16,0.0538461538461538,19500,20550,1050,1615365,30000.0,제일기획보통주
9890,30000,2020-08-20,0.0421348314606741,17800,17050,-750,736928,30000.0,제일기획보통주
9891,30000,2020-08-18,0.0663129973474801,18850,17600,-1250,896760,30000.0,제일기획보통주
9892,30000,2020-07-31,0.0495049504950495,20200,19200,-1000,1074189,30000.0,제일기획보통주
9893,30000,2020-07-28,0.0879120879120879,18200,19800,1600,2419211,30000.0,제일기획보통주
9894,30000,2020-07-27,0.0520231213872832,17300,18200,900,723239,30000.0,제일기획보통주
9895,30000,2020-06-16,0.0854430379746835,15800,17150,1350,798886,30000.0,제일기획보통주
9896,30000,2020-06-15,0.0705882352941176,17000,15800,-1200,886191,30000.0,제일기획보통주
9897,30000,2020-06-12,0.0422535211267605,17750,17000,-750,1020223,30000.0,제일기획보통주
9898,30000,2020-06-02,0.0701754385964912,17100,18300,1200,1966142,30000.0,제일기획보통주
9899,30000,2020-04-23,0.0568862275449101,16700,17650,950,1490803,30000.0,제일기획보통주
9900,30000,2020-04-08,0.0462427745664739,17300,16500,-800,1329439,30000.0,제일기획보통주
9901,30000,2020-04-06,0.062111801242236,16100,17100,1000,804397,30000.0,제일기획보통주
9902,30000,2020-04-02,0.0490196078431372,15300,16050,750,713238,30000.0,제일기획보통주
9903,30000,2020-03-27,0.0608108108108108,14800,15700,900,1347478,30000.0,제일기획보통주
9904,30000,2020-03-25,0.1927710843373494,12450,14850,2400,2293283,30000.0,제일기획보통주
9905,30000,2020-03-23,0.093984962406015,13300,12050,-1250,666144,30000.0,제일기획보통주
9906,30000,2020-03-20,0.1176470588235294,11900,13300,1400,982485,30000.0,제일기획보통주
9907,30000,2020-03-19,0.1185185185185185,13500,11900,-1600,1256746,30000.0,제일기획보통주
9908,30000,2020-03-18,0.0753424657534246,14600,13500,-1100,919240,30000.0,제일기획보통주
9909,30000,2020-03-17,0.0610932475884244,15550,14600,-950,919909,30000.0,제일기획보통주
9910,30000,2020-03-16,0.0460122699386503,16300,15550,-750,717666,30000.0,제일기획보통주
9911,30000,2020-03-13,0.0659025787965616,17450,16300,-1150,885620,30000.0,제일기획보통주
9912,30000,2020-03-12,0.0412087912087912,18200,17450,-750,591468,30000.0,제일기획보통주
9913,30000,2020-03-09,0.0409207161125319,19550,18750,-800,327564,30000.0,제일기획보통주
9914,30000,2019-08-05,0.0523255813953488,25800,27150,1350,345158,30000.0,제일기획보통주
9915,30000,2019-07-23,0.0429553264604811,29100,27850,-1250,762040,30000.0,제일기획보통주
9916,30000,2019-03-15,0.0526315789473684,22800,24000,1200,526771,30000.0,제일기획보통주
9917,30000,2019-01-31,0.0444444444444444,22500,23500,1000,370013,30000.0,제일기획보통주
9918,30000,2019-01-11,0.0505494505494505,22750,21600,-1150,426491,30000.0,제일기획보통주
9919,30000,2018-12-27,0.0547368421052631,23750,22450,-1300,454663,30000.0,제일기획보통주
9920,30000,2018-11-01,0.0462555066079295,22700,21650,-1050,410506,30000.0,제일기획보통주
9921,30000,2018-10-31,0.0913461538461538,20800,22700,1900,669902,30000.0,제일기획보통주
9922,30000,2018-09-27,0.0477386934673366,19900,20850,950,393600,30000.0,제일기획보통주
9923,30000,2018-06-28,0.0561224489795918,19600,20700,1100,365866,30000.0,제일기획보통주
9924,30000,2018-06-27,0.0439024390243902,20500,19600,-900,380032,30000.0,제일기획보통주
9925,30000,2018-06-15,0.0405727923627685,20950,20100,-850,794204,30000.0,제일기획보통주
9926,30000,2018-05-11,0.0597826086956521,18400,19500,1100,634979,30000.0,제일기획보통주
9927,30000,2018-04-02,0.0638888888888888,18000,19150,1150,669106,30000.0,제일기획보통주
9928,30000,2018-02-12,0.0561224489795918,19600,18500,-1100,670792,30000.0,제일기획보통주
9929,30000,2018-01-31,0.0759493670886076,19750,21250,1500,2452728,30000.0,제일기획보통주
9930,30000,2017-10-31,0.0947368421052631,19000,20800,1800,2522659,30000.0,제일기획보통주
9931,30000,2017-10-30,0.0497237569060773,18100,19000,900,759742,30000.0,제일기획보통주
9932,30000,2017-07-31,0.0462724935732647,19450,20350,900,1432172,30000.0,제일기획보통주
9933,30000,2017-01-31,0.0911764705882352,17000,18550,1550,2222868,30000.0,제일기획보통주
9934,30000,2017-01-03,0.0407523510971786,15950,16600,650,445104,30000.0,제일기획보통주
9935,30000,2016-12-27,0.0664451827242525,15050,16050,1000,629181,30000.0,제일기획보통주
9936,30000,2016-10-27,0.0577507598784194,16450,17400,950,16012195,30000.0,제일기획보통주
9937,30000,2016-09-28,0.0460526315789473,15200,15900,700,475290,30000.0,제일기획보통주
9938,30200,2021-05-24,0.0482315112540192,31100,32600,1500,2261161,30200.0,케이티보통주
9939,30200,2021-02-16,0.0748987854251012,24700,26550,1850,8410853,30200.0,케이티보통주
9940,30200,2021-01-25,0.0443037974683544,23700,24750,1050,4000922,30200.0,케이티보통주
9941,30200,2020-12-29,0.0509803921568627,25500,24200,-1300,3596616,30200.0,케이티보통주
9942,30200,2020-06-16,0.0418502202643171,22700,23650,950,851098,30200.0,케이티보통주
9943,30200,2020-06-15,0.0462184873949579,23800,22700,-1100,1178814,30200.0,케이티보통주
9944,30200,2020-04-20,0.0477272727272727,22000,23050,1050,1904121,30200.0,케이티보통주
9945,30200,2020-04-06,0.0753768844221105,19900,21400,1500,2008413,30200.0,케이티보통주
9946,30200,2020-03-25,0.051490514905149,18450,19400,950,1365226,30200.0,케이티보통주
9947,30200,2020-03-24,0.0453257790368272,17650,18450,800,1619980,30200.0,케이티보통주
9948,30200,2020-03-23,0.0661375661375661,18900,17650,-1250,1376171,30200.0,케이티보통주
9949,30200,2020-03-20,0.0617977528089887,17800,18900,1100,1472194,30200.0,케이티보통주
9950,30200,2020-03-19,0.0631578947368421,19000,17800,-1200,2038799,30200.0,케이티보통주
9951,30200,2020-03-18,0.0570719602977667,20150,19000,-1150,1342355,30200.0,케이티보통주
9952,30200,2020-03-13,0.0454545454545454,22000,21000,-1000,2435169,30200.0,케이티보통주
9953,30200,2017-07-03,0.0429447852760736,32600,34000,1400,1940688,30200.0,케이티보통주
9954,31430,2021-05-31,0.0488888888888888,225000,236000,11000,86963,31430.0,신세계인터내셔날보통주
9955,31430,2021-05-13,0.0431965442764578,231500,221500,-10000,114655,31430.0,신세계인터내셔날보통주
9956,31430,2021-05-11,0.0410958904109589,219000,228000,9000,164872,31430.0,신세계인터내셔날보통주
9957,31430,2021-05-10,0.0631067961165048,206000,219000,13000,244510,31430.0,신세계인터내셔날보통주
9958,31430,2021-04-05,0.040506329113924,197500,205500,8000,62437,31430.0,신세계인터내셔날보통주
9959,31430,2021-03-15,0.0408163265306122,196000,204000,8000,56500,31430.0,신세계인터내셔날보통주
9960,31430,2021-03-03,0.0419947506561679,190500,198500,8000,175251,31430.0,신세계인터내셔날보통주
9961,31430,2021-02-25,0.0463215258855585,183500,192000,8500,60580,31430.0,신세계인터내셔날보통주
9962,31430,2021-02-24,0.0442708333333333,192000,183500,-8500,82858,31430.0,신세계인터내셔날보통주
9963,31430,2021-02-23,0.040650406504065,184500,192000,7500,117694,31430.0,신세계인터내셔날보통주
9964,31430,2021-01-29,0.0445682451253481,179500,171500,-8000,73345,31430.0,신세계인터내셔날보통주
9965,31430,2021-01-25,0.0619718309859154,177500,188500,11000,191769,31430.0,신세계인터내셔날보통주
9966,31430,2021-01-13,0.0476190476190476,168000,176000,8000,176650,31430.0,신세계인터내셔날보통주
9967,31430,2020-12-09,0.0578778135048231,155500,164500,9000,175373,31430.0,신세계인터내셔날보통주
9968,31430,2020-11-24,0.0490196078431372,153000,160500,7500,101247,31430.0,신세계인터내셔날보통주
9969,31430,2020-11-10,0.0415224913494809,144500,150500,6000,82648,31430.0,신세계인터내셔날보통주
9970,31430,2020-10-21,0.0408163265306122,147000,153000,6000,61541,31430.0,신세계인터내셔날보통주
9971,31430,2020-09-11,0.0576271186440678,147500,156000,8500,146555,31430.0,신세계인터내셔날보통주
9972,31430,2020-09-08,0.0638297872340425,141000,150000,9000,117459,31430.0,신세계인터내셔날보통주
9973,31430,2020-09-02,0.0472727272727272,137500,144000,6500,84446,31430.0,신세계인터내셔날보통주
9974,31430,2020-08-27,0.0419580419580419,143000,137000,-6000,88536,31430.0,신세계인터내셔날보통주
9975,31430,2020-08-20,0.0404040404040404,148500,142500,-6000,84222,31430.0,신세계인터내셔날보통주
9976,31430,2020-08-18,0.1027190332326284,165500,148500,-17000,135034,31430.0,신세계인터내셔날보통주
9977,31430,2020-07-03,0.0562913907284768,151000,159500,8500,106125,31430.0,신세계인터내셔날보통주
9978,31430,2020-07-01,0.0477707006369426,157000,149500,-7500,130655,31430.0,신세계인터내셔날보통주
9979,31430,2020-06-30,0.0501672240802675,149500,157000,7500,351693,31430.0,신세계인터내셔날보통주
9980,31430,2020-06-25,0.0511182108626198,156500,148500,-8000,161128,31430.0,신세계인터내셔날보통주
9981,31430,2020-06-22,0.0491329479768786,173000,164500,-8500,115042,31430.0,신세계인터내셔날보통주
9982,31430,2020-06-15,0.0631578947368421,190000,178000,-12000,77737,31430.0,신세계인터내셔날보통주
9983,31430,2020-06-12,0.0428211586901763,198500,190000,-8500,66878,31430.0,신세계인터내셔날보통주
9984,31430,2020-05-18,0.044041450777202,193000,201500,8500,40397,31430.0,신세계인터내셔날보통주
9985,31430,2020-05-11,0.0429594272076372,209500,200500,-9000,76674,31430.0,신세계인터내셔날보통주
9986,31430,2020-04-28,0.0479616306954436,208500,218500,10000,88862,31430.0,신세계인터내셔날보통주
9987,31430,2020-04-17,0.0510204081632653,196000,206000,10000,127520,31430.0,신세계인터내셔날보통주
9988,31430,2020-04-08,0.0506666666666666,187500,197000,9500,131321,31430.0,신세계인터내셔날보통주
9989,31430,2020-03-30,0.0461538461538461,195000,186000,-9000,90526,31430.0,신세계인터내셔날보통주
9990,31430,2020-03-25,0.056,187500,198000,10500,65573,31430.0,신세계인터내셔날보통주
9991,31430,2020-03-24,0.0504201680672268,178500,187500,9000,60527,31430.0,신세계인터내셔날보통주
9992,31430,2020-03-23,0.1097256857855361,200500,178500,-22000,76834,31430.0,신세계인터내셔날보통주
9993,31430,2020-03-12,0.0448877805486284,200500,191500,-9000,60088,31430.0,신세계인터내셔날보통주
9994,31430,2020-03-05,0.0761154855643044,190500,205000,14500,119616,31430.0,신세계인터내셔날보통주
9995,31430,2020-03-04,0.0495867768595041,181500,190500,9000,62982,31430.0,신세계인터내셔날보통주
9996,31430,2020-02-28,0.04177545691906,191500,183500,-8000,50926,31430.0,신세계인터내셔날보통주
9997,31430,2020-02-25,0.0426666666666666,187500,195500,8000,56153,31430.0,신세계인터내셔날보통주
9998,31430,2020-02-24,0.050632911392405,197500,187500,-10000,69137,31430.0,신세계인터내셔날보통주
9999,31430,2020-02-05,0.0516431924882629,213000,202000,-11000,167327,31430.0,신세계인터내셔날보통주
10000,31430,2020-01-28,0.1327800829875518,241000,209000,-32000,227010,31430.0,신세계인터내셔날보통주
10001,31430,2020-01-23,0.0549019607843137,255000,241000,-14000,99826,31430.0,신세계인터내셔날보통주
10002,31430,2020-01-13,0.045816733067729,251000,262500,11500,80132,31430.0,신세계인터내셔날보통주
10003,31430,2020-01-07,0.0883002207505518,226500,246500,20000,140800,31430.0,신세계인터내셔날보통주
10004,31430,2019-12-12,0.0412147505422993,230500,221000,-9500,497274,31430.0,신세계인터내셔날보통주
10005,31430,2019-12-10,0.0580046403712296,215500,228000,12500,55658,31430.0,신세계인터내셔날보통주
10006,31430,2019-12-06,0.0623501199040767,208500,221500,13000,56422,31430.0,신세계인터내셔날보통주
10007,31430,2019-11-28,0.0401002506265664,199500,207500,8000,60115,31430.0,신세계인터내셔날보통주
10008,31430,2019-11-25,0.0580474934036939,189500,200500,11000,54224,31430.0,신세계인터내셔날보통주
10009,31430,2019-10-29,0.0440771349862259,181500,189500,8000,49236,31430.0,신세계인터내셔날보통주
10010,31430,2019-09-26,0.0482573726541554,186500,195500,9000,97070,31430.0,신세계인터내셔날보통주
10011,31430,2019-09-24,0.0470914127423822,180500,189000,8500,69786,31430.0,신세계인터내셔날보통주
10012,31430,2019-09-09,0.0782122905027933,179000,193000,14000,96888,31430.0,신세계인터내셔날보통주
10013,31430,2019-09-05,0.0438144329896907,194000,185500,-8500,59221,31430.0,신세계인터내셔날보통주
10014,31430,2019-09-03,0.05420054200542,184500,194500,10000,75091,31430.0,신세계인터내셔날보통주
10015,31430,2019-08-30,0.0421348314606741,178000,185500,7500,71524,31430.0,신세계인터내셔날보통주
10016,31430,2019-08-26,0.0844686648501362,183500,168000,-15500,63747,31430.0,신세계인터내셔날보통주
10017,31430,2019-08-20,0.0473372781065088,169000,177000,8000,52298,31430.0,신세계인터내셔날보통주
10018,31430,2019-08-16,0.0482954545454545,176000,167500,-8500,35478,31430.0,신세계인터내셔날보통주
10019,31430,2019-08-12,0.081081081081081,166500,180000,13500,59502,31430.0,신세계인터내셔날보통주
10020,31430,2019-08-09,0.0403458213256484,173500,166500,-7000,40253,31430.0,신세계인터내셔날보통주
10021,31430,2019-08-08,0.1193548387096774,155000,173500,18500,68087,31430.0,신세계인터내셔날보통주
10022,31430,2019-08-07,0.0519877675840978,163500,155000,-8500,57066,31430.0,신세계인터내셔날보통주
10023,31430,2019-08-05,0.0591549295774647,177500,167000,-10500,27045,31430.0,신세계인터내셔날보통주
10024,31430,2019-07-31,0.0555555555555555,180000,170000,-10000,45453,31430.0,신세계인터내셔날보통주
10025,31430,2019-07-09,0.070528967254408,198500,184500,-14000,69439,31430.0,신세계인터내셔날보통주
10026,31430,2019-07-02,0.0604651162790697,215000,202000,-13000,79870,31430.0,신세계인터내셔날보통주
10027,31430,2019-06-27,0.0558375634517766,197000,208000,11000,83719,31430.0,신세계인터내셔날보통주
10028,31430,2019-06-14,0.0676855895196506,229000,213500,-15500,213830,31430.0,신세계인터내셔날보통주
10029,31430,2019-06-13,0.0497925311203319,241000,229000,-12000,268447,31430.0,신세계인터내셔날보통주
10030,31430,2019-06-04,0.0431519699812382,266500,255000,-11500,111452,31430.0,신세계인터내셔날보통주
10031,31430,2019-05-30,0.0441696113074204,283000,270500,-12500,99863,31430.0,신세계인터내셔날보통주
10032,31430,2019-05-23,0.0505050505050505,297000,282000,-15000,85909,31430.0,신세계인터내셔날보통주
10033,31430,2019-05-13,0.0620915032679738,306000,287000,-19000,95493,31430.0,신세계인터내셔날보통주
10034,31430,2019-05-10,0.047945205479452,292000,306000,14000,85306,31430.0,신세계인터내셔날보통주
10035,31430,2019-04-10,0.0633116883116883,308000,327500,19500,58665,31430.0,신세계인터내셔날보통주
10036,31430,2019-04-08,0.0403361344537815,297500,309500,12000,46507,31430.0,신세계인터내셔날보통주
10037,31430,2019-03-21,0.055379746835443,316000,298500,-17500,134769,31430.0,신세계인터내셔날보통주
10038,31430,2019-03-20,0.0429042904290429,303000,316000,13000,49294,31430.0,신세계인터내셔날보통주
10039,31430,2019-03-11,0.0571428571428571,262500,277500,15000,64358,31430.0,신세계인터내셔날보통주
10040,31430,2019-03-07,0.0865191146881287,248500,270000,21500,107937,31430.0,신세계인터내셔날보통주
10041,31430,2019-03-05,0.0545851528384279,229000,241500,12500,70744,31430.0,신세계인터내셔날보통주
10042,31430,2019-02-25,0.0554272517321016,216500,228500,12000,56948,31430.0,신세계인터내셔날보통주
10043,31430,2019-02-19,0.052757793764988,208500,219500,11000,107345,31430.0,신세계인터내셔날보통주
10044,31430,2019-01-31,0.0510948905109489,205500,216000,10500,103814,31430.0,신세계인터내셔날보통주
10045,31430,2019-01-23,0.0861618798955613,191500,208000,16500,139199,31430.0,신세계인터내셔날보통주
10046,31430,2019-01-22,0.0788732394366197,177500,191500,14000,140572,31430.0,신세계인터내셔날보통주
10047,31430,2019-01-17,0.0547945205479452,182500,172500,-10000,64276,31430.0,신세계인터내셔날보통주
10048,31430,2019-01-14,0.043103448275862,174000,181500,7500,69836,31430.0,신세계인터내셔날보통주
10049,31430,2019-01-02,0.0848329048843187,194500,178000,-16500,65304,31430.0,신세계인터내셔날보통주
10050,31430,2018-12-27,0.0588235294117647,178500,189000,10500,51751,31430.0,신세계인터내셔날보통주
10051,31430,2018-12-17,0.0427807486631016,187000,195000,8000,50999,31430.0,신세계인터내셔날보통주
10052,31430,2018-12-14,0.0459183673469387,196000,187000,-9000,51909,31430.0,신세계인터내셔날보통주
10053,31430,2018-12-13,0.0710382513661202,183000,196000,13000,98267,31430.0,신세계인터내셔날보통주
10054,31430,2018-12-12,0.0733137829912023,170500,183000,12500,97494,31430.0,신세계인터내셔날보통주
10055,31430,2018-12-06,0.0524861878453038,181000,171500,-9500,50465,31430.0,신세계인터내셔날보통주
10056,31430,2018-12-04,0.0550724637681159,172500,182000,9500,88865,31430.0,신세계인터내셔날보통주
10057,31430,2018-11-28,0.040983606557377,183000,175500,-7500,56548,31430.0,신세계인터내셔날보통주
10058,31430,2018-11-21,0.0632183908045977,174000,185000,11000,97981,31430.0,신세계인터내셔날보통주
10059,31430,2018-11-19,0.0473372781065088,169000,177000,8000,85906,31430.0,신세계인터내셔날보통주
10060,31430,2018-11-15,0.1621621621621621,148000,172000,24000,233440,31430.0,신세계인터내셔날보통주
10061,31430,2018-11-12,0.0423452768729641,153500,147000,-6500,63156,31430.0,신세계인터내셔날보통주
10062,31430,2018-11-09,0.043613707165109,160500,153500,-7000,177908,31430.0,신세계인터내셔날보통주
10063,31430,2018-11-08,0.0664451827242525,150500,160500,10000,83821,31430.0,신세계인터내셔날보통주
10064,31430,2018-11-05,0.0613496932515337,163000,153000,-10000,61421,31430.0,신세계인터내셔날보통주
10065,31430,2018-11-02,0.0482315112540192,155500,163000,7500,76898,31430.0,신세계인터내셔날보통주
10066,31430,2018-11-01,0.0542372881355932,147500,155500,8000,82926,31430.0,신세계인터내셔날보통주
10067,31430,2018-10-30,0.0607142857142857,140000,148500,8500,85431,31430.0,신세계인터내셔날보통주
10068,31430,2018-10-29,0.0697674418604651,150500,140000,-10500,85653,31430.0,신세계인터내셔날보통주
10069,31430,2018-10-26,0.0444444444444444,157500,150500,-7000,110643,31430.0,신세계인터내셔날보통주
10070,31430,2018-10-23,0.0814606741573033,178000,163500,-14500,121196,31430.0,신세계인터내셔날보통주
10071,31430,2018-10-10,0.0555555555555555,198000,187000,-11000,93352,31430.0,신세계인터내셔날보통주
10072,31430,2018-10-04,0.0519187358916478,221500,210000,-11500,150096,31430.0,신세계인터내셔날보통주
10073,31430,2018-09-21,0.0443458980044345,225500,235500,10000,117870,31430.0,신세계인터내셔날보통주
10074,31430,2018-09-11,0.0742574257425742,202000,217000,15000,63056,31430.0,신세계인터내셔날보통주
10075,31430,2018-08-27,0.048469387755102,196000,205500,9500,78585,31430.0,신세계인터내셔날보통주
10076,31430,2018-08-16,0.0476190476190476,168000,176000,8000,77597,31430.0,신세계인터내셔날보통주
10077,31430,2018-08-14,0.05,160000,168000,8000,51361,31430.0,신세계인터내셔날보통주
10078,31430,2018-08-10,0.0545977011494252,174000,164500,-9500,112323,31430.0,신세계인터내셔날보통주
10079,31430,2018-08-07,0.047752808988764,178000,169500,-8500,131094,31430.0,신세계인터내셔날보통주
10080,31430,2018-08-01,0.0405797101449275,172500,179500,7000,105629,31430.0,신세계인터내셔날보통주
10081,31430,2018-07-24,0.0518731988472622,173500,182500,9000,56134,31430.0,신세계인터내셔날보통주
10082,31430,2018-07-17,0.0425531914893617,188000,180000,-8000,69801,31430.0,신세계인터내셔날보통주
10083,31430,2018-07-13,0.0543478260869565,184000,194000,10000,95438,31430.0,신세계인터내셔날보통주
10084,31430,2018-07-12,0.0424929178470254,176500,184000,7500,58466,31430.0,신세계인터내셔날보통주
10085,31430,2018-07-10,0.0455840455840455,175500,183500,8000,109625,31430.0,신세계인터내셔날보통주
10086,31430,2018-07-09,0.1136363636363636,198000,175500,-22500,241401,31430.0,신세계인터내셔날보통주
10087,31430,2018-07-03,0.0514018691588785,214000,203000,-11000,174130,31430.0,신세계인터내셔날보통주
10088,31430,2018-07-02,0.0541871921182266,203000,214000,11000,123854,31430.0,신세계인터내셔날보통주
10089,31430,2018-06-29,0.0437017994858611,194500,203000,8500,66769,31430.0,신세계인터내셔날보통주
10090,31430,2018-06-21,0.1107954545454545,176000,195500,19500,241897,31430.0,신세계인터내셔날보통주
10091,31430,2018-06-20,0.073170731707317,164000,176000,12000,82427,31430.0,신세계인터내셔날보통주
10092,31430,2018-06-18,0.0529411764705882,170000,161000,-9000,48608,31430.0,신세계인터내셔날보통주
10093,31430,2018-06-12,0.0473372781065088,169000,177000,8000,60920,31430.0,신세계인터내셔날보통주
10094,31430,2018-06-04,0.0589970501474926,169500,179500,10000,52359,31430.0,신세계인터내셔날보통주
10095,31430,2018-05-23,0.0537974683544303,158000,166500,8500,51987,31430.0,신세계인터내셔날보통주
10096,31430,2018-05-15,0.0459016393442622,152500,159500,7000,48717,31430.0,신세계인터내셔날보통주
10097,31430,2018-05-11,0.0434782608695652,149500,156000,6500,97914,31430.0,신세계인터내셔날보통주
10098,31430,2018-05-10,0.1198501872659176,133500,149500,16000,75813,31430.0,신세계인터내셔날보통주
10099,31430,2018-05-08,0.0437956204379562,137000,131000,-6000,28234,31430.0,신세계인터내셔날보통주
10100,31430,2018-05-02,0.0559701492537313,134000,141500,7500,64894,31430.0,신세계인터내셔날보통주
10101,31430,2018-04-25,0.0551181102362204,127000,134000,7000,98222,31430.0,신세계인터내셔날보통주
10102,31430,2018-04-16,0.0905511811023622,127000,138500,11500,76084,31430.0,신세계인터내셔날보통주
10103,31430,2018-04-11,0.0786026200873362,114500,123500,9000,67855,31430.0,신세계인터내셔날보통주
10104,31430,2018-04-03,0.0721153846153846,104000,111500,7500,117817,31430.0,신세계인터내셔날보통주
10105,31430,2018-04-02,0.0822060353798126,96100,104000,7900,101277,31430.0,신세계인터내셔날보통주
10106,31430,2018-03-30,0.0797752808988764,89000,96100,7100,80098,31430.0,신세계인터내셔날보통주
10107,31430,2018-03-28,0.0435294117647058,85000,88700,3700,36291,31430.0,신세계인터내셔날보통주
10108,31430,2018-03-13,0.0444444444444444,90000,86000,-4000,24677,31430.0,신세계인터내셔날보통주
10109,31430,2018-03-12,0.0465116279069767,86000,90000,4000,31058,31430.0,신세계인터내셔날보통주
10110,31430,2018-02-13,0.0419235511713933,81100,77700,-3400,37743,31430.0,신세계인터내셔날보통주
10111,31430,2018-02-05,0.0519187358916478,88600,84000,-4600,36450,31430.0,신세계인터내셔날보통주
10112,31430,2018-02-01,0.0490430622009569,83600,87700,4100,40517,31430.0,신세계인터내셔날보통주
10113,31430,2018-01-24,0.0419753086419753,81000,84400,3400,95267,31430.0,신세계인터내셔날보통주
10114,31430,2018-01-22,0.050314465408805,79500,83500,4000,126250,31430.0,신세계인터내셔날보통주
10115,31430,2018-01-09,0.040787623066104,71100,74000,2900,40737,31430.0,신세계인터내셔날보통주
10116,31430,2017-11-27,0.0591549295774647,71000,75200,4200,148659,31430.0,신세계인터내셔날보통주
10117,31430,2017-11-20,0.04375,64000,66800,2800,53663,31430.0,신세계인터내셔날보통주
10118,31430,2017-11-03,0.043261231281198,60100,62700,2600,24777,31430.0,신세계인터내셔날보통주
10119,31430,2017-09-21,0.0705128205128205,62400,58000,-4400,85372,31430.0,신세계인터내셔날보통주
10120,31430,2017-08-16,0.0411392405063291,63200,65800,2600,22551,31430.0,신세계인터내셔날보통주
10121,31430,2017-08-11,0.0510948905109489,68500,65000,-3500,48379,31430.0,신세계인터내셔날보통주
10122,31430,2017-05-31,0.0708446866485013,73400,78600,5200,62278,31430.0,신세계인터내셔날보통주
10123,31430,2017-04-19,0.070460704607046,73800,79000,5200,67399,31430.0,신세계인터내셔날보통주
10124,31430,2017-03-23,0.056,62500,66000,3500,60840,31430.0,신세계인터내셔날보통주
10125,31430,2016-11-09,0.042407660738714,73100,70000,-3100,54279,31430.0,신세계인터내셔날보통주
10126,31430,2016-11-07,0.0471204188481675,76400,72800,-3600,55253,31430.0,신세계인터내셔날보통주
10127,31430,2016-10-11,0.0767230169050715,76900,82800,5900,88003,31430.0,신세계인터내셔날보통주
10128,31430,2016-09-29,0.0453333333333333,75000,78400,3400,95169,31430.0,신세계인터내셔날보통주
10129,31430,2016-09-23,0.048780487804878,69700,73100,3400,41698,31430.0,신세계인터내셔날보통주
10130,31430,2016-08-29,0.0406824146981627,76200,73100,-3100,24698,31430.0,신세계인터내셔날보통주
10131,31430,2016-08-26,0.0539419087136929,72300,76200,3900,33422,31430.0,신세계인터내셔날보통주
10132,31430,2016-08-08,0.0458115183246073,76400,79900,3500,43488,31430.0,신세계인터내셔날보통주
10133,32350,2021-05-31,0.0702179176755447,20650,22100,1450,2037821,32350.0,롯데관광개발 보통주
10134,32350,2021-05-25,0.0658227848101265,19750,21050,1300,2004908,32350.0,롯데관광개발 보통주
10135,32350,2021-05-03,0.051490514905149,18450,17500,-950,713554,32350.0,롯데관광개발 보통주
10136,32350,2021-04-06,0.0472440944881889,19050,19950,900,1044732,32350.0,롯데관광개발 보통주
10137,32350,2021-04-01,0.0427807486631016,18700,19500,800,680826,32350.0,롯데관광개발 보통주
10138,32350,2021-03-24,0.0439276485788113,19350,20200,850,1934067,32350.0,롯데관광개발 보통주
10139,32350,2021-03-22,0.0441176470588235,20400,19500,-900,1214856,32350.0,롯데관광개발 보통주
10140,32350,2021-03-15,0.0492227979274611,19300,20250,950,1037149,32350.0,롯데관광개발 보통주
10141,32350,2021-03-08,0.0676328502415458,20700,19300,-1400,1104766,32350.0,롯데관광개발 보통주
10142,32350,2021-02-25,0.0597014925373134,20100,21300,1200,1770899,32350.0,롯데관광개발 보통주
10143,32350,2021-02-24,0.046875,19200,20100,900,3655799,32350.0,롯데관광개발 보통주
10144,32350,2021-02-23,0.0909090909090909,17600,19200,1600,1763831,32350.0,롯데관광개발 보통주
10145,32350,2021-02-16,0.0647058823529411,17000,18100,1100,1145227,32350.0,롯데관광개발 보통주
10146,32350,2021-02-01,0.0739549839228295,15550,16700,1150,1605039,32350.0,롯데관광개발 보통주
10147,32350,2021-01-18,0.0407523510971786,15950,15300,-650,714826,32350.0,롯데관광개발 보통주
10148,32350,2021-01-14,0.040133779264214,14950,15550,600,1376239,32350.0,롯데관광개발 보통주
10149,32350,2020-12-22,0.0447284345047923,15650,14950,-700,552073,32350.0,롯데관광개발 보통주
10150,32350,2020-12-21,0.0457317073170731,16400,15650,-750,557477,32350.0,롯데관광개발 보통주
10151,32350,2020-12-14,0.0581395348837209,17200,16200,-1000,534086,32350.0,롯데관광개발 보통주
10152,32350,2020-10-26,0.0477707006369426,15700,14950,-750,143358,32350.0,롯데관광개발 보통주
10153,32350,2020-10-07,0.043046357615894,15100,15750,650,184606,32350.0,롯데관광개발 보통주
10154,32350,2020-09-29,0.0547945205479452,14600,15400,800,254662,32350.0,롯데관광개발 보통주
10155,32350,2020-09-04,0.1269841269841269,18900,16500,-2400,2308626,32350.0,롯데관광개발 보통주
10156,32350,2020-08-12,0.0773638968481375,17450,18800,1350,1841625,32350.0,롯데관광개발 보통주
10157,32350,2020-07-22,0.0603174603174603,15750,16700,950,1825155,32350.0,롯데관광개발 보통주
10158,32350,2020-07-21,0.0824742268041237,14550,15750,1200,1112946,32350.0,롯데관광개발 보통주
10159,32350,2020-06-30,0.0809716599190283,12350,13350,1000,657997,32350.0,롯데관광개발 보통주
10160,32350,2020-06-16,0.073469387755102,12250,13150,900,402284,32350.0,롯데관광개발 보통주
10161,32350,2020-06-15,0.1123188405797101,13800,12250,-1550,673460,32350.0,롯데관광개발 보통주
10162,32350,2020-05-29,0.0538461538461538,13000,13700,700,578193,32350.0,롯데관광개발 보통주
10163,32350,2020-05-19,0.0505836575875486,12850,13500,650,859460,32350.0,롯데관광개발 보통주
10164,32350,2020-05-12,0.0472440944881889,12700,12100,-600,370830,32350.0,롯데관광개발 보통주
10165,32350,2020-05-08,0.0416666666666666,12000,12500,500,573870,32350.0,롯데관광개발 보통주
10166,32350,2020-04-28,0.0642201834862385,10900,11600,700,879401,32350.0,롯데관광개발 보통주
10167,32350,2020-04-27,0.058252427184466,10300,10900,600,253351,32350.0,롯데관광개발 보통주
10168,32350,2020-04-21,0.0535714285714285,11200,10600,-600,496556,32350.0,롯데관광개발 보통주
10169,32350,2020-04-10,0.1189516129032258,9920,11100,1180,539393,32350.0,롯데관광개발 보통주
10170,32350,2020-04-07,0.0480349344978165,9160,9600,440,505915,32350.0,롯데관광개발 보통주
10171,32350,2020-04-06,0.0638792102206736,8610,9160,550,337675,32350.0,롯데관광개발 보통주
10172,32350,2020-03-31,0.0464547677261613,8180,8560,380,373909,32350.0,롯데관광개발 보통주
10173,32350,2020-03-30,0.0543352601156069,8650,8180,-470,501430,32350.0,롯데관광개발 보통주
10174,32350,2020-03-26,0.0438047559449311,7990,8340,350,674917,32350.0,롯데관광개발 보통주
10175,32350,2020-03-25,0.0568783068783068,7560,7990,430,490842,32350.0,롯데관광개발 보통주
10176,32350,2020-03-23,0.0566037735849056,7950,7500,-450,365651,32350.0,롯데관광개발 보통주
10177,32350,2020-03-20,0.0614152202937249,7490,7950,460,545964,32350.0,롯데관광개발 보통주
10178,32350,2020-03-19,0.1677777777777777,9000,7490,-1510,1580513,32350.0,롯데관광개발 보통주
10179,32350,2020-03-18,0.0445859872611464,9420,9000,-420,516074,32350.0,롯데관광개발 보통주
10180,32350,2020-03-13,0.0763285024154589,10350,9560,-790,755785,32350.0,롯데관광개발 보통주
10181,32350,2020-03-09,0.0570175438596491,11400,10750,-650,411514,32350.0,롯데관광개발 보통주
10182,32350,2020-03-05,0.0495495495495495,11100,11650,550,431909,32350.0,롯데관광개발 보통주
10183,32350,2020-02-28,0.0585585585585585,11100,10450,-650,758932,32350.0,롯데관광개발 보통주
10184,32350,2020-02-27,0.043103448275862,11600,11100,-500,390499,32350.0,롯데관광개발 보통주
10185,32350,2020-02-24,0.0930232558139534,12900,11700,-1200,549268,32350.0,롯데관광개발 보통주
10186,32350,2020-02-12,0.0520446096654275,13450,14150,700,385484,32350.0,롯데관광개발 보통주
10187,32350,2020-01-28,0.0853242320819112,14650,13400,-1250,867415,32350.0,롯데관광개발 보통주
10188,32350,2019-12-27,0.0679245283018867,13250,14150,900,505780,32350.0,롯데관광개발 보통주
10189,32350,2019-10-31,0.0441767068273092,12450,13000,550,428666,32350.0,롯데관광개발 보통주
10190,32350,2019-10-28,0.080168776371308,11850,12800,950,2334840,32350.0,롯데관광개발 보통주
10191,32350,2019-09-26,0.0405405405405405,11100,11550,450,204837,32350.0,롯데관광개발 보통주
10192,32350,2019-09-18,0.0474308300395256,12650,12050,-600,4028550,32350.0,롯데관광개발 보통주
10193,32350,2019-09-11,0.0446096654275092,13450,12850,-600,300194,32350.0,롯데관광개발 보통주
10194,32350,2019-08-26,0.0401606425702811,12450,12950,500,357786,32350.0,롯데관광개발 보통주
10195,32350,2019-06-13,0.0428015564202334,12850,13400,550,161467,32350.0,롯데관광개발 보통주
10196,32350,2019-06-11,0.0564516129032258,12400,13100,700,133909,32350.0,롯데관광개발 보통주
10197,32350,2019-06-07,0.0585774058577405,11950,12650,700,202286,32350.0,롯데관광개발 보통주
10198,32350,2019-05-29,0.0436507936507936,12600,12050,-550,91424,32350.0,롯데관광개발 보통주
10199,32350,2019-05-28,0.0413223140495867,12100,12600,500,90250,32350.0,롯데관광개발 보통주
10200,32350,2019-04-12,0.0474452554744525,13700,14350,650,458167,32350.0,롯데관광개발 보통주
10201,32350,2019-04-08,0.0629921259842519,12700,13500,800,599042,32350.0,롯데관광개발 보통주
10202,32350,2019-03-28,0.0465116279069767,12900,12300,-600,279176,32350.0,롯데관광개발 보통주
10203,32350,2019-03-13,0.1098039215686274,12750,14150,1400,808060,32350.0,롯데관광개발 보통주
10204,32350,2019-02-19,0.0454545454545454,14300,14950,650,1121510,32350.0,롯데관광개발 보통주
10205,32350,2019-01-07,0.0557491289198606,14350,15150,800,584874,32350.0,롯데관광개발 보통주
10206,32350,2019-01-03,0.046979865771812,14900,14200,-700,691056,32350.0,롯데관광개발 보통주
10207,32350,2018-12-27,0.0936329588014981,13350,14600,1250,1175610,32350.0,롯데관광개발 보통주
10208,32350,2018-12-21,0.0423076923076923,13000,13550,550,495471,32350.0,롯데관광개발 보통주
10209,32350,2018-12-05,0.0602836879432624,14100,13250,-850,729306,32350.0,롯데관광개발 보통주
10210,32350,2018-11-30,0.0474452554744525,13700,14350,650,923653,32350.0,롯데관광개발 보통주
10211,32350,2018-11-22,0.0501930501930501,12950,13600,650,1052564,32350.0,롯데관광개발 보통주
10212,32350,2018-11-21,0.0614754098360655,12200,12950,750,846707,32350.0,롯데관광개발 보통주
10213,32350,2018-11-15,0.0970873786407767,10300,11300,1000,752595,32350.0,롯데관광개발 보통주
10214,32350,2018-11-06,0.0484581497797356,11350,10800,-550,802770,32350.0,롯데관광개발 보통주
10215,32350,2018-10-30,0.1594202898550724,13800,11600,-2200,696930,32350.0,롯데관광개발 보통주
10216,32350,2018-10-24,0.0469314079422382,13850,14500,650,53804,32350.0,롯데관광개발 보통주
10217,32350,2018-10-23,0.0513698630136986,14600,13850,-750,26149,32350.0,롯데관광개발 보통주
10218,32350,2018-10-10,0.0404984423676012,16050,15400,-650,125889,32350.0,롯데관광개발 보통주
10219,32350,2018-10-01,0.0865384615384615,15600,16950,1350,539983,32350.0,롯데관광개발 보통주
10220,32350,2018-08-31,0.0605187319884726,17350,16750,-600,180598,32350.0,롯데관광개발 보통주
10221,32350,2018-07-30,0.0533980582524271,20600,19500,-1100,583001,32350.0,롯데관광개발 보통주
10222,32350,2018-07-27,0.0456852791878172,19700,20600,900,975210,32350.0,롯데관광개발 보통주
10223,32350,2018-07-02,0.0649651972157772,21550,20150,-1400,98446,32350.0,롯데관광개발 보통주
10224,32350,2018-06-26,0.0433839479392624,23050,22050,-1000,89633,32350.0,롯데관광개발 보통주
10225,32350,2018-06-21,0.0457380457380457,24050,22950,-1100,166361,32350.0,롯데관광개발 보통주
10226,32350,2018-06-12,0.1277108433734939,20750,23400,2650,2207749,32350.0,롯데관광개발 보통주
10227,32350,2018-06-05,0.0440097799511002,20450,21350,900,431875,32350.0,롯데관광개발 보통주
10228,32350,2018-05-16,0.0414634146341463,20500,19650,-850,89550,32350.0,롯데관광개발 보통주
10229,32350,2018-05-02,0.0443925233644859,21400,20450,-950,217410,32350.0,롯데관광개발 보통주
10230,32350,2018-04-30,0.0439024390243902,20500,21400,900,275766,32350.0,롯데관광개발 보통주
10231,32350,2018-04-25,0.0731132075471698,21200,19650,-1550,215899,32350.0,롯데관광개발 보통주
10232,32350,2018-04-19,0.0771144278606965,20100,21650,1550,950878,32350.0,롯데관광개발 보통주
10233,32350,2018-04-13,0.0733695652173913,18400,19750,1350,435762,32350.0,롯데관광개발 보통주
10234,32350,2018-04-05,0.0816831683168316,20200,18550,-1650,569915,32350.0,롯데관광개발 보통주
10235,32350,2018-04-02,0.2980769230769231,15600,20250,4650,1505305,32350.0,롯데관광개발 보통주
10236,32350,2018-03-27,0.0618556701030927,14550,15450,900,198360,32350.0,롯데관광개발 보통주
10237,32350,2018-03-14,0.0625,16000,15000,-1000,189013,32350.0,롯데관광개발 보통주
10238,32350,2018-03-09,0.1172413793103448,14500,16200,1700,979855,32350.0,롯데관광개발 보통주
10239,32350,2018-03-05,0.0451127819548872,13300,13900,600,123658,32350.0,롯데관광개발 보통주
10240,32350,2018-02-14,0.0588235294117647,14450,13600,-850,234995,32350.0,롯데관광개발 보통주
10241,32350,2018-02-13,0.0433212996389891,13850,14450,600,519755,32350.0,롯데관광개발 보통주
10242,32350,2018-02-07,0.0711743772241993,14050,13050,-1000,237953,32350.0,롯데관광개발 보통주
10243,32350,2018-02-05,0.0888157894736842,15200,13850,-1350,1114685,32350.0,롯데관광개발 보통주
10244,32350,2018-02-01,0.1692913385826771,12700,14850,2150,2466587,32350.0,롯데관광개발 보통주
10245,32350,2018-01-24,0.0547445255474452,13700,12950,-750,255164,32350.0,롯데관광개발 보통주
10246,32350,2018-01-17,0.1373390557939914,11650,13250,1600,1273454,32350.0,롯데관광개발 보통주
10247,32350,2018-01-02,0.0694444444444444,10800,11550,750,129944,32350.0,롯데관광개발 보통주
10248,32350,2017-12-27,0.0485436893203883,10300,10800,500,67264,32350.0,롯데관광개발 보통주
10249,32350,2017-12-21,0.0929203539823008,11300,10250,-1050,149232,32350.0,롯데관광개발 보통주
10250,32350,2017-12-12,0.0566801619433198,12350,11650,-700,177502,32350.0,롯데관광개발 보통주
10251,32350,2017-12-08,0.0803571428571428,11200,12100,900,1085390,32350.0,롯데관광개발 보통주
10252,32350,2017-12-07,0.0627615062761506,11950,11200,-750,213742,32350.0,롯데관광개발 보통주
10253,32350,2017-11-28,0.0642857142857142,14000,13100,-900,3248504,32350.0,롯데관광개발 보통주
10254,32350,2017-11-02,0.0732600732600732,13650,12650,-1000,487306,32350.0,롯데관광개발 보통주
10255,32350,2017-10-30,0.2966507177033493,10450,13550,3100,2825966,32350.0,롯데관광개발 보통주
10256,32350,2017-10-27,0.2997512437810945,8040,10450,2410,536812,32350.0,롯데관광개발 보통주
10257,32350,2017-08-10,0.0467171717171717,7920,8290,370,34814,32350.0,롯데관광개발 보통주
10258,32350,2017-05-18,0.0660592255125284,8780,9360,580,222615,32350.0,롯데관광개발 보통주
10259,32350,2017-05-17,0.0694275274056029,8210,8780,570,268911,32350.0,롯데관광개발 보통주
10260,32350,2017-02-07,0.0549597855227882,7460,7870,410,13951,32350.0,롯데관광개발 보통주
10261,32350,2017-01-19,0.0427807486631016,7480,7800,320,26222,32350.0,롯데관광개발 보통주
10262,32350,2016-11-24,0.0442132639791937,7690,7350,-340,33125,32350.0,롯데관광개발 보통주
10263,32350,2016-10-25,0.0517241379310344,8700,9150,450,50612,32350.0,롯데관광개발 보통주
10264,32350,2016-09-19,0.056043956043956,9100,9610,510,61581,32350.0,롯데관광개발 보통주
10265,32350,2016-09-08,0.0476190476190476,9870,9400,-470,159201,32350.0,롯데관광개발 보통주
10266,32350,2016-08-23,0.0426540284360189,10550,10100,-450,83199,32350.0,롯데관광개발 보통주
10267,32350,2016-08-08,0.2964426877470356,12650,16400,3750,650678,32350.0,롯데관광개발 보통주
10268,32640,2021-05-11,0.0462633451957295,14050,14700,650,4345232,32640.0,LG유플러스보통주
10269,32640,2021-04-06,0.0411522633744856,12150,12650,500,5066746,32640.0,LG유플러스보통주
10270,32640,2020-11-26,0.0482456140350877,11400,11950,550,6672655,32640.0,LG유플러스보통주
10271,32640,2020-08-18,0.0447154471544715,12300,11750,-550,3295087,32640.0,LG유플러스보통주
10272,32640,2020-08-12,0.042016806722689,11900,12400,500,5613573,32640.0,LG유플러스보통주
10273,32640,2020-08-10,0.0517241379310344,11600,12200,600,5829345,32640.0,LG유플러스보통주
10274,32640,2020-07-23,0.0413223140495867,12100,11600,-500,6049921,32640.0,LG유플러스보통주
10275,32640,2020-06-15,0.0476190476190476,12600,12000,-600,1977159,32640.0,LG유플러스보통주
10276,32640,2020-05-04,0.0449438202247191,13350,12750,-600,2183559,32640.0,LG유플러스보통주
10277,32640,2020-04-14,0.055793991416309,11650,12300,650,1987722,32640.0,LG유플러스보통주
10278,32640,2020-04-06,0.0888888888888888,11250,12250,1000,3006547,32640.0,LG유플러스보통주
10279,32640,2020-04-02,0.0758293838862559,10550,11350,800,3139243,32640.0,LG유플러스보통주
10280,32640,2020-03-25,0.0406091370558375,9850,10250,400,3263266,32640.0,LG유플러스보통주
10281,32640,2020-03-24,0.0401267159450897,9470,9850,380,2870350,32640.0,LG유플러스보통주
10282,32640,2020-03-19,0.0844660194174757,10300,9430,-870,3128963,32640.0,LG유플러스보통주
10283,32640,2020-03-18,0.0678733031674208,11050,10300,-750,2309109,32640.0,LG유플러스보통주
10284,32640,2020-03-13,0.0404858299595141,12350,11850,-500,3319611,32640.0,LG유플러스보통주
10285,32640,2019-11-07,0.0483271375464684,13450,14100,650,2956971,32640.0,LG유플러스보통주
10286,32640,2019-05-23,0.0635451505016722,14950,14000,-950,5651464,32640.0,LG유플러스보통주
10287,32640,2019-04-03,0.060702875399361,15650,14700,-950,9016651,32640.0,LG유플러스보통주
10288,32640,2019-02-08,0.0612244897959183,14700,15600,900,5820324,32640.0,LG유플러스보통주
10289,32640,2019-01-30,0.0712074303405572,16150,15000,-1150,9518645,32640.0,LG유플러스보통주
10290,32640,2019-01-29,0.0415430267062314,16850,16150,-700,3154755,32640.0,LG유플러스보통주
10291,32640,2019-01-21,0.0432276657060518,17350,16600,-750,2372145,32640.0,LG유플러스보통주
10292,32640,2018-11-28,0.0602409638554216,16600,17600,1000,4813489,32640.0,LG유플러스보통주
10293,32640,2018-10-01,0.0546448087431694,18300,17300,-1000,2328303,32640.0,LG유플러스보통주
10294,32640,2018-09-27,0.056547619047619,16800,17750,950,3263337,32640.0,LG유플러스보통주
10295,32640,2018-09-13,0.0481927710843373,16600,17400,800,3892890,32640.0,LG유플러스보통주
10296,32640,2018-09-12,0.050632911392405,15800,16600,800,3220757,32640.0,LG유플러스보통주
10297,32640,2018-08-07,0.0681114551083591,16150,15050,-1100,4298753,32640.0,LG유플러스보통주
10298,32640,2018-06-25,0.0484429065743944,14450,13750,-700,2666998,32640.0,LG유플러스보통주
10299,32640,2018-06-18,0.044776119402985,13400,14000,600,5571628,32640.0,LG유플러스보통주
10300,32640,2018-06-08,0.0642570281124498,12450,13250,800,4874497,32640.0,LG유플러스보통주
10301,32640,2018-06-04,0.042016806722689,11900,12400,500,1710787,32640.0,LG유플러스보통주
10302,32640,2018-04-13,0.0441767068273092,12450,11900,-550,4540918,32640.0,LG유플러스보통주
10303,32640,2018-02-07,0.0439560439560439,13650,13050,-600,3427259,32640.0,LG유플러스보통주
10304,32640,2018-02-05,0.0415224913494809,14450,13850,-600,1707131,32640.0,LG유플러스보통주
10305,32640,2018-01-18,0.0451388888888888,14400,15050,650,3853961,32640.0,LG유플러스보통주
10306,32640,2018-01-09,0.0782918149466192,14050,15150,1100,3807655,32640.0,LG유플러스보통주
10307,32640,2017-12-13,0.0505415162454873,13850,14550,700,2563821,32640.0,LG유플러스보통주
10308,32640,2017-12-08,0.0551724137931034,14500,13700,-800,3663185,32640.0,LG유플러스보통주
10309,32640,2017-12-05,0.0457746478873239,14200,14850,650,3897750,32640.0,LG유플러스보통주
10310,32640,2017-11-30,0.0452830188679245,13250,13850,600,5122236,32640.0,LG유플러스보통주
10311,32640,2017-11-24,0.0459770114942528,13050,13650,600,2578389,32640.0,LG유플러스보통주
10312,32640,2017-11-22,0.044,12500,13050,550,3206135,32640.0,LG유플러스보통주
10313,32640,2017-08-31,0.0644067796610169,14750,13800,-950,16069220,32640.0,LG유플러스보통주
10314,32640,2017-08-11,0.0447284345047923,15650,14950,-700,4641479,32640.0,LG유플러스보통주
10315,32640,2017-07-10,0.04,15000,15600,600,1452818,32640.0,LG유플러스보통주
10316,32640,2017-06-28,0.0617647058823529,17000,15950,-1050,9148927,32640.0,LG유플러스보통주
10317,32640,2017-05-31,0.0418006430868167,15550,16200,650,3688113,32640.0,LG유플러스보통주
10318,32640,2017-05-18,0.0579710144927536,13800,14600,800,3688795,32640.0,LG유플러스보통주
10319,32640,2017-05-15,0.04,13750,13200,-550,2616713,32640.0,LG유플러스보통주
10320,32640,2017-03-22,0.0416666666666666,14400,15000,600,2549757,32640.0,LG유플러스보통주
10321,32640,2017-03-15,0.0462633451957295,14050,14700,650,2594425,32640.0,LG유플러스보통주
10322,32640,2017-03-02,0.05859375,12800,13550,750,3428244,32640.0,LG유플러스보통주
10323,32640,2017-02-03,0.0476190476190476,11550,12100,550,3147031,32640.0,LG유플러스보통주
10324,32640,2016-11-15,0.0434782608695652,11500,12000,500,1581714,32640.0,LG유플러스보통주
10325,32640,2016-11-01,0.0423728813559322,11800,12300,500,1652538,32640.0,LG유플러스보통주
10326,32640,2016-10-24,0.0565217391304347,11500,12150,650,1594124,32640.0,LG유플러스보통주
10327,32830,2021-05-03,0.040391676866585,81700,85000,3300,1849657,32830.0,삼성생명보험보통주
10328,32830,2021-04-14,0.0508474576271186,76700,80600,3900,896786,32830.0,삼성생명보험보통주
10329,32830,2021-03-02,0.0453333333333333,75000,78400,3400,828000,32830.0,삼성생명보험보통주
10330,32830,2021-02-22,0.0463576158940397,75500,79000,3500,1218533,32830.0,삼성생명보험보통주
10331,32830,2021-02-17,0.0463215258855585,73400,76800,3400,957165,32830.0,삼성생명보험보통주
10332,32830,2021-01-18,0.049636803874092,82600,78500,-4100,1161683,32830.0,삼성생명보험보통주
10333,32830,2021-01-07,0.041343669250646,77400,80600,3200,1947359,32830.0,삼성생명보험보통주
10334,32830,2020-12-22,0.0554089709762532,75800,80000,4200,2136409,32830.0,삼성생명보험보통주
10335,32830,2020-12-11,0.0453920220082531,72700,76000,3300,1091351,32830.0,삼성생명보험보통주
10336,32830,2020-11-19,0.047486033519553,71600,75000,3400,1391353,32830.0,삼성생명보험보통주
10337,32830,2020-09-22,0.04,62500,60000,-2500,803162,32830.0,삼성생명보험보통주
10338,32830,2020-09-01,0.0718954248366013,61200,65600,4400,2641377,32830.0,삼성생명보험보통주
10339,32830,2020-08-20,0.0539682539682539,63000,59600,-3400,1612953,32830.0,삼성생명보험보통주
10340,32830,2020-08-19,0.065989847715736,59100,63000,3900,2918565,32830.0,삼성생명보험보통주
10341,32830,2020-08-18,0.0949464012251148,65300,59100,-6200,3076232,32830.0,삼성생명보험보통주
10342,32830,2020-08-14,0.0917941585535466,71900,65300,-6600,4598985,32830.0,삼성생명보험보통주
10343,32830,2020-08-13,0.2104377104377104,59400,71900,12500,7226406,32830.0,삼성생명보험보통주
10344,32830,2020-08-12,0.0550621669626998,56300,59400,3100,1678762,32830.0,삼성생명보험보통주
10345,32830,2020-08-10,0.1228426395939086,49250,55300,6050,3134363,32830.0,삼성생명보험보통주
10346,32830,2020-08-06,0.0548523206751054,47400,50000,2600,1399072,32830.0,삼성생명보험보통주
10347,32830,2020-06-16,0.0491620111731843,44750,46950,2200,578499,32830.0,삼성생명보험보통주
10348,32830,2020-06-15,0.0458422174840085,46900,44750,-2150,727179,32830.0,삼성생명보험보통주
10349,32830,2020-06-12,0.0428571428571428,49000,46900,-2100,791765,32830.0,삼성생명보험보통주
10350,32830,2020-06-03,0.0518672199170124,48200,50700,2500,1753024,32830.0,삼성생명보험보통주
10351,32830,2020-05-19,0.0495495495495495,44400,46600,2200,927699,32830.0,삼성생명보험보통주
10352,32830,2020-05-04,0.0417515274949083,49100,47050,-2050,913449,32830.0,삼성생명보험보통주
10353,32830,2020-04-27,0.0511727078891258,46900,49300,2400,766422,32830.0,삼성생명보험보통주
10354,32830,2020-04-10,0.1447963800904977,44200,50600,6400,3246690,32830.0,삼성생명보험보통주
10355,32830,2020-04-01,0.0511627906976744,43000,40800,-2200,651313,32830.0,삼성생명보험보통주
10356,32830,2020-03-26,0.0588235294117647,45050,42400,-2650,1396917,32830.0,삼성생명보험보통주
10357,32830,2020-03-25,0.1686121919584954,38550,45050,6500,1325096,32830.0,삼성생명보험보통주
10358,32830,2020-03-24,0.0561643835616438,36500,38550,2050,786810,32830.0,삼성생명보험보통주
10359,32830,2020-03-23,0.0751104565537555,33950,36500,2550,943863,32830.0,삼성생명보험보통주
10360,32830,2020-03-20,0.0642633228840125,31900,33950,2050,700255,32830.0,삼성생명보험보통주
10361,32830,2020-03-19,0.09375,35200,31900,-3300,1005840,32830.0,삼성생명보험보통주
10362,32830,2020-03-18,0.1031847133757961,39250,35200,-4050,925997,32830.0,삼성생명보험보통주
10363,32830,2020-03-17,0.0914351851851851,43200,39250,-3950,900643,32830.0,삼성생명보험보통주
10364,32830,2020-03-16,0.059847660500544,45950,43200,-2750,522549,32830.0,삼성생명보험보통주
10365,32830,2020-03-12,0.0507968127490039,50200,47650,-2550,893419,32830.0,삼성생명보험보통주
10366,32830,2020-03-09,0.0755395683453237,55600,51400,-4200,581390,32830.0,삼성생명보험보통주
10367,32830,2020-02-24,0.0507692307692307,65000,61700,-3300,396835,32830.0,삼성생명보험보통주
10368,32830,2019-01-31,0.0525751072961373,93200,88300,-4900,1138071,32830.0,삼성생명보험보통주
10369,32830,2018-11-22,0.0411111111111111,90000,86300,-3700,577166,32830.0,삼성생명보험보통주
10370,32830,2018-10-11,0.0411392405063291,94800,90900,-3900,337633,32830.0,삼성생명보험보통주
10371,32830,2018-09-21,0.0468920392584514,91700,96000,4300,670255,32830.0,삼성생명보험보통주
10372,32830,2018-05-31,0.041860465116279,107500,103000,-4500,793402,32830.0,삼성생명보험보통주
10373,32830,2018-02-23,0.040650406504065,123000,128000,5000,309916,32830.0,삼성생명보험보통주
10374,32830,2018-01-30,0.0421455938697318,130500,125000,-5500,785334,32830.0,삼성생명보험보통주
10375,32830,2017-10-31,0.0424710424710424,129500,135000,5500,512542,32830.0,삼성생명보험보통주
10376,32830,2017-10-25,0.0470588235294117,127500,133500,6000,851150,32830.0,삼성생명보험보통주
10377,32830,2017-10-11,0.0789473684210526,114000,123000,9000,619650,32830.0,삼성생명보험보통주
10378,32830,2017-09-07,0.054054054054054,111000,117000,6000,423899,32830.0,삼성생명보험보통주
10379,32830,2017-05-15,0.0423728813559322,118000,123000,5000,642789,32830.0,삼성생명보험보통주
10380,32830,2017-03-14,0.0458715596330275,109000,114000,5000,544362,32830.0,삼성생명보험보통주
10381,32830,2016-11-14,0.0407239819004524,110500,115000,4500,601144,32830.0,삼성생명보험보통주
10382,32830,2016-11-11,0.0473933649289099,105500,110500,5000,626027,32830.0,삼성생명보험보통주
10383,32830,2016-10-06,0.0430622009569378,104500,109000,4500,589943,32830.0,삼성생명보험보통주
10384,32830,2016-08-19,0.0462962962962962,108000,103000,-5000,548647,32830.0,삼성생명보험보통주
10385,32830,2016-08-18,0.0536585365853658,102500,108000,5500,1038485,32830.0,삼성생명보험보통주
10386,33780,2020-12-29,0.0598194130925507,88600,83300,-5300,1503342,33780.0,케이티앤지보통주
10387,33780,2020-08-06,0.0736579275905118,80100,86000,5900,1395915,33780.0,케이티앤지보통주
10388,33780,2020-06-16,0.0416141235813367,79300,82600,3300,435544,33780.0,케이티앤지보통주
10389,33780,2020-06-15,0.046875,83200,79300,-3900,542656,33780.0,케이티앤지보통주
10390,33780,2020-05-25,0.0450121654501216,82200,85900,3700,938074,33780.0,케이티앤지보통주
10391,33780,2020-05-22,0.0458015267175572,78600,82200,3600,1531549,33780.0,케이티앤지보통주
10392,33780,2020-04-03,0.0504908835904628,71300,74900,3600,606101,33780.0,케이티앤지보통주
10393,33780,2020-04-01,0.0495314591700133,74700,71000,-3700,487326,33780.0,케이티앤지보통주
10394,33780,2020-03-25,0.0649926144756277,67700,72100,4400,657557,33780.0,케이티앤지보통주
10395,33780,2020-03-24,0.0644654088050314,63600,67700,4100,705417,33780.0,케이티앤지보통주
10396,33780,2020-03-23,0.0633284241531664,67900,63600,-4300,600618,33780.0,케이티앤지보통주
10397,33780,2020-03-19,0.0847682119205298,75500,69100,-6400,881642,33780.0,케이티앤지보통주
10398,33780,2020-03-04,0.0400471142520612,84900,81500,-3400,2017991,33780.0,케이티앤지보통주
10399,33780,2018-05-10,0.0457856399583766,96100,100500,4400,522158,33780.0,케이티앤지보통주
10400,33780,2017-09-15,0.0443349753694581,101500,106000,4500,526725,33780.0,케이티앤지보통주
10401,33780,2017-07-31,0.0460251046025104,119500,114000,-5500,481578,33780.0,케이티앤지보통주
10402,33780,2017-03-16,0.0443349753694581,101500,97000,-4500,1348685,33780.0,케이티앤지보통주
10403,33780,2016-11-11,0.055045871559633,109000,103000,-6000,741271,33780.0,케이티앤지보통주
10404,33780,2016-10-25,0.0440528634361233,113500,108500,-5000,590313,33780.0,케이티앤지보통주
10405,34020,2021-06-02,0.1164556962025316,19750,22050,2300,65569886,34020.0,두산중공업보통주
10406,34020,2021-05-31,0.1148459383753501,17850,19900,2050,40307576,34020.0,두산중공업보통주
10407,34020,2021-05-28,0.0625,16800,17850,1050,22969402,34020.0,두산중공업보통주
10408,34020,2021-05-27,0.0434782608695652,16100,16800,700,22653777,34020.0,두산중공업보통주
10409,34020,2021-05-26,0.0952380952380952,14700,16100,1400,25778709,34020.0,두산중공업보통주
10410,34020,2021-05-24,0.0467625899280575,13900,14550,650,14284697,34020.0,두산중공업보통주
10411,34020,2021-05-20,0.0952380952380952,12600,13800,1200,10551893,34020.0,두산중공업보통주
10412,34020,2021-05-03,0.082437275985663,13950,12800,-1150,6583366,34020.0,두산중공업보통주
10413,34020,2021-04-14,0.0669144981412639,13450,14350,900,9803404,34020.0,두산중공업보통주
10414,34020,2021-03-29,0.0433070866141732,12700,13250,550,7978246,34020.0,두산중공업보통주
10415,34020,2021-03-12,0.070754716981132,10600,11350,750,4854988,34020.0,두산중공업보통주
10416,34020,2021-03-03,0.0560747663551401,10700,11300,600,3121554,34020.0,두산중공업보통주
10417,34020,2021-02-26,0.045045045045045,11100,10600,-500,3778708,34020.0,두산중공업보통주
10418,34020,2021-02-25,0.0829268292682926,10250,11100,850,3366323,34020.0,두산중공업보통주
10419,34020,2021-02-24,0.0681818181818181,11000,10250,-750,4156906,34020.0,두산중공업보통주
10420,34020,2021-01-29,0.0711462450592885,12650,11750,-900,6873260,34020.0,두산중공업보통주
10421,34020,2021-01-14,0.0451127819548872,13300,13900,600,7981165,34020.0,두산중공업보통주
10422,34020,2021-01-11,0.0528169014084507,14200,13450,-750,6981930,34020.0,두산중공업보통주
10423,34020,2021-01-05,0.0575539568345323,13900,14700,800,7228208,34020.0,두산중공업보통주
10424,34020,2020-12-01,0.0746268656716417,16750,15500,-1250,9105455,34020.0,두산중공업보통주
10425,34020,2020-11-27,0.0654205607476635,16050,17100,1050,16536985,34020.0,두산중공업보통주
10426,34020,2020-11-26,0.0422077922077922,15400,16050,650,7391253,34020.0,두산중공업보통주
10427,34020,2020-11-18,0.0599369085173501,15850,14900,-950,7600712,34020.0,두산중공업보통주
10428,34020,2020-11-16,0.0425531914893617,16450,15750,-700,5797926,34020.0,두산중공업보통주
10429,34020,2020-11-09,0.064625850340136,14700,15650,950,16870984,34020.0,두산중공업보통주
10430,34020,2020-11-05,0.0505415162454873,13850,14550,700,5530543,34020.0,두산중공업보통주
10431,34020,2020-10-26,0.0539568345323741,13900,13150,-750,3274617,34020.0,두산중공업보통주
10432,34020,2020-10-19,0.1078838174273859,12050,13350,1300,8173802,34020.0,두산중공업보통주
10433,34020,2020-10-05,0.0526315789473684,13300,14000,700,3595091,34020.0,두산중공업보통주
10434,34020,2020-09-28,0.0505836575875486,12850,13500,650,5477811,34020.0,두산중공업보통주
10435,34020,2020-09-23,0.0428571428571428,14000,13400,-600,5174096,34020.0,두산중공업보통주
10436,34020,2020-09-21,0.04,15000,14400,-600,5982061,34020.0,두산중공업보통주
10437,34020,2020-09-16,0.0466666666666666,15000,15700,700,8133286,34020.0,두산중공업보통주
10438,34020,2020-09-10,0.0425531914893617,14100,14700,600,24374578,34020.0,두산중공업보통주
10439,34020,2020-09-09,0.0754098360655737,15250,14100,-1150,11886727,34020.0,두산중공업보통주
10440,34020,2020-09-08,0.0527950310559006,16100,15250,-850,14535692,34020.0,두산중공업보통주
10441,34020,2020-09-02,0.0501567398119122,15950,16750,800,44917768,34020.0,두산중공업보통주
10442,34020,2020-08-31,0.2384615384615384,13000,16100,3100,72792099,34020.0,두산중공업보통주
10443,34020,2020-08-28,0.2621359223300971,10300,13000,2700,72620662,34020.0,두산중공업보통주
10444,34020,2020-08-14,0.074361820199778,9010,9680,670,29948472,34020.0,두산중공업보통주
10445,34020,2020-08-03,0.1171428571428571,10500,9270,-1230,14335122,34020.0,두산중공업보통주
10446,34020,2020-07-29,0.0904522613065326,9950,10850,900,22574519,34020.0,두산중공업보통주
10447,34020,2020-07-28,0.1423650975889782,8710,9950,1240,7321406,34020.0,두산중공업보통주
10448,34020,2020-07-27,0.0660954712362301,8170,8710,540,4790529,34020.0,두산중공업보통주
10449,34020,2020-07-24,0.0511033681765389,8610,8170,-440,3983059,34020.0,두산중공업보통주
10450,34020,2020-07-22,0.2,7150,8580,1430,81915574,34020.0,두산중공업보통주
10451,34020,2020-07-21,0.3,5500,7150,1650,33938081,34020.0,두산중공업보통주
10452,34020,2020-07-20,0.1190233977619532,4915,5500,585,14522226,34020.0,두산중공업보통주
10453,34020,2020-06-30,0.0420258620689655,4640,4835,195,4391289,34020.0,두산중공업보통주
10454,34020,2020-06-16,0.1039657020364415,4665,5150,485,7651105,34020.0,두산중공업보통주
10455,34020,2020-06-15,0.0594758064516129,4960,4665,-295,2380851,34020.0,두산중공업보통주
10456,34020,2020-06-02,0.0945945945945946,4440,4860,420,12206389,34020.0,두산중공업보통주
10457,34020,2020-05-27,0.1428571428571428,3990,4560,570,18027176,34020.0,두산중공업보통주
10458,34020,2020-05-22,0.040097205346294,4115,3950,-165,2473381,34020.0,두산중공업보통주
10459,34020,2020-05-19,0.0463917525773195,3880,4060,180,3387190,34020.0,두산중공업보통주
10460,34020,2020-04-24,0.0409207161125319,3910,3750,-160,1752023,34020.0,두산중공업보통주
10461,34020,2020-04-20,0.0706806282722513,3820,4090,270,6061652,34020.0,두산중공업보통주
10462,34020,2020-04-16,0.0845588235294117,4080,3735,-345,4869416,34020.0,두산중공업보통주
10463,34020,2020-04-03,0.0405594405594405,3575,3720,145,4658939,34020.0,두산중공업보통주
10464,34020,2020-04-01,0.0497803806734992,3415,3585,170,11071823,34020.0,두산중공업보통주
10465,34020,2020-03-30,0.0487465181058495,3590,3415,-175,4475555,34020.0,두산중공업보통주
10466,34020,2020-03-27,0.1012269938650306,3260,3590,330,12592104,34020.0,두산중공업보통주
10467,34020,2020-03-26,0.065359477124183,3060,3260,200,6259963,34020.0,두산중공업보통주
10468,34020,2020-03-25,0.0909090909090909,2805,3060,255,4245711,34020.0,두산중공업보통주
10469,34020,2020-03-24,0.1356275303643724,2470,2805,335,2832196,34020.0,두산중공업보통주
10470,34020,2020-03-23,0.0714285714285714,2660,2470,-190,2689734,34020.0,두산중공업보통주
10471,34020,2020-03-19,0.0863557858376511,2895,2645,-250,3790942,34020.0,두산중공업보통주
10472,34020,2020-03-18,0.0691318327974276,3110,2895,-215,3309600,34020.0,두산중공업보통주
10473,34020,2020-03-17,0.0779896013864818,2885,3110,225,5123524,34020.0,두산중공업보통주
10474,34020,2020-03-16,0.0708534621578099,3105,2885,-220,4159318,34020.0,두산중공업보통주
10475,34020,2020-03-13,0.0519083969465648,3275,3105,-170,6606806,34020.0,두산중공업보통주
10476,34020,2020-03-12,0.0877437325905292,3590,3275,-315,9676133,34020.0,두산중공업보통주
10477,34020,2020-03-11,0.2144420131291028,4570,3590,-980,18831495,34020.0,두산중공업보통주
10478,34020,2020-03-09,0.0542168674698795,4980,4710,-270,2004801,34020.0,두산중공업보통주
10479,34020,2020-02-24,0.0427509293680297,5380,5150,-230,1933589,34020.0,두산중공업보통주
10480,34020,2020-02-17,0.0579964850615114,5690,6020,330,4456082,34020.0,두산중공업보통주
10481,34020,2020-02-14,0.0498154981549815,5420,5690,270,2734795,34020.0,두산중공업보통주
10482,34020,2020-01-30,0.0571428571428571,5950,5610,-340,2112366,34020.0,두산중공업보통주
10483,34020,2020-01-29,0.0434083601286173,6220,5950,-270,1843903,34020.0,두산중공업보통주
10484,34020,2020-01-23,0.0586206896551724,5800,6140,340,3923005,34020.0,두산중공업보통주
10485,34020,2020-01-22,0.0526315789473684,5510,5800,290,2030554,34020.0,두산중공업보통주
10486,34020,2019-12-12,0.0449438202247191,5340,5580,240,1789927,34020.0,두산중공업보통주
10487,34020,2019-11-01,0.0602605863192182,6140,5770,-370,3360057,34020.0,두산중공업보통주
10488,34020,2019-09-19,0.0413589364844904,6770,7050,280,2802848,34020.0,두산중공업보통주
10489,34020,2019-09-17,0.0478325859491778,6690,7010,320,6977102,34020.0,두산중공업보통주
10490,34020,2019-09-16,0.0602218700475435,6310,6690,380,2180028,34020.0,두산중공업보통주
10491,34020,2019-08-19,0.0522522522522522,5550,5840,290,1256394,34020.0,두산중공업보통주
10492,34020,2019-08-05,0.1049913941480206,5810,5200,-610,3513614,34020.0,두산중공업보통주
10493,34020,2019-07-29,0.040625,6400,6140,-260,1900235,34020.0,두산중공업보통주
10494,34020,2019-07-26,0.0474631751227495,6110,6400,290,4164548,34020.0,두산중공업보통주
10495,34020,2019-06-28,0.0606060606060606,6600,6200,-400,2601348,34020.0,두산중공업보통주
10496,34020,2019-05-30,0.0468227424749163,5980,6260,280,1822254,34020.0,두산중공업보통주
10497,34020,2019-05-29,0.0416666666666666,6240,5980,-260,2044631,34020.0,두산중공업보통주
10498,34020,2019-05-13,0.0524691358024691,6480,6140,-340,1774059,34020.0,두산중공업보통주
10499,34020,2019-05-03,0.0577956989247311,7440,7010,-430,2470841,34020.0,두산중공업보통주
10500,34020,2019-05-02,0.0643776824034334,6990,7440,450,4654884,34020.0,두산중공업보통주
10501,34020,2019-04-18,0.0403899721448468,7180,6890,-290,1424647,34020.0,두산중공업보통주
10502,34020,2019-04-01,0.0597907324364723,6690,7090,400,1656328,34020.0,두산중공업보통주
10503,34020,2019-02-22,0.0884279475982532,9160,8350,-810,5643940,34020.0,두산중공업보통주
10504,34020,2019-02-14,0.0985645933014354,10450,9420,-1030,5235166,34020.0,두산중공업보통주
10505,34020,2019-02-13,0.045662100456621,10950,10450,-500,1487102,34020.0,두산중공업보통주
10506,34020,2019-02-07,0.0403587443946188,11150,11600,450,795714,34020.0,두산중공업보통주
10507,34020,2018-12-26,0.0986046511627907,10750,9690,-1060,2279461,34020.0,두산중공업보통주
10508,34020,2018-11-26,0.0552995391705069,10850,11450,600,1629886,34020.0,두산중공업보통주
10509,34020,2018-11-14,0.0675675675675675,11100,10350,-750,2558000,34020.0,두산중공업보통주
10510,34020,2018-11-02,0.0547945205479452,10950,11550,600,800678,34020.0,두산중공업보통주
10511,34020,2018-10-11,0.0597014925373134,13400,12600,-800,1034277,34020.0,두산중공업보통주
10512,34020,2018-10-10,0.0629370629370629,14300,13400,-900,1121651,34020.0,두산중공업보통주
10513,34020,2018-08-01,0.0498338870431893,15050,14300,-750,1471602,34020.0,두산중공업보통주
10514,34020,2018-07-06,0.0419580419580419,14300,14900,600,634266,34020.0,두산중공업보통주
10515,34020,2018-07-02,0.0734824281150159,15650,14500,-1150,1669731,34020.0,두산중공업보통주
10516,34020,2018-06-21,0.0461538461538461,16250,15500,-750,869543,34020.0,두산중공업보통주
10517,34020,2018-06-19,0.064516129032258,17050,15950,-1100,2405351,34020.0,두산중공업보통주
10518,34020,2018-06-14,0.0588235294117647,18700,17600,-1100,1273870,34020.0,두산중공업보통주
10519,34020,2018-05-29,0.0555555555555555,19800,18700,-1100,1292202,34020.0,두산중공업보통주
10520,34020,2018-05-28,0.064516129032258,18600,19800,1200,1916388,34020.0,두산중공업보통주
10521,34020,2018-05-25,0.0412371134020618,19400,18600,-800,1403864,34020.0,두산중공업보통주
10522,34020,2018-05-14,0.056701030927835,19400,20500,1100,1855015,34020.0,두산중공업보통주
10523,34020,2018-05-10,0.0594594594594594,18500,19600,1100,1781460,34020.0,두산중공업보통주
10524,34020,2018-05-04,0.040650406504065,18450,19200,750,1682285,34020.0,두산중공업보통주
10525,34020,2018-04-18,0.0594059405940594,15150,16050,900,1840724,34020.0,두산중공업보통주
10526,34020,2018-03-27,0.0816993464052287,15300,16550,1250,2240849,34020.0,두산중공업보통주
10527,34020,2018-01-29,0.0464396284829721,16150,16900,750,1830016,34020.0,두산중공업보통주
10528,34020,2018-01-10,0.0424242424242424,16500,17200,700,2060863,34020.0,두산중공업보통주
10529,34020,2017-12-08,0.0538922155688622,16700,15800,-900,1391743,34020.0,두산중공업보통주
10530,34020,2017-12-05,0.0900621118012422,16100,17550,1450,3019559,34020.0,두산중공업보통주
10531,34020,2017-11-15,0.04,17500,16800,-700,878226,34020.0,두산중공업보통주
10532,34020,2017-10-23,0.0515463917525773,19400,18400,-1000,2046507,34020.0,두산중공업보통주
10533,34020,2017-10-19,0.059299191374663,18550,19650,1100,2013938,34020.0,두산중공업보통주
10534,34020,2017-08-03,0.0875912408759124,20550,18750,-1800,2151421,34020.0,두산중공업보통주
10535,34020,2017-07-14,0.0472813238770685,21150,20150,-1000,1379999,34020.0,두산중공업보통주
10536,34020,2017-06-28,0.0439814814814814,21600,20650,-950,1369069,34020.0,두산중공업보통주
10537,34020,2017-06-19,0.1099585062240663,24100,21450,-2650,3351941,34020.0,두산중공업보통주
10538,34020,2017-05-29,0.0468085106382978,23500,22400,-1100,1883429,34020.0,두산중공업보통주
10539,34020,2017-04-05,0.0461215932914046,23850,24950,1100,1552075,34020.0,두산중공업보통주
10540,34020,2017-03-23,0.0428571428571428,24500,25550,1050,1216026,34020.0,두산중공업보통주
10541,34020,2017-03-07,0.0480167014613778,23950,25100,1150,1225705,34020.0,두산중공업보통주
10542,34020,2017-02-28,0.0770676691729323,26600,24550,-2050,3256278,34020.0,두산중공업보통주
10543,34020,2017-02-01,0.0400728597449908,27450,28550,1100,421770,34020.0,두산중공업보통주
10544,34020,2016-12-20,0.0592734225621414,26150,27700,1550,1233580,34020.0,두산중공업보통주
10545,34020,2016-12-07,0.0520446096654275,26900,25500,-1400,663612,34020.0,두산중공업보통주
10546,34020,2016-11-18,0.0460992907801418,28200,26900,-1300,1067127,34020.0,두산중공업보통주
10547,34020,2016-11-11,0.0527306967984934,26550,27950,1400,1266798,34020.0,두산중공업보통주
10548,34020,2016-11-10,0.0993788819875776,24150,26550,2400,1160017,34020.0,두산중공업보통주
10549,34020,2016-11-09,0.056640625,25600,24150,-1450,1452446,34020.0,두산중공업보통주
10550,34020,2016-10-12,0.0452755905511811,25400,26550,1150,801632,34020.0,두산중공업보통주
10551,34020,2016-10-06,0.0721442885771543,24950,26750,1800,1291773,34020.0,두산중공업보통주
10552,34020,2016-09-12,0.0406779661016949,29500,28300,-1200,536770,34020.0,두산중공업보통주
10553,34020,2016-08-05,0.0609037328094302,25450,27000,1550,1206287,34020.0,두산중공업보통주
10554,34220,2021-05-18,0.0427927927927927,22200,23150,950,3287855,34220.0,LG디스플레이보통주
10555,34220,2021-05-11,0.0527383367139959,24650,23350,-1300,6080934,34220.0,LG디스플레이보통주
10556,34220,2021-04-22,0.0602409638554216,24900,26400,1500,10914551,34220.0,LG디스플레이보통주
10557,34220,2021-04-06,0.0508130081300813,24600,25850,1250,14103251,34220.0,LG디스플레이보통주
10558,34220,2021-04-05,0.074235807860262,22900,24600,1700,9200249,34220.0,LG디스플레이보통주
10559,34220,2021-02-26,0.0464135021097046,23700,22600,-1100,5206863,34220.0,LG디스플레이보통주
10560,34220,2021-02-24,0.0545454545454545,24750,23400,-1350,4020060,34220.0,LG디스플레이보통주
10561,34220,2021-02-15,0.0463157894736842,23750,24850,1100,5495342,34220.0,LG디스플레이보통주
10562,34220,2021-02-01,0.0459770114942528,21750,22750,1000,4883218,34220.0,LG디스플레이보통주
10563,34220,2021-01-29,0.0543478260869565,23000,21750,-1250,6345072,34220.0,LG디스플레이보통주
10564,34220,2021-01-27,0.0497925311203319,24100,22900,-1200,8529941,34220.0,LG디스플레이보통주
10565,34220,2021-01-21,0.0964705882352941,21250,23300,2050,28035650,34220.0,LG디스플레이보통주
10566,34220,2021-01-14,0.0513447432762836,20450,21500,1050,9918191,34220.0,LG디스플레이보통주
10567,34220,2020-12-23,0.0641399416909621,17150,18250,1100,41667728,34220.0,LG디스플레이보통주
10568,34220,2020-12-15,0.0684523809523809,16800,17950,1150,12241478,34220.0,LG디스플레이보통주
10569,34220,2020-09-24,0.050314465408805,15900,15100,-800,2427886,34220.0,LG디스플레이보통주
10570,34220,2020-09-07,0.0437710437710437,14850,15500,650,7013744,34220.0,LG디스플레이보통주
10571,34220,2020-08-24,0.1310861423220973,13350,15100,1750,16215702,34220.0,LG디스플레이보통주
10572,34220,2020-08-21,0.0637450199203187,12550,13350,800,5879552,34220.0,LG디스플레이보통주
10573,34220,2020-08-18,0.0510948905109489,13700,13000,-700,4192002,34220.0,LG디스플레이보통주
10574,34220,2020-08-10,0.0604838709677419,12400,13150,750,5966549,34220.0,LG디스플레이보통주
10575,34220,2020-07-07,0.046875,12800,12200,-600,4885103,34220.0,LG디스플레이보통주
10576,34220,2020-07-06,0.0987124463519313,11650,12800,1150,6978606,34220.0,LG디스플레이보통주
10577,34220,2020-06-25,0.0416666666666666,12000,11500,-500,1823799,34220.0,LG디스플레이보통주
10578,34220,2020-06-16,0.0636363636363636,11000,11700,700,2563988,34220.0,LG디스플레이보통주
10579,34220,2020-06-15,0.055793991416309,11650,11000,-650,3822273,34220.0,LG디스플레이보통주
10580,34220,2020-06-12,0.0411522633744856,12150,11650,-500,4066174,34220.0,LG디스플레이보통주
10581,34220,2020-06-08,0.0537190082644628,12100,12750,650,5597187,34220.0,LG디스플레이보통주
10582,34220,2020-06-03,0.063063063063063,11100,11800,700,8077649,34220.0,LG디스플레이보통주
10583,34220,2020-06-02,0.0422535211267605,10650,11100,450,5562644,34220.0,LG디스플레이보통주
10584,34220,2020-06-01,0.0441176470588235,10200,10650,450,2552725,34220.0,LG디스플레이보통주
10585,34220,2020-05-22,0.0420560747663551,10700,10250,-450,2796866,34220.0,LG디스플레이보통주
10586,34220,2020-04-06,0.0422535211267605,10650,11100,450,1901519,34220.0,LG디스플레이보통주
10587,34220,2020-04-01,0.045045045045045,11100,10600,-500,2231413,34220.0,LG디스플레이보통주
10588,34220,2020-03-27,0.0465116279069767,10750,11250,500,5865020,34220.0,LG디스플레이보통주
10589,34220,2020-03-25,0.048780487804878,10250,10750,500,4920992,34220.0,LG디스플레이보통주
10590,34220,2020-03-24,0.0939167556029882,9370,10250,880,3739858,34220.0,LG디스플레이보통주
10591,34220,2020-03-23,0.0902912621359223,10300,9370,-930,3396532,34220.0,LG디스플레이보통주
10592,34220,2020-03-20,0.1573033707865168,8900,10300,1400,4192287,34220.0,LG디스플레이보통주
10593,34220,2020-03-19,0.1082164328657314,9980,8900,-1080,7779555,34220.0,LG디스플레이보통주
10594,34220,2020-03-18,0.0672897196261682,10700,9980,-720,3593393,34220.0,LG디스플레이보통주
10595,34220,2020-03-16,0.0442477876106194,11300,10800,-500,4055023,34220.0,LG디스플레이보통주
10596,34220,2020-03-13,0.0661157024793388,12100,11300,-800,8381686,34220.0,LG디스플레이보통주
10597,34220,2020-03-12,0.0656370656370656,12950,12100,-850,5584879,34220.0,LG디스플레이보통주
10598,34220,2020-03-09,0.07773851590106,14150,13050,-1100,3743057,34220.0,LG디스플레이보통주
10599,34220,2020-02-28,0.0456140350877193,14250,13600,-650,3704643,34220.0,LG디스플레이보통주
10600,34220,2020-02-06,0.0440251572327044,15900,16600,700,3835888,34220.0,LG디스플레이보통주
10601,34220,2020-02-04,0.0631229235880398,15050,16000,950,4247243,34220.0,LG디스플레이보통주
10602,34220,2020-01-31,0.0440677966101694,14750,15400,650,4270468,34220.0,LG디스플레이보통주
10603,34220,2020-01-08,0.0428134556574923,16350,15650,-700,2625706,34220.0,LG디스플레이보통주
10604,34220,2019-12-09,0.0952380952380952,14700,16100,1400,7738658,34220.0,LG디스플레이보통주
10605,34220,2019-11-28,0.057347670250896,13950,14750,800,4722787,34220.0,LG디스플레이보통주
10606,34220,2019-11-05,0.0543478260869565,13800,14550,750,2978553,34220.0,LG디스플레이보통주
10607,34220,2019-08-30,0.0648854961832061,13100,13950,850,4674155,34220.0,LG디스플레이보통주
10608,34220,2019-08-05,0.0477941176470588,13600,12950,-650,6358682,34220.0,LG디스플레이보통주
10609,34220,2019-08-02,0.0555555555555555,14400,13600,-800,4849174,34220.0,LG디스플레이보통주
10610,34220,2019-07-31,0.0793650793650793,15750,14500,-1250,12170624,34220.0,LG디스플레이보통주
10611,34220,2019-07-08,0.0488505747126436,17400,16550,-850,2269949,34220.0,LG디스플레이보통주
10612,34220,2019-06-21,0.0464480874316939,18300,17450,-850,3206330,34220.0,LG디스플레이보통주
10613,34220,2019-06-20,0.0701754385964912,17100,18300,1200,4157464,34220.0,LG디스플레이보통주
10614,34220,2019-05-09,0.0426666666666666,18750,17950,-800,2819720,34220.0,LG디스플레이보통주
10615,34220,2019-05-07,0.0412371134020618,19400,18600,-800,2709965,34220.0,LG디스플레이보통주
10616,34220,2019-04-24,0.0635294117647058,21250,19900,-1350,3839009,34220.0,LG디스플레이보통주
10617,34220,2019-04-09,0.0481927710843373,20750,21750,1000,3635185,34220.0,LG디스플레이보통주
10618,34220,2019-02-21,0.048469387755102,19600,20550,950,4282357,34220.0,LG디스플레이보통주
10619,34220,2019-01-31,0.0430379746835443,19750,18900,-850,4145813,34220.0,LG디스플레이보통주
10620,34220,2019-01-10,0.0421052631578947,19000,19800,800,3059417,34220.0,LG디스플레이보통주
10621,34220,2018-12-13,0.0518731988472622,17350,18250,900,4303965,34220.0,LG디스플레이보통주
10622,34220,2018-11-28,0.0518731988472622,17350,18250,900,2743583,34220.0,LG디스플레이보통주
10623,34220,2018-11-09,0.0558823529411764,17000,17950,950,3566050,34220.0,LG디스플레이보통주
10624,34220,2018-11-02,0.0575757575757575,16500,17450,950,2250229,34220.0,LG디스플레이보통주
10625,34220,2018-10-23,0.0521978021978022,18200,17250,-950,3792907,34220.0,LG디스플레이보통주
10626,34220,2018-10-12,0.0518731988472622,17350,18250,900,2560059,34220.0,LG디스플레이보통주
10627,34220,2018-09-11,0.0495283018867924,21200,20150,-1050,3546663,34220.0,LG디스플레이보통주
10628,34220,2018-08-22,0.0408602150537634,23250,22300,-950,3260031,34220.0,LG디스플레이보통주
10629,34220,2018-08-08,0.0442477876106194,22600,21600,-1000,4132999,34220.0,LG디스플레이보통주
10630,34220,2018-07-26,0.0415647921760391,20450,21300,850,3770513,34220.0,LG디스플레이보통주
10631,34220,2018-07-25,0.0466200466200466,21450,20450,-1000,4548875,34220.0,LG디스플레이보통주
10632,34220,2018-07-19,0.0541871921182266,20300,21400,1100,4084153,34220.0,LG디스플레이보통주
10633,34220,2018-07-09,0.0472222222222222,18000,18850,850,2976090,34220.0,LG디스플레이보통주
10634,34220,2018-06-29,0.0457142857142857,17500,18300,800,4454897,34220.0,LG디스플레이보통주
10635,34220,2018-06-28,0.0437158469945355,18300,17500,-800,3166935,34220.0,LG디스플레이보통주
10636,34220,2018-06-18,0.0424528301886792,21200,20300,-900,4274096,34220.0,LG디스플레이보통주
10637,34220,2018-06-15,0.0428893905191873,22150,21200,-950,4193942,34220.0,LG디스플레이보통주
10638,34220,2018-05-29,0.0522727272727272,22000,23150,1150,4490612,34220.0,LG디스플레이보통주
10639,34220,2018-05-11,0.0401785714285714,22400,23300,900,2342673,34220.0,LG디스플레이보통주
10640,34220,2018-01-23,0.0585365853658536,30750,32550,1800,9952861,34220.0,LG디스플레이보통주
10641,34220,2018-01-16,0.0689655172413793,29000,31000,2000,8051821,34220.0,LG디스플레이보통주
10642,34220,2017-11-21,0.060200668896321,29900,31700,1800,9244310,34220.0,LG디스플레이보통주
10643,34220,2017-10-20,0.0481099656357388,29100,30500,1400,5039655,34220.0,LG디스플레이보통주
10644,34220,2017-10-12,0.0512396694214876,30250,28700,-1550,7527765,34220.0,LG디스플레이보통주
10645,34220,2017-09-19,0.05,34000,32300,-1700,8209512,34220.0,LG디스플레이보통주
10646,34220,2017-09-05,0.0644628099173553,30250,32200,1950,6391055,34220.0,LG디스플레이보통주
10647,34220,2017-07-20,0.0816599732262382,37350,34300,-3050,13883506,34220.0,LG디스플레이보통주
10648,34220,2017-07-04,0.0533515731874145,36550,38500,1950,4768875,34220.0,LG디스플레이보통주
10649,34220,2017-06-13,0.0773638968481375,34900,37600,2700,5879867,34220.0,LG디스플레이보통주
10650,34220,2017-06-12,0.0490463215258855,36700,34900,-1800,5350754,34220.0,LG디스플레이보통주
10651,34220,2017-06-07,0.0427098674521354,33950,35400,1450,4874654,34220.0,LG디스플레이보통주
10652,34220,2017-05-30,0.0612582781456953,30200,32050,1850,7849718,34220.0,LG디스플레이보통주
10653,34220,2017-05-26,0.0415944540727903,28850,30050,1200,5303654,34220.0,LG디스플레이보통주
10654,34220,2017-04-27,0.0493630573248407,31400,29850,-1550,5097192,34220.0,LG디스플레이보통주
10655,34220,2017-03-29,0.0428082191780821,29200,30450,1250,3222461,34220.0,LG디스플레이보통주
10656,34220,2017-01-25,0.04251968503937,31750,30400,-1350,3640103,34220.0,LG디스플레이보통주
10657,34220,2016-12-06,0.0467625899280575,27800,29100,1300,1349604,34220.0,LG디스플레이보통주
10658,34220,2016-11-09,0.0455373406193078,27450,26200,-1250,2101154,34220.0,LG디스플레이보통주
10659,34220,2016-10-28,0.0439189189189189,29600,28300,-1300,2194023,34220.0,LG디스플레이보통주
10660,34220,2016-10-07,0.0440140845070422,28400,29650,1250,2062704,34220.0,LG디스플레이보통주
10661,34220,2016-09-08,0.0488599348534201,30700,29200,-1500,1864611,34220.0,LG디스플레이보통주
10662,34730,2021-04-09,0.050179211469534,279000,293000,14000,694443,34730.0,SK보통주
10663,34730,2021-03-30,0.0465549348230912,268500,281000,12500,581621,34730.0,SK보통주
10664,34730,2021-03-26,0.076171875,256000,275500,19500,833364,34730.0,SK보통주
10665,34730,2021-03-25,0.0491803278688524,244000,256000,12000,420832,34730.0,SK보통주
10666,34730,2021-03-02,0.0438095238095238,262500,274000,11500,405669,34730.0,SK보통주
10667,34730,2021-02-26,0.0523465703971119,277000,262500,-14500,548833,34730.0,SK보통주
10668,34730,2021-02-25,0.0452830188679245,265000,277000,12000,329598,34730.0,SK보통주
10669,34730,2021-02-01,0.0578778135048231,311000,329000,18000,584069,34730.0,SK보통주
10670,34730,2021-01-28,0.0487444608567208,338500,322000,-16500,795974,34730.0,SK보통주
10671,34730,2021-01-26,0.0422535211267605,355000,340000,-15000,946865,34730.0,SK보통주
10672,34730,2021-01-25,0.0823170731707317,328000,355000,27000,803628,34730.0,SK보통주
10673,34730,2021-01-20,0.0809061488673139,309000,334000,25000,1358636,34730.0,SK보통주
10674,34730,2021-01-13,0.0532859680284191,281500,296500,15000,1017559,34730.0,SK보통주
10675,34730,2021-01-07,0.0842490842490842,273000,296000,23000,1946685,34730.0,SK보통주
10676,34730,2021-01-06,0.0854870775347912,251500,273000,21500,2378756,34730.0,SK보통주
10677,34730,2020-12-11,0.0411522633744856,243000,253000,10000,590106,34730.0,SK보통주
10678,34730,2020-12-02,0.0699774266365688,221500,237000,15500,1065538,34730.0,SK보통주
10679,34730,2020-12-01,0.0472813238770685,211500,221500,10000,316450,34730.0,SK보통주
10680,34730,2020-11-16,0.0478468899521531,209000,219000,10000,475806,34730.0,SK보통주
10681,34730,2020-11-11,0.0615384615384615,195000,207000,12000,590944,34730.0,SK보통주
10682,34730,2020-09-24,0.050125313283208,199500,189500,-10000,309274,34730.0,SK보통주
10683,34730,2020-08-31,0.0446428571428571,224000,214000,-10000,487729,34730.0,SK보통주
10684,34730,2020-08-28,0.041860465116279,215000,224000,9000,446589,34730.0,SK보통주
10685,34730,2020-08-25,0.0471698113207547,212000,222000,10000,237042,34730.0,SK보통주
10686,34730,2020-08-20,0.0584269662921348,222500,209500,-13000,396676,34730.0,SK보통주
10687,34730,2020-08-18,0.0471092077087794,233500,222500,-11000,304434,34730.0,SK보통주
10688,34730,2020-08-05,0.0479302832244008,229500,240500,11000,721764,34730.0,SK보통주
10689,34730,2020-08-04,0.0551724137931034,217500,229500,12000,464562,34730.0,SK보통주
10690,34730,2020-07-14,0.045360824742268,242500,231500,-11000,729003,34730.0,SK보통주
10691,34730,2020-07-02,0.0622895622895622,297000,278500,-18500,2892772,34730.0,SK보통주
10692,34730,2020-06-24,0.0743134087237479,309500,286500,-23000,3591128,34730.0,SK보통주
10693,34730,2020-06-23,0.0563139931740614,293000,309500,16500,1550365,34730.0,SK보통주
10694,34730,2020-06-19,0.0502431118314424,308500,293000,-15500,1451060,34730.0,SK보통주
10695,34730,2020-06-15,0.089605734767025,279000,304000,25000,4331754,34730.0,SK보통주
10696,34730,2020-06-12,0.0856031128404669,257000,279000,22000,1298434,34730.0,SK보통주
10697,34730,2020-06-05,0.0730688935281837,239500,257000,17500,871235,34730.0,SK보통주
10698,34730,2020-05-28,0.0430528375733855,255500,244500,-11000,675566,34730.0,SK보통주
10699,34730,2020-05-26,0.050709939148073,246500,259000,12500,763255,34730.0,SK보통주
10700,34730,2020-05-25,0.0787746170678337,228500,246500,18000,737103,34730.0,SK보통주
10701,34730,2020-05-20,0.1017369727047146,201500,222000,20500,1317938,34730.0,SK보통주
10702,34730,2020-05-18,0.1098901098901098,182000,202000,20000,630281,34730.0,SK보통주
10703,34730,2020-04-17,0.0443213296398892,180500,188500,8000,244505,34730.0,SK보통주
10704,34730,2020-04-10,0.0467836257309941,171000,179000,8000,279238,34730.0,SK보통주
10705,34730,2020-03-31,0.046875,160000,167500,7500,342668,34730.0,SK보통주
10706,34730,2020-03-27,0.0453074433656957,154500,161500,7000,465790,34730.0,SK보통주
10707,34730,2020-03-25,0.1231343283582089,134000,150500,16500,771051,34730.0,SK보통주
10708,34730,2020-03-24,0.2407407407407407,108000,134000,26000,771510,34730.0,SK보통주
10709,34730,2020-03-23,0.1111111111111111,121500,108000,-13500,336085,34730.0,SK보통주
10710,34730,2020-03-20,0.1355140186915887,107000,121500,14500,444841,34730.0,SK보통주
10711,34730,2020-03-19,0.1370967741935483,124000,107000,-17000,541476,34730.0,SK보통주
10712,34730,2020-03-18,0.1014492753623188,138000,124000,-14000,387932,34730.0,SK보통주
10713,34730,2020-03-17,0.0515463917525773,145500,138000,-7500,306127,34730.0,SK보통주
10714,34730,2020-03-16,0.0791139240506329,158000,145500,-12500,275952,34730.0,SK보통주
10715,34730,2020-03-12,0.0628571428571428,175000,164000,-11000,413438,34730.0,SK보통주
10716,34730,2020-03-09,0.0539845758354755,194500,184000,-10500,267208,34730.0,SK보통주
10717,34730,2020-02-28,0.0423940149625935,200500,192000,-8500,231899,34730.0,SK보통주
10718,34730,2020-02-24,0.0494117647058823,212500,202000,-10500,246357,34730.0,SK보통주
10719,34730,2020-01-28,0.0414937759336099,241000,231000,-10000,136552,34730.0,SK보통주
10720,34730,2020-01-08,0.0486381322957198,257000,244500,-12500,175476,34730.0,SK보통주
10721,34730,2019-11-22,0.047970479704797,271000,258000,-13000,509755,34730.0,SK보통주
10722,34730,2019-10-24,0.0461215932914046,238500,249500,11000,261073,34730.0,SK보통주
10723,34730,2019-10-01,0.0980392156862745,204000,224000,20000,372320,34730.0,SK보통주
10724,34730,2019-09-16,0.0637254901960784,204000,217000,13000,283391,34730.0,SK보통주
10725,34730,2019-05-29,0.0418410041841004,239000,229000,-10000,148233,34730.0,SK보통주
10726,34730,2019-02-12,0.0437262357414448,263000,274500,11500,130509,34730.0,SK보통주
10727,34730,2018-11-12,0.0438931297709923,262000,273500,11500,87713,34730.0,SK보통주
10728,34730,2018-10-11,0.0595446584938704,285500,268500,-17000,147543,34730.0,SK보통주
10729,34730,2018-07-25,0.0510948905109489,274000,260000,-14000,301800,34730.0,SK보통주
10730,34730,2018-03-06,0.0553571428571428,280000,295500,15500,178629,34730.0,SK보통주
10731,34730,2018-01-25,0.0475409836065573,305000,319500,14500,210974,34730.0,SK보통주
10732,34730,2017-10-10,0.0434027777777777,288000,300500,12500,193764,34730.0,SK보통주
10733,34730,2017-06-01,0.0420475319926873,273500,285000,11500,393625,34730.0,SK보통주
10734,34730,2016-10-17,0.0503597122302158,208500,219000,10500,241975,34730.0,SK보통주
10735,34730,2016-08-19,0.0424107142857142,224000,214500,-9500,205429,34730.0,SK보통주
10736,34730,2016-08-04,0.0433734939759036,207500,216500,9000,151970,34730.0,SK보통주
10737,35250,2021-05-25,0.0665362035225048,25550,27250,1700,3681876,35250.0,강원랜드보통주
10738,35250,2021-03-04,0.044,25000,26100,1100,3434034,35250.0,강원랜드보통주
10739,35250,2021-01-12,0.050632911392405,23700,24900,1200,2679231,35250.0,강원랜드보통주
10740,35250,2020-11-11,0.0515695067264574,22300,23450,1150,2233904,35250.0,강원랜드보통주
10741,35250,2020-10-12,0.073394495412844,21800,23400,1600,2848581,35250.0,강원랜드보통주
10742,35250,2020-08-20,0.0478359908883826,21950,20900,-1050,878512,35250.0,강원랜드보통주
10743,35250,2020-08-18,0.0494623655913978,23250,22100,-1150,1052861,35250.0,강원랜드보통주
10744,35250,2020-06-16,0.049438202247191,22250,23350,1100,961986,35250.0,강원랜드보통주
10745,35250,2020-06-15,0.065126050420168,23800,22250,-1550,913933,35250.0,강원랜드보통주
10746,35250,2020-05-28,0.0609523809523809,26250,24650,-1600,2098021,35250.0,강원랜드보통주
10747,35250,2020-05-27,0.0437375745526839,25150,26250,1100,2447025,35250.0,강원랜드보통주
10748,35250,2020-05-20,0.0504201680672268,23800,25000,1200,2267014,35250.0,강원랜드보통주
10749,35250,2020-05-13,0.042016806722689,23800,22800,-1000,1272235,35250.0,강원랜드보통주
10750,35250,2020-04-16,0.0421940928270042,23700,24700,1000,1636066,35250.0,강원랜드보통주
10751,35250,2020-04-09,0.1228915662650602,20750,23300,2550,3190691,35250.0,강원랜드보통주
10752,35250,2020-04-06,0.0723860589812332,18650,20000,1350,1134267,35250.0,강원랜드보통주
10753,35250,2020-04-01,0.0658227848101265,19750,18450,-1300,1179317,35250.0,강원랜드보통주
10754,35250,2020-03-25,0.0602739726027397,18250,19350,1100,832297,35250.0,강원랜드보통주
10755,35250,2020-03-24,0.123076923076923,16250,18250,2000,863640,35250.0,강원랜드보통주
10756,35250,2020-03-23,0.0660919540229885,17400,16250,-1150,1149502,35250.0,강원랜드보통주
10757,35250,2020-03-19,0.0864864864864864,18500,16900,-1600,1359042,35250.0,강원랜드보통주
10758,35250,2020-03-18,0.0656565656565656,19800,18500,-1300,685727,35250.0,강원랜드보통주
10759,35250,2020-03-17,0.0526315789473684,20900,19800,-1100,852460,35250.0,강원랜드보통주
10760,35250,2020-03-12,0.0433839479392624,23050,22050,-1000,966872,35250.0,강원랜드보통주
10761,35250,2020-02-28,0.0440251572327044,23850,22800,-1050,962204,35250.0,강원랜드보통주
10762,35250,2020-02-24,0.0499001996007984,25050,23800,-1250,687517,35250.0,강원랜드보통주
10763,35250,2019-04-12,0.0432,31250,32600,1350,640551,35250.0,강원랜드보통주
10764,35250,2019-02-15,0.0723589001447178,34550,32050,-2500,2770596,35250.0,강원랜드보통주
10765,35250,2018-12-14,0.0467153284671532,34250,32650,-1600,512360,35250.0,강원랜드보통주
10766,35250,2018-11-29,0.0658978583196046,30350,32350,2000,1455692,35250.0,강원랜드보통주
10767,35250,2018-08-10,0.0783582089552238,26800,28900,2100,2206212,35250.0,강원랜드보통주
10768,35250,2018-06-21,0.0404217926186291,28450,27300,-1150,620613,35250.0,강원랜드보통주
10769,35250,2018-04-20,0.0416666666666666,27600,28750,1150,1890896,35250.0,강원랜드보통주
10770,35250,2018-02-09,0.0493630573248407,31400,29850,-1550,781360,35250.0,강원랜드보통주
10771,35250,2018-01-02,0.0790229885057471,34800,32050,-2750,2012609,35250.0,강원랜드보통주
10772,35250,2017-11-14,0.0532212885154061,35700,37600,1900,831991,35250.0,강원랜드보통주
10773,35250,2017-07-27,0.0438472418670438,35350,36900,1550,619451,35250.0,강원랜드보통주
10774,35250,2017-05-16,0.0428015564202334,38550,36900,-1650,499267,35250.0,강원랜드보통주
10775,35250,2017-03-22,0.043115438108484,35950,37500,1550,834410,35250.0,강원랜드보통주
10776,35250,2017-01-09,0.0416088765603328,36050,34550,-1500,672511,35250.0,강원랜드보통주
10777,35250,2016-11-30,0.0403768506056527,37150,35650,-1500,808262,35250.0,강원랜드보통주
10778,35250,2016-11-03,0.0563564875491481,38150,36000,-2150,823904,35250.0,강원랜드보통주
10779,35420,2021-03-18,0.0521512385919165,383500,403500,20000,1818409,35420.0,NAVER보통주
10780,35420,2021-03-03,0.0582781456953642,377500,399500,22000,1287551,35420.0,NAVER보통주
10781,35420,2021-02-24,0.0422535211267605,390500,374000,-16500,1078485,35420.0,NAVER보통주
10782,35420,2021-02-15,0.0518417462482946,366500,385500,19000,1172475,35420.0,NAVER보통주
10783,35420,2021-02-02,0.0416666666666666,348000,362500,14500,1951062,35420.0,NAVER보통주
10784,35420,2021-01-22,0.0651162790697674,322500,343500,21000,3303950,35420.0,NAVER보통주
10785,35420,2021-01-21,0.047077922077922,308000,322500,14500,1941446,35420.0,NAVER보통주
10786,35420,2021-01-08,0.077720207253886,289500,312000,22500,3175396,35420.0,NAVER보통주
10787,35420,2020-11-10,0.0503355704697986,298000,283000,-15000,1728995,35420.0,NAVER보통주
10788,35420,2020-11-04,0.0547703180212014,283000,298500,15500,1623712,35420.0,NAVER보통주
10789,35420,2020-10-28,0.0529100529100529,283500,298500,15000,698195,35420.0,NAVER보통주
10790,35420,2020-09-23,0.0421792618629174,284500,296500,12000,984136,35420.0,NAVER보통주
10791,35420,2020-09-07,0.0426179604261796,328500,314500,-14000,1308247,35420.0,NAVER보통주
10792,35420,2020-08-03,0.0448504983388704,301000,314500,13500,1341104,35420.0,NAVER보통주
10793,35420,2020-07-23,0.0518518518518518,270000,284000,14000,1396607,35420.0,NAVER보통주
10794,35420,2020-07-20,0.0471014492753623,276000,263000,-13000,1556415,35420.0,NAVER보통주
10795,35420,2020-07-16,0.0471204188481675,286500,273000,-13500,1338814,35420.0,NAVER보통주
10796,35420,2020-07-10,0.04,287500,299000,11500,2120904,35420.0,NAVER보통주
10797,35420,2020-06-22,0.0821643286573146,249500,270000,20500,1841479,35420.0,NAVER보통주
10798,35420,2020-06-16,0.0518358531317494,231500,243500,12000,1155474,35420.0,NAVER보통주
10799,35420,2020-06-15,0.0433884297520661,242000,231500,-10500,1311773,35420.0,NAVER보통주
10800,35420,2020-06-08,0.0411255411255411,231000,240500,9500,1624752,35420.0,NAVER보통주
10801,35420,2020-06-01,0.0486725663716814,226000,237000,11000,1140644,35420.0,NAVER보통주
10802,35420,2020-05-29,0.0602910602910602,240500,226000,-14500,3114298,35420.0,NAVER보통주
10803,35420,2020-05-28,0.0525164113785558,228500,240500,12000,1625154,35420.0,NAVER보통주
10804,35420,2020-05-27,0.0439330543933054,239000,228500,-10500,1351505,35420.0,NAVER보통주
10805,35420,2020-05-25,0.0455531453362256,230500,241000,10500,1015069,35420.0,NAVER보통주
10806,35420,2020-05-06,0.0653266331658291,199000,212000,13000,992225,35420.0,NAVER보통주
10807,35420,2020-04-23,0.0439560439560439,182000,190000,8000,1521478,35420.0,NAVER보통주
10808,35420,2020-04-17,0.0498533724340175,170500,179000,8500,900031,35420.0,NAVER보통주
10809,35420,2020-04-02,0.0644171779141104,163000,173500,10500,1086863,35420.0,NAVER보통주
10810,35420,2020-04-01,0.0411764705882352,170000,163000,-7000,720283,35420.0,NAVER보통주
10811,35420,2020-03-31,0.0461538461538461,162500,170000,7500,858165,35420.0,NAVER보통주
10812,35420,2020-03-27,0.0754098360655737,152500,164000,11500,1217815,35420.0,NAVER보통주
10813,35420,2020-03-24,0.0909090909090909,143000,156000,13000,960786,35420.0,NAVER보통주
10814,35420,2020-03-23,0.0714285714285714,154000,143000,-11000,1033851,35420.0,NAVER보통주
10815,35420,2020-03-20,0.0694444444444444,144000,154000,10000,997895,35420.0,NAVER보통주
10816,35420,2020-03-16,0.0662650602409638,166000,155000,-11000,812823,35420.0,NAVER보통주
10817,35420,2020-03-09,0.064066852367688,179500,168000,-11500,668089,35420.0,NAVER보통주
10818,35420,2020-02-28,0.0439560439560439,182000,174000,-8000,830654,35420.0,NAVER보통주
10819,35420,2019-11-19,0.0448179271708683,178500,170500,-8000,1055749,35420.0,NAVER보통주
10820,35420,2019-11-14,0.1392405063291139,158000,180000,22000,2042648,35420.0,NAVER보통주
10821,35420,2019-10-31,0.0614886731391585,154500,164000,9500,1409619,35420.0,NAVER보통주
10822,35420,2019-10-04,0.0414012738853503,157000,150500,-6500,602642,35420.0,NAVER보통주
10823,35420,2019-08-20,0.0467625899280575,139000,145500,6500,556246,35420.0,NAVER보통주
10824,35420,2019-07-26,0.0522388059701492,134000,141000,7000,1440686,35420.0,NAVER보통주
10825,35420,2019-07-25,0.0850202429149797,123500,134000,10500,1635774,35420.0,NAVER보통주
10826,35420,2019-02-26,0.0436507936507936,126000,131500,5500,591643,35420.0,NAVER보통주
10827,35420,2019-01-21,0.0472727272727272,137500,131000,-6500,457161,35420.0,NAVER보통주
10828,35420,2019-01-15,0.0433070866141732,127000,132500,5500,335999,35420.0,NAVER보통주
10829,35420,2019-01-07,0.047808764940239,125500,131500,6000,502619,35420.0,NAVER보통주
10830,35420,2018-12-21,0.0433070866141732,127000,121500,-5500,507653,35420.0,NAVER보통주
10831,35420,2018-12-19,0.0450819672131147,122000,127500,5500,385472,35420.0,NAVER보통주
10832,35420,2018-12-06,0.04,125000,120000,-5000,445309,35420.0,NAVER보통주
10833,35420,2018-11-26,0.087719298245614,114000,124000,10000,805023,35420.0,NAVER보통주
10834,35420,2018-11-23,0.0410958904109589,109500,114000,4500,691736,35420.0,NAVER보통주
10835,35420,2018-11-02,0.0448430493273542,111500,116500,5000,1320415,35420.0,NAVER보통주
10836,35420,2018-10-26,0.0504201680672268,119000,113000,-6000,1544405,35420.0,NAVER보통주
10837,35420,2018-10-25,0.0629921259842519,127000,119000,-8000,1529110,35420.0,NAVER보통주
10838,35420,2018-10-15,0.0422535211267605,142000,136000,-6000,642772,35420.0,NAVER보통주
10839,35420,2018-02-09,0.0415183867141162,843000,808000,-35000,158070,35420.0,NAVER보통주
10840,35420,2018-01-08,0.0462555066079295,908000,950000,42000,196338,35420.0,NAVER보통주
10841,35420,2017-10-27,0.0464285714285714,840000,879000,39000,236645,35420.0,NAVER보통주
10842,35420,2017-10-26,0.044776119402985,804000,840000,36000,342341,35420.0,NAVER보통주
10843,35420,2017-10-18,0.0611979166666666,768000,815000,47000,219631,35420.0,NAVER보통주
10844,35420,2017-09-14,0.0493827160493827,729000,765000,36000,226589,35420.0,NAVER보통주
10845,35420,2017-06-12,0.0677083333333333,960000,895000,-65000,198383,35420.0,NAVER보통주
10846,35420,2017-06-09,0.0786516853932584,890000,960000,70000,183462,35420.0,NAVER보통주
10847,35420,2017-05-11,0.0509708737864077,824000,866000,42000,174898,35420.0,NAVER보통주
10848,35420,2017-04-13,0.0442708333333333,768000,802000,34000,173040,35420.0,NAVER보통주
10849,35420,2017-04-11,0.0586797066014669,818000,770000,-48000,263066,35420.0,NAVER보통주
10850,35420,2017-03-21,0.0647921760391198,818000,871000,53000,150195,35420.0,NAVER보통주
10851,35420,2017-03-02,0.0502577319587628,776000,815000,39000,150962,35420.0,NAVER보통주
10852,35420,2017-01-04,0.0560625814863103,767000,810000,43000,120359,35420.0,NAVER보통주
10853,35420,2016-12-08,0.072,750000,804000,54000,134987,35420.0,NAVER보통주
10854,35420,2016-12-01,0.0426065162907268,798000,764000,-34000,103862,35420.0,NAVER보통주
10855,35420,2016-11-11,0.0570719602977667,806000,760000,-46000,214331,35420.0,NAVER보통주
10856,35420,2016-10-13,0.042824074074074,864000,827000,-37000,96099,35420.0,NAVER보통주
10857,35720,2021-05-27,0.0460251046025104,119500,125000,5500,7398732,35720.0,카카오보통주
10858,35720,2021-04-06,0.0836653386454183,502000,544000,42000,1724958,35720.0,카카오보통주
10859,35720,2021-03-11,0.0413043478260869,460000,479000,19000,928091,35720.0,카카오보통주
10860,35720,2021-03-10,0.0430839002267573,441000,460000,19000,899669,35720.0,카카오보통주
10861,35720,2021-02-10,0.061822125813449,461000,489500,28500,1814483,35720.0,카카오보통주
10862,35720,2021-01-11,0.0437788018433179,434000,453000,19000,3157747,35720.0,카카오보통주
10863,35720,2021-01-08,0.0782608695652174,402500,434000,31500,2466715,35720.0,카카오보통주
10864,35720,2020-12-04,0.0414438502673796,374000,389500,15500,1561745,35720.0,카카오보통주
10865,35720,2020-11-10,0.0417227456258411,371500,356000,-15500,1105100,35720.0,카카오보통주
10866,35720,2020-11-04,0.0683506686478454,336500,359500,23000,1431026,35720.0,카카오보통주
10867,35720,2020-09-28,0.0497866287339971,351500,369000,17500,674705,35720.0,카카오보통주
10868,35720,2020-08-27,0.0471938775510204,392000,410500,18500,1981840,35720.0,카카오보통주
10869,35720,2020-08-18,0.0427586206896551,362500,378000,15500,3032037,35720.0,카카오보통주
10870,35720,2020-08-03,0.0655021834061135,343500,366000,22500,1636803,35720.0,카카오보통주
10871,35720,2020-07-20,0.0461538461538461,325000,310000,-15000,1534422,35720.0,카카오보통주
10872,35720,2020-07-16,0.0459259259259259,337500,322000,-15500,1941508,35720.0,카카오보통주
10873,35720,2020-07-09,0.0838414634146341,328000,355500,27500,2463503,35720.0,카카오보통주
10874,35720,2020-07-08,0.0563607085346215,310500,328000,17500,1869663,35720.0,카카오보통주
10875,35720,2020-07-02,0.059369202226345,269500,285500,16000,1378545,35720.0,카카오보통주
10876,35720,2020-06-16,0.0415841584158415,252500,263000,10500,915456,35720.0,카카오보통주
10877,35720,2020-06-15,0.0507518796992481,266000,252500,-13500,1549230,35720.0,카카오보통주
10878,35720,2020-05-25,0.0850202429149797,247000,268000,21000,2653776,35720.0,카카오보통주
10879,35720,2020-05-22,0.04,237500,247000,9500,1887064,35720.0,카카오보통주
10880,35720,2020-05-20,0.0522727272727272,220000,231500,11500,1773960,35720.0,카카오보통주
10881,35720,2020-05-06,0.0697050938337801,186500,199500,13000,2035947,35720.0,카카오보통주
10882,35720,2020-04-23,0.0480225988700565,177000,185500,8500,1509799,35720.0,카카오보통주
10883,35720,2020-04-02,0.0431893687707641,150500,157000,6500,1043790,35720.0,카카오보통주
10884,35720,2020-03-24,0.0766550522648083,143500,154500,11000,1271387,35720.0,카카오보통주
10885,35720,2020-03-23,0.040133779264214,149500,143500,-6000,1569378,35720.0,카카오보통주
10886,35720,2020-03-20,0.1156716417910447,134000,149500,15500,1765756,35720.0,카카오보통주
10887,35720,2020-03-19,0.0496453900709219,141000,134000,-7000,2157141,35720.0,카카오보통주
10888,35720,2020-03-18,0.0440677966101694,147500,141000,-6500,1107527,35720.0,카카오보통주
10889,35720,2020-03-16,0.0723270440251572,159000,147500,-11500,1252484,35720.0,카카오보통주
10890,35720,2020-03-12,0.0473372781065088,169000,161000,-8000,1218070,35720.0,카카오보통주
10891,35720,2020-03-09,0.0455840455840455,175500,167500,-8000,805638,35720.0,카카오보통주
10892,35720,2020-02-19,0.0439560439560439,182000,190000,8000,1362998,35720.0,카카오보통주
10893,35720,2020-02-13,0.0406976744186046,172000,179000,7000,1877980,35720.0,카카오보통주
10894,35720,2019-12-05,0.0416666666666666,156000,149500,-6500,841460,35720.0,카카오보통주
10895,35720,2019-08-05,0.046692607003891,128500,122500,-6000,597268,35720.0,카카오보통주
10896,35720,2019-07-08,0.0411985018726591,133500,128000,-5500,581000,35720.0,카카오보통주
10897,35720,2019-05-17,0.0674157303370786,133500,124500,-9000,5222004,35720.0,카카오보통주
10898,35720,2019-05-14,0.0428015564202334,128500,134000,5500,1360661,35720.0,카카오보통주
10899,35720,2019-05-03,0.040650406504065,123000,128000,5000,1098989,35720.0,카카오보통주
10900,35720,2019-04-16,0.0633484162895927,110500,117500,7000,1744272,35720.0,카카오보통주
10901,35720,2019-04-15,0.0780487804878048,102500,110500,8000,1228969,35720.0,카카오보통주
10902,35720,2019-03-19,0.0465116279069767,107500,102500,-5000,605054,35720.0,카카오보통주
10903,35720,2019-03-04,0.0483091787439613,103500,108500,5000,853038,35720.0,카카오보통주
10904,35720,2019-02-26,0.0528992878942014,98300,103500,5200,1238902,35720.0,카카오보통주
10905,35720,2018-12-20,0.0462962962962962,108000,103000,-5000,579446,35720.0,카카오보통주
10906,35720,2018-11-26,0.0416666666666666,108000,112500,4500,460406,35720.0,카카오보통주
10907,35720,2018-11-19,0.0439024390243902,102500,107000,4500,346393,35720.0,카카오보통주
10908,35720,2018-11-08,0.0460251046025104,95600,100000,4400,644793,35720.0,카카오보통주
10909,35720,2018-11-02,0.0547798066595059,93100,98200,5100,409600,35720.0,카카오보통주
10910,35720,2018-10-25,0.0504032258064516,99200,94200,-5000,1024715,35720.0,카카오보통주
10911,35720,2018-10-11,0.0528846153846153,104000,98500,-5500,957608,35720.0,카카오보통주
10912,35720,2018-08-09,0.0546218487394958,119000,125500,6500,1622449,35720.0,카카오보통주
10913,35720,2018-08-07,0.0572687224669603,113500,120000,6500,742353,35720.0,카카오보통주
10914,35720,2018-06-22,0.0654205607476635,107000,114000,7000,651617,35720.0,카카오보통주
10915,35720,2018-03-23,0.0543478260869565,138000,130500,-7500,1233587,35720.0,카카오보통주
10916,35720,2018-03-13,0.0407407407407407,135000,140500,5500,1320091,35720.0,카카오보통주
10917,35720,2018-03-06,0.0772357723577235,123000,132500,9500,1167882,35720.0,카카오보통주
10918,35720,2018-02-27,0.065040650406504,123000,131000,8000,1272000,35720.0,카카오보통주
10919,35720,2018-02-09,0.067193675889328,126500,118000,-8500,2074927,35720.0,카카오보통주
10920,35720,2018-02-05,0.0627177700348432,143500,134500,-9000,1624472,35720.0,카카오보통주
10921,35720,2018-01-17,0.0462633451957295,140500,134000,-6500,2415858,35720.0,카카오보통주
10922,35720,2018-01-11,0.060200668896321,149500,140500,-9000,2474827,35720.0,카카오보통주
10923,35720,2018-01-10,0.0477707006369426,157000,149500,-7500,1656798,35720.0,카카오보통주
10924,35720,2018-01-04,0.046979865771812,149000,156000,7000,2265019,35720.0,카카오보통주
10925,35720,2018-01-02,0.0693430656934306,137000,146500,9500,1345951,35720.0,카카오보통주
10926,35720,2017-12-27,0.1071428571428571,126000,139500,13500,1561744,35720.0,카카오보통주
10927,35720,2017-12-18,0.0561403508771929,142500,134500,-8000,1462446,35720.0,카카오보통주
10928,35720,2017-11-30,0.0586206896551724,145000,136500,-8500,1808464,35720.0,카카오보통주
10929,35720,2017-11-22,0.0403726708074534,161000,154500,-6500,4520630,35720.0,카카오보통주
10930,35720,2017-11-01,0.0486111111111111,144000,151000,7000,1022580,35720.0,카카오보통주
10931,35720,2017-10-26,0.0410958904109589,146000,140000,-6000,1893626,35720.0,카카오보통주
10932,35720,2017-10-18,0.0571428571428571,157500,148500,-9000,1640427,35720.0,카카오보통주
10933,35720,2017-10-13,0.0438871473354232,159500,152500,-7000,2543079,35720.0,카카오보통주
10934,35720,2017-10-12,0.0598006644518272,150500,159500,9000,1304122,35720.0,카카오보통주
10935,35720,2017-09-20,0.0401459854014598,137000,142500,5500,1321516,35720.0,카카오보통주
10936,35720,2017-09-05,0.0502092050209205,119500,125500,6000,1049572,35720.0,카카오보통주
10937,35720,2017-07-31,0.081081081081081,111000,120000,9000,3120156,35720.0,카카오보통주
10938,35720,2017-07-05,0.0427263479145473,98300,102500,4200,596647,35720.0,카카오보통주
10939,35720,2017-06-12,0.0437158469945355,109800,105000,-4800,1280193,35720.0,카카오보통주
10940,35720,2017-04-20,0.0412844036697247,87200,90800,3600,1559946,35720.0,카카오보통주
10941,35720,2017-04-03,0.0469314079422382,83100,87000,3900,862856,35720.0,카카오보통주
10942,35720,2017-02-21,0.0424528301886792,84800,88400,3600,1573781,35720.0,카카오보통주
10943,35720,2017-02-09,0.0701754385964912,79800,85400,5600,1550608,35720.0,카카오보통주
10944,35720,2017-01-04,0.05375,80000,84300,4300,1224395,35720.0,카카오보통주
10945,35720,2017-01-03,0.0430247718383311,76700,80000,3300,445180,35720.0,카카오보통주
10946,35720,2016-12-09,0.0406290956749672,76300,79400,3100,300441,35720.0,카카오보통주
10947,35720,2016-11-16,0.056578947368421,76000,80300,4300,566246,35720.0,카카오보통주
10948,35720,2016-11-10,0.1178120617110799,71300,79700,8400,1182920,35720.0,카카오보통주
10949,35720,2016-11-09,0.0403768506056527,74300,71300,-3000,529993,35720.0,카카오보통주
10950,35720,2016-11-02,0.0442359249329758,74600,71300,-3300,640159,35720.0,카카오보통주
10951,35720,2016-10-31,0.0402010050251256,79600,76400,-3200,498234,35720.0,카카오보통주
10952,35720,2016-10-05,0.0529556650246305,81200,85500,4300,728681,35720.0,카카오보통주
10953,36460,2021-05-03,0.0687679083094555,34900,32500,-2400,1398615,36460.0,한국가스공사보통주
10954,36460,2021-04-29,0.0433482810164424,33450,34900,1450,1387063,36460.0,한국가스공사보통주
10955,36460,2021-02-08,0.053125,32000,33700,1700,720646,36460.0,한국가스공사보통주
10956,36460,2021-01-29,0.0402476780185758,32300,31000,-1300,645236,36460.0,한국가스공사보통주
10957,36460,2021-01-28,0.044378698224852,33800,32300,-1500,785981,36460.0,한국가스공사보통주
10958,36460,2021-01-14,0.0629800307219662,32550,34600,2050,1723659,36460.0,한국가스공사보통주
10959,36460,2021-01-12,0.0565428109854604,30950,32700,1750,2376805,36460.0,한국가스공사보통주
10960,36460,2020-12-11,0.0528109028960817,29350,30900,1550,1314524,36460.0,한국가스공사보통주
10961,36460,2020-11-10,0.0547945205479452,29200,30800,1600,912825,36460.0,한국가스공사보통주
10962,36460,2020-11-05,0.0748175182481751,27400,29450,2050,1016864,36460.0,한국가스공사보통주
10963,36460,2020-10-26,0.0577849117174959,31150,29350,-1800,932391,36460.0,한국가스공사보통주
10964,36460,2020-10-21,0.0816666666666666,30000,32450,2450,1943334,36460.0,한국가스공사보통주
10965,36460,2020-10-20,0.0461049284578696,31450,30000,-1450,1175583,36460.0,한국가스공사보통주
10966,36460,2020-10-19,0.0697278911564625,29400,31450,2050,2582882,36460.0,한국가스공사보통주
10967,36460,2020-10-16,0.0888888888888888,27000,29400,2400,3010505,36460.0,한국가스공사보통주
10968,36460,2020-10-15,0.0756972111553784,25100,27000,1900,1029107,36460.0,한국가스공사보통주
10969,36460,2020-10-05,0.0425963488843813,24650,25700,1050,417112,36460.0,한국가스공사보통주
10970,36460,2020-09-16,0.0438413361169102,23950,25000,1050,832021,36460.0,한국가스공사보통주
10971,36460,2020-08-20,0.0443548387096774,24800,23700,-1100,422064,36460.0,한국가스공사보통주
10972,36460,2020-08-18,0.0623818525519848,26450,24800,-1650,530953,36460.0,한국가스공사보통주
10973,36460,2020-08-11,0.0404858299595141,24700,25700,1000,480550,36460.0,한국가스공사보통주
10974,36460,2020-06-16,0.1072124756335282,25650,28400,2750,489187,36460.0,한국가스공사보통주
10975,36460,2020-06-15,0.0756756756756756,27750,25650,-2100,489953,36460.0,한국가스공사보통주
10976,36460,2020-06-12,0.0512820512820512,29250,27750,-1500,520910,36460.0,한국가스공사보통주
10977,36460,2020-04-13,0.0571992110453648,25350,26800,1450,811153,36460.0,한국가스공사보통주
10978,36460,2020-04-06,0.0565610859728506,22100,23350,1250,397145,36460.0,한국가스공사보통주
10979,36460,2020-03-25,0.0620155038759689,19350,20550,1200,577543,36460.0,한국가스공사보통주
10980,36460,2020-03-24,0.0573770491803278,18300,19350,1050,426787,36460.0,한국가스공사보통주
10981,36460,2020-03-23,0.0542635658914728,19350,18300,-1050,447626,36460.0,한국가스공사보통주
10982,36460,2020-03-20,0.1656626506024096,16600,19350,2750,603641,36460.0,한국가스공사보통주
10983,36460,2020-03-19,0.0853994490358126,18150,16600,-1550,664690,36460.0,한국가스공사보통주
10984,36460,2020-03-18,0.0856423173803526,19850,18150,-1700,455853,36460.0,한국가스공사보통주
10985,36460,2020-03-17,0.0592417061611374,21100,19850,-1250,579279,36460.0,한국가스공사보통주
10986,36460,2020-03-13,0.0880503144654088,23850,21750,-2100,775512,36460.0,한국가스공사보통주
10987,36460,2020-03-12,0.05168986083499,25150,23850,-1300,615505,36460.0,한국가스공사보통주
10988,36460,2020-03-09,0.0444444444444444,27000,25800,-1200,400724,36460.0,한국가스공사보통주
10989,36460,2020-01-28,0.050071530758226,34950,33200,-1750,459159,36460.0,한국가스공사보통주
10990,36460,2020-01-08,0.040983606557377,36600,35100,-1500,415248,36460.0,한국가스공사보통주
10991,36460,2019-05-14,0.041405269761606,39850,41500,1650,390552,36460.0,한국가스공사보통주
10992,36460,2019-05-02,0.0693391115926327,46150,42950,-3200,1635597,36460.0,한국가스공사보통주
10993,36460,2019-04-03,0.0470588235294117,46750,48950,2200,540088,36460.0,한국가스공사보통주
10994,36460,2019-04-01,0.0454545454545454,45100,47150,2050,317621,36460.0,한국가스공사보통주
10995,36460,2019-02-28,0.0475285171102661,52600,50100,-2500,366351,36460.0,한국가스공사보통주
10996,36460,2019-01-11,0.048,50000,52400,2400,256739,36460.0,한국가스공사보통주
10997,36460,2018-12-19,0.0517578125,51200,48550,-2650,529428,36460.0,한국가스공사보통주
10998,36460,2018-12-10,0.0433070866141732,50800,53000,2200,239151,36460.0,한국가스공사보통주
10999,36460,2018-11-14,0.0575815738963531,52100,49100,-3000,608420,36460.0,한국가스공사보통주
11000,36460,2018-10-26,0.0548446069469835,54700,51700,-3000,200765,36460.0,한국가스공사보통주
11001,36460,2018-09-27,0.0425894378194207,58700,61200,2500,462806,36460.0,한국가스공사보통주
11002,36460,2018-08-06,0.0521739130434782,57500,54500,-3000,528215,36460.0,한국가스공사보통주
11003,36460,2018-07-06,0.0491228070175438,57000,59800,2800,349950,36460.0,한국가스공사보통주
11004,36460,2018-07-04,0.0451505016722408,59800,57100,-2700,436323,36460.0,한국가스공사보통주
11005,36460,2018-07-02,0.0638629283489096,64200,60100,-4100,352264,36460.0,한국가스공사보통주
11006,36460,2018-06-25,0.0453808752025931,61700,64500,2800,387818,36460.0,한국가스공사보통주
11007,36460,2018-06-21,0.0443037974683544,63200,60400,-2800,281398,36460.0,한국가스공사보통주
11008,36460,2018-06-15,0.0543657331136738,60700,64000,3300,519189,36460.0,한국가스공사보통주
11009,36460,2018-06-14,0.0515625,64000,60700,-3300,665509,36460.0,한국가스공사보통주
11010,36460,2018-05-25,0.0596774193548387,62000,58300,-3700,644695,36460.0,한국가스공사보통주
11011,36460,2018-05-14,0.0602836879432624,56400,59800,3400,776472,36460.0,한국가스공사보통주
11012,36460,2018-05-10,0.0409683426443202,53700,55900,2200,446426,36460.0,한국가스공사보통주
11013,36460,2018-05-03,0.063573883161512,58200,54500,-3700,496268,36460.0,한국가스공사보통주
11014,36460,2018-05-02,0.0620437956204379,54800,58200,3400,973608,36460.0,한국가스공사보통주
11015,36460,2018-04-23,0.056,50000,52800,2800,514427,36460.0,한국가스공사보통주
11016,36460,2018-03-26,0.0447284345047923,46950,49050,2100,298771,36460.0,한국가스공사보통주
11017,36460,2018-03-12,0.0433862433862433,47250,49300,2050,311788,36460.0,한국가스공사보통주
11018,36460,2018-03-02,0.0631808278867102,45900,48800,2900,496042,36460.0,한국가스공사보통주
11019,36460,2018-02-19,0.060879368658399,44350,47050,2700,255282,36460.0,한국가스공사보통주
11020,36460,2018-01-24,0.0407331975560081,49100,51100,2000,762019,36460.0,한국가스공사보통주
11021,36460,2018-01-12,0.0727069351230425,44700,47950,3250,1038998,36460.0,한국가스공사보통주
11022,36460,2018-01-02,0.0423031727379553,42550,44350,1800,327142,36460.0,한국가스공사보통주
11023,36460,2017-12-15,0.0421686746987951,41500,43250,1750,309394,36460.0,한국가스공사보통주
11024,36460,2017-11-14,0.0777511961722488,41800,45050,3250,927132,36460.0,한국가스공사보통주
11025,36460,2017-08-11,0.0441176470588235,51000,48750,-2250,381784,36460.0,한국가스공사보통주
11026,36460,2017-05-16,0.0626927029804727,48650,51700,3050,928708,36460.0,한국가스공사보통주
11027,36460,2017-05-12,0.0406852248394004,46700,48600,1900,512385,36460.0,한국가스공사보통주
11028,36460,2017-03-21,0.0415335463258785,46950,45000,-1950,561582,36460.0,한국가스공사보통주
11029,36460,2016-12-01,0.0455075845974329,42850,44800,1950,467125,36460.0,한국가스공사보통주
11030,36460,2016-11-22,0.0419580419580419,42900,44700,1800,297492,36460.0,한국가스공사보통주
11031,36570,2021-05-10,0.0578313253012048,830000,878000,48000,257577,36570.0,엔씨소프트보통주
11032,36570,2021-03-29,0.0712694877505567,898000,834000,-64000,343144,36570.0,엔씨소프트보통주
11033,36570,2021-02-25,0.0406852248394004,934000,972000,38000,95195,36570.0,엔씨소프트보통주
11034,36570,2021-02-22,0.066198595787362,997000,931000,-66000,216700,36570.0,엔씨소프트보통주
11035,36570,2021-02-08,0.0635245901639344,976000,1038000,62000,239999,36570.0,엔씨소프트보통주
11036,36570,2021-02-04,0.0456349206349206,1008000,962000,-46000,138692,36570.0,엔씨소프트보통주
11037,36570,2021-01-26,0.0422110552763819,995000,953000,-42000,127191,36570.0,엔씨소프트보통주
11038,36570,2021-01-08,0.0506863780359028,947000,995000,48000,198693,36570.0,엔씨소프트보통주
11039,36570,2021-01-04,0.0504833512352309,931000,978000,47000,151790,36570.0,엔씨소프트보통주
11040,36570,2020-12-01,0.0518518518518518,810000,852000,42000,193153,36570.0,엔씨소프트보통주
11041,36570,2020-11-10,0.0556872037914691,844000,797000,-47000,172812,36570.0,엔씨소프트보통주
11042,36570,2020-11-04,0.0703324808184143,782000,837000,55000,197108,36570.0,엔씨소프트보통주
11043,36570,2020-10-30,0.045510455104551,813000,776000,-37000,92285,36570.0,엔씨소프트보통주
11044,36570,2020-09-10,0.0493046776232617,791000,830000,39000,172103,36570.0,엔씨소프트보통주
11045,36570,2020-08-27,0.0550122249388753,818000,863000,45000,232351,36570.0,엔씨소프트보통주
11046,36570,2020-08-21,0.0510855683269476,783000,823000,40000,158623,36570.0,엔씨소프트보통주
11047,36570,2020-08-20,0.0689655172413793,841000,783000,-58000,271930,36570.0,엔씨소프트보통주
11048,36570,2020-08-18,0.0435779816513761,872000,834000,-38000,170816,36570.0,엔씨소프트보통주
11049,36570,2020-08-13,0.0552941176470588,850000,897000,47000,363276,36570.0,엔씨소프트보통주
11050,36570,2020-08-03,0.0406905055487053,811000,844000,33000,152000,36570.0,엔씨소프트보통주
11051,36570,2020-07-23,0.0580720092915214,861000,811000,-50000,339183,36570.0,엔씨소프트보통주
11052,36570,2020-07-16,0.052801724137931,928000,879000,-49000,199187,36570.0,엔씨소프트보통주
11053,36570,2020-07-06,0.0540254237288135,944000,995000,51000,138049,36570.0,엔씨소프트보통주
11054,36570,2020-07-02,0.0795072788353863,893000,964000,71000,220292,36570.0,엔씨소프트보통주
11055,36570,2020-06-16,0.0802469135802469,810000,875000,65000,149986,36570.0,엔씨소프트보통주
11056,36570,2020-05-21,0.056,750000,792000,42000,208754,36570.0,엔씨소프트보통주
11057,36570,2020-05-14,0.044382801664355,721000,753000,32000,214951,36570.0,엔씨소프트보통주
11058,36570,2020-05-12,0.0686695278969957,699000,747000,48000,344771,36570.0,엔씨소프트보통주
11059,36570,2020-05-08,0.0510835913312693,646000,679000,33000,194176,36570.0,엔씨소프트보통주
11060,36570,2020-04-22,0.0545171339563862,642000,677000,35000,139859,36570.0,엔씨소프트보통주
11061,36570,2020-04-06,0.0479134466769706,647000,678000,31000,97158,36570.0,엔씨소프트보통주
11062,36570,2020-04-02,0.0614886731391585,618000,656000,38000,148473,36570.0,엔씨소프트보통주
11063,36570,2020-04-01,0.0521472392638036,652000,618000,-34000,123474,36570.0,엔씨소프트보통주
11064,36570,2020-03-31,0.0448717948717948,624000,652000,28000,193212,36570.0,엔씨소프트보통주
11065,36570,2020-03-24,0.1346153846153846,572000,649000,77000,236136,36570.0,엔씨소프트보통주
11066,36570,2020-03-20,0.0698113207547169,530000,567000,37000,236382,36570.0,엔씨소프트보통주
11067,36570,2020-03-19,0.0701754385964912,570000,530000,-40000,400206,36570.0,엔씨소프트보통주
11068,36570,2020-03-16,0.0717628705148206,641000,595000,-46000,201806,36570.0,엔씨소프트보통주
11069,36570,2020-03-04,0.0603829160530191,679000,720000,41000,156369,36570.0,엔씨소프트보통주
11070,36570,2020-02-19,0.048854961832061,655000,687000,32000,140128,36570.0,엔씨소프트보통주
11071,36570,2020-02-14,0.0445151033386327,629000,657000,28000,157977,36570.0,엔씨소프트보통주
11072,36570,2020-01-03,0.044362292051756,541000,565000,24000,112404,36570.0,엔씨소프트보통주
11073,36570,2019-12-06,0.0737051792828685,502000,539000,37000,199337,36570.0,엔씨소프트보통주
11074,36570,2019-11-15,0.0437262357414448,526000,549000,23000,90461,36570.0,엔씨소프트보통주
11075,36570,2019-11-01,0.0426356589147286,516000,538000,22000,79749,36570.0,엔씨소프트보통주
11076,36570,2019-08-01,0.0425752855659397,481500,502000,20500,101832,36570.0,엔씨소프트보통주
11077,36570,2019-03-28,0.0407523510971786,478500,498000,19500,130105,36570.0,엔씨소프트보통주
11078,36570,2019-02-12,0.041988950276243,452500,433500,-19000,313420,36570.0,엔씨소프트보통주
11079,36570,2018-12-17,0.04,500000,480000,-20000,99691,36570.0,엔씨소프트보통주
11080,36570,2018-11-28,0.0412371134020618,485000,505000,20000,204294,36570.0,엔씨소프트보통주
11081,36570,2018-11-26,0.040084388185654,474000,493000,19000,137824,36570.0,엔씨소프트보통주
11082,36570,2018-10-30,0.0408415841584158,404000,420500,16500,134531,36570.0,엔씨소프트보통주
11083,36570,2018-10-02,0.0692307692307692,455000,423500,-31500,220739,36570.0,엔씨소프트보통주
11084,36570,2018-09-04,0.053177691309987,385500,406000,20500,148337,36570.0,엔씨소프트보통주
11085,36570,2018-08-14,0.0814606741573033,356000,385000,29000,244138,36570.0,엔씨소프트보통주
11086,36570,2018-06-28,0.0488771466314399,378500,360000,-18500,119217,36570.0,엔씨소프트보통주
11087,36570,2018-05-15,0.0552238805970149,335000,353500,18500,240218,36570.0,엔씨소프트보통주
11088,36570,2018-05-11,0.0417867435158501,347000,332500,-14500,457226,36570.0,엔씨소프트보통주
11089,36570,2018-05-09,0.0482456140350877,342000,358500,16500,136092,36570.0,엔씨소프트보통주
11090,36570,2018-02-28,0.0445859872611464,392500,375000,-17500,260471,36570.0,엔씨소프트보통주
11091,36570,2018-02-09,0.0588957055214723,407500,383500,-24000,192589,36570.0,엔씨소프트보통주
11092,36570,2018-02-05,0.041049030786773,438500,420500,-18000,147065,36570.0,엔씨소프트보통주
11093,36570,2018-01-26,0.0564042303172738,425500,449500,24000,331267,36570.0,엔씨소프트보통주
11094,36570,2017-12-27,0.0407925407925407,429000,446500,17500,124365,36570.0,엔씨소프트보통주
11095,36570,2017-12-20,0.056338028169014,461500,435500,-26000,387985,36570.0,엔씨소프트보통주
11096,36570,2017-12-13,0.0472103004291845,466000,488000,22000,393983,36570.0,엔씨소프트보통주
11097,36570,2017-11-30,0.0562162162162162,462500,436500,-26000,309466,36570.0,엔씨소프트보통주
11098,36570,2017-11-21,0.0520361990950226,442000,465000,23000,458836,36570.0,엔씨소프트보통주
11099,36570,2017-11-16,0.0504807692307692,416000,437000,21000,377982,36570.0,엔씨소프트보통주
11100,36570,2017-11-09,0.0685840707964601,452000,421000,-31000,1059233,36570.0,엔씨소프트보통주
11101,36570,2017-10-31,0.0530864197530864,405000,426500,21500,296521,36570.0,엔씨소프트보통주
11102,36570,2017-10-30,0.0402843601895734,422000,405000,-17000,401475,36570.0,엔씨소프트보통주
11103,36570,2017-10-19,0.0649779735682819,454000,424500,-29500,325330,36570.0,엔씨소프트보통주
11104,36570,2017-10-10,0.0581270182992465,464500,437500,-27000,434789,36570.0,엔씨소프트보통주
11105,36570,2017-09-07,0.0569476082004555,439000,464000,25000,609603,36570.0,엔씨소프트보통주
11106,36570,2017-09-06,0.0578313253012048,415000,439000,24000,480874,36570.0,엔씨소프트보통주
11107,36570,2017-07-20,0.0721220527045769,360500,386500,26000,494831,36570.0,엔씨소프트보통주
11108,36570,2017-07-10,0.0429835651074589,395500,378500,-17000,504924,36570.0,엔씨소프트보통주
11109,36570,2017-07-06,0.0424710424710424,388500,405000,16500,749146,36570.0,엔씨소프트보통주
11110,36570,2017-06-29,0.0470262793914246,361500,378500,17000,622353,36570.0,엔씨소프트보통주
11111,36570,2017-06-28,0.0634715025906735,386000,361500,-24500,864760,36570.0,엔씨소프트보통주
11112,36570,2017-06-23,0.1178160919540229,348000,389000,41000,1569094,36570.0,엔씨소프트보통주
11113,36570,2017-06-22,0.0465753424657534,365000,348000,-17000,1853507,36570.0,엔씨소프트보통주
11114,36570,2017-06-20,0.1141104294478527,407500,361000,-46500,1104285,36570.0,엔씨소프트보통주
11115,36570,2017-05-17,0.0446304044630404,358500,374500,16000,381194,36570.0,엔씨소프트보통주
11116,36570,2017-05-12,0.046195652173913,368000,351000,-17000,454470,36570.0,엔씨소프트보통주
11117,36570,2017-04-13,0.0622222222222222,337500,358500,21000,616917,36570.0,엔씨소프트보통주
11118,36570,2017-04-12,0.056338028169014,319500,337500,18000,349162,36570.0,엔씨소프트보통주
11119,36570,2017-03-29,0.0518134715025906,289500,304500,15000,362242,36570.0,엔씨소프트보통주
11120,36570,2017-02-27,0.0666666666666666,300000,280000,-20000,331502,36570.0,엔씨소프트보통주
11121,36570,2017-02-07,0.0474683544303797,316000,301000,-15000,510053,36570.0,엔씨소프트보통주
11122,36570,2017-01-20,0.0466666666666666,300000,314000,14000,271677,36570.0,엔씨소프트보통주
11123,36570,2017-01-19,0.0471204188481675,286500,300000,13500,550008,36570.0,엔씨소프트보통주
11124,36570,2017-01-03,0.0443548387096774,248000,259000,11000,160386,36570.0,엔씨소프트보통주
11125,36570,2016-12-23,0.0477099236641221,262000,249500,-12500,205021,36570.0,엔씨소프트보통주
11126,36570,2016-12-09,0.110091743119266,218000,242000,24000,503100,36570.0,엔씨소프트보통주
11127,36570,2016-12-08,0.0973084886128364,241500,218000,-23500,421158,36570.0,엔씨소프트보통주
11128,36570,2016-12-01,0.0992647058823529,272000,245000,-27000,443257,36570.0,엔씨소프트보통주
11129,36570,2016-11-25,0.0497017892644135,251500,264000,12500,145749,36570.0,엔씨소프트보통주
11130,36570,2016-11-11,0.0604395604395604,273000,256500,-16500,219777,36570.0,엔씨소프트보통주
11131,39130,2021-06-02,0.0475113122171945,88400,92600,4200,582070,39130.0,하나투어보통주
11132,39130,2021-05-31,0.0692124105011933,83800,89600,5800,460268,39130.0,하나투어보통주
11133,39130,2021-05-25,0.0443864229765013,76600,80000,3400,546287,39130.0,하나투어보통주
11134,39130,2021-05-17,0.0804093567251462,68400,73900,5500,774795,39130.0,하나투어보통주
11135,39130,2021-02-23,0.0631229235880398,60200,64000,3800,722205,39130.0,하나투어보통주
11136,39130,2021-01-18,0.0708782742681047,64900,60300,-4600,432011,39130.0,하나투어보통주
11137,39130,2021-01-14,0.0702341137123745,59800,64000,4200,1186765,39130.0,하나투어보통주
11138,39130,2020-12-29,0.0745697896749522,52300,56200,3900,398040,39130.0,하나투어보통주
11139,39130,2020-12-24,0.0433070866141732,50800,53000,2200,198077,39130.0,하나투어보통주
11140,39130,2020-12-14,0.0493197278911564,58800,55900,-2900,408741,39130.0,하나투어보통주
11141,39130,2020-12-02,0.0892531876138433,54900,59800,4900,923180,39130.0,하나투어보통주
11142,39130,2020-11-25,0.056910569105691,49200,52000,2800,897999,39130.0,하나투어보통주
11143,39130,2020-11-24,0.047923322683706,46950,49200,2250,651458,39130.0,하나투어보통주
11144,39130,2020-11-11,0.0556186152099886,44050,46500,2450,1235763,39130.0,하나투어보통주
11145,39130,2020-11-10,0.0916976456009913,40350,44050,3700,1511118,39130.0,하나투어보통주
11146,39130,2020-10-12,0.0446650124069478,40300,42100,1800,745200,39130.0,하나투어보통주
11147,39130,2020-08-18,0.0818070818070818,40950,37600,-3350,471776,39130.0,하나투어보통주
11148,39130,2020-08-12,0.0627400768245838,39050,41500,2450,2248457,39130.0,하나투어보통주
11149,39130,2020-07-21,0.0427236315086782,37450,39050,1600,151164,39130.0,하나투어보통주
11150,39130,2020-07-15,0.0514603616133518,35950,37800,1850,175352,39130.0,하나투어보통주
11151,39130,2020-06-30,0.0535714285714285,36400,38350,1950,139703,39130.0,하나투어보통주
11152,39130,2020-05-26,0.0423940149625935,40100,41800,1700,192623,39130.0,하나투어보통주
11153,39130,2020-05-19,0.0705128205128205,39000,41750,2750,609857,39130.0,하나투어보통주
11154,39130,2020-05-18,0.0626702997275204,36700,39000,2300,278157,39130.0,하나투어보통주
11155,39490,2021-05-13,0.0490566037735849,132500,126000,-6500,362936,39490.0,키움증권보통주
11156,39490,2021-05-10,0.0524344569288389,133500,140500,7000,402606,39490.0,키움증권보통주
11157,39490,2021-05-03,0.0415094339622641,132500,127000,-5500,125164,39490.0,키움증권보통주
11158,39490,2021-04-20,0.0488721804511278,133000,139500,6500,275579,39490.0,키움증권보통주
11159,39490,2021-04-01,0.0515873015873015,126000,132500,6500,310435,39490.0,키움증권보통주
11160,39490,2021-03-25,0.0408163265306122,122500,127500,5000,193008,39490.0,키움증권보통주
11161,39490,2021-03-18,0.0447154471544715,123000,128500,5500,234789,39490.0,키움증권보통주
11162,39490,2021-03-11,0.0595744680851063,117500,124500,7000,320108,39490.0,키움증권보통주
11163,39490,2021-02-26,0.0408921933085501,134500,129000,-5500,228753,39490.0,키움증권보통주
11164,39490,2021-02-23,0.0459363957597173,141500,135000,-6500,218566,39490.0,키움증권보통주
11165,39490,2021-02-10,0.0476190476190476,157500,150000,-7500,411313,39490.0,키움증권보통주
11166,39490,2021-02-08,0.0402684563758389,149000,155000,6000,259371,39490.0,키움증권보통주
11167,39490,2021-01-22,0.0627062706270627,151500,142000,-9500,559331,39490.0,키움증권보통주
11168,39490,2021-01-19,0.0567375886524822,141000,149000,8000,217876,39490.0,키움증권보통주
11169,39490,2021-01-18,0.0408163265306122,147000,141000,-6000,174061,39490.0,키움증권보통주
11170,39490,2021-01-12,0.0401234567901234,162000,155500,-6500,428191,39490.0,키움증권보통주
11171,39490,2021-01-11,0.0657894736842105,152000,162000,10000,708792,39490.0,키움증권보통주
11172,39490,2021-01-06,0.0557620817843866,134500,142000,7500,1184781,39490.0,키움증권보통주
11173,39490,2021-01-04,0.0632411067193675,126500,134500,8000,441480,39490.0,키움증권보통주
11174,39490,2020-12-17,0.048689138576779,133500,127000,-6500,555410,39490.0,키움증권보통주
11175,39490,2020-12-10,0.05,140000,133000,-7000,653699,39490.0,키움증권보통주
11176,39490,2020-12-04,0.0743494423791821,134500,144500,10000,222603,39490.0,키움증권보통주
11177,39490,2020-12-02,0.0505836575875486,128500,135000,6500,171234,39490.0,키움증권보통주
11178,39490,2020-11-26,0.0666666666666666,120000,128000,8000,380867,39490.0,키움증권보통주
11179,39490,2020-11-23,0.0565217391304347,115000,121500,6500,272429,39490.0,키움증권보통주
11180,39490,2020-11-17,0.048780487804878,123000,117000,-6000,238563,39490.0,키움증권보통주
11181,39490,2020-11-16,0.1232876712328767,109500,123000,13500,411528,39490.0,키움증권보통주
11182,39490,2020-10-21,0.0539979231568016,96300,101500,5200,140814,39490.0,키움증권보통주
11183,39490,2020-09-24,0.0594059405940594,101000,95000,-6000,135757,39490.0,키움증권보통주
11184,39490,2020-09-09,0.0442477876106194,113000,108000,-5000,117050,39490.0,키움증권보통주
11185,39490,2020-09-02,0.0491071428571428,112000,117500,5500,179184,39490.0,키움증권보통주
11186,39490,2020-08-25,0.0619047619047619,105000,111500,6500,129447,39490.0,키움증권보통주
11187,39490,2020-08-10,0.102803738317757,107000,118000,11000,451774,39490.0,키움증권보통주
11188,39490,2020-08-05,0.05,100000,105000,5000,513471,39490.0,키움증권보통주
11189,39490,2020-07-20,0.0417475728155339,103000,98700,-4300,159468,39490.0,키움증권보통주
11190,39490,2020-07-17,0.0934182590233545,94200,103000,8800,224420,39490.0,키움증권보통주
11191,39490,2020-07-13,0.0892018779342723,85200,92800,7600,202359,39490.0,키움증권보통주
11192,39490,2020-07-08,0.0453514739229024,88200,84200,-4000,166962,39490.0,키움증권보통주
11193,39490,2020-06-29,0.0457079152731326,89700,85600,-4100,96348,39490.0,키움증권보통주
11194,39490,2020-06-25,0.0601659751037344,96400,90600,-5800,170716,39490.0,키움증권보통주
11195,39490,2020-06-17,0.0689655172413793,87000,93000,6000,231189,39490.0,키움증권보통주
11196,39490,2020-06-16,0.0519951632406287,82700,87000,4300,129806,39490.0,키움증권보통주
11197,39490,2020-06-15,0.048331415420023,86900,82700,-4200,75860,39490.0,키움증권보통주
11198,39490,2020-06-03,0.0402684563758389,89400,93000,3600,216388,39490.0,키움증권보통주
11199,39490,2020-06-02,0.0836363636363636,82500,89400,6900,188583,39490.0,키움증권보통주
11200,39490,2020-06-01,0.0456273764258555,78900,82500,3600,78525,39490.0,키움증권보통주
11201,39490,2020-05-19,0.0491803278688524,79300,83200,3900,191845,39490.0,키움증권보통주
11202,39490,2020-05-18,0.0531208499335989,75300,79300,4000,115885,39490.0,키움증권보통주
11203,39490,2020-04-06,0.1058122205663189,67100,74200,7100,219858,39490.0,키움증권보통주
11204,39490,2020-04-01,0.04,70000,67200,-2800,130208,39490.0,키움증권보통주
11205,39490,2020-03-25,0.1199324324324324,59200,66300,7100,145727,39490.0,키움증권보통주
11206,39490,2020-03-24,0.1254752851711026,52600,59200,6600,126698,39490.0,키움증권보통주
11207,39490,2020-03-23,0.0706713780918728,56600,52600,-4000,104078,39490.0,키움증권보통주
11208,39490,2020-03-20,0.0404411764705882,54400,56600,2200,121777,39490.0,키움증권보통주
11209,39490,2020-03-13,0.0598290598290598,58500,55000,-3500,231429,39490.0,키움증권보통주
11210,39490,2020-03-12,0.0699523052464228,62900,58500,-4400,121055,39490.0,키움증권보통주
11211,39490,2020-03-09,0.0400593471810089,67400,64700,-2700,72732,39490.0,키움증권보통주
11212,39490,2020-01-28,0.0708762886597938,77600,72100,-5500,161129,39490.0,키움증권보통주
11213,39490,2020-01-23,0.0490196078431372,81600,77600,-4000,92898,39490.0,키움증권보통주
11214,39490,2019-12-13,0.0442953020134228,74500,77800,3300,133048,39490.0,키움증권보통주
11215,39490,2019-08-26,0.0409711684370258,65900,63200,-2700,109180,39490.0,키움증권보통주
11216,39490,2019-08-20,0.0450310559006211,64400,67300,2900,64740,39490.0,키움증권보통주
11217,39490,2019-08-16,0.053731343283582,67000,63400,-3600,171099,39490.0,키움증권보통주
11218,39490,2019-08-08,0.0406626506024096,66400,69100,2700,87112,39490.0,키움증권보통주
11219,39490,2019-08-02,0.0509641873278236,72600,68900,-3700,246025,39490.0,키움증권보통주
11220,39490,2019-06-25,0.0462633451957295,84300,80400,-3900,177934,39490.0,키움증권보통주
11221,39490,2019-04-18,0.0512249443207126,89800,85200,-4600,223594,39490.0,키움증권보통주
11222,39490,2019-04-03,0.0597519729425028,88700,94000,5300,225712,39490.0,키움증권보통주
11223,39490,2019-04-01,0.0591861898890258,81100,85900,4800,112361,39490.0,키움증권보통주
11224,39490,2019-02-08,0.0497737556561085,88400,84000,-4400,126974,39490.0,키움증권보통주
11225,39490,2019-01-24,0.0660146699266503,81800,87200,5400,253423,39490.0,키움증권보통주
11226,39490,2019-01-16,0.0476190476190476,79800,83600,3800,217660,39490.0,키움증권보통주
11227,39490,2019-01-15,0.0583554376657824,75400,79800,4400,144507,39490.0,키움증권보통주
11228,39490,2019-01-02,0.0460358056265984,78200,74600,-3600,86300,39490.0,키움증권보통주
11229,39490,2018-12-06,0.0497630331753554,84400,80200,-4200,103081,39490.0,키움증권보통주
11230,39490,2018-12-04,0.0419426048565121,90600,86800,-3800,73165,39490.0,키움증권보통주
11231,39490,2018-12-03,0.0658823529411764,85000,90600,5600,126113,39490.0,키움증권보통주
11232,39490,2018-11-29,0.0496894409937888,80500,84500,4000,262867,39490.0,키움증권보통주
11233,39490,2018-11-23,0.04,80000,76800,-3200,87500,39490.0,키움증권보통주
11234,39490,2018-11-02,0.0986842105263157,76000,83500,7500,157893,39490.0,키움증권보통주
11235,39490,2018-10-25,0.0456989247311828,74400,71000,-3400,167542,39490.0,키움증권보통주
11236,39490,2018-10-23,0.0507152145643693,76900,73000,-3900,87850,39490.0,키움증권보통주
11237,39490,2018-10-11,0.0632911392405063,79000,74000,-5000,188626,39490.0,키움증권보통주
11238,39490,2018-10-04,0.0494938132733408,88900,84500,-4400,188621,39490.0,키움증권보통주
11239,39490,2018-10-02,0.0642105263157894,95000,88900,-6100,210338,39490.0,키움증권보통주
11240,39490,2018-08-27,0.0478309232480533,89900,94200,4300,167085,39490.0,키움증권보통주
11241,39490,2018-08-21,0.041860465116279,86000,89600,3600,128184,39490.0,키움증권보통주
11242,39490,2018-08-13,0.0679287305122494,89800,83700,-6100,287378,39490.0,키움증권보통주
11243,39490,2018-07-04,0.0427184466019417,103000,98600,-4400,124460,39490.0,키움증권보통주
11244,39490,2018-07-02,0.0783410138248847,108500,100000,-8500,182007,39490.0,키움증권보통주
11245,39490,2018-06-29,0.0432692307692307,104000,108500,4500,158534,39490.0,키움증권보통주
11246,39490,2018-06-20,0.0420560747663551,107000,111500,4500,189316,39490.0,키움증권보통주
11247,39490,2018-05-28,0.0614754098360655,122000,129500,7500,190713,39490.0,키움증권보통주
11248,39490,2018-05-14,0.040650406504065,123000,128000,5000,211103,39490.0,키움증권보통주
11249,39490,2018-03-23,0.0502283105022831,109500,104000,-5500,101301,39490.0,키움증권보통주
11250,39490,2018-03-12,0.0555555555555555,108000,114000,6000,156485,39490.0,키움증권보통주
11251,39490,2018-03-09,0.0588235294117647,102000,108000,6000,179985,39490.0,키움증권보통주
11252,39490,2018-03-06,0.041025641025641,97500,101500,4000,157172,39490.0,키움증권보통주
11253,39490,2018-02-20,0.045662100456621,109500,104500,-5000,53599,39490.0,키움증권보통주
11254,39490,2018-02-12,0.0689655172413793,101500,108500,7000,251548,39490.0,키움증권보통주
11255,39490,2018-02-09,0.0424528301886792,106000,101500,-4500,165318,39490.0,키움증권보통주
11256,39490,2018-02-08,0.0495049504950495,101000,106000,5000,164144,39490.0,키움증권보통주
11257,39490,2018-02-01,0.0420560747663551,107000,111500,4500,132845,39490.0,키움증권보통주
11258,39490,2018-01-23,0.058252427184466,103000,109000,6000,174025,39490.0,키움증권보통주
11259,39490,2018-01-18,0.0678137651821862,98800,105500,6700,173495,39490.0,키움증권보통주
11260,39490,2018-01-15,0.055496264674493,93700,98900,5200,189223,39490.0,키움증권보통주
11261,39490,2018-01-12,0.0733104238258877,87300,93700,6400,221577,39490.0,키움증권보통주
11262,39490,2017-12-13,0.0573870573870573,81900,86600,4700,69956,39490.0,키움증권보통주
11263,39490,2017-11-22,0.059880239520958,83500,88500,5000,334491,39490.0,키움증권보통주
11264,39490,2017-11-15,0.0794044665012407,80600,87000,6400,265573,39490.0,키움증권보통주
11265,39490,2017-11-13,0.0868983957219251,74800,81300,6500,324329,39490.0,키움증권보통주
11266,39490,2017-10-12,0.0505464480874316,73200,76900,3700,166749,39490.0,키움증권보통주
11267,39490,2017-09-25,0.0633893919793014,77300,72400,-4900,304807,39490.0,키움증권보통주
11268,39490,2017-09-07,0.0487483530961791,75900,79600,3700,108044,39490.0,키움증권보통주
11269,39490,2017-08-03,0.0442890442890442,85800,82000,-3800,94879,39490.0,키움증권보통주
11270,39490,2017-06-02,0.0457746478873239,85200,89100,3900,125924,39490.0,키움증권보통주
11271,39490,2017-03-16,0.0733830845771144,80400,86300,5900,113036,39490.0,키움증권보통주
11272,39490,2017-03-03,0.0512820512820512,78000,74000,-4000,46495,39490.0,키움증권보통주
11273,39490,2017-02-16,0.0557103064066852,71800,75800,4000,67704,39490.0,키움증권보통주
11274,39490,2017-02-06,0.0611664295874822,70300,74600,4300,85693,39490.0,키움증권보통주
11275,39490,2016-12-23,0.044776119402985,67000,70000,3000,82513,39490.0,키움증권보통주
11276,39490,2016-12-08,0.0626959247648902,63800,67800,4000,60689,39490.0,키움증권보통주
11277,39490,2016-12-05,0.04,65000,62400,-2600,48386,39490.0,키움증권보통주
11278,39490,2016-11-18,0.057057057057057,66600,62800,-3800,110242,39490.0,키움증권보통주
11279,39490,2016-10-24,0.0418994413407821,71600,68600,-3000,49134,39490.0,키움증권보통주
11280,39490,2016-09-12,0.0411686586985391,75300,72200,-3100,79499,39490.0,키움증권보통주
11281,42660,2021-06-01,0.0994065281899109,33700,37050,3350,1727706,42660.0,대우조선해양보통주
11282,42660,2021-05-20,0.0546448087431694,36600,34600,-2000,742026,42660.0,대우조선해양보통주
11283,42660,2021-05-10,0.0630872483221476,37250,39600,2350,1487804,42660.0,대우조선해양보통주
11284,42660,2021-04-30,0.0576368876080691,34700,36700,2000,2140561,42660.0,대우조선해양보통주
11285,42660,2021-04-29,0.0793157076205287,32150,34700,2550,1694175,42660.0,대우조선해양보통주
11286,42660,2021-04-26,0.0671256454388984,29050,31000,1950,1307440,42660.0,대우조선해양보통주
11287,42660,2021-03-26,0.0695488721804511,26600,28450,1850,1309490,42660.0,대우조선해양보통주
11288,42660,2021-03-12,0.0475247524752475,25250,26450,1200,692857,42660.0,대우조선해양보통주
11289,42660,2021-02-01,0.0470347648261758,24450,25600,1150,261473,42660.0,대우조선해양보통주
11290,42660,2021-01-29,0.0504854368932038,25750,24450,-1300,416750,42660.0,대우조선해양보통주
11291,42660,2020-11-23,0.0607843137254901,25500,27050,1550,2212852,42660.0,대우조선해양보통주
11292,42660,2020-11-16,0.0805785123966942,24200,26150,1950,1739443,42660.0,대우조선해양보통주
11293,42660,2020-11-09,0.0553097345132743,22600,23850,1250,621940,42660.0,대우조선해양보통주
11294,42660,2020-09-29,0.043859649122807,22800,23800,1000,404465,42660.0,대우조선해양보통주
11295,42660,2020-09-10,0.0508849557522123,22600,23750,1150,549400,42660.0,대우조선해양보통주
11296,42660,2020-09-07,0.042316258351893,22450,23400,950,493575,42660.0,대우조선해양보통주
11297,42660,2020-08-20,0.0615711252653927,23550,22100,-1450,502721,42660.0,대우조선해양보통주
11298,42660,2020-08-18,0.0838206627680311,25650,23500,-2150,704736,42660.0,대우조선해양보통주
11299,42660,2020-08-11,0.086864406779661,23600,25650,2050,1219173,42660.0,대우조선해양보통주
11300,42660,2020-07-21,0.0473118279569892,23250,24350,1100,492707,42660.0,대우조선해양보통주
11301,42660,2020-07-13,0.0425055928411633,22350,23300,950,312027,42660.0,대우조선해양보통주
11302,42660,2020-07-10,0.0407725321888412,23300,22350,-950,429207,42660.0,대우조선해양보통주
11303,42660,2020-07-01,0.0794824399260628,27050,24900,-2150,1028686,42660.0,대우조선해양보통주
11304,42660,2020-06-29,0.05078125,25600,26900,1300,1098850,42660.0,대우조선해양보통주
11305,42660,2020-06-16,0.0662393162393162,23400,24950,1550,849619,42660.0,대우조선해양보통주
11306,42660,2020-06-15,0.1034482758620689,26100,23400,-2700,984564,42660.0,대우조선해양보통주
11307,42660,2020-06-08,0.0461254612546125,27100,28350,1250,3537538,42660.0,대우조선해양보통주
11308,42660,2020-06-04,0.059625212947189,29350,27600,-1750,2429705,42660.0,대우조선해양보통주
11309,42660,2020-06-03,0.0711678832116788,27400,29350,1950,4178023,42660.0,대우조선해양보통주
11310,42660,2020-06-02,0.1440501043841336,23950,27400,3450,4417417,42660.0,대우조선해양보통주
11311,42660,2020-06-01,0.0986238532110091,21800,23950,2150,1048534,42660.0,대우조선해양보통주
11312,42660,2020-05-29,0.0430622009569378,20900,21800,900,923044,42660.0,대우조선해양보통주
11313,42660,2020-05-27,0.1070496083550913,19150,21200,2050,1871491,42660.0,대우조선해양보통주
11314,42660,2020-05-26,0.0407608695652173,18400,19150,750,803098,42660.0,대우조선해양보통주
11315,42660,2020-05-25,0.0823529411764705,17000,18400,1400,1041965,42660.0,대우조선해양보통주
11316,42660,2020-05-19,0.042042042042042,16650,17350,700,514234,42660.0,대우조선해양보통주
11317,42660,2020-04-22,0.0515151515151515,16500,17350,850,474714,42660.0,대우조선해양보통주
11318,42660,2020-04-13,0.0467836257309941,17100,16300,-800,356497,42660.0,대우조선해양보통주
11319,42660,2020-04-10,0.0555555555555555,16200,17100,900,644232,42660.0,대우조선해양보통주
11320,42660,2020-04-09,0.0728476821192053,15100,16200,1100,435261,42660.0,대우조선해양보통주
11321,42660,2020-04-07,0.0517241379310344,14500,15250,750,500151,42660.0,대우조선해양보통주
11322,42660,2020-04-06,0.0469314079422382,13850,14500,650,357290,42660.0,대우조선해양보통주
11323,42660,2020-04-02,0.0606060606060606,13200,14000,800,442345,42660.0,대우조선해양보통주
11324,42660,2020-03-27,0.073170731707317,12300,13200,900,811940,42660.0,대우조선해양보통주
11325,42660,2020-03-25,0.0735930735930736,11550,12400,850,1191737,42660.0,대우조선해양보통주
11326,42660,2020-03-23,0.1004016064257028,12450,11200,-1250,521951,42660.0,대우조선해양보통주
11327,42660,2020-03-19,0.1428571428571428,14000,12000,-2000,443469,42660.0,대우조선해양보통주
11328,42660,2020-03-18,0.0967741935483871,15500,14000,-1500,335676,42660.0,대우조선해양보통주
11329,42660,2020-03-16,0.0619469026548672,16950,15900,-1050,236901,42660.0,대우조선해양보통주
11330,42660,2020-03-13,0.0788043478260869,18400,16950,-1450,532857,42660.0,대우조선해양보통주
11331,42660,2020-03-12,0.0776942355889724,19950,18400,-1550,344850,42660.0,대우조선해양보통주
11332,42660,2020-03-09,0.072072072072072,22200,20600,-1600,250940,42660.0,대우조선해양보통주
11333,42660,2020-03-06,0.0410367170626349,23150,22200,-950,160938,42660.0,대우조선해양보통주
11334,42660,2020-02-24,0.0557851239669421,24200,22850,-1350,209050,42660.0,대우조선해양보통주
11335,42660,2020-02-06,0.0729166666666666,24000,25750,1750,337768,42660.0,대우조선해양보통주
11336,42660,2020-01-28,0.0482625482625482,25900,24650,-1250,198795,42660.0,대우조선해양보통주
11337,42660,2019-09-09,0.0415944540727903,28850,30050,1200,251308,42660.0,대우조선해양보통주
11338,42660,2019-08-30,0.05,26000,27300,1300,227306,42660.0,대우조선해양보통주
11339,42660,2019-08-19,0.1058091286307053,24100,26650,2550,405600,42660.0,대우조선해양보통주
11340,42660,2019-08-06,0.0589390962671905,25450,23950,-1500,516472,42660.0,대우조선해양보통주
11341,42660,2019-08-05,0.046816479400749,26700,25450,-1250,303314,42660.0,대우조선해양보통주
11342,42660,2019-08-02,0.0631578947368421,28500,26700,-1800,250843,42660.0,대우조선해양보통주
11343,42660,2019-07-25,0.0457516339869281,30600,29200,-1400,168173,42660.0,대우조선해양보통주
11344,42660,2019-04-01,0.0483005366726296,27950,29300,1350,307663,42660.0,대우조선해양보통주
11345,42660,2019-02-01,0.0864864864864864,37000,33800,-3200,3094450,42660.0,대우조선해양보통주
11346,42660,2019-01-28,0.0405209840810419,34550,35950,1400,941710,42660.0,대우조선해양보통주
11347,42660,2019-01-21,0.0641627543035993,31950,34000,2050,1102090,42660.0,대우조선해양보통주
11348,42660,2019-01-08,0.0426829268292682,32800,31400,-1400,639906,42660.0,대우조선해양보통주
11349,42660,2018-12-27,0.0692307692307692,32500,34750,2250,660947,42660.0,대우조선해양보통주
11350,42660,2018-12-26,0.048316251830161,34150,32500,-1650,677213,42660.0,대우조선해양보통주
11351,42660,2018-12-19,0.0686406460296096,37150,34600,-2550,1099961,42660.0,대우조선해양보통주
11352,42660,2018-12-12,0.0888888888888888,33750,36750,3000,776744,42660.0,대우조선해양보통주
11353,42660,2018-12-06,0.0505050505050505,34650,32900,-1750,625779,42660.0,대우조선해양보통주
11354,42660,2018-11-19,0.0470430107526881,37200,35450,-1750,1228288,42660.0,대우조선해양보통주
11355,42660,2018-11-15,0.0480349344978165,34350,36000,1650,737598,42660.0,대우조선해양보통주
11356,42660,2018-11-08,0.0411184210526315,30400,31650,1250,511681,42660.0,대우조선해양보통주
11357,42660,2018-11-06,0.0756013745704467,29100,31300,2200,688069,42660.0,대우조선해양보통주
11358,42660,2018-11-02,0.0475352112676056,28400,29750,1350,226537,42660.0,대우조선해양보통주
11359,42660,2018-10-31,0.0502692998204667,27850,29250,1400,538720,42660.0,대우조선해양보통주
11360,42660,2018-10-26,0.0612244897959183,29400,27600,-1800,668482,42660.0,대우조선해양보통주
11361,42660,2018-10-17,0.053731343283582,33500,31700,-1800,2620577,42660.0,대우조선해양보통주
11362,42660,2018-10-11,0.0693069306930693,35350,32900,-2450,657536,42660.0,대우조선해양보통주
11363,42660,2018-10-08,0.0636856368563685,36900,34550,-2350,761775,42660.0,대우조선해양보통주
11364,42660,2018-10-02,0.0539772727272727,35200,37100,1900,757294,42660.0,대우조선해양보통주
11365,42660,2018-09-27,0.0448430493273542,33450,34950,1500,652572,42660.0,대우조선해양보통주
11366,42660,2018-09-17,0.04,31250,32500,1250,552735,42660.0,대우조선해양보통주
11367,42660,2018-08-20,0.0900383141762452,26100,28450,2350,1895683,42660.0,대우조선해양보통주
11368,42660,2018-07-26,0.0844155844155844,23100,25050,1950,936794,42660.0,대우조선해양보통주
11369,42660,2018-07-24,0.0408997955010225,24450,23450,-1000,836602,42660.0,대우조선해양보통주
11370,42660,2018-07-23,0.0493562231759656,23300,24450,1150,523394,42660.0,대우조선해양보통주
11371,42660,2018-07-06,0.0603621730382293,24850,26350,1500,754100,42660.0,대우조선해양보통주
11372,42660,2018-07-02,0.0592592592592592,27000,25400,-1600,553030,42660.0,대우조선해양보통주
11373,42660,2018-06-25,0.0499001996007984,25050,26300,1250,647872,42660.0,대우조선해양보통주
11374,42660,2018-06-22,0.050314465408805,23850,25050,1200,489856,42660.0,대우조선해양보통주
11375,42660,2018-06-18,0.058027079303675,25850,24350,-1500,901451,42660.0,대우조선해양보통주
11376,42660,2018-06-14,0.055956678700361,27700,26150,-1550,2570168,42660.0,대우조선해양보통주
11377,42660,2018-06-11,0.0488721804511278,26600,27900,1300,1202754,42660.0,대우조선해양보통주
11378,42660,2018-05-14,0.0424710424710424,25900,27000,1100,720489,42660.0,대우조선해양보통주
11379,42660,2018-04-30,0.0476190476190476,25200,24000,-1200,1256428,42660.0,대우조선해양보통주
11380,42660,2018-04-25,0.0512333965844402,26350,25000,-1350,654020,42660.0,대우조선해양보통주
11381,42660,2018-04-05,0.072265625,25600,27450,1850,1298023,42660.0,대우조선해양보통주
11382,42660,2018-04-03,0.0451127819548872,26600,25400,-1200,1033372,42660.0,대우조선해양보통주
11383,42660,2018-03-20,0.0533596837944664,25300,26650,1350,1204514,42660.0,대우조선해양보통주
11384,42660,2018-03-15,0.0531496062992126,25400,26750,1350,1052395,42660.0,대우조선해양보통주
11385,42660,2018-03-14,0.0644567219152854,27150,25400,-1750,1142877,42660.0,대우조선해양보통주
11386,42660,2018-03-06,0.1035940803382663,23650,26100,2450,1267727,42660.0,대우조선해양보통주
11387,42660,2018-02-23,0.0769230769230769,22750,24500,1750,1670749,42660.0,대우조선해양보통주
11388,42660,2018-02-21,0.0610328638497652,21300,22600,1300,730556,42660.0,대우조선해양보통주
11389,42660,2018-02-19,0.0897755610972568,20050,21850,1800,858005,42660.0,대우조선해양보통주
11390,42660,2018-02-14,0.0580474934036939,18950,20050,1100,306984,42660.0,대우조선해양보통주
11391,42660,2018-02-12,0.0533980582524271,20600,19500,-1100,1020228,42660.0,대우조선해양보통주
11392,42660,2018-02-07,0.05,22000,20900,-1100,686588,42660.0,대우조선해양보통주
11393,42660,2018-02-05,0.0578158458244111,23350,22000,-1350,789143,42660.0,대우조선해양보통주
11394,42660,2018-01-30,0.0579064587973273,22450,23750,1300,1859129,42660.0,대우조선해양보통주
11395,42660,2018-01-25,0.0681818181818181,19800,21150,1350,1587988,42660.0,대우조선해양보통주
11396,42660,2018-01-22,0.0718232044198895,18100,19400,1300,1091237,42660.0,대우조선해양보통주
11397,42660,2018-01-17,0.0447368421052631,19000,18150,-850,728905,42660.0,대우조선해양보통주
11398,42660,2018-01-15,0.1040462427745664,17300,19100,1800,1839224,42660.0,대우조선해양보통주
11399,42660,2018-01-12,0.0880503144654088,15900,17300,1400,905957,42660.0,대우조선해양보통주
11400,42660,2018-01-04,0.0406976744186046,17200,16500,-700,526458,42660.0,대우조선해양보통주
11401,42660,2018-01-03,0.1205211726384364,15350,17200,1850,819973,42660.0,대우조선해양보통주
11402,42660,2018-01-02,0.1043165467625899,13900,15350,1450,382063,42660.0,대우조선해양보통주
11403,42660,2017-12-27,0.0633333333333333,15000,14050,-950,402003,42660.0,대우조선해양보통주
11404,42660,2017-12-20,0.0410094637223974,15850,15200,-650,343135,42660.0,대우조선해양보통주
11405,42660,2017-11-30,0.0466472303206997,17150,17950,800,997827,42660.0,대우조선해양보통주
11406,42660,2017-11-10,0.0595238095238095,21000,19750,-1250,1264200,42660.0,대우조선해양보통주
11407,42660,2017-11-08,0.0904255319148936,18800,20500,1700,2632812,42660.0,대우조선해양보통주
11408,42660,2017-11-07,0.0444444444444444,18000,18800,800,972138,42660.0,대우조선해양보통주
11409,42660,2017-11-06,0.0588235294117647,17000,18000,1000,1427696,42660.0,대우조선해양보통주
11410,42660,2017-10-31,0.0541237113402061,19400,18350,-1050,1872129,42660.0,대우조선해양보통주
11411,42660,2017-10-30,0.0669642857142857,44800,19400,-25400,11060393,42660.0,대우조선해양보통주
11412,42670,2021-06-02,0.0902255639097744,13300,14500,1200,19591771,42670.0,두산인프라코어보통주
11413,42670,2021-05-31,0.0443548387096774,12400,12950,550,11992608,42670.0,두산인프라코어보통주
11414,42670,2021-05-28,0.0553191489361702,11750,12400,650,14373798,42670.0,두산인프라코어보통주
11415,42670,2021-05-13,0.0409090909090909,11000,10550,-450,4801289,42670.0,두산인프라코어보통주
11416,42670,2021-05-11,0.0412844036697247,10900,11350,450,14154086,42670.0,두산인프라코어보통주
11417,42670,2021-05-03,0.0509259259259259,10800,10250,-550,5959635,42670.0,두산인프라코어보통주
11418,42670,2021-04-01,0.066079295154185,11350,10600,-750,7763356,42670.0,두산인프라코어보통주
11419,42670,2021-03-29,0.0975609756097561,10250,11250,1000,22752864,42670.0,두산인프라코어보통주
11420,42670,2021-03-25,0.0575916230366492,9550,10100,550,23996748,42670.0,두산인프라코어보통주
11421,42670,2021-03-23,0.0576923076923076,9880,9310,-570,14863431,42670.0,두산인프라코어보통주
11422,42670,2021-03-22,0.218249075215783,8110,9880,1770,62580004,42670.0,두산인프라코어보통주
11423,42670,2021-02-01,0.0747549019607843,8160,8770,610,11273586,42670.0,두산인프라코어보통주
11424,42670,2021-01-15,0.0439814814814814,8640,8260,-380,6562871,42670.0,두산인프라코어보통주
11425,42670,2021-01-13,0.0481481481481481,8100,8490,390,8397976,42670.0,두산인프라코어보통주
11426,42670,2020-12-14,0.0419091967403958,8590,8230,-360,6488161,42670.0,두산인프라코어보통주
11427,42670,2020-12-10,0.0638036809815951,8150,8670,520,22855766,42670.0,두산인프라코어보통주
11428,42670,2020-11-25,0.0534698521046643,8790,8320,-470,12188171,42670.0,두산인프라코어보통주
11429,42670,2020-11-24,0.0476706392199349,9230,8790,-440,12806795,42670.0,두산인프라코어보통주
11430,42670,2020-11-23,0.0417607223476298,8860,9230,370,8729943,42670.0,두산인프라코어보통주
11431,42670,2020-09-22,0.1375921375921376,8140,9260,1120,128207788,42670.0,두산인프라코어보통주
11432,42670,2020-08-20,0.046070460704607,7380,7720,340,30331867,42670.0,두산인프라코어보통주
11433,42670,2020-08-18,0.0771175726927939,7910,7300,-610,7438307,42670.0,두산인프라코어보통주
11434,42670,2020-08-03,0.050632911392405,7110,7470,360,13652678,42670.0,두산인프라코어보통주
11435,42670,2020-07-22,0.092964824120603,7960,7220,-740,62527985,42670.0,두산인프라코어보통주
11436,42670,2020-07-21,0.2535433070866141,6350,7960,1610,110041784,42670.0,두산인프라코어보통주
11437,42670,2020-07-10,0.0421216848673947,6410,6140,-270,4986046,42670.0,두산인프라코어보통주
11438,42670,2020-07-01,0.0524137931034482,7250,6870,-380,7222222,42670.0,두산인프라코어보통주
11439,42670,2020-06-30,0.0677466863033873,6790,7250,460,17249692,42670.0,두산인프라코어보통주
11440,42670,2020-06-18,0.0848938826466916,8010,7330,-680,21193004,42670.0,두산인프라코어보통주
11441,42670,2020-06-17,0.070855614973262,7480,8010,530,88519880,42670.0,두산인프라코어보통주
11442,42670,2020-06-16,0.2986111111111111,5760,7480,1720,51073794,42670.0,두산인프라코어보통주
11443,42670,2020-06-15,0.06645056726094,6170,5760,-410,8640884,42670.0,두산인프라코어보통주
11444,42670,2020-06-12,0.0594512195121951,6560,6170,-390,6067728,42670.0,두산인프라코어보통주
11445,42670,2020-06-08,0.0489296636085626,6540,6860,320,23620188,42670.0,두산인프라코어보통주
11446,42670,2020-06-03,0.1281588447653429,5540,6250,710,43558257,42670.0,두산인프라코어보통주
11447,42670,2020-06-01,0.0576923076923076,5200,5500,300,5456417,42670.0,두산인프라코어보통주
11448,42670,2020-05-22,0.0535405872193437,5790,5480,-310,5280992,42670.0,두산인프라코어보통주
11449,42670,2020-05-15,0.1270833333333333,4800,5410,610,38619904,42670.0,두산인프라코어보통주
11450,42670,2020-05-11,0.0891861761426978,4485,4885,400,13258746,42670.0,두산인프라코어보통주
11451,42670,2020-04-27,0.0437956204379562,4110,4290,180,1753934,42670.0,두산인프라코어보통주
11452,42670,2020-04-20,0.0710059171597633,4225,4525,300,9560181,42670.0,두산인프라코어보통주
11453,42670,2020-04-16,0.0471491228070175,4560,4345,-215,4476501,42670.0,두산인프라코어보통주
11454,42670,2020-04-06,0.0699126092384519,4005,4285,280,8411291,42670.0,두산인프라코어보통주
11455,42670,2020-04-03,0.0987654320987654,3645,4005,360,11779605,42670.0,두산인프라코어보통주
11456,42670,2020-04-01,0.1351351351351351,3145,3570,425,15531184,42670.0,두산인프라코어보통주
11457,42670,2020-03-25,0.0654545454545454,2750,2930,180,3558988,42670.0,두산인프라코어보통주
11458,42670,2020-03-24,0.0848126232741617,2535,2750,215,2703985,42670.0,두산인프라코어보통주
11459,42670,2020-03-23,0.0913978494623656,2790,2535,-255,3332863,42670.0,두산인프라코어보통주
11460,42670,2020-03-20,0.08984375,2560,2790,230,3660865,42670.0,두산인프라코어보통주
11461,42670,2020-03-19,0.120274914089347,2910,2560,-350,3725438,42670.0,두산인프라코어보통주
11462,42670,2020-03-18,0.0551948051948051,3080,2910,-170,2282900,42670.0,두산인프라코어보통주
11463,42670,2020-03-13,0.0872093023255814,3440,3140,-300,6505944,42670.0,두산인프라코어보통주
11464,42670,2020-03-12,0.0740242261103634,3715,3440,-275,3850813,42670.0,두산인프라코어보통주
11465,42670,2020-03-11,0.0437580437580437,3885,3715,-170,4189611,42670.0,두산인프라코어보통주
11466,42670,2020-03-09,0.0611510791366906,4170,3915,-255,2661135,42670.0,두산인프라코어보통주
11467,42670,2020-03-06,0.0424799081515499,4355,4170,-185,1490765,42670.0,두산인프라코어보통주
11468,42670,2020-02-28,0.0410958904109589,4380,4200,-180,1901237,42670.0,두산인프라코어보통주
11469,42670,2020-02-24,0.0413870246085011,4470,4285,-185,2347861,42670.0,두산인프라코어보통주
11470,42670,2020-01-28,0.0487571701720841,5230,4975,-255,2206175,42670.0,두산인프라코어보통주
11471,42670,2020-01-08,0.0436432637571157,5270,5040,-230,1776678,42670.0,두산인프라코어보통주
11472,42670,2019-10-31,0.0520134228187919,5960,5650,-310,4103542,42670.0,두산인프라코어보통주
11473,42670,2019-10-14,0.0415973377703826,6010,6260,250,1070604,42670.0,두산인프라코어보통주
11474,42670,2019-09-16,0.0425867507886435,6340,6610,270,2215130,42670.0,두산인프라코어보통주
11475,42670,2019-08-19,0.0515463917525773,5820,6120,300,1574295,42670.0,두산인프라코어보통주
11476,42670,2019-08-05,0.0646766169154228,6030,5640,-390,2262735,42670.0,두산인프라코어보통주
11477,42670,2019-06-28,0.0646616541353383,6650,6220,-430,3473101,42670.0,두산인프라코어보통주
11478,42670,2019-02-14,0.053231939163498,7890,7470,-420,7820860,42670.0,두산인프라코어보통주
11479,42670,2019-02-13,0.057347670250896,8370,7890,-480,6337019,42670.0,두산인프라코어보통주
11480,42670,2019-01-09,0.0651041666666666,7680,8180,500,2912827,42670.0,두산인프라코어보통주
11481,42670,2018-11-02,0.0569620253164556,7900,8350,450,3324757,42670.0,두산인프라코어보통주
11482,42670,2018-10-30,0.0448484848484848,8250,7880,-370,4892711,42670.0,두산인프라코어보통주
11483,42670,2018-10-11,0.0761904761904762,9450,8730,-720,3199119,42670.0,두산인프라코어보통주
11484,42670,2018-10-10,0.0521564694082246,9970,9450,-520,2980588,42670.0,두산인프라코어보통주
11485,42670,2018-09-19,0.0593311758360302,9270,9820,550,5672319,42670.0,두산인프라코어보통주
11486,42670,2018-08-03,0.0612244897959183,9800,10400,600,2827385,42670.0,두산인프라코어보통주
11487,42670,2018-07-24,0.0488069414316702,9220,9670,450,2973418,42670.0,두산인프라코어보통주
11488,42670,2018-07-06,0.0444444444444444,9000,9400,400,2203244,42670.0,두산인프라코어보통주
11489,42670,2018-07-02,0.0456431535269709,9640,9200,-440,2261090,42670.0,두산인프라코어보통주
11490,42670,2018-06-25,0.0532481363152289,9390,9890,500,3038396,42670.0,두산인프라코어보통주
11491,42670,2018-06-11,0.0528846153846153,10400,10950,550,6770463,42670.0,두산인프라코어보통주
11492,42670,2018-05-29,0.0530973451327433,11300,10700,-600,3917725,42670.0,두산인프라코어보통주
11493,42670,2018-05-28,0.0813397129186602,10450,11300,850,7671514,42670.0,두산인프라코어보통주
11494,42670,2018-05-14,0.0460829493087557,10850,11350,500,7213451,42670.0,두산인프라코어보통주
11495,42670,2018-05-10,0.0792079207920792,10100,10900,800,8010567,42670.0,두산인프라코어보통주
11496,42670,2018-04-30,0.09508547008547,9360,10250,890,11531016,42670.0,두산인프라코어보통주
11497,42670,2018-04-25,0.0486039296794208,9670,9200,-470,4066896,42670.0,두산인프라코어보통주
11498,42670,2018-04-24,0.0409041980624327,9290,9670,380,3464554,42670.0,두산인프라코어보통주
11499,42670,2018-04-04,0.0470035252643948,8510,8110,-400,6657237,42670.0,두산인프라코어보통주
11500,42670,2018-04-02,0.1230610134436401,9670,8480,-1190,13194648,42670.0,두산인프라코어보통주
11501,42670,2018-03-26,0.0578602620087336,9160,9690,530,4043615,42670.0,두산인프라코어보통주
11502,42670,2018-03-23,0.05175983436853,9660,9160,-500,2466063,42670.0,두산인프라코어보통주
11503,42670,2018-03-07,0.050755939524838,9260,8790,-470,4140153,42670.0,두산인프라코어보통주
11504,42670,2018-02-28,0.040082219938335,9730,9340,-390,2290010,42670.0,두산인프라코어보통주
11505,42670,2018-02-22,0.0436893203883495,10300,9850,-450,4844136,42670.0,두산인프라코어보통주
11506,42670,2018-01-09,0.0758196721311475,9760,10500,740,10469876,42670.0,두산인프라코어보통주
11507,42670,2018-01-02,0.0448791714614499,8690,9080,390,3017579,42670.0,두산인프라코어보통주
11508,42670,2017-12-04,0.0439189189189189,8880,9270,390,3293972,42670.0,두산인프라코어보통주
11509,42670,2017-11-13,0.0418367346938775,9800,9390,-410,3620956,42670.0,두산인프라코어보통주
11510,42670,2017-10-13,0.0672853828306264,8620,9200,580,10229811,42670.0,두산인프라코어보통주
11511,42670,2017-09-07,0.0510948905109489,8220,8640,420,5689692,42670.0,두산인프라코어보통주
11512,42670,2017-08-04,0.0450121654501216,8220,8590,370,4183580,42670.0,두산인프라코어보통주
11513,42670,2017-08-01,0.0570719602977667,8060,8520,460,6389427,42670.0,두산인프라코어보통주
11514,42670,2017-07-31,0.0426908150064683,7730,8060,330,2680364,42670.0,두산인프라코어보통주
11515,42670,2017-07-28,0.0409429280397022,8060,7730,-330,2581617,42670.0,두산인프라코어보통주
11516,42670,2017-06-26,0.0447585394581861,8490,8110,-380,3241534,42670.0,두산인프라코어보통주
11517,42670,2017-06-19,0.0451977401129943,8850,8450,-400,3077044,42670.0,두산인프라코어보통주
11518,42670,2017-05-29,0.1354051054384017,9010,7790,-1220,14175215,42670.0,두산인프라코어보통주
11519,42670,2017-04-26,0.0455991516436903,9430,9860,430,3597164,42670.0,두산인프라코어보통주
11520,42670,2017-04-05,0.0536692223439211,9130,9620,490,2674975,42670.0,두산인프라코어보통주
11521,42670,2017-03-22,0.0453201970443349,10150,9690,-460,3258107,42670.0,두산인프라코어보통주
11522,42670,2017-03-16,0.0433403805496828,9460,9870,410,4572066,42670.0,두산인프라코어보통주
11523,42670,2017-03-07,0.0468409586056644,9180,9610,430,6394262,42670.0,두산인프라코어보통주
11524,42670,2017-02-27,0.0414333706606942,8930,9300,370,4691734,42670.0,두산인프라코어보통주
11525,42670,2017-02-22,0.0528789659224441,8510,8960,450,4670087,42670.0,두산인프라코어보통주
11526,42670,2017-02-16,0.0577777777777777,9000,8480,-520,5649573,42670.0,두산인프라코어보통주
11527,42670,2017-02-10,0.0511296076099881,8410,8840,430,3747294,42670.0,두산인프라코어보통주
11528,42670,2016-12-20,0.0453460620525059,8380,8760,380,6140551,42670.0,두산인프라코어보통주
11529,42670,2016-12-08,0.0458015267175572,7860,8220,360,5046142,42670.0,두산인프라코어보통주
11530,42670,2016-12-05,0.0494791666666666,7680,8060,380,4813338,42670.0,두산인프라코어보통주
11531,42670,2016-11-18,0.1434554973821989,9550,8180,-1370,23086920,42670.0,두산인프라코어보통주
11532,42670,2016-11-14,0.1660649819494584,8310,9690,1380,36640185,42670.0,두산인프라코어보통주
11533,42670,2016-11-11,0.0400500625782227,7990,8310,320,8402291,42670.0,두산인프라코어보통주
11534,42670,2016-11-10,0.1479885057471264,6960,7990,1030,17913361,42670.0,두산인프라코어보통주
11535,42670,2016-11-09,0.0682730923694779,7470,6960,-510,6182757,42670.0,두산인프라코어보통주
11536,42670,2016-10-12,0.0480349344978165,6870,7200,330,4472645,42670.0,두산인프라코어보통주
11537,42670,2016-10-11,0.0458333333333333,7200,6870,-330,6436373,42670.0,두산인프라코어보통주
11538,42670,2016-10-10,0.0721649484536082,7760,7200,-560,12647741,42670.0,두산인프라코어보통주
11539,42670,2016-10-07,0.0559610705596107,8220,7760,-460,5491717,42670.0,두산인프라코어보통주
11540,42670,2016-10-06,0.0444726810673443,7870,8220,350,3743217,42670.0,두산인프라코어보통주
11541,42670,2016-09-20,0.0466439135381114,8790,8380,-410,3844929,42670.0,두산인프라코어보통주
11542,42670,2016-09-12,0.0577777777777777,9000,8480,-520,4800981,42670.0,두산인프라코어보통주
11543,42670,2016-09-07,0.0412249705535924,8490,8840,350,5268340,42670.0,두산인프라코어보통주
11544,42670,2016-09-05,0.0425273390036452,8230,8580,350,3875260,42670.0,두산인프라코어보통주
11545,42670,2016-08-29,0.0485436893203883,8240,7840,-400,3526876,42670.0,두산인프라코어보통주
11546,42670,2016-08-05,0.0610079575596817,7540,8000,460,4095321,42670.0,두산인프라코어보통주
11547,42700,2021-06-03,0.0575757575757575,33000,34900,1900,2379427,42700.0,한미반도체보통주
11548,42700,2021-05-27,0.0597484276729559,31800,33700,1900,988557,42700.0,한미반도체보통주
11549,42700,2021-05-24,0.0496350364963503,34250,32550,-1700,933280,42700.0,한미반도체보통주
11550,42700,2021-05-18,0.0458715596330275,32700,34200,1500,1294112,42700.0,한미반도체보통주
11551,42700,2021-05-14,0.095,30000,32850,2850,2050356,42700.0,한미반도체보통주
11552,42700,2021-05-13,0.0536277602523659,31700,30000,-1700,1258659,42700.0,한미반도체보통주
11553,42700,2021-04-29,0.04,35000,33600,-1400,1990236,42700.0,한미반도체보통주
11554,42700,2021-04-28,0.0825688073394495,38150,35000,-3150,2057001,42700.0,한미반도체보통주
11555,42700,2021-04-26,0.0643356643356643,35750,38050,2300,1617750,42700.0,한미반도체보통주
11556,42700,2021-04-23,0.0514705882352941,34000,35750,1750,1561390,42700.0,한미반도체보통주
11557,42700,2021-04-05,0.1169811320754717,26500,29600,3100,5801383,42700.0,한미반도체보통주
11558,42700,2021-04-01,0.0676229508196721,24400,26050,1650,1781210,42700.0,한미반도체보통주
11559,42700,2021-03-23,0.0420650095602294,26150,25050,-1100,923223,42700.0,한미반도체보통주
11560,42700,2021-03-18,0.0443974630021141,23650,24700,1050,1108441,42700.0,한미반도체보통주
11561,42700,2021-03-15,0.0440528634361233,22700,23700,1000,1053035,42700.0,한미반도체보통주
11562,42700,2021-03-11,0.0866336633663366,20200,21950,1750,861079,42700.0,한미반도체보통주
11563,42700,2021-02-24,0.052863436123348,22700,21500,-1200,1314180,42700.0,한미반도체보통주
11564,42700,2021-02-23,0.0580912863070539,24100,22700,-1400,1380044,42700.0,한미반도체보통주
11565,42700,2021-02-19,0.1226851851851851,21600,24250,2650,10339907,42700.0,한미반도체보통주
11566,42700,2021-02-15,0.0620155038759689,19350,20550,1200,1135182,42700.0,한미반도체보통주
11567,42700,2021-02-01,0.0687830687830687,18900,20200,1300,866041,42700.0,한미반도체보통주
11568,42700,2021-01-29,0.0454545454545454,19800,18900,-900,778157,42700.0,한미반도체보통주
11569,42700,2021-01-27,0.0498812351543943,21050,20000,-1050,893733,42700.0,한미반도체보통주
11570,42700,2021-01-18,0.0610079575596817,18850,20000,1150,3088776,42700.0,한미반도체보통주
11571,42700,2021-01-15,0.0649717514124293,17700,18850,1150,7994829,42700.0,한미반도체보통주
11572,42700,2020-12-29,0.0848484848484848,16500,17900,1400,1485125,42700.0,한미반도체보통주
11573,42700,2020-12-21,0.0460122699386503,16300,17050,750,1069395,42700.0,한미반도체보통주
11574,42700,2020-12-17,0.0534591194968553,15900,16750,850,2901563,42700.0,한미반도체보통주
11575,42700,2020-12-16,0.1197183098591549,14200,15900,1700,3124324,42700.0,한미반도체보통주
11576,42700,2020-12-08,0.0674603174603174,12600,13450,850,2955553,42700.0,한미반도체보통주
11577,42700,2020-11-19,0.0447154471544715,12300,12850,550,1279869,42700.0,한미반도체보통주
11578,42700,2020-11-16,0.0818965517241379,11600,12550,950,2869763,42700.0,한미반도체보통주
11579,42700,2020-11-13,0.045045045045045,11100,11600,500,670736,42700.0,한미반도체보통주
11580,42700,2020-10-29,0.0483091787439613,10350,10850,500,599232,42700.0,한미반도체보통주
11581,42700,2020-10-23,0.0509259259259259,10800,10250,-550,669169,42700.0,한미반도체보통주
11582,42700,2020-10-12,0.0571428571428571,10500,11100,600,843797,42700.0,한미반도체보통주
11583,42700,2020-09-28,0.0454545454545454,9900,10350,450,253746,42700.0,한미반도체보통주
11584,42700,2020-09-08,0.0761904761904762,10500,11300,800,2386744,42700.0,한미반도체보통주
11585,42700,2020-08-20,0.0824074074074074,10800,9910,-890,1165998,42700.0,한미반도체보통주
11586,42700,2020-08-18,0.05,11000,10450,-550,780412,42700.0,한미반도체보통주
11587,42700,2020-08-12,0.040983606557377,12200,11700,-500,5498280,42700.0,한미반도체보통주
11588,42700,2020-07-21,0.1602497398543184,9610,11150,1540,9822948,42700.0,한미반도체보통주
11589,42700,2020-07-17,0.101010101010101,8910,9810,900,4747288,42700.0,한미반도체보통주
11590,42700,2020-07-08,0.0568181818181818,7920,8370,450,1203748,42700.0,한미반도체보통주
11591,42700,2020-07-03,0.0706521739130434,7360,7880,520,675714,42700.0,한미반도체보통주
11592,42700,2020-06-15,0.064039408866995,8120,7600,-520,602759,42700.0,한미반도체보통주
11593,42700,2020-05-28,0.0425531914893617,9400,9000,-400,563211,42700.0,한미반도체보통주
11594,42700,2020-05-27,0.0408163265306122,9800,9400,-400,577332,42700.0,한미반도체보통주
11595,42700,2020-05-25,0.0776699029126213,9270,9990,720,1324121,42700.0,한미반도체보통주
11596,42700,2020-05-20,0.1188811188811188,8580,9600,1020,4665545,42700.0,한미반도체보통주
11597,42700,2020-05-08,0.0441527446300716,8380,8750,370,499565,42700.0,한미반도체보통주
11598,42700,2020-05-07,0.0514429109159347,7970,8380,410,325237,42700.0,한미반도체보통주
11599,42700,2020-04-17,0.0626702997275204,7340,7800,460,512513,42700.0,한미반도체보통주
11600,42700,2020-04-07,0.0654338549075391,7030,7490,460,506536,42700.0,한미반도체보통주
11601,42700,2020-03-25,0.1215106732348111,6090,6830,740,465857,42700.0,한미반도체보통주
11602,42700,2020-03-24,0.0855614973262032,5610,6090,480,414274,42700.0,한미반도체보통주
11603,42700,2020-03-23,0.0757825370675453,6070,5610,-460,319987,42700.0,한미반도체보통주
11604,42700,2020-03-20,0.1518026565464895,5270,6070,800,638207,42700.0,한미반도체보통주
11605,42700,2020-03-19,0.1904761904761904,6510,5270,-1240,446896,42700.0,한미반도체보통주
11606,42700,2020-03-18,0.0646551724137931,6960,6510,-450,238027,42700.0,한미반도체보통주
11607,42700,2020-03-16,0.0503311258278145,7550,7170,-380,264906,42700.0,한미반도체보통주
11608,42700,2020-03-13,0.0467171717171717,7920,7550,-370,617541,42700.0,한미반도체보통주
11609,42700,2020-03-12,0.0736842105263157,8550,7920,-630,436659,42700.0,한미반도체보통주
11610,42700,2020-03-11,0.0489432703003337,8990,8550,-440,230337,42700.0,한미반도체보통주
11611,42700,2020-03-09,0.044468546637744,9220,8810,-410,238220,42700.0,한미반도체보통주
11612,42700,2020-03-02,0.0531177829099307,8660,9120,460,303635,42700.0,한미반도체보통주
11613,42700,2020-02-28,0.0493962678375411,9110,8660,-450,431721,42700.0,한미반도체보통주
11614,42700,2020-02-27,0.0588842975206611,9680,9110,-570,351920,42700.0,한미반도체보통주
11615,42700,2020-02-25,0.0522306855277475,9190,9670,480,311201,42700.0,한미반도체보통주
11616,42700,2020-02-13,0.060021436227224,9330,9890,560,1396365,42700.0,한미반도체보통주
11617,42700,2020-01-31,0.0460526315789473,9120,8700,-420,817061,42700.0,한미반도체보통주
11618,42700,2020-01-28,0.0413306451612903,9920,9510,-410,822448,42700.0,한미반도체보통주
11619,42700,2020-01-23,0.0431125131440588,9510,9920,410,1394861,42700.0,한미반도체보통주
11620,42700,2020-01-22,0.0543237250554323,9020,9510,490,3979330,42700.0,한미반도체보통주
11621,42700,2020-01-16,0.0616113744075829,8440,8960,520,669926,42700.0,한미반도체보통주
11622,42700,2020-01-09,0.0636942675159235,7850,8350,500,616267,42700.0,한미반도체보통주
11623,42700,2019-12-17,0.0651289009497964,7370,7850,480,1289746,42700.0,한미반도체보통주
11624,42700,2019-12-16,0.0634920634920634,6930,7370,440,1326390,42700.0,한미반도체보통주
11625,42700,2019-12-13,0.1,6300,6930,630,3514800,42700.0,한미반도체보통주
11626,42700,2019-11-25,0.0426229508196721,6100,6360,260,79334,42700.0,한미반도체보통주
11627,42700,2019-11-20,0.0508982035928143,6680,6340,-340,283813,42700.0,한미반도체보통주
11628,42700,2019-10-14,0.0493827160493827,6480,6800,320,158318,42700.0,한미반도체보통주
11629,42700,2019-09-09,0.0492307692307692,6500,6180,-320,241636,42700.0,한미반도체보통주
11630,42700,2019-09-05,0.0617886178861788,6150,6530,380,444476,42700.0,한미반도체보통주
11631,42700,2019-09-04,0.0441426146010186,5890,6150,260,232799,42700.0,한미반도체보통주
11632,42700,2019-08-30,0.0512820512820512,5460,5740,280,136942,42700.0,한미반도체보통주
11633,42700,2019-08-26,0.0564373897707231,5670,5350,-320,186272,42700.0,한미반도체보통주
11634,42700,2019-08-13,0.0443686006825938,5860,6120,260,156686,42700.0,한미반도체보통주
11635,42700,2019-08-06,0.0909090909090909,6050,5500,-550,324542,42700.0,한미반도체보통주
11636,42700,2019-08-05,0.0735068912710566,6530,6050,-480,212217,42700.0,한미반도체보통주
11637,42700,2019-07-29,0.0560471976401179,6780,6400,-380,161967,42700.0,한미반도체보통주
11638,42700,2019-07-08,0.088,7500,6840,-660,509528,42700.0,한미반도체보통주
11639,42700,2019-06-19,0.0490883590462833,7130,7480,350,424645,42700.0,한미반도체보통주
11640,42700,2019-05-09,0.0498261877172653,8630,8200,-430,529422,42700.0,한미반도체보통주
11641,42700,2019-04-23,0.0726846424384525,8530,9150,620,1329248,42700.0,한미반도체보통주
11642,42700,2019-04-17,0.0685920577617328,8310,8880,570,1164248,42700.0,한미반도체보통주
11643,42700,2019-03-25,0.0410798122065727,8520,8170,-350,134954,42700.0,한미반도체보통주
11644,42700,2019-03-15,0.058890147225368,8830,8310,-520,368341,42700.0,한미반도체보통주
11645,42700,2019-03-14,0.094175960346964,8070,8830,760,666355,42700.0,한미반도체보통주
11646,42700,2019-02-28,0.0438799076212471,8660,8280,-380,327500,42700.0,한미반도체보통주
11647,42700,2019-02-12,0.0868454661558109,7830,8510,680,514909,42700.0,한미반도체보통주
11648,42700,2019-01-31,0.04177545691906,7660,7980,320,1069313,42700.0,한미반도체보통주
11649,42700,2019-01-03,0.0719041278295605,7510,6970,-540,331118,42700.0,한미반도체보통주
11650,42700,2018-12-10,0.0536529680365296,8760,8290,-470,315468,42700.0,한미반도체보통주
11651,42700,2018-12-07,0.0428571428571428,8400,8760,360,197029,42700.0,한미반도체보통주
11652,42700,2018-12-03,0.0802919708029197,8220,8880,660,419484,42700.0,한미반도체보통주
11653,42700,2018-11-28,0.0414572864321608,7960,8290,330,218776,42700.0,한미반도체보통주
11654,42700,2018-11-20,0.0755148741418764,8740,8080,-660,583694,42700.0,한미반도체보통주
11655,42700,2018-11-07,0.0451541850220264,9080,8670,-410,238865,42700.0,한미반도체보통주
11656,42700,2018-10-15,0.0428100987925356,9110,9500,390,228573,42700.0,한미반도체보통주
11657,42700,2018-10-12,0.0580720092915214,8610,9110,500,170000,42700.0,한미반도체보통주
11658,42700,2018-10-11,0.0741935483870967,9300,8610,-690,231237,42700.0,한미반도체보통주
11659,42700,2018-10-02,0.048780487804878,10250,9750,-500,236853,42700.0,한미반도체보통주
11660,42700,2018-09-19,0.0821256038647343,10350,11200,850,2251717,42700.0,한미반도체보통주
11661,42700,2018-08-27,0.0482456140350877,11400,11950,550,712134,42700.0,한미반도체보통주
11662,42700,2018-08-24,0.0410958904109589,10950,11400,450,983728,42700.0,한미반도체보통주
11663,42700,2018-08-22,0.1111111111111111,9900,11000,1100,1249446,42700.0,한미반도체보통주
11664,42700,2018-07-31,0.0492610837438423,10150,10650,500,458124,42700.0,한미반도체보통주
11665,42700,2018-07-13,0.0764904386951631,8890,9570,680,346296,42700.0,한미반도체보통주
11666,42700,2018-07-10,0.0574162679425837,8360,8840,480,178817,42700.0,한미반도체보통주
11667,42700,2018-06-28,0.0582857142857142,8750,8240,-510,232944,42700.0,한미반도체보통주
11668,42700,2018-05-29,0.0404040404040404,9900,9500,-400,313668,42700.0,한미반도체보통주
11669,42700,2018-04-04,0.0428571428571428,10500,10050,-450,424557,42700.0,한미반도체보통주
11670,42700,2018-04-02,0.0488888888888888,11250,10700,-550,309257,42700.0,한미반도체보통주
11671,42700,2018-03-26,0.0509259259259259,10800,11350,550,288928,42700.0,한미반도체보통주
11672,42700,2018-03-22,0.041860465116279,10750,11200,450,377652,42700.0,한미반도체보통주
11673,42700,2018-03-07,0.054054054054054,11100,10500,-600,332072,42700.0,한미반도체보통주
11674,42700,2018-03-05,0.0517241379310344,11600,11000,-600,395867,42700.0,한미반도체보통주
11675,42700,2018-02-14,0.0488888888888888,11250,11800,550,202565,42700.0,한미반도체보통주
11676,42700,2018-02-08,0.1380952380952381,10500,11950,1450,782860,42700.0,한미반도체보통주
11677,42700,2018-02-07,0.054054054054054,11100,10500,-600,495842,42700.0,한미반도체보통주
11678,42700,2018-01-16,0.0407239819004524,11050,11500,450,316985,42700.0,한미반도체보통주
11679,42700,2017-12-21,0.0537190082644628,12100,11450,-650,262126,42700.0,한미반도체보통주
11680,42700,2017-12-19,0.0474137931034482,11600,12150,550,514490,42700.0,한미반도체보통주
11681,42700,2017-12-11,0.0412844036697247,10900,11350,450,357169,42700.0,한미반도체보통주
11682,42700,2017-11-22,0.13215859030837,11350,12850,1500,3742341,42700.0,한미반도체보통주
11683,42700,2017-11-21,0.0657276995305164,10650,11350,700,764799,42700.0,한미반도체보통주
11684,42700,2017-11-10,0.0482180293501048,9540,10000,460,589945,42700.0,한미반도체보통주
11685,42700,2017-11-09,0.046,10000,9540,-460,574334,42700.0,한미반도체보통주
11686,42700,2017-11-08,0.0559662090813094,9470,10000,530,586178,42700.0,한미반도체보통주
11687,42700,2017-10-27,0.053821313240043,9290,9790,500,618740,42700.0,한미반도체보통주
11688,42700,2017-10-20,0.0403050108932461,9180,9550,370,964694,42700.0,한미반도체보통주
11689,42700,2017-10-17,0.04959630911188,8670,9100,430,1758788,42700.0,한미반도체보통주
11690,42700,2017-09-28,0.075812274368231,8310,8940,630,1523958,42700.0,한미반도체보통주
11691,42700,2017-09-25,0.0467762326169405,7910,8280,370,235114,42700.0,한미반도체보통주
11692,42700,2017-09-07,0.0496894409937888,8050,8450,400,563287,42700.0,한미반도체보통주
11693,42700,2017-08-30,0.0612244897959183,7350,7800,450,350443,42700.0,한미반도체보통주
11694,42700,2017-08-03,0.0450771055753262,8430,8050,-380,503861,42700.0,한미반도체보통주
11695,42700,2017-07-24,0.0617283950617283,8910,9460,550,2811971,42700.0,한미반도체보통주
11696,42700,2017-07-21,0.0408878504672897,8560,8910,350,1454792,42700.0,한미반도체보통주
11697,42700,2017-07-04,0.0470446320868516,8290,8680,390,649738,42700.0,한미반도체보통주
11698,42700,2017-06-27,0.0410798122065727,8520,8870,350,1453150,42700.0,한미반도체보통주
11699,42700,2017-06-14,0.0542986425339366,8840,8360,-480,1413432,42700.0,한미반도체보통주
11700,42700,2017-06-08,0.1619537275064267,7780,9040,1260,5453451,42700.0,한미반도체보통주
11701,42700,2017-05-15,0.0422163588390501,7580,7900,320,644892,42700.0,한미반도체보통주
11702,42700,2017-04-11,0.0417827298050139,17950,18700,750,236974,42700.0,한미반도체보통주
11703,42700,2017-04-03,0.0445103857566765,16850,17600,750,133265,42700.0,한미반도체보통주
11704,42700,2017-01-13,0.0696864111498257,14350,15350,1000,490584,42700.0,한미반도체보통주
11705,42700,2016-12-26,0.0413793103448275,14500,15100,600,180823,42700.0,한미반도체보통주
11706,42700,2016-12-16,0.0522388059701492,13400,14100,700,167395,42700.0,한미반도체보통주
11707,42700,2016-12-08,0.0526315789473684,12350,13000,650,96963,42700.0,한미반도체보통주
11708,42700,2016-11-10,0.0411985018726591,13350,13900,550,63823,42700.0,한미반도체보통주
11709,42700,2016-11-09,0.0531914893617021,14100,13350,-750,154469,42700.0,한미반도체보통주
11710,42700,2016-10-21,0.0452961672473867,14350,15000,650,142069,42700.0,한미반도체보통주
11711,42700,2016-09-19,0.0547445255474452,13700,14450,750,107136,42700.0,한미반도체보통주
11712,42700,2016-08-29,0.0451612903225806,15500,14800,-700,80773,42700.0,한미반도체보통주
11713,42700,2016-08-18,0.0769230769230769,14300,15400,1100,274145,42700.0,한미반도체보통주
11714,47040,2021-06-02,0.0622754491017964,8350,8870,520,27759396,47040.0,대우건설보통주
11715,47040,2021-05-31,0.0426065162907268,7980,8320,340,13553906,47040.0,대우건설보통주
11716,47040,2021-05-18,0.0571428571428571,7350,7770,420,10224705,47040.0,대우건설보통주
11717,47040,2021-04-29,0.0695410292072322,7190,7690,500,27493195,47040.0,대우건설보통주
11718,47040,2021-04-20,0.0510204081632653,6860,7210,350,15109308,47040.0,대우건설보통주
11719,47040,2021-04-08,0.0785824345146379,6490,7000,510,25827417,47040.0,대우건설보통주
11720,47040,2021-03-29,0.0463678516228748,6470,6770,300,10592458,47040.0,대우건설보통주
11721,47040,2021-03-22,0.0459016393442622,6100,6380,280,6503952,47040.0,대우건설보통주
11722,47040,2021-03-15,0.0570469798657718,5960,6300,340,15376092,47040.0,대우건설보통주
11723,47040,2021-03-12,0.0419580419580419,5720,5960,240,10629289,47040.0,대우건설보통주
11724,47040,2021-02-04,0.0506134969325153,6520,6190,-330,11256306,47040.0,대우건설보통주
11725,47040,2021-02-01,0.0949152542372881,5900,6460,560,12801447,47040.0,대우건설보통주
11726,47040,2021-01-29,0.0664556962025316,6320,5900,-420,11265125,47040.0,대우건설보통주
11727,47040,2021-01-28,0.0411861614497528,6070,6320,250,18960759,47040.0,대우건설보통주
11728,47040,2021-01-18,0.057335581787521,5930,6270,340,23957542,47040.0,대우건설보통주
11729,47040,2021-01-14,0.0595446584938704,5710,6050,340,11516315,47040.0,대우건설보통주
11730,47040,2021-01-05,0.1242718446601941,5150,5790,640,63694731,47040.0,대우건설보통주
11731,47040,2020-12-30,0.0697424892703862,4660,4985,325,22854653,47040.0,대우건설보통주
11732,47040,2020-12-18,0.0646651270207852,4330,4610,280,8850284,47040.0,대우건설보통주
11733,47040,2020-12-14,0.0466101694915254,4720,4500,-220,5419254,47040.0,대우건설보통주
11734,47040,2020-12-10,0.0872093023255814,4300,4675,375,33951737,47040.0,대우건설보통주
11735,47040,2020-12-09,0.0804020100502512,3980,4300,320,8524837,47040.0,대우건설보통주
11736,47040,2020-12-04,0.0696452036793692,3805,4070,265,14254782,47040.0,대우건설보통주
11737,47040,2020-12-03,0.0733427362482369,3545,3805,260,11263948,47040.0,대우건설보통주
11738,47040,2020-11-19,0.0464480874316939,3660,3490,-170,4364138,47040.0,대우건설보통주
11739,47040,2020-11-11,0.0403458213256484,3470,3610,140,7035574,47040.0,대우건설보통주
11740,47040,2020-11-10,0.0547112462006079,3290,3470,180,7730072,47040.0,대우건설보통주
11741,47040,2020-11-09,0.0511182108626198,3130,3290,160,5387105,47040.0,대우건설보통주
11742,47040,2020-10-23,0.0545454545454545,3025,3190,165,5085754,47040.0,대우건설보통주
11743,47040,2020-08-31,0.0438311688311688,3080,2945,-135,20806884,47040.0,대우건설보통주
11744,47040,2020-08-20,0.0504451038575667,3370,3200,-170,2141779,47040.0,대우건설보통주
11745,47040,2020-08-18,0.0439716312056737,3525,3370,-155,1720632,47040.0,대우건설보통주
11746,47040,2020-08-04,0.050287356321839,3480,3655,175,4655043,47040.0,대우건설보통주
11747,47040,2020-07-28,0.0713266761768901,3505,3755,250,5826855,47040.0,대우건설보통주
11748,47040,2020-06-16,0.057471264367816,3480,3680,200,1116764,47040.0,대우건설보통주
11749,47040,2020-06-15,0.056910569105691,3690,3480,-210,1414033,47040.0,대우건설보통주
11750,47040,2020-06-05,0.0432569974554707,3930,4100,170,1715900,47040.0,대우건설보통주
11751,47040,2020-05-29,0.0478796169630642,3655,3830,175,2547093,47040.0,대우건설보통주
11752,47040,2020-04-27,0.0424242424242424,3300,3440,140,911273,47040.0,대우건설보통주
11753,47040,2020-04-22,0.0407854984894259,3310,3445,135,2014014,47040.0,대우건설보통주
11754,47040,2020-04-14,0.0507131537242472,3155,3315,160,2427988,47040.0,대우건설보통주
11755,47040,2020-04-02,0.0525362318840579,2760,2905,145,1379518,47040.0,대우건설보통주
11756,47040,2020-04-01,0.0612244897959183,2940,2760,-180,1814015,47040.0,대우건설보통주
11757,47040,2020-03-31,0.0481283422459893,2805,2940,135,2285175,47040.0,대우건설보통주
11758,47040,2020-03-25,0.1307847082494969,2485,2810,325,3340166,47040.0,대우건설보통주
11759,47040,2020-03-24,0.0923076923076923,2275,2485,210,2317386,47040.0,대우건설보통주
11760,47040,2020-03-23,0.1007905138339921,2530,2275,-255,2216825,47040.0,대우건설보통주
11761,47040,2020-03-20,0.0675105485232067,2370,2530,160,3331959,47040.0,대우건설보통주
11762,47040,2020-03-19,0.1520572450805009,2795,2370,-425,4389516,47040.0,대우건설보통주
11763,47040,2020-03-18,0.0940032414910859,3085,2795,-290,2749166,47040.0,대우건설보통주
11764,47040,2020-03-17,0.0565749235474006,3270,3085,-185,2440175,47040.0,대우건설보통주
11765,47040,2020-03-13,0.0681818181818181,3520,3280,-240,3513467,47040.0,대우건설보통주
11766,47040,2020-03-12,0.0712401055408971,3790,3520,-270,2831225,47040.0,대우건설보통주
11767,47040,2020-03-09,0.0643203883495145,4120,3855,-265,2693924,47040.0,대우건설보통주
11768,47040,2020-03-06,0.0407450523864959,4295,4120,-175,1284056,47040.0,대우건설보통주
11769,47040,2020-03-05,0.0644361833952912,4035,4295,260,2277299,47040.0,대우건설보통주
11770,47040,2020-02-24,0.0452961672473867,4305,4110,-195,2081759,47040.0,대우건설보통주
11771,47040,2020-02-06,0.0870056497175141,4425,4810,385,2744930,47040.0,대우건설보통주
11772,47040,2020-01-09,0.0416171224732461,4205,4380,175,1805007,47040.0,대우건설보통주
11773,47040,2020-01-08,0.0497175141242937,4425,4205,-220,2788299,47040.0,대우건설보통주
11774,47040,2020-01-06,0.0415335463258785,4695,4500,-195,1287069,47040.0,대우건설보통주
11775,47040,2019-12-12,0.0465872156013001,4615,4830,215,2128026,47040.0,대우건설보통주
11776,47040,2019-11-05,0.0406147091108671,4555,4740,185,1661776,47040.0,대우건설보통주
11777,47040,2019-11-04,0.0495391705069124,4340,4555,215,1169977,47040.0,대우건설보통주
11778,47040,2019-09-16,0.1198630136986301,4380,4905,525,6281206,47040.0,대우건설보통주
11779,47040,2019-08-05,0.0406905055487053,4055,3890,-165,1262235,47040.0,대우건설보통주
11780,47040,2019-07-25,0.0446224256292906,4370,4175,-195,1873386,47040.0,대우건설보통주
11781,47040,2019-03-14,0.0431125131440588,4755,4960,205,1355240,47040.0,대우건설보통주
11782,47040,2019-01-30,0.0676156583629893,5620,5240,-380,9250936,47040.0,대우건설보통주
11783,47040,2019-01-29,0.0490693739424703,5910,5620,-290,3412149,47040.0,대우건설보통주
11784,47040,2019-01-23,0.0656028368794326,5640,6010,370,2289355,47040.0,대우건설보통주
11785,47040,2019-01-09,0.0403669724770642,5450,5670,220,1242213,47040.0,대우건설보통주
11786,47040,2018-12-27,0.0404624277456647,5190,5400,210,1078547,47040.0,대우건설보통주
11787,47040,2018-12-19,0.042031523642732,5710,5470,-240,1568225,47040.0,대우건설보통주
11788,47040,2018-12-14,0.0523255813953488,5160,5430,270,2784203,47040.0,대우건설보통주
11789,47040,2018-12-12,0.0436590436590436,4810,5020,210,1369919,47040.0,대우건설보통주
11790,47040,2018-11-28,0.060796645702306,4770,5060,290,1778085,47040.0,대우건설보통주
11791,47040,2018-11-02,0.0458515283842794,4580,4790,210,1057123,47040.0,대우건설보통주
11792,47040,2018-10-30,0.0562571756601607,4355,4600,245,2238419,47040.0,대우건설보통주
11793,47040,2018-10-29,0.0542888165038002,4605,4355,-250,3221589,47040.0,대우건설보통주
11794,47040,2018-10-26,0.0725075528700906,4965,4605,-360,3434976,47040.0,대우건설보통주
11795,47040,2018-10-11,0.0578661844484629,5530,5210,-320,2375429,47040.0,대우건설보통주
11796,47040,2018-10-10,0.0432525951557093,5780,5530,-250,2098033,47040.0,대우건설보통주
11797,47040,2018-09-21,0.0556521739130434,5750,6070,320,3549469,47040.0,대우건설보통주
11798,47040,2018-09-10,0.075,5200,5590,390,4435077,47040.0,대우건설보통주
11799,47040,2018-08-06,0.043859649122807,5700,5450,-250,1873014,47040.0,대우건설보통주
11800,47040,2018-07-02,0.0613287904599659,5870,5510,-360,2788902,47040.0,대우건설보통주
11801,47040,2018-06-14,0.0459259259259259,6750,6440,-310,4014882,47040.0,대우건설보통주
11802,47040,2018-06-11,0.0642633228840125,6380,6790,410,4214171,47040.0,대우건설보통주
11803,47040,2018-06-05,0.0566343042071197,6180,6530,350,3463619,47040.0,대우건설보통주
11804,47040,2018-05-29,0.0545977011494252,6960,6580,-380,4024110,47040.0,대우건설보통주
11805,47040,2018-05-28,0.1447368421052631,6080,6960,880,13248700,47040.0,대우건설보통주
11806,47040,2018-05-25,0.0674846625766871,6520,6080,-440,8480778,47040.0,대우건설보통주
11807,47040,2018-05-21,0.0494350282485875,7080,6730,-350,3923502,47040.0,대우건설보통주
11808,47040,2018-05-14,0.0762052877138413,6430,6920,490,9223127,47040.0,대우건설보통주
11809,47040,2018-05-08,0.0423600605143721,6610,6330,-280,4274532,47040.0,대우건설보통주
11810,47040,2018-04-30,0.0672268907563025,5950,6350,400,9798465,47040.0,대우건설보통주
11811,47040,2018-04-19,0.0550918196994991,5990,6320,330,7978654,47040.0,대우건설보통주
11812,47040,2018-04-18,0.0545774647887323,5680,5990,310,4398386,47040.0,대우건설보통주
11813,47040,2018-04-09,0.0488721804511278,5320,5580,260,4703256,47040.0,대우건설보통주
11814,47040,2018-03-12,0.0421052631578947,5700,5940,240,3408070,47040.0,대우건설보통주
11815,47040,2018-03-09,0.051660516605166,5420,5700,280,3881470,47040.0,대우건설보통주
11816,47040,2018-03-06,0.076771653543307,5080,5470,390,4692440,47040.0,대우건설보통주
11817,47040,2018-02-19,0.0591836734693877,4900,5190,290,3682367,47040.0,대우건설보통주
11818,47040,2018-02-08,0.0880281690140845,5680,5180,-500,11719649,47040.0,대우건설보통주
11819,47040,2018-02-06,0.0448504983388704,6020,5750,-270,4198424,47040.0,대우건설보통주
11820,47040,2018-01-19,0.0401396160558464,5730,5960,230,4679922,47040.0,대우건설보통주
11821,47040,2017-12-15,0.0741410488245931,5530,5940,410,3307940,47040.0,대우건설보통주
11822,47040,2017-12-14,0.0449050086355785,5790,5530,-260,2871682,47040.0,대우건설보통주
11823,47040,2017-12-07,0.0437062937062937,5720,5470,-250,3151425,47040.0,대우건설보통주
11824,47040,2017-11-21,0.0585365853658536,6150,5790,-360,7143712,47040.0,대우건설보통주
11825,47040,2017-11-13,0.0592592592592592,6750,6350,-400,7286856,47040.0,대우건설보통주
11826,47040,2017-11-09,0.0421875,6400,6670,270,12015690,47040.0,대우건설보통주
11827,47040,2017-11-07,0.0455212922173274,6810,6500,-310,26215099,47040.0,대우건설보통주
11828,47040,2017-11-02,0.0681198910081744,7340,6840,-500,7026872,47040.0,대우건설보통주
11829,47040,2017-10-24,0.042796005706134,7010,7310,300,1785514,47040.0,대우건설보통주
11830,47040,2017-09-04,0.044414535666218,7430,7100,-330,2128558,47040.0,대우건설보통주
11831,47040,2017-09-01,0.0568990042674253,7030,7430,400,6159334,47040.0,대우건설보통주
11832,47040,2017-08-03,0.0612745098039215,8160,7660,-500,2854513,47040.0,대우건설보통주
11833,47040,2017-06-29,0.0489208633093525,6950,7290,340,1867266,47040.0,대우건설보통주
11834,47040,2017-05-24,0.062807881773399,8120,7610,-510,36770279,47040.0,대우건설보통주
11835,47040,2017-04-13,0.0464135021097046,7110,6780,-330,10426634,47040.0,대우건설보통주
11836,47040,2017-03-28,0.0442225392296719,7010,7320,310,1388249,47040.0,대우건설보통주
11837,47040,2017-03-23,0.0489913544668587,6940,7280,340,2109328,47040.0,대우건설보통주
11838,47040,2017-03-07,0.0459770114942528,6090,6370,280,1464485,47040.0,대우건설보통주
11839,47040,2017-02-09,0.0915887850467289,5350,5840,490,4746627,47040.0,대우건설보통주
11840,47040,2016-11-18,0.0402193784277879,5470,5250,-220,2423166,47040.0,대우건설보통주
11841,47040,2016-11-16,0.0550774526678141,5810,5490,-320,7375151,47040.0,대우건설보통주
11842,47040,2016-11-15,0.1367013372956909,6730,5810,-920,8759304,47040.0,대우건설보통주
11843,47040,2016-11-10,0.0510366826156299,6270,6590,320,1990332,47040.0,대우건설보통주
11844,47050,2021-05-18,0.0488372093023255,21500,22550,1050,1007439,47050.0,포스코인터내셔널보통주
11845,47050,2021-05-12,0.0456521739130434,23000,21950,-1050,1879688,47050.0,포스코인터내셔널보통주
11846,47050,2021-05-04,0.0406698564593301,20900,21750,850,1481012,47050.0,포스코인터내셔널보통주
11847,47050,2021-04-30,0.0561797752808988,22250,21000,-1250,1644079,47050.0,포스코인터내셔널보통주
11848,47050,2021-04-27,0.0619047619047619,21000,22300,1300,3844090,47050.0,포스코인터내셔널보통주
11849,47050,2021-04-26,0.0606060606060606,19800,21000,1200,5735896,47050.0,포스코인터내셔널보통주
11850,47050,2021-03-30,0.0425,20000,20850,850,1114536,47050.0,포스코인터내셔널보통주
11851,47050,2021-03-25,0.050125313283208,19950,20950,1000,1788181,47050.0,포스코인터내셔널보통주
11852,47050,2021-03-23,0.0949227373068432,22650,20500,-2150,4229806,47050.0,포스코인터내셔널보통주
11853,47050,2021-03-18,0.0659090909090909,22000,23450,1450,3250047,47050.0,포스코인터내셔널보통주
11854,47050,2021-02-25,0.056338028169014,21300,22500,1200,1850466,47050.0,포스코인터내셔널보통주
11855,47050,2021-02-24,0.0759219088937093,23050,21300,-1750,2750876,47050.0,포스코인터내셔널보통주
11856,47050,2021-02-17,0.0508083140877598,21650,22750,1100,6991364,47050.0,포스코인터내셔널보통주
11857,47050,2021-02-15,0.0407239819004524,22100,21200,-900,1997078,47050.0,포스코인터내셔널보통주
11858,47050,2021-02-09,0.0431965442764578,23150,22150,-1000,3435084,47050.0,포스코인터내셔널보통주
11859,47050,2021-02-08,0.0498866213151927,22050,23150,1100,7315347,47050.0,포스코인터내셔널보통주
11860,47050,2021-02-04,0.1709844559585492,19300,22600,3300,18348535,47050.0,포스코인터내셔널보통주
11861,47050,2021-02-01,0.109090909090909,16500,18300,1800,14003744,47050.0,포스코인터내셔널보통주
11862,47050,2021-01-22,0.0581395348837209,17200,16200,-1000,2655699,47050.0,포스코인터내셔널보통주
11863,47050,2021-01-21,0.1278688524590163,15250,17200,1950,6494009,47050.0,포스코인터내셔널보통주
11864,47050,2021-01-11,0.0441640378548895,15850,15150,-700,1790563,47050.0,포스코인터내셔널보통주
11865,47050,2021-01-07,0.0830564784053156,15050,16300,1250,3461515,47050.0,포스코인터내셔널보통주
11866,47050,2020-12-29,0.0427631578947368,15200,14550,-650,957680,47050.0,포스코인터내셔널보통주
11867,47050,2020-12-11,0.0549828178694158,14550,15350,800,1877299,47050.0,포스코인터내셔널보통주
11868,47050,2020-10-26,0.0445205479452054,14600,13950,-650,400683,47050.0,포스코인터내셔널보통주
11869,47050,2020-10-21,0.0734265734265734,14300,15350,1050,1048983,47050.0,포스코인터내셔널보통주
11870,47050,2020-06-16,0.1167883211678832,13700,15300,1600,726010,47050.0,포스코인터내셔널보통주
11871,47050,2020-06-15,0.0452961672473867,14350,13700,-650,409164,47050.0,포스코인터내셔널보통주
11872,47050,2020-06-12,0.0651465798045602,15350,14350,-1000,592461,47050.0,포스코인터내셔널보통주
11873,47050,2020-05-29,0.0631229235880398,15050,16000,950,977981,47050.0,포스코인터내셔널보통주
11874,47050,2020-05-22,0.0529801324503311,15100,14300,-800,428478,47050.0,포스코인터내셔널보통주
11875,47050,2020-05-18,0.0683453237410072,13900,14850,950,696451,47050.0,포스코인터내셔널보통주
11876,47050,2020-04-13,0.04,13750,13200,-550,359188,47050.0,포스코인터내셔널보통주
11877,47050,2020-04-09,0.0488721804511278,13300,13950,650,537208,47050.0,포스코인터내셔널보통주
11878,47050,2020-04-07,0.0461538461538461,13000,13600,600,775056,47050.0,포스코인터내셔널보통주
11879,47050,2020-04-06,0.1255411255411255,11550,13000,1450,997539,47050.0,포스코인터내셔널보통주
11880,47050,2020-04-02,0.0934579439252336,10700,11700,1000,584551,47050.0,포스코인터내셔널보통주
11881,47050,2020-04-01,0.0572687224669603,11350,10700,-650,450457,47050.0,포스코인터내셔널보통주
11882,47050,2020-03-25,0.09508547008547,9360,10250,890,843342,47050.0,포스코인터내셔널보통주
11883,47050,2020-03-24,0.0758620689655172,8700,9360,660,616264,47050.0,포스코인터내셔널보통주
11884,47050,2020-03-23,0.105858170606372,9730,8700,-1030,659090,47050.0,포스코인터내셔널보통주
11885,47050,2020-03-20,0.0704070407040704,9090,9730,640,657286,47050.0,포스코인터내셔널보통주
11886,47050,2020-03-19,0.1044334975369458,10150,9090,-1060,1009767,47050.0,포스코인터내셔널보통주
11887,47050,2020-03-18,0.064516129032258,10850,10150,-700,599194,47050.0,포스코인터내셔널보통주
11888,47050,2020-03-16,0.050632911392405,11850,11250,-600,405830,47050.0,포스코인터내셔널보통주
11889,47050,2020-03-13,0.0632411067193675,12650,11850,-800,894262,47050.0,포스코인터내셔널보통주
11890,47050,2020-03-12,0.0698529411764705,13600,12650,-950,986916,47050.0,포스코인터내셔널보통주
11891,47050,2020-03-09,0.0833333333333333,15000,13750,-1250,856008,47050.0,포스코인터내셔널보통주
11892,47050,2020-02-28,0.0447284345047923,15650,14950,-700,970470,47050.0,포스코인터내셔널보통주
11893,47050,2020-02-07,0.0648967551622418,16950,18050,1100,915139,47050.0,포스코인터내셔널보통주
11894,47050,2019-09-16,0.0424403183023872,18850,19650,800,605522,47050.0,포스코인터내셔널보통주
11895,47050,2019-06-18,0.0463768115942029,17250,18050,800,402520,47050.0,포스코인터내셔널보통주
11896,47050,2019-01-09,0.0586666666666666,18750,19850,1100,536000,47050.0,포스코인터내셔널보통주
11897,47050,2019-01-07,0.0504201680672268,17850,18750,900,487843,47050.0,포스코인터내셔널보통주
11898,47050,2018-12-26,0.0402144772117962,18650,17900,-750,336645,47050.0,포스코인터내셔널보통주
11899,47050,2018-11-14,0.0690537084398976,19550,18200,-1350,897186,47050.0,포스코인터내셔널보통주
11900,47050,2018-11-06,0.0635359116022099,18100,19250,1150,561827,47050.0,포스코인터내셔널보통주
11901,47050,2018-11-02,0.0545977011494252,17400,18350,950,319421,47050.0,포스코인터내셔널보통주
11902,47050,2018-09-27,0.045,20000,20900,900,849797,47050.0,포스코인터내셔널보통주
11903,47050,2018-09-13,0.0445026178010471,19100,19950,850,795263,47050.0,포스코인터내셔널보통주
11904,47050,2018-09-07,0.0444444444444444,18000,18800,800,598896,47050.0,포스코인터내셔널보통주
11905,47050,2018-07-24,0.105,20000,17900,-2100,2471710,47050.0,포스코인터내셔널보통주
11906,47050,2018-07-02,0.0514018691588785,21400,20300,-1100,685133,47050.0,포스코인터내셔널보통주
11907,47050,2018-06-28,0.0471464019851116,20150,21100,950,879236,47050.0,포스코인터내셔널보통주
11908,47050,2018-06-19,0.0411899313501144,21850,20950,-900,764222,47050.0,포스코인터내셔널보통주
11909,47050,2018-06-18,0.0561555075593952,23150,21850,-1300,736666,47050.0,포스코인터내셔널보통주
11910,47050,2018-05-28,0.0454545454545454,23100,24150,1050,1197751,47050.0,포스코인터내셔널보통주
11911,47050,2018-05-25,0.0434782608695652,24150,23100,-1050,784200,47050.0,포스코인터내셔널보통주
11912,47050,2018-05-18,0.0512295081967213,24400,25650,1250,807603,47050.0,포스코인터내셔널보통주
11913,47050,2018-05-16,0.064453125,25600,23950,-1650,1100707,47050.0,포스코인터내셔널보통주
11914,47050,2018-05-14,0.0907127429805615,23150,25250,2100,2414406,47050.0,포스코인터내셔널보통주
11915,47050,2018-05-10,0.0748299319727891,22050,23700,1650,1129475,47050.0,포스코인터내셔널보통주
11916,47050,2018-04-25,0.0582120582120582,24050,22650,-1400,1003700,47050.0,포스코인터내셔널보통주
11917,47050,2018-04-10,0.0606741573033707,22250,23600,1350,770151,47050.0,포스코인터내셔널보통주
11918,47050,2018-03-26,0.0448430493273542,22300,23300,1000,974438,47050.0,포스코인터내셔널보통주
11919,47050,2018-03-22,0.0564705882352941,21250,22450,1200,1511605,47050.0,포스코인터내셔널보통주
11920,47050,2018-03-15,0.0576441102756892,19950,21100,1150,834715,47050.0,포스코인터내셔널보통주
11921,47050,2018-02-27,0.0422535211267605,21300,20400,-900,696773,47050.0,포스코인터내셔널보통주
11922,47050,2018-02-07,0.0413943355119825,22950,22000,-950,622208,47050.0,포스코인터내셔널보통주
11923,47050,2018-02-06,0.04375,24000,22950,-1050,907296,47050.0,포스코인터내셔널보통주
11924,47050,2018-01-25,0.1241217798594847,21350,24000,2650,3536944,47050.0,포스코인터내셔널보통주
11925,47050,2018-01-24,0.0414634146341463,20500,21350,850,623513,47050.0,포스코인터내셔널보통주
11926,47050,2018-01-12,0.0411622276029055,20650,21500,850,1050815,47050.0,포스코인터내셔널보통주
11927,47050,2018-01-11,0.0417633410672853,21550,20650,-900,863020,47050.0,포스코인터내셔널보통주
11928,47050,2018-01-10,0.0668316831683168,20200,21550,1350,1949546,47050.0,포스코인터내셔널보통주
11929,47050,2018-01-03,0.04,18750,19500,750,1116006,47050.0,포스코인터내셔널보통주
11930,47050,2017-11-15,0.041025641025641,19500,18700,-800,1134941,47050.0,포스코인터내셔널보통주
11931,47050,2017-11-07,0.0656565656565656,19800,21100,1300,1558400,47050.0,포스코인터내셔널보통주
11932,47050,2017-10-25,0.04177545691906,19150,19950,800,433052,47050.0,포스코인터내셔널보통주
11933,47050,2017-09-22,0.0415647921760391,20450,19600,-850,561648,47050.0,포스코인터내셔널보통주
11934,47050,2017-08-01,0.0553191489361702,23500,24800,1300,848933,47050.0,포스코인터내셔널보통주
11935,47050,2017-05-26,0.0438247011952191,25100,24000,-1100,978943,47050.0,포스코인터내셔널보통주
11936,47050,2017-05-25,0.0818965517241379,23200,25100,1900,1174217,47050.0,포스코인터내셔널보통주
11937,47050,2017-04-07,0.0412147505422993,23050,24000,950,496751,47050.0,포스코인터내셔널보통주
11938,47050,2017-03-31,0.0506607929515418,22700,23850,1150,665447,47050.0,포스코인터내셔널보통주
11939,47050,2017-01-31,0.0485981308411214,26750,25450,-1300,382895,47050.0,포스코인터내셔널보통주
11940,47050,2017-01-19,0.0476190476190476,28350,27000,-1350,504928,47050.0,포스코인터내셔널보통주
11941,47050,2017-01-11,0.0422018348623853,27250,28400,1150,250675,47050.0,포스코인터내셔널보통주
11942,47050,2016-12-12,0.0491803278688524,27450,28800,1350,434195,47050.0,포스코인터내셔널보통주
11943,47050,2016-12-08,0.0707456978967495,26150,28000,1850,398191,47050.0,포스코인터내셔널보통주
11944,47050,2016-11-24,0.0409683426443202,26850,25750,-1100,218115,47050.0,포스코인터내셔널보통주
11945,47050,2016-11-16,0.0667976424361493,25450,27150,1700,655391,47050.0,포스코인터내셔널보통주
11946,47050,2016-11-10,0.0502092050209205,23900,25100,1200,439405,47050.0,포스코인터내셔널보통주
11947,47050,2016-11-07,0.048832271762208,23550,24700,1150,233641,47050.0,포스코인터내셔널보통주
11948,47050,2016-11-01,0.0521042084168336,24950,23650,-1300,351705,47050.0,포스코인터내셔널보통주
11949,47050,2016-10-27,0.0417457305502846,26350,25250,-1100,508162,47050.0,포스코인터내셔널보통주
11950,47050,2016-10-11,0.04930966469428,25350,26600,1250,557650,47050.0,포스코인터내셔널보통주
11951,47050,2016-09-29,0.1261061946902655,22600,25450,2850,1391762,47050.0,포스코인터내셔널보통주
11952,47050,2016-09-12,0.0443974630021141,23650,22600,-1050,164367,47050.0,포스코인터내셔널보통주
11953,47050,2016-08-19,0.0495689655172413,23200,24350,1150,528889,47050.0,포스코인터내셔널보통주
11954,47050,2016-08-03,0.0512249443207126,22450,21300,-1150,529312,47050.0,포스코인터내셔널보통주
11955,47810,2021-03-23,0.0426666666666666,37500,35900,-1600,1547311,47810.0,한국항공우주산업보통주
11956,47810,2021-03-19,0.0452616690240452,35350,36950,1600,1797497,47810.0,한국항공우주산업보통주
11957,47810,2021-03-11,0.0716510903426791,32100,34400,2300,1763532,47810.0,한국항공우주산업보통주
11958,47810,2021-02-26,0.0583214793741109,35150,33100,-2050,2022812,47810.0,한국항공우주산업보통주
11959,47810,2021-02-24,0.0550964187327823,36300,34300,-2000,1795775,47810.0,한국항공우주산업보통주
11960,47810,2021-02-04,0.1329479768786127,34600,39200,4600,11773559,47810.0,한국항공우주산업보통주
11961,47810,2021-02-02,0.05625,32000,33800,1800,2829109,47810.0,한국항공우주산업보통주
11962,47810,2021-01-25,0.0596774193548387,31000,32850,1850,2295295,47810.0,한국항공우주산업보통주
11963,47810,2021-01-20,0.0515806988352745,30050,31600,1550,3814580,47810.0,한국항공우주산업보통주
11964,47810,2021-01-18,0.0702702702702702,27750,29700,1950,4369224,47810.0,한국항공우주산업보통주
11965,47810,2021-01-04,0.0426356589147286,25800,26900,1100,1568992,47810.0,한국항공우주산업보통주
11966,47810,2020-12-11,0.0458333333333333,24000,25100,1100,1849269,47810.0,한국항공우주산업보통주
11967,47810,2020-11-11,0.0646551724137931,23200,24700,1500,1759417,47810.0,한국항공우주산업보통주
11968,47810,2020-08-20,0.0438413361169102,23950,22900,-1050,773324,47810.0,한국항공우주산업보통주
11969,47810,2020-08-18,0.0461847389558232,24900,23750,-1150,779871,47810.0,한국항공우주산업보통주
11970,47810,2020-06-17,0.049800796812749,25100,26350,1250,3434205,47810.0,한국항공우주산업보통주
11971,47810,2020-06-12,0.0423076923076923,26000,24900,-1100,850731,47810.0,한국항공우주산업보통주
11972,47810,2020-05-27,0.0597938144329896,24250,25700,1450,1928534,47810.0,한국항공우주산업보통주
11973,47810,2020-05-04,0.0701754385964912,25650,23850,-1800,1373770,47810.0,한국항공우주산업보통주
11974,47810,2020-04-24,0.0560165975103734,24100,25450,1350,3553804,47810.0,한국항공우주산업보통주
11975,47810,2020-04-21,0.0550847457627118,23600,24900,1300,7928199,47810.0,한국항공우주산업보통주
11976,47810,2020-04-20,0.0442477876106194,22600,23600,1000,1117443,47810.0,한국항공우주산업보통주
11977,47810,2020-04-13,0.0434782608695652,23000,22000,-1000,548489,47810.0,한국항공우주산업보통주
11978,47810,2020-04-07,0.0599520383693045,20850,22100,1250,1094423,47810.0,한국항공우주산업보통주
11979,47810,2020-03-25,0.1713483146067415,17800,20850,3050,1551938,47810.0,한국항공우주산업보통주
11980,47810,2020-03-24,0.0886850152905198,16350,17800,1450,573719,47810.0,한국항공우주산업보통주
11981,47810,2020-03-23,0.0916666666666666,18000,16350,-1650,984506,47810.0,한국항공우주산업보통주
11982,47810,2020-03-20,0.0975609756097561,16400,18000,1600,872172,47810.0,한국항공우주산업보통주
11983,47810,2020-03-19,0.1182795698924731,18600,16400,-2200,1294787,47810.0,한국항공우주산업보통주
11984,47810,2020-03-18,0.0558375634517766,19700,18600,-1100,645476,47810.0,한국항공우주산업보통주
11985,47810,2020-03-13,0.0644444444444444,22500,21050,-1450,1151590,47810.0,한국항공우주산업보통주
11986,47810,2020-03-12,0.0585774058577405,23900,22500,-1400,854536,47810.0,한국항공우주산업보통주
11987,47810,2020-03-09,0.048169556840077,25950,24700,-1250,475175,47810.0,한국항공우주산업보통주
11988,47810,2020-02-28,0.0517560073937153,27050,25650,-1400,1135203,47810.0,한국항공우주산업보통주
11989,47810,2020-02-24,0.0556521739130434,28750,27150,-1600,689537,47810.0,한국항공우주산업보통주
11990,47810,2019-09-24,0.048780487804878,41000,39000,-2000,1143727,47810.0,한국항공우주산업보통주
11991,47810,2019-09-04,0.0463659147869674,39900,41750,1850,994768,47810.0,한국항공우주산업보통주
11992,47810,2019-08-08,0.0450704225352112,35500,37100,1600,826625,47810.0,한국항공우주산업보통주
11993,47810,2019-07-30,0.0413105413105413,35100,36550,1450,959873,47810.0,한국항공우주산업보통주
11994,47810,2019-07-16,0.0426470588235294,34000,35450,1450,373872,47810.0,한국항공우주산업보통주
11995,47810,2019-05-03,0.0707213578500707,35350,32850,-2500,1621207,47810.0,한국항공우주산업보통주
11996,47810,2019-02-14,0.0554722638680659,33350,35200,1850,1897778,47810.0,한국항공우주산업보통주
11997,47810,2018-11-19,0.0678513731825525,30950,33050,2100,1585861,47810.0,한국항공우주산업보통주
11998,47810,2018-11-15,0.0567484662576687,32600,30750,-1850,2595791,47810.0,한국항공우주산업보통주
11999,47810,2018-11-02,0.0546075085324232,29300,30900,1600,738506,47810.0,한국항공우주산업보통주
12000,47810,2018-10-11,0.0511627906976744,32250,30600,-1650,1708254,47810.0,한국항공우주산업보통주
12001,47810,2018-10-01,0.0527065527065527,35100,33250,-1850,6405737,47810.0,한국항공우주산업보통주
12002,47810,2018-09-28,0.298,50000,35100,-14900,13510259,47810.0,한국항공우주산업보통주
12003,47810,2018-09-27,0.081081081081081,46250,50000,3750,3044692,47810.0,한국항공우주산업보통주
12004,47810,2018-08-17,0.0433070866141732,38100,39750,1650,1293668,47810.0,한국항공우주산업보통주
12005,47810,2018-07-19,0.0653120464441219,34450,32200,-2250,3768499,47810.0,한국항공우주산업보통주
12006,47810,2018-07-18,0.0934210526315789,38000,34450,-3550,4119910,47810.0,한국항공우주산업보통주
12007,47810,2018-07-13,0.0545905707196029,40300,38100,-2200,3009444,47810.0,한국항공우주산업보통주
12008,47810,2018-07-11,0.0651162790697674,43000,40200,-2800,8817167,47810.0,한국항공우주산업보통주
12009,47810,2018-06-20,0.0517435320584926,44450,42150,-2300,1491938,47810.0,한국항공우주산업보통주
12010,47810,2018-06-07,0.0743243243243243,44400,47700,3300,1701333,47810.0,한국항공우주산업보통주
12011,47810,2018-05-29,0.0448275862068965,43500,45450,1950,1126529,47810.0,한국항공우주산업보통주
12012,47810,2018-05-10,0.0485327313769751,44300,42150,-2150,999401,47810.0,한국항공우주산업보통주
12013,47810,2018-05-04,0.0645539906103286,42600,45350,2750,1240485,47810.0,한국항공우주산업보통주
12014,47810,2018-05-02,0.042824074074074,43200,41350,-1850,1060746,47810.0,한국항공우주산업보통주
12015,47810,2018-04-30,0.0431893687707641,45150,43200,-1950,951630,47810.0,한국항공우주산업보통주
12016,47810,2018-03-23,0.045631067961165,51500,49150,-2350,830126,47810.0,한국항공우주산업보통주
12017,47810,2018-03-21,0.0669371196754563,49300,52600,3300,1948321,47810.0,한국항공우주산업보통주
12018,47810,2018-03-12,0.0404145077720207,48250,50200,1950,478997,47810.0,한국항공우주산업보통주
12019,47810,2018-02-19,0.0537056928034371,46550,49050,2500,903051,47810.0,한국항공우주산업보통주
12020,47810,2018-01-17,0.0607843137254901,51000,54100,3100,2386198,47810.0,한국항공우주산업보통주
12021,47810,2018-01-16,0.0602910602910602,48100,51000,2900,1040424,47810.0,한국항공우주산업보통주
12022,47810,2017-12-08,0.0543032786885245,48800,46150,-2650,1342291,47810.0,한국항공우주산업보통주
12023,47810,2017-11-16,0.0534653465346534,50500,53200,2700,1083343,47810.0,한국항공우주산업보통주
12024,47810,2017-11-13,0.0453686200378071,52900,50500,-2400,1562566,47810.0,한국항공우주산업보통주
12025,47810,2017-10-24,0.0458553791887125,56700,54100,-2600,1942534,47810.0,한국항공우주산업보통주
12026,47810,2017-10-19,0.1781970649895178,47700,56200,8500,6381889,47810.0,한국항공우주산업보통주
12027,47810,2017-10-10,0.091533180778032,43700,47700,4000,2181642,47810.0,한국항공우주산업보통주
12028,47810,2017-09-21,0.0584415584415584,46200,43500,-2700,1803887,47810.0,한국항공우주산업보통주
12029,47810,2017-09-07,0.0804195804195804,42900,46350,3450,2019094,47810.0,한국항공우주산업보통주
12030,47810,2017-08-28,0.0588235294117647,43350,45900,2550,3131464,47810.0,한국항공우주산업보통주
12031,47810,2017-08-25,0.044578313253012,41500,43350,1850,2389239,47810.0,한국항공우주산업보통주
12032,47810,2017-08-16,0.1612466124661246,36900,42850,5950,10090088,47810.0,한국항공우주산업보통주
12033,47810,2017-08-14,0.0452781371280724,38650,36900,-1750,3327931,47810.0,한국항공우주산업보통주
12034,47810,2017-08-07,0.0487179487179487,39000,40900,1900,3811337,47810.0,한국항공우주산업보통주
12035,47810,2017-08-03,0.1210045662100456,43800,38500,-5300,10303863,47810.0,한국항공우주산업보통주
12036,47810,2017-08-02,0.1657142857142857,52500,43800,-8700,4726187,47810.0,한국항공우주산업보통주
12037,47810,2017-07-19,0.0469238790406673,47950,50200,2250,3387718,47810.0,한국항공우주산업보통주
12038,47810,2017-07-18,0.0598039215686274,51000,47950,-3050,5613751,47810.0,한국항공우주산업보통주
12039,47810,2017-07-17,0.1145833333333333,57600,51000,-6600,4510461,47810.0,한국항공우주산업보통주
12040,47810,2017-07-14,0.0557377049180327,61000,57600,-3400,2611346,47810.0,한국항공우주산업보통주
12041,47810,2017-04-18,0.0578947368421052,57000,60300,3300,1370057,47810.0,한국항공우주산업보통주
12042,47810,2017-02-03,0.0658499234303215,65300,61000,-4300,2205497,47810.0,한국항공우주산업보통주
12043,47810,2017-02-02,0.0431309904153354,62600,65300,2700,697098,47810.0,한국항공우주산업보통주
12044,47810,2016-12-12,0.0552147239263803,65200,68800,3600,599067,47810.0,한국항공우주산업보통주
12045,47810,2016-11-17,0.0615384615384615,65000,69000,4000,851685,47810.0,한국항공우주산업보통주
12046,47810,2016-11-15,0.065406976744186,68800,64300,-4500,1098940,47810.0,한국항공우주산업보통주
12047,47810,2016-11-10,0.1109375,64000,71100,7100,2052261,47810.0,한국항공우주산업보통주
12048,47810,2016-11-02,0.0530546623794212,62200,58900,-3300,1753310,47810.0,한국항공우주산업보통주
12049,47810,2016-11-01,0.0401234567901234,64800,62200,-2600,1051006,47810.0,한국항공우주산업보통주
12050,47810,2016-10-31,0.0456553755522827,67900,64800,-3100,705888,47810.0,한국항공우주산업보통주
12051,47810,2016-10-26,0.0482758620689655,72500,69000,-3500,936590,47810.0,한국항공우주산업보통주
12052,47810,2016-10-13,0.0503875968992248,77400,73500,-3900,1113560,47810.0,한국항공우주산업보통주
12053,47810,2016-09-23,0.0471014492753623,82800,78900,-3900,1868863,47810.0,한국항공우주산업보통주
12054,47810,2016-08-30,0.0744010088272383,79300,85200,5900,1591023,47810.0,한국항공우주산업보통주
12055,51600,2021-06-01,0.0466883821932681,46050,43900,-2150,841591,51600.0,한전KPS 보통주
12056,51600,2021-05-26,0.0955882352941176,40800,44700,3900,1344903,51600.0,한전KPS 보통주
12057,51600,2021-05-20,0.0485678704856787,40150,42100,1950,1088713,51600.0,한전KPS 보통주
12058,51600,2021-05-18,0.0401554404145077,38600,40150,1550,1006648,51600.0,한전KPS 보통주
12059,51600,2021-05-13,0.0919540229885057,34800,38000,3200,1253531,51600.0,한전KPS 보통주
12060,51600,2021-04-23,0.0430555555555555,36000,34450,-1550,672203,51600.0,한전KPS 보통주
12061,51600,2021-04-22,0.0541727672035139,34150,36000,1850,1300001,51600.0,한전KPS 보통주
12062,51600,2021-04-19,0.0402777777777777,36000,34550,-1450,675357,51600.0,한전KPS 보통주
12063,51600,2021-04-15,0.0506512301013024,34550,36300,1750,1017518,51600.0,한전KPS 보통주
12064,51600,2020-12-29,0.0512820512820512,31200,29600,-1600,654841,51600.0,한전KPS 보통주
12065,51600,2020-12-18,0.0462809917355371,30250,31650,1400,1462255,51600.0,한전KPS 보통주
12066,51600,2020-08-11,0.0524534686971235,29550,31100,1550,801517,51600.0,한전KPS 보통주
12067,51600,2020-06-16,0.0426621160409556,29300,30550,1250,226565,51600.0,한전KPS 보통주
12068,51600,2020-06-15,0.0487012987012987,30800,29300,-1500,262705,51600.0,한전KPS 보통주
12069,51600,2020-04-16,0.0458715596330275,32700,31200,-1500,248249,51600.0,한전KPS 보통주
12070,51600,2020-04-07,0.0527156549520766,31300,32950,1650,202659,51600.0,한전KPS 보통주
12071,51600,2020-04-06,0.0415973377703826,30050,31300,1250,139011,51600.0,한전KPS 보통주
12072,51600,2020-04-02,0.051056338028169,28400,29850,1450,173681,51600.0,한전KPS 보통주
12073,51600,2020-03-27,0.0452961672473867,28700,30000,1300,222623,51600.0,한전KPS 보통주
12074,51600,2020-03-26,0.0493601462522851,27350,28700,1350,264029,51600.0,한전KPS 보통주
12075,51600,2020-03-25,0.058027079303675,25850,27350,1500,219641,51600.0,한전KPS 보통주
12076,51600,2020-03-24,0.0444444444444444,24750,25850,1100,228585,51600.0,한전KPS 보통주
12077,51600,2020-03-23,0.0799256505576208,26900,24750,-2150,275575,51600.0,한전KPS 보통주
12078,51600,2020-03-19,0.0652557319223985,28350,26500,-1850,291425,51600.0,한전KPS 보통주
12079,51600,2020-03-12,0.0497667185069984,32150,30550,-1600,245405,51600.0,한전KPS 보통주
12080,51600,2020-01-30,0.0467762326169405,39550,37700,-1850,227864,51600.0,한전KPS 보통주
12081,51600,2019-10-10,0.0469897209985315,34050,32450,-1600,273704,51600.0,한전KPS 보통주
12082,51600,2019-06-25,0.0486322188449848,32900,31300,-1600,308720,51600.0,한전KPS 보통주
12083,51600,2019-05-20,0.0402476780185758,32300,31000,-1300,279183,51600.0,한전KPS 보통주
12084,51600,2019-05-15,0.0690161527165932,34050,31700,-2350,476260,51600.0,한전KPS 보통주
12085,51600,2019-04-29,0.0594900849858356,35300,37400,2100,398155,51600.0,한전KPS 보통주
12086,51600,2019-02-18,0.0625931445603576,33550,35650,2100,649765,51600.0,한전KPS 보통주
12087,51600,2019-01-30,0.0645669291338582,31750,33800,2050,352503,51600.0,한전KPS 보통주
12088,51600,2019-01-14,0.0460829493087557,32550,34050,1500,281541,51600.0,한전KPS 보통주
12089,51600,2019-01-04,0.0551181102362204,31750,33500,1750,348167,51600.0,한전KPS 보통주
12090,51600,2018-12-18,0.0645645645645645,33300,35450,2150,626793,51600.0,한전KPS 보통주
12091,51600,2018-11-26,0.0442176870748299,29400,30700,1300,518550,51600.0,한전KPS 보통주
12092,51600,2018-11-15,0.0506566604127579,26650,28000,1350,362811,51600.0,한전KPS 보통주
12093,51600,2018-11-02,0.0407407407407407,27000,28100,1100,208095,51600.0,한전KPS 보통주
12094,51600,2018-09-18,0.0472222222222222,36000,34300,-1700,238407,51600.0,한전KPS 보통주
12095,51600,2018-07-06,0.0443425076452599,32700,34150,1450,214137,51600.0,한전KPS 보통주
12096,51600,2018-07-02,0.0715287517531556,35650,33100,-2550,472426,51600.0,한전KPS 보통주
12097,51600,2018-06-25,0.0436619718309859,35500,37050,1550,274681,51600.0,한전KPS 보통주
12098,51600,2018-06-18,0.0689655172413793,39150,36450,-2700,439700,51600.0,한전KPS 보통주
12099,51600,2018-05-29,0.0476190476190476,43050,41000,-2050,395687,51600.0,한전KPS 보통주
12100,51600,2018-05-28,0.0436363636363636,41250,43050,1800,275751,51600.0,한전KPS 보통주
12101,51600,2018-05-03,0.1558823529411764,51000,43050,-7950,1535065,51600.0,한전KPS 보통주
12102,51600,2018-04-19,0.0648351648351648,45500,48450,2950,526149,51600.0,한전KPS 보통주
12103,51600,2018-04-04,0.053030303030303,46200,43750,-2450,247710,51600.0,한전KPS 보통주
12104,51600,2018-03-28,0.043103448275862,46400,44400,-2000,178906,51600.0,한전KPS 보통주
12105,51600,2018-03-19,0.0439684329199549,44350,46300,1950,499627,51600.0,한전KPS 보통주
12106,51600,2018-03-15,0.0423529411764705,42500,44300,1800,340293,51600.0,한전KPS 보통주
12107,51600,2018-02-05,0.0426309378806333,41050,39300,-1750,189551,51600.0,한전KPS 보통주
12108,51600,2018-01-10,0.0455136540962288,38450,40200,1750,292867,51600.0,한전KPS 보통주
12109,51600,2017-12-21,0.0406698564593301,41800,40100,-1700,178242,51600.0,한전KPS 보통주
12110,51600,2017-11-24,0.0453333333333333,37500,39200,1700,252730,51600.0,한전KPS 보통주
12111,51600,2017-11-09,0.0442583732057416,41800,39950,-1850,658435,51600.0,한전KPS 보통주
12112,51600,2017-10-23,0.0646221248630887,45650,42700,-2950,500913,51600.0,한전KPS 보통주
12113,51600,2017-09-27,0.0424469413233458,40050,41750,1700,183839,51600.0,한전KPS 보통주
12114,51600,2017-08-01,0.0455555555555555,45000,47050,2050,365606,51600.0,한전KPS 보통주
12115,51600,2017-07-26,0.041860465116279,43000,44800,1800,218515,51600.0,한전KPS 보통주
12116,51600,2017-07-14,0.0841750841750841,44550,40800,-3750,880270,51600.0,한전KPS 보통주
12117,51600,2017-06-19,0.0567307692307692,52000,49050,-2950,612368,51600.0,한전KPS 보통주
12118,51600,2017-05-04,0.0407079646017699,56500,58800,2300,175757,51600.0,한전KPS 보통주
12119,51600,2017-03-22,0.0449826989619377,57800,60400,2600,209676,51600.0,한전KPS 보통주
12120,51600,2017-03-07,0.048172757475083,60200,63100,2900,280066,51600.0,한전KPS 보통주
12121,51600,2017-02-24,0.042031523642732,57100,59500,2400,796422,51600.0,한전KPS 보통주
12122,51600,2016-12-12,0.0427046263345195,56200,58600,2400,157360,51600.0,한전KPS 보통주
12123,51600,2016-11-17,0.0646853146853146,57200,60900,3700,198963,51600.0,한전KPS 보통주
12124,51600,2016-10-21,0.0420475319926873,54700,57000,2300,1032565,51600.0,한전KPS 보통주
12125,51600,2016-10-07,0.0427807486631016,56100,53700,-2400,271375,51600.0,한전KPS 보통주
12126,51600,2016-09-22,0.0402576489533011,62100,59600,-2500,301506,51600.0,한전KPS 보통주
12127,51600,2016-08-19,0.0488505747126436,69600,66200,-3400,180420,51600.0,한전KPS 보통주
12128,51900,2021-04-23,0.0471821756225425,1526000,1598000,72000,88636,51900.0,LG생활건강보통주
12129,51900,2021-01-25,0.0729833546734955,1562000,1676000,114000,111499,51900.0,LG생활건강보통주
12130,51900,2020-08-21,0.042,1500000,1563000,63000,36757,51900.0,LG생활건강보통주
12131,51900,2020-08-18,0.0415335463258785,1565000,1500000,-65000,50554,51900.0,LG생활건강보통주
12132,51900,2020-08-11,0.0885813148788927,1445000,1573000,128000,93232,51900.0,LG생활건강보통주
12133,51900,2020-07-21,0.048448145344436,1321000,1385000,64000,77971,51900.0,LG생활건강보통주
12134,51900,2020-06-26,0.0469851213782302,1277000,1337000,60000,48453,51900.0,LG생활건강보통주
12135,51900,2020-06-25,0.0505576208178438,1345000,1277000,-68000,45849,51900.0,LG생활건강보통주
12136,51900,2020-06-23,0.0450949367088607,1264000,1321000,57000,52597,51900.0,LG생활건강보통주
12137,51900,2020-06-15,0.0415094339622641,1325000,1270000,-55000,47831,51900.0,LG생활건강보통주
12138,51900,2020-04-23,0.0800299177262528,1337000,1444000,107000,148170,51900.0,LG생활건강보통주
12139,51900,2020-04-17,0.0486985726280436,1191000,1249000,58000,62084,51900.0,LG생활건강보통주
12140,51900,2020-04-06,0.0506872852233677,1164000,1223000,59000,60263,51900.0,LG생활건강보통주
12141,51900,2020-04-02,0.0597572362278244,1071000,1135000,64000,56498,51900.0,LG생활건강보통주
12142,51900,2020-04-01,0.04375,1120000,1071000,-49000,66300,51900.0,LG생활건강보통주
12143,51900,2020-03-24,0.073170731707317,1066000,1144000,78000,69628,51900.0,LG생활건강보통주
12144,51900,2020-03-16,0.043859649122807,1140000,1090000,-50000,66839,51900.0,LG생활건강보통주
12145,51900,2020-03-12,0.0476190476190476,1218000,1160000,-58000,89277,51900.0,LG생활건강보통주
12146,51900,2020-02-24,0.063049853372434,1364000,1278000,-86000,67766,51900.0,LG생활건강보통주
12147,51900,2020-01-28,0.0711638250555967,1349000,1253000,-96000,98803,51900.0,LG생활건강보통주
12148,51900,2020-01-13,0.0454206999255398,1343000,1404000,61000,49449,51900.0,LG생활건강보통주
12149,51900,2020-01-07,0.0752602081665332,1249000,1343000,94000,62787,51900.0,LG생활건강보통주
12150,51900,2019-10-08,0.0434782608695652,1265000,1320000,55000,43337,51900.0,LG생활건강보통주
12151,51900,2019-09-03,0.0476595744680851,1175000,1231000,56000,43123,51900.0,LG생활건강보통주
12152,51900,2019-07-26,0.0642201834862385,1308000,1224000,-84000,77045,51900.0,LG생활건강보통주
12153,51900,2019-03-13,0.040912667191188,1271000,1323000,52000,45163,51900.0,LG생활건강보통주
12154,51900,2019-02-20,0.0547385620915032,1224000,1291000,67000,57740,51900.0,LG생활건강보통주
12155,51900,2019-01-30,0.044776119402985,1206000,1260000,54000,50277,51900.0,LG생활건강보통주
12156,51900,2019-01-25,0.0552631578947368,1140000,1203000,63000,78685,51900.0,LG생활건강보통주
12157,51900,2019-01-15,0.043557168784029,1102000,1150000,48000,44161,51900.0,LG생활건강보통주
12158,51900,2018-11-15,0.0768518518518518,1080000,1163000,83000,55402,51900.0,LG생활건강보통주
12159,51900,2018-11-09,0.0480274442538593,1166000,1110000,-56000,77679,51900.0,LG생활건강보통주
12160,51900,2018-11-01,0.0871647509578544,1044000,1135000,91000,64566,51900.0,LG생활건강보통주
12161,51900,2018-10-29,0.053393665158371,1105000,1046000,-59000,45211,51900.0,LG생활건강보통주
12162,51900,2018-10-25,0.0410958904109589,1095000,1140000,45000,73811,51900.0,LG생활건강보통주
12163,51900,2018-10-12,0.0620821394460362,1047000,1112000,65000,67214,51900.0,LG생활건강보통주
12164,51900,2018-10-11,0.081578947368421,1140000,1047000,-93000,85540,51900.0,LG생활건강보통주
12165,51900,2018-10-10,0.042016806722689,1190000,1140000,-50000,37869,51900.0,LG생활건강보통주
12166,51900,2018-10-04,0.07710100231303,1297000,1197000,-100000,65853,51900.0,LG생활건강보통주
12167,51900,2018-09-27,0.0492610837438423,1218000,1278000,60000,47830,51900.0,LG생활건강보통주
12168,51900,2018-09-14,0.0516074450084602,1182000,1243000,61000,35288,51900.0,LG생활건강보통주
12169,51900,2018-08-23,0.0521008403361344,1190000,1252000,62000,55157,51900.0,LG생활건강보통주
12170,51900,2018-08-01,0.0429752066115702,1210000,1262000,52000,50303,51900.0,LG생활건강보통주
12171,51900,2018-07-25,0.0555972952667167,1331000,1257000,-74000,79239,51900.0,LG생활건강보통주
12172,51900,2018-07-24,0.0455616653574234,1273000,1331000,58000,44286,51900.0,LG생활건강보통주
12173,51900,2018-07-10,0.0402684563758389,1341000,1287000,-54000,46498,51900.0,LG생활건강보통주
12174,51900,2018-07-03,0.0450643776824034,1398000,1335000,-63000,84971,51900.0,LG생활건강보통주
12175,51900,2018-06-20,0.049680624556423,1409000,1479000,70000,33455,51900.0,LG생활건강보통주
12176,51900,2018-05-24,0.0513643659711075,1246000,1310000,64000,27795,51900.0,LG생활건강보통주
12177,51900,2018-05-03,0.056115107913669,1390000,1312000,-78000,22844,51900.0,LG생활건강보통주
12178,51900,2018-04-30,0.0562837316885119,1297000,1370000,73000,42548,51900.0,LG생활건강보통주
12179,51900,2018-03-08,0.0407407407407407,1080000,1124000,44000,55455,51900.0,LG생활건강보통주
12180,51900,2018-01-24,0.043261231281198,1202000,1150000,-52000,140552,51900.0,LG생활건강보통주
12181,51900,2018-01-10,0.0644599303135888,1148000,1222000,74000,53136,51900.0,LG생활건강보통주
12182,51900,2017-10-26,0.0595026642984014,1126000,1193000,67000,75956,51900.0,LG생활건강보통주
12183,51900,2017-10-24,0.0649717514124293,1062000,1131000,69000,63698,51900.0,LG생활건강보통주
12184,51900,2017-10-13,0.0451282051282051,975000,1019000,44000,67005,51900.0,LG생활건강보통주
12185,51900,2017-09-29,0.0493273542600896,892000,936000,44000,64022,51900.0,LG생활건강보통주
12186,51900,2017-09-22,0.0502232142857142,896000,851000,-45000,61567,51900.0,LG생활건강보통주
12187,51900,2017-05-04,0.0776470588235294,850000,916000,66000,77210,51900.0,LG생활건강보통주
12188,51900,2017-04-17,0.0446428571428571,784000,819000,35000,45294,51900.0,LG생활건강보통주
12189,51900,2017-03-03,0.0821759259259259,864000,793000,-71000,130170,51900.0,LG생활건강보통주
12190,51900,2017-01-02,0.0466744457409568,857000,817000,-40000,39687,51900.0,LG생활건강보통주
12191,51900,2016-10-31,0.0442890442890442,858000,820000,-38000,58560,51900.0,LG생활건강보통주
12192,51900,2016-10-25,0.0834236186348862,923000,846000,-77000,236944,51900.0,LG생활건강보통주
12193,51900,2016-10-07,0.054140127388535,942000,891000,-51000,98516,51900.0,LG생활건강보통주
12194,51900,2016-09-29,0.0442655935613682,994000,950000,-44000,88348,51900.0,LG생활건강보통주
12195,51900,2016-08-23,0.0646551724137931,928000,988000,60000,100777,51900.0,LG생활건강보통주
12196,51900,2016-08-05,0.0446521287642783,963000,920000,-43000,106934,51900.0,LG생활건강보통주
12197,51905,2021-01-28,0.0405405405405405,740000,710000,-30000,11316,51905.0,LG생활건강1우선주
12198,51905,2021-01-25,0.0578279266572637,709000,750000,41000,28681,51905.0,LG생활건강1우선주
12199,51905,2020-08-18,0.067774936061381,782000,729000,-53000,6007,51905.0,LG생활건강1우선주
12200,51905,2020-08-11,0.0410958904109589,730000,760000,30000,15554,51905.0,LG생활건강1우선주
12201,51905,2020-06-30,0.0507246376811594,690000,725000,35000,9372,51905.0,LG생활건강1우선주
12202,51905,2020-06-15,0.0569877883310719,737000,695000,-42000,6771,51905.0,LG생활건강1우선주
12203,51905,2020-05-04,0.0495867768595041,726000,690000,-36000,9679,51905.0,LG생활건강1우선주
12204,51905,2020-04-23,0.0598885793871866,718000,761000,43000,9100,51905.0,LG생활건강1우선주
12205,51905,2020-04-17,0.0465116279069767,645000,675000,30000,4922,51905.0,LG생활건강1우선주
12206,51905,2020-04-06,0.0404984423676012,642000,668000,26000,7903,51905.0,LG생활건강1우선주
12207,51905,2020-03-13,0.0463215258855585,734000,700000,-34000,10398,51905.0,LG생활건강1우선주
12208,51905,2020-03-12,0.064968152866242,785000,734000,-51000,5401,51905.0,LG생활건강1우선주
12209,51905,2020-02-28,0.0541935483870967,775000,733000,-42000,4639,51905.0,LG생활건강1우선주
12210,51905,2020-02-24,0.0609756097560975,820000,770000,-50000,2438,51905.0,LG생활건강1우선주
12211,51905,2020-01-29,0.0504774897680764,733000,770000,37000,2783,51905.0,LG생활건강1우선주
12212,51905,2020-01-28,0.0905707196029776,806000,733000,-73000,3148,51905.0,LG생활건강1우선주
12213,51905,2020-01-21,0.0554899645808736,847000,800000,-47000,2119,51905.0,LG생활건강1우선주
12214,51905,2020-01-13,0.0544993662864385,789000,832000,43000,2930,51905.0,LG생활건강1우선주
12215,51905,2020-01-07,0.0457516339869281,765000,800000,35000,5105,51905.0,LG생활건강1우선주
12216,51905,2019-08-06,0.04,775000,744000,-31000,3088,51905.0,LG생활건강1우선주
12217,51905,2019-07-31,0.0414507772020725,772000,804000,32000,2832,51905.0,LG생활건강1우선주
12218,51905,2019-07-26,0.0624235006119951,817000,766000,-51000,2011,51905.0,LG생활건강1우선주
12219,51905,2019-06-04,0.0585831062670299,734000,777000,43000,5855,51905.0,LG생활건강1우선주
12220,51905,2019-05-09,0.064968152866242,785000,734000,-51000,1861,51905.0,LG생활건강1우선주
12221,51905,2019-03-15,0.0645994832041343,774000,824000,50000,3126,51905.0,LG생활건강1우선주
12222,51905,2019-02-20,0.0439093484419263,706000,737000,31000,3350,51905.0,LG생활건강1우선주
12223,51905,2018-11-30,0.0428571428571428,700000,670000,-30000,4608,51905.0,LG생활건강1우선주
12224,51905,2018-11-01,0.0587431693989071,732000,689000,-43000,2214,51905.0,LG생활건강1우선주
12225,51905,2018-10-31,0.1656050955414012,628000,732000,104000,2754,51905.0,LG생활건강1우선주
12226,51905,2018-10-12,0.054628224582701,659000,695000,36000,2544,51905.0,LG생활건강1우선주
12227,51905,2018-10-11,0.0757363253856942,713000,659000,-54000,3877,51905.0,LG생활건강1우선주
12228,51905,2018-10-05,0.0683544303797468,790000,736000,-54000,6680,51905.0,LG생활건강1우선주
12229,51905,2018-10-01,0.0485074626865671,804000,843000,39000,6019,51905.0,LG생활건강1우선주
12230,51905,2018-09-27,0.046875,768000,804000,36000,3526,51905.0,LG생활건강1우선주
12231,51905,2018-08-23,0.0439393939393939,660000,689000,29000,1295,51905.0,LG생활건강1우선주
12232,51905,2018-07-25,0.040787623066104,711000,682000,-29000,1172,51905.0,LG생활건강1우선주
12233,51905,2018-07-19,0.0480109739368998,729000,694000,-35000,1094,51905.0,LG생활건강1우선주
12234,51905,2018-07-13,0.0499286733238231,701000,736000,35000,990,51905.0,LG생활건강1우선주
12235,51905,2018-06-20,0.0534979423868312,729000,768000,39000,3382,51905.0,LG생활건강1우선주
12236,51905,2018-05-03,0.0412371134020618,776000,744000,-32000,1072,51905.0,LG생활건강1우선주
12237,51905,2018-04-02,0.043175487465181,718000,749000,31000,1426,51905.0,LG생활건강1우선주
12238,51905,2018-02-19,0.0553745928338762,614000,648000,34000,1307,51905.0,LG생활건강1우선주
12239,51905,2018-01-24,0.0438472418670438,707000,676000,-31000,3694,51905.0,LG생활건강1우선주
12240,51905,2018-01-10,0.0480349344978165,687000,720000,33000,2011,51905.0,LG생활건강1우선주
12241,51905,2017-10-10,0.0702341137123745,598000,640000,42000,4971,51905.0,LG생활건강1우선주
12242,51905,2017-05-08,0.05,580000,609000,29000,5874,51905.0,LG생활건강1우선주
12243,51905,2017-05-04,0.0760667903525046,539000,580000,41000,5861,51905.0,LG생활건강1우선주
12244,51905,2017-03-03,0.0789473684210526,570000,525000,-45000,6256,51905.0,LG생활건강1우선주
12245,51905,2017-02-10,0.0438095238095238,525000,548000,23000,3903,51905.0,LG생활건강1우선주
12246,51905,2017-01-06,0.0457142857142857,525000,549000,24000,3501,51905.0,LG생활건강1우선주
12247,51905,2017-01-04,0.0525291828793774,514000,541000,27000,3268,51905.0,LG생활건강1우선주
12248,51905,2017-01-02,0.0888099467140319,563000,513000,-50000,4304,51905.0,LG생활건강1우선주
12249,51905,2016-11-11,0.0418326693227091,502000,481000,-21000,4566,51905.0,LG생활건강1우선주
12250,51905,2016-10-26,0.0494252873563218,435000,456500,21500,12413,51905.0,LG생활건강1우선주
12251,51905,2016-10-25,0.0512540894220283,458500,435000,-23500,19526,51905.0,LG생활건강1우선주
12252,51905,2016-10-05,0.0451923076923076,520000,496500,-23500,6107,51905.0,LG생활건강1우선주
12253,51905,2016-09-08,0.0476190476190476,525000,550000,25000,7855,51905.0,LG생활건강1우선주
12254,51905,2016-08-31,0.0595903165735568,537000,569000,32000,9777,51905.0,LG생활건강1우선주
12255,51905,2016-08-23,0.0684931506849315,511000,546000,35000,6129,51905.0,LG생활건강1우선주
12256,51905,2016-08-05,0.0533088235294117,544000,515000,-29000,20064,51905.0,LG생활건강1우선주
12257,51910,2021-05-26,0.0672645739910313,892000,832000,-60000,760533,51910.0,LG화학보통주
12258,51910,2021-05-12,0.0526893523600439,911000,863000,-48000,494315,51910.0,LG화학보통주
12259,51910,2021-04-29,0.0685393258426966,890000,951000,61000,1405704,51910.0,LG화학보통주
12260,51910,2021-04-13,0.0624235006119951,817000,868000,51000,713786,51910.0,LG화학보통주
12261,51910,2021-03-16,0.077639751552795,966000,891000,-75000,941008,51910.0,LG화학보통주
12262,51910,2021-03-11,0.0538720538720538,891000,939000,48000,601480,51910.0,LG화학보통주
12263,51910,2021-03-05,0.0450867052023121,865000,904000,39000,548940,51910.0,LG화학보통주
12264,51910,2021-03-02,0.0722021660649819,831000,891000,60000,697301,51910.0,LG화학보통주
12265,51910,2021-02-26,0.0662921348314606,890000,831000,-59000,656689,51910.0,LG화학보통주
12266,51910,2021-01-07,0.0808988764044943,890000,962000,72000,706912,51910.0,LG화학보통주
12267,51910,2021-01-04,0.078883495145631,824000,889000,65000,858451,51910.0,LG화학보통주
12268,51910,2020-11-24,0.0681818181818181,748000,799000,51000,858347,51910.0,LG화학보통주
12269,51910,2020-11-10,0.0435967302452316,734000,702000,-32000,563688,51910.0,LG화학보통주
12270,51910,2020-11-06,0.0635155096011816,677000,720000,43000,1268197,51910.0,LG화학보통주
12271,51910,2020-11-05,0.0415384615384615,650000,677000,27000,446583,51910.0,LG화학보통주
12272,51910,2020-11-03,0.0529695024077046,623000,656000,33000,638480,51910.0,LG화학보통주
12273,51910,2020-10-30,0.0614439324116743,651000,611000,-40000,820454,51910.0,LG화학보통주
12274,51910,2020-10-13,0.0416666666666666,672000,644000,-28000,678451,51910.0,LG화학보통주
12275,51910,2020-09-29,0.0447284345047923,626000,654000,28000,677451,51910.0,LG화학보통주
12276,51910,2020-09-21,0.0585585585585585,666000,627000,-39000,1239438,51910.0,LG화학보통주
12277,51910,2020-09-17,0.0611353711790393,687000,645000,-42000,3408145,51910.0,LG화학보통주
12278,51910,2020-09-16,0.0537190082644628,726000,687000,-39000,958233,51910.0,LG화학보통주
12279,51910,2020-08-26,0.061711079943899,713000,757000,44000,1094918,51910.0,LG화학보통주
12280,51910,2020-08-21,0.047976011994003,667000,699000,32000,1078744,51910.0,LG화학보통주
12281,51910,2020-08-14,0.0502035278154681,737000,700000,-37000,1160403,51910.0,LG화학보통주
12282,51910,2020-08-11,0.0527777777777777,720000,758000,38000,1087515,51910.0,LG화학보통주
12283,51910,2020-08-07,0.0970588235294117,680000,746000,66000,1399982,51910.0,LG화학보통주
12284,51910,2020-08-05,0.043613707165109,642000,670000,28000,917661,51910.0,LG화학보통주
12285,51910,2020-08-03,0.1179577464788732,568000,635000,67000,1715295,51910.0,LG화학보통주
12286,51910,2020-07-31,0.0716981132075471,530000,568000,38000,1376453,51910.0,LG화학보통주
12287,51910,2020-07-09,0.0506822612085769,513000,539000,26000,819218,51910.0,LG화학보통주
12288,51910,2020-06-19,0.0427698574338085,491000,512000,21000,738862,51910.0,LG화학보통주
12289,51910,2020-06-16,0.139018691588785,428000,487500,59500,1156149,51910.0,LG화학보통주
12290,51910,2020-06-15,0.0735930735930736,462000,428000,-34000,851192,51910.0,LG화학보통주
12291,51910,2020-06-11,0.0522727272727272,440000,463000,23000,1250374,51910.0,LG화학보통주
12292,51910,2020-06-04,0.0424469413233458,400500,417500,17000,966577,51910.0,LG화학보통주
12293,51910,2020-05-27,0.0446859903381642,414000,395500,-18500,622426,51910.0,LG화학보통주
12294,51910,2020-05-26,0.0629011553273427,389500,414000,24500,958956,51910.0,LG화학보통주
12295,51910,2020-05-21,0.0413793103448275,362500,377500,15000,1033430,51910.0,LG화학보통주
12296,51910,2020-05-13,0.0414201183431952,338000,352000,14000,861294,51910.0,LG화학보통주
12297,51910,2020-05-04,0.0438247011952191,376500,360000,-16500,669179,51910.0,LG화학보통주
12298,51910,2020-04-17,0.0568513119533527,343000,362500,19500,753764,51910.0,LG화학보통주
12299,51910,2020-04-16,0.0505359877488514,326500,343000,16500,621763,51910.0,LG화학보통주
12300,51910,2020-04-07,0.042158516020236,296500,309000,12500,717617,51910.0,LG화학보통주
12301,51910,2020-04-01,0.0426229508196721,305000,292000,-13000,599459,51910.0,LG화학보통주
12302,51910,2020-03-25,0.0677083333333333,288000,307500,19500,803831,51910.0,LG화학보통주
12303,51910,2020-03-24,0.0746268656716417,268000,288000,20000,966345,51910.0,LG화학보통주
12304,51910,2020-03-20,0.1847826086956521,230000,272500,42500,1306067,51910.0,LG화학보통주
12305,51910,2020-03-19,0.1785714285714285,280000,230000,-50000,1394682,51910.0,LG화학보통주
12306,51910,2020-03-18,0.0864600326264274,306500,280000,-26500,946373,51910.0,LG화학보통주
12307,51910,2020-03-16,0.0822320117474302,340500,312500,-28000,747892,51910.0,LG화학보통주
12308,51910,2020-03-12,0.0643835616438356,365000,341500,-23500,1041370,51910.0,LG화학보통주
12309,51910,2020-03-09,0.065,400000,374000,-26000,611394,51910.0,LG화학보통주
12310,51910,2020-02-28,0.0515463917525773,388000,368000,-20000,643995,51910.0,LG화학보통주
12311,51910,2020-02-11,0.0684754521963824,387000,413500,26500,983089,51910.0,LG화학보통주
12312,51910,2020-02-04,0.0842857142857142,350000,379500,29500,995237,51910.0,LG화학보통주
12313,51910,2020-01-20,0.063063063063063,333000,354000,21000,556519,51910.0,LG화학보통주
12314,51910,2020-01-10,0.0603588907014681,306500,325000,18500,610981,51910.0,LG화학보통주
12315,51910,2019-12-04,0.0420032310177706,309500,296500,-13000,316394,51910.0,LG화학보통주
12316,51910,2019-09-25,0.0672782874617737,327000,305000,-22000,962072,51910.0,LG화학보통주
12317,51910,2019-08-14,0.046925566343042,309000,323500,14500,192588,51910.0,LG화학보통주
12318,51910,2019-08-05,0.0482654600301659,331500,315500,-16000,234602,51910.0,LG화학보통주
12319,51910,2019-07-25,0.0495049504950495,353500,336000,-17500,488905,51910.0,LG화학보통주
12320,51910,2019-03-21,0.0523415977961432,363000,382000,19000,422078,51910.0,LG화학보통주
12321,51910,2018-12-21,0.0421511627906976,344000,358500,14500,397305,51910.0,LG화학보통주
12322,51910,2018-12-03,0.0564399421128798,345500,365000,19500,327930,51910.0,LG화학보통주
12323,51910,2018-11-02,0.0560471976401179,339000,358000,19000,239187,51910.0,LG화학보통주
12324,51910,2018-10-26,0.0456553755522827,339500,324000,-15500,320435,51910.0,LG화학보통주
12325,51910,2018-10-19,0.0410094637223974,317000,330000,13000,241703,51910.0,LG화학보통주
12326,51910,2018-10-04,0.0665722379603399,353000,329500,-23500,487014,51910.0,LG화학보통주
12327,51910,2018-10-02,0.0420624151967435,368500,353000,-15500,271022,51910.0,LG화학보통주
12328,51910,2018-08-03,0.0426666666666666,375000,391000,16000,424377,51910.0,LG화학보통주
12329,51910,2018-07-25,0.0937972768532526,330500,361500,31000,1134542,51910.0,LG화학보통주
12330,51910,2018-07-02,0.047976011994003,333500,317500,-16000,370321,51910.0,LG화학보통주
12331,51910,2018-06-19,0.0463847203274215,366500,349500,-17000,295137,51910.0,LG화학보통주
12332,51910,2018-06-04,0.0771513353115727,337000,363000,26000,512468,51910.0,LG화학보통주
12333,51910,2018-05-02,0.0583333333333333,360000,339000,-21000,523971,51910.0,LG화학보통주
12334,51910,2018-04-25,0.0587449933244325,374500,352500,-22000,496231,51910.0,LG화학보통주
12335,51910,2018-03-28,0.0421836228287841,403000,386000,-17000,292609,51910.0,LG화학보통주
12336,51910,2018-03-09,0.0503875968992248,387000,406500,19500,364917,51910.0,LG화학보통주
12337,51910,2018-02-02,0.043010752688172,418500,400500,-18000,468545,51910.0,LG화학보통주
12338,51910,2018-01-08,0.0481481481481481,405000,424500,19500,321484,51910.0,LG화학보통주
12339,51910,2017-09-22,0.0514138817480719,389000,369000,-20000,568634,51910.0,LG화학보통주
12340,51910,2017-09-13,0.0448717948717948,390000,407500,17500,448119,51910.0,LG화학보통주
12341,51910,2017-09-11,0.0523489932885906,372500,392000,19500,337307,51910.0,LG화학보통주
12342,51910,2017-08-22,0.0401146131805157,349000,363000,14000,317416,51910.0,LG화학보통주
12343,51910,2017-08-04,0.0410334346504559,329000,342500,13500,509506,51910.0,LG화학보통주
12344,51910,2017-07-13,0.0484140233722871,299500,314000,14500,896560,51910.0,LG화학보통주
12345,51910,2017-03-21,0.0424028268551236,283000,295000,12000,526655,51910.0,LG화학보통주
12346,51910,2017-02-01,0.0400763358778625,262000,272500,10500,249084,51910.0,LG화학보통주
12347,51910,2017-01-11,0.0467289719626168,267500,280000,12500,559100,51910.0,LG화학보통주
12348,51910,2016-11-24,0.0639658848614072,234500,219500,-15000,808712,51910.0,LG화학보통주
12349,51910,2016-11-09,0.0415841584158415,252500,242000,-10500,472018,51910.0,LG화학보통주
12350,51910,2016-09-06,0.0580524344569288,267000,251500,-15500,773416,51910.0,LG화학보통주
12351,51915,2021-05-27,0.0465116279069767,387000,369000,-18000,94591,51915.0,LG화학1우선주
12352,51915,2021-05-26,0.0685920577617328,415500,387000,-28500,69977,51915.0,LG화학1우선주
12353,51915,2021-05-12,0.0465116279069767,430000,410000,-20000,30516,51915.0,LG화학1우선주
12354,51915,2021-05-03,0.0426487093153759,445500,426500,-19000,23346,51915.0,LG화학1우선주
12355,51915,2021-04-29,0.0592417061611374,422000,447000,25000,129711,51915.0,LG화학1우선주
12356,51915,2021-04-13,0.0435897435897435,390000,407000,17000,53901,51915.0,LG화학1우선주
12357,51915,2021-03-17,0.040764331210191,392500,376500,-16000,73718,51915.0,LG화학1우선주
12358,51915,2021-03-16,0.059880239520958,417500,392500,-25000,102618,51915.0,LG화학1우선주
12359,51915,2021-03-02,0.0513478818998716,389500,409500,20000,46025,51915.0,LG화학1우선주
12360,51915,2021-02-26,0.0614457831325301,415000,389500,-25500,69959,51915.0,LG화학1우선주
12361,51915,2021-02-23,0.040045766590389,437000,419500,-17500,40894,51915.0,LG화학1우선주
12362,51915,2021-01-11,0.0434782608695652,460000,480000,20000,195789,51915.0,LG화학1우선주
12363,51915,2021-01-08,0.1004784688995215,418000,460000,42000,173227,51915.0,LG화학1우선주
12364,51915,2021-01-07,0.0676883780332056,391500,418000,26500,145550,51915.0,LG화학1우선주
12365,51915,2020-12-22,0.0418781725888324,394000,377500,-16500,53502,51915.0,LG화학1우선주
12366,51915,2020-11-30,0.0429530201342281,372500,356500,-16000,99252,51915.0,LG화학1우선주
12367,51915,2020-11-06,0.045045045045045,333000,348000,15000,133013,51915.0,LG화학1우선주
12368,51915,2020-11-05,0.040625,320000,333000,13000,54426,51915.0,LG화학1우선주
12369,51915,2020-10-30,0.0432098765432098,324000,310000,-14000,61219,51915.0,LG화학1우선주
12370,51915,2020-10-15,0.0454545454545454,308000,322000,14000,84349,51915.0,LG화학1우선주
12371,51915,2020-10-12,0.0400593471810089,337000,323500,-13500,79260,51915.0,LG화학1우선주
12372,51915,2020-09-29,0.0683333333333333,300000,320500,20500,101992,51915.0,LG화학1우선주
12373,51915,2020-09-21,0.0726698262243285,316500,293500,-23000,196240,51915.0,LG화학1우선주
12374,51915,2020-09-17,0.0913043478260869,345000,313500,-31500,627821,51915.0,LG화학1우선주
12375,51915,2020-09-16,0.0547945205479452,365000,345000,-20000,132302,51915.0,LG화학1우선주
12376,51915,2020-08-31,0.0458015267175572,393000,375000,-18000,156130,51915.0,LG화학1우선주
12377,51915,2020-08-26,0.0469168900804289,373000,390500,17500,183692,51915.0,LG화학1우선주
12378,51915,2020-08-21,0.0841949778434268,338500,367000,28500,176030,51915.0,LG화학1우선주
12379,51915,2020-08-18,0.0552560646900269,371000,350500,-20500,185533,51915.0,LG화학1우선주
12380,51915,2020-08-14,0.0547770700636942,392500,371000,-21500,154943,51915.0,LG화학1우선주
12381,51915,2020-08-07,0.1518817204301075,372000,428500,56500,555242,51915.0,LG화학1우선주
12382,51915,2020-08-05,0.0676470588235294,340000,363000,23000,333709,51915.0,LG화학1우선주
12383,51915,2020-08-04,0.0932475884244373,311000,340000,29000,398884,51915.0,LG화학1우선주
12384,51915,2020-08-03,0.169172932330827,266000,311000,45000,469814,51915.0,LG화학1우선주
12385,51915,2020-07-16,0.0408163265306122,269500,258500,-11000,68313,51915.0,LG화학1우선주
12386,51915,2020-07-09,0.0446096654275092,269000,281000,12000,116361,51915.0,LG화학1우선주
12387,51915,2020-07-07,0.0405405405405405,259000,269500,10500,96897,51915.0,LG화학1우선주
12388,51915,2020-06-25,0.0402193784277879,273500,262500,-11000,89052,51915.0,LG화학1우선주
12389,51915,2020-06-19,0.0433962264150943,265000,276500,11500,214188,51915.0,LG화학1우선주
12390,51915,2020-06-16,0.1569086651053864,213500,247000,33500,283206,51915.0,LG화학1우선주
12391,51915,2020-06-15,0.0953389830508474,236000,213500,-22500,169002,51915.0,LG화학1우선주
12392,51915,2020-06-11,0.102803738317757,214000,236000,22000,321714,51915.0,LG화학1우선주
12393,51915,2020-06-10,0.0594059405940594,202000,214000,12000,112966,51915.0,LG화학1우선주
12394,51915,2020-06-05,0.0450928381962864,188500,197000,8500,76124,51915.0,LG화학1우선주
12395,51915,2020-05-26,0.0823529411764705,170000,184000,14000,89261,51915.0,LG화학1우선주
12396,51915,2020-04-17,0.0778816199376947,160500,173000,12500,43057,51915.0,LG화학1우선주
12397,51915,2020-04-16,0.0422077922077922,154000,160500,6500,38151,51915.0,LG화학1우선주
12398,51915,2020-04-01,0.054054054054054,148000,140000,-8000,38847,51915.0,LG화학1우선주
12399,51915,2020-03-25,0.1058823529411764,127500,141000,13500,43478,51915.0,LG화학1우선주
12400,51915,2020-03-24,0.1184210526315789,114000,127500,13500,44943,51915.0,LG화학1우선주
12401,51915,2020-03-23,0.05,120000,114000,-6000,43526,51915.0,LG화학1우선주
12402,51915,2020-03-20,0.1483253588516746,104500,120000,15500,70469,51915.0,LG화학1우선주
12403,51915,2020-03-19,0.1771653543307086,127000,104500,-22500,65475,51915.0,LG화학1우선주
12404,51915,2020-03-18,0.1118881118881118,143000,127000,-16000,38163,51915.0,LG화학1우선주
12405,51915,2020-03-17,0.0529801324503311,151000,143000,-8000,53480,51915.0,LG화학1우선주
12406,51915,2020-03-16,0.0679012345679012,162000,151000,-11000,51838,51915.0,LG화학1우선주
12407,51915,2020-03-13,0.0608695652173913,172500,162000,-10500,69156,51915.0,LG화학1우선주
12408,51915,2020-03-12,0.0416666666666666,180000,172500,-7500,56059,51915.0,LG화학1우선주
12409,51915,2020-03-09,0.0632911392405063,197500,185000,-12500,52144,51915.0,LG화학1우선주
12410,51915,2020-02-11,0.0401002506265664,199500,207500,8000,125584,51915.0,LG화학1우선주
12411,51915,2020-02-04,0.0684931506849315,182500,195000,12500,75159,51915.0,LG화학1우선주
12412,51915,2020-01-28,0.0600522193211488,191500,180000,-11500,30516,51915.0,LG화학1우선주
12413,51915,2020-01-20,0.047486033519553,179000,187500,8500,49594,51915.0,LG화학1우선주
12414,51915,2019-09-25,0.0498614958448753,180500,171500,-9000,43420,51915.0,LG화학1우선주
12415,51915,2019-08-05,0.0588235294117647,178500,168000,-10500,23680,51915.0,LG화학1우선주
12416,51915,2019-03-21,0.0521091811414392,201500,212000,10500,27069,51915.0,LG화학1우선주
12417,51915,2019-01-31,0.0402843601895734,211000,202500,-8500,23634,51915.0,LG화학1우선주
12418,51915,2019-01-18,0.04,200000,208000,8000,12680,51915.0,LG화학1우선주
12419,51915,2018-12-21,0.0548302872062663,191500,202000,10500,45466,51915.0,LG화학1우선주
12420,51915,2018-12-03,0.0460358056265984,195500,204500,9000,9629,51915.0,LG화학1우선주
12421,51915,2018-10-31,0.0445026178010471,191000,199500,8500,15624,51915.0,LG화학1우선주
12422,51915,2018-10-19,0.0524861878453038,181000,190500,9500,10635,51915.0,LG화학1우선주
12423,51915,2018-07-25,0.0493827160493827,202500,212500,10000,33078,51915.0,LG화학1우선주
12424,51915,2018-07-02,0.0421836228287841,201500,193000,-8500,9545,51915.0,LG화학1우선주
12425,51915,2018-06-27,0.0547619047619047,210000,198500,-11500,17231,51915.0,LG화학1우선주
12426,51915,2018-06-04,0.0531645569620253,197500,208000,10500,16007,51915.0,LG화학1우선주
12427,51915,2018-05-30,0.0497630331753554,211000,200500,-10500,10048,51915.0,LG화학1우선주
12428,51915,2018-03-28,0.0544662309368191,229500,217000,-12500,24173,51915.0,LG화학1우선주
12429,51915,2018-03-09,0.056338028169014,213000,225000,12000,17754,51915.0,LG화학1우선주
12430,51915,2018-02-07,0.0439560439560439,227500,217500,-10000,17040,51915.0,LG화학1우선주
12431,51915,2017-10-16,0.0405679513184584,246500,236500,-10000,31063,51915.0,LG화학1우선주
12432,51915,2017-09-22,0.0406976744186046,258000,247500,-10500,24216,51915.0,LG화학1우선주
12433,51915,2017-09-13,0.0452830188679245,265000,277000,12000,31908,51915.0,LG화학1우선주
12434,51915,2017-09-11,0.0453648915187376,253500,265000,11500,46082,51915.0,LG화학1우선주
12435,51915,2017-08-30,0.0556660039761431,251500,265500,14000,37527,51915.0,LG화학1우선주
12436,51915,2017-08-04,0.0434782608695652,230000,240000,10000,31678,51915.0,LG화학1우선주
12437,51915,2017-07-13,0.0515970515970515,203500,214000,10500,28535,51915.0,LG화학1우선주
12438,51915,2017-03-21,0.0532212885154061,178500,188000,9500,22532,51915.0,LG화학1우선주
12439,51915,2017-01-31,0.0526315789473684,180500,171000,-9500,24771,51915.0,LG화학1우선주
12440,51915,2017-01-26,0.0403458213256484,173500,180500,7000,23880,51915.0,LG화학1우선주
12441,51915,2017-01-11,0.0448179271708683,178500,186500,8000,30345,51915.0,LG화학1우선주
12442,51915,2017-01-02,0.0445682451253481,179500,171500,-8000,13097,51915.0,LG화학1우선주
12443,51915,2016-09-13,0.0518292682926829,164000,155500,-8500,27423,51915.0,LG화학1우선주
12444,51915,2016-08-05,0.0412087912087912,182000,174500,-7500,20948,51915.0,LG화학1우선주
12445,52690,2021-06-01,0.0447504302925989,58100,55500,-2600,1178800,52690.0,한국전력기술 보통주
12446,52690,2021-05-28,0.0410714285714285,56000,58300,2300,2747426,52690.0,한국전력기술 보통주
12447,52690,2021-05-26,0.1622481442205726,47150,54800,7650,3485082,52690.0,한국전력기술 보통주
12448,52690,2021-05-25,0.0406917599186164,49150,47150,-2000,998548,52690.0,한국전력기술 보통주
12449,52690,2021-05-21,0.0553435114503816,52400,49500,-2900,4542660,52690.0,한국전력기술 보통주
12450,52690,2021-05-20,0.1366594360086767,46100,52400,6300,2694663,52690.0,한국전력기술 보통주
12451,52690,2021-05-18,0.0989272943980929,41950,46100,4150,1592174,52690.0,한국전력기술 보통주
12452,52690,2021-05-17,0.0461346633416458,40100,41950,1850,745137,52690.0,한국전력기술 보통주
12453,52690,2021-05-13,0.0528350515463917,38800,40850,2050,2347306,52690.0,한국전력기술 보통주
12454,52690,2021-05-11,0.0783216783216783,35750,38550,2800,818610,52690.0,한국전력기술 보통주
12455,52690,2021-05-07,0.0514372163388804,33050,34750,1700,512133,52690.0,한국전력기술 보통주
12456,52690,2021-05-04,0.0743801652892562,36300,33600,-2700,893385,52690.0,한국전력기술 보통주
12457,52690,2021-05-03,0.0546875,38400,36300,-2100,360046,52690.0,한국전력기술 보통주
12458,52690,2021-04-30,0.0420624151967435,36850,38400,1550,798119,52690.0,한국전력기술 보통주
12459,52690,2021-04-29,0.0611464968152866,39250,36850,-2400,402421,52690.0,한국전력기술 보통주
12460,52690,2021-04-27,0.0493333333333333,37500,39350,1850,669837,52690.0,한국전력기술 보통주
12461,52690,2021-04-26,0.0717821782178217,40400,37500,-2900,1178889,52690.0,한국전력기술 보통주
12462,52690,2021-04-23,0.1755102040816326,49000,40400,-8600,1808859,52690.0,한국전력기술 보통주
12463,52690,2021-04-22,0.12,43750,49000,5250,4052860,52690.0,한국전력기술 보통주
12464,52690,2021-04-20,0.15086782376502,37450,43100,5650,2409652,52690.0,한국전력기술 보통주
12465,52690,2021-04-15,0.0523338048090523,35350,37200,1850,1960098,52690.0,한국전력기술 보통주
12466,52690,2021-04-14,0.1293929712460063,31300,35350,4050,1719288,52690.0,한국전력기술 보통주
12467,52690,2021-04-12,0.0966608084358523,28450,31200,2750,1173641,52690.0,한국전력기술 보통주
12468,52690,2021-04-07,0.0454545454545454,28600,27300,-1300,607917,52690.0,한국전력기술 보통주
12469,52690,2021-04-06,0.0671641791044776,26800,28600,1800,1269264,52690.0,한국전력기술 보통주
12470,52690,2021-04-02,0.1260869565217391,23000,25900,2900,1933704,52690.0,한국전력기술 보통주
12471,52690,2021-03-31,0.0417633410672853,21550,22450,900,257164,52690.0,한국전력기술 보통주
12472,52690,2021-03-17,0.0532687651331719,20650,21750,1100,724468,52690.0,한국전력기술 보통주
12473,52690,2021-03-04,0.076056338028169,17750,19100,1350,973605,52690.0,한국전력기술 보통주
12474,52690,2020-12-22,0.0501392757660167,17950,17050,-900,273057,52690.0,한국전력기술 보통주
12475,52690,2020-12-18,0.0637681159420289,17250,18350,1100,1537208,52690.0,한국전력기술 보통주
12476,52690,2020-09-04,0.0892307692307692,16250,17700,1450,888322,52690.0,한국전력기술 보통주
12477,52690,2020-08-20,0.0507462686567164,16750,15900,-850,121824,52690.0,한국전력기술 보통주
12478,52690,2020-08-18,0.0462427745664739,17300,16500,-800,119581,52690.0,한국전력기술 보통주
12479,52690,2020-08-06,0.042042042042042,16650,17350,700,352112,52690.0,한국전력기술 보통주
12480,52690,2020-08-04,0.0433436532507739,16150,16850,700,258210,52690.0,한국전력기술 보통주
12481,52690,2020-07-21,0.0496894409937888,16100,16900,800,224365,52690.0,한국전력기술 보통주
12482,52690,2020-06-16,0.0422077922077922,15400,16050,650,66569,52690.0,한국전력기술 보통주
12483,52690,2020-06-15,0.0464396284829721,16150,15400,-750,145004,52690.0,한국전력기술 보통주
12484,52690,2020-04-16,0.056338028169014,17750,16750,-1000,262008,52690.0,한국전력기술 보통주
12485,52690,2020-04-07,0.0725552050473186,15850,17000,1150,240575,52690.0,한국전력기술 보통주
12486,52690,2020-04-06,0.0496688741721854,15100,15850,750,154002,52690.0,한국전력기술 보통주
12487,52690,2020-03-25,0.0433212996389891,13850,14450,600,179738,52690.0,한국전력기술 보통주
12488,52690,2020-03-24,0.0572519083969465,13100,13850,750,116364,52690.0,한국전력기술 보통주
12489,52690,2020-03-23,0.0642857142857142,14000,13100,-900,108968,52690.0,한국전력기술 보통주
12490,52690,2020-03-20,0.081081081081081,12950,14000,1050,149530,52690.0,한국전력기술 보통주
12491,52690,2020-03-19,0.0407407407407407,13500,12950,-550,215863,52690.0,한국전력기술 보통주
12492,52690,2020-03-18,0.0459363957597173,14150,13500,-650,119831,52690.0,한국전력기술 보통주
12493,52690,2020-03-16,0.0402684563758389,14900,14300,-600,161160,52690.0,한국전력기술 보통주
12494,52690,2020-03-13,0.083076923076923,16250,14900,-1350,373874,52690.0,한국전력기술 보통주
12495,52690,2020-03-12,0.0552325581395348,17200,16250,-950,228552,52690.0,한국전력기술 보통주
12496,52690,2020-01-29,0.0494117647058823,21250,20200,-1050,217083,52690.0,한국전력기술 보통주
12497,52690,2020-01-23,0.0444444444444444,20250,21150,900,230562,52690.0,한국전력기술 보통주
12498,52690,2020-01-22,0.0602094240837696,19100,20250,1150,237922,52690.0,한국전력기술 보통주
12499,52690,2019-12-19,0.0883116883116883,19250,20950,1700,622611,52690.0,한국전력기술 보통주
12500,52690,2019-10-02,0.0402684563758389,22350,21450,-900,139961,52690.0,한국전력기술 보통주
12501,52690,2019-09-25,0.0633946830265848,24450,22900,-1550,255292,52690.0,한국전력기술 보통주
12502,52690,2019-09-23,0.0842572062084257,22550,24450,1900,566630,52690.0,한국전력기술 보통주
12503,52690,2019-09-18,0.1151960784313725,20400,22750,2350,759696,52690.0,한국전력기술 보통주
12504,52690,2019-09-17,0.0822281167108753,18850,20400,1550,900784,52690.0,한국전력기술 보통주
12505,52690,2019-08-05,0.0517711171662125,18350,17400,-950,90671,52690.0,한국전력기술 보통주
12506,52690,2019-07-19,0.0450928381962864,18850,19700,850,72699,52690.0,한국전력기술 보통주
12507,52690,2019-06-25,0.0809628008752735,22850,21000,-1850,183168,52690.0,한국전력기술 보통주
12508,52690,2019-05-31,0.0464547677261613,20450,21400,950,131195,52690.0,한국전력기술 보통주
12509,52690,2019-04-29,0.0570776255707762,21900,23150,1250,171854,52690.0,한국전력기술 보통주
12510,52690,2019-03-05,0.0487364620938628,27700,29050,1350,261328,52690.0,한국전력기술 보통주
12511,52690,2019-03-04,0.0492424242424242,26400,27700,1300,157081,52690.0,한국전력기술 보통주
12512,52690,2019-02-28,0.0469314079422382,27700,26400,-1300,149469,52690.0,한국전력기술 보통주
12513,52690,2019-02-22,0.0544090056285178,26650,28100,1450,206895,52690.0,한국전력기술 보통주
12514,52690,2019-01-30,0.0628930817610062,23850,25350,1500,193891,52690.0,한국전력기술 보통주
12515,52690,2019-01-28,0.0425101214574898,24700,23650,-1050,167498,52690.0,한국전력기술 보통주
12516,52690,2019-01-14,0.1298076923076923,20800,23500,2700,534257,52690.0,한국전력기술 보통주
12517,52690,2018-12-21,0.0495495495495495,22200,21100,-1100,77561,52690.0,한국전력기술 보통주
12518,52690,2018-12-13,0.0473815461346633,20050,21000,950,110640,52690.0,한국전력기술 보통주
12519,52690,2018-11-26,0.0671462829736211,20850,22250,1400,257018,52690.0,한국전력기술 보통주
12520,52690,2018-11-21,0.0416666666666666,20400,21250,850,96653,52690.0,한국전력기술 보통주
12521,52690,2018-11-15,0.0472440944881889,19050,19950,900,68086,52690.0,한국전력기술 보통주
12522,52690,2018-10-23,0.0703883495145631,20600,19150,-1450,118985,52690.0,한국전력기술 보통주
12523,52690,2018-10-15,0.054054054054054,18500,19500,1000,115089,52690.0,한국전력기술 보통주
12524,52690,2018-10-11,0.0794044665012407,20150,18550,-1600,161920,52690.0,한국전력기술 보통주
12525,52690,2018-10-10,0.0404761904761904,21000,20150,-850,76514,52690.0,한국전력기술 보통주
12526,52690,2018-10-01,0.0404761904761904,21000,21850,850,149867,52690.0,한국전력기술 보통주
12527,52690,2018-08-23,0.0404761904761904,21000,21850,850,168809,52690.0,한국전력기술 보통주
12528,52690,2018-08-01,0.0422535211267605,21300,20400,-900,434655,52690.0,한국전력기술 보통주
12529,52690,2018-07-27,0.0434782608695652,23000,22000,-1000,230723,52690.0,한국전력기술 보통주
12530,52690,2018-07-24,0.0558035714285714,22400,23650,1250,191795,52690.0,한국전력기술 보통주
12531,52690,2018-07-06,0.0622119815668202,21700,23050,1350,148103,52690.0,한국전력기술 보통주
12532,52690,2018-07-02,0.1509433962264151,26500,22500,-4000,801439,52690.0,한국전력기술 보통주
12533,52690,2018-06-27,0.0601769911504424,28250,26550,-1700,132787,52690.0,한국전력기술 보통주
12534,52690,2018-06-19,0.0649819494584837,27700,25900,-1800,178241,52690.0,한국전력기술 보통주
12535,52690,2018-06-14,0.0868167202572347,31100,28400,-2700,304241,52690.0,한국전력기술 보통주
12536,52690,2018-06-11,0.0572390572390572,29700,31400,1700,183872,52690.0,한국전력기술 보통주
12537,52690,2018-05-29,0.087719298245614,34200,31200,-3000,508899,52690.0,한국전력기술 보통주
12538,52690,2018-05-28,0.0442748091603053,32750,34200,1450,354785,52690.0,한국전력기술 보통주
12539,52690,2018-05-14,0.0898876404494382,35600,38800,3200,400530,52690.0,한국전력기술 보통주
12540,52690,2018-05-09,0.0465116279069767,36550,34850,-1700,288637,52690.0,한국전력기술 보통주
12541,52690,2018-05-03,0.0629183400267737,37350,35000,-2350,495269,52690.0,한국전력기술 보통주
12542,52690,2018-04-30,0.0453900709219858,35250,36850,1600,704426,52690.0,한국전력기술 보통주
12543,52690,2018-04-24,0.0557065217391304,36800,34750,-2050,397006,52690.0,한국전력기술 보통주
12544,52690,2018-04-20,0.0608308605341246,33700,35750,2050,531110,52690.0,한국전력기술 보통주
12545,52690,2018-04-19,0.0614173228346456,31750,33700,1950,473901,52690.0,한국전력기술 보통주
12546,52690,2018-04-16,0.1195079086115993,28450,31850,3400,563659,52690.0,한국전력기술 보통주
12547,52690,2018-04-13,0.0498154981549815,27100,28450,1350,170823,52690.0,한국전력기술 보통주
12548,52690,2018-04-04,0.0480132450331125,30200,28750,-1450,245940,52690.0,한국전력기술 보통주
12549,52690,2018-04-02,0.0624,31250,29300,-1950,262646,52690.0,한국전력기술 보통주
12550,52690,2018-03-29,0.0716783216783216,28600,30650,2050,624726,52690.0,한국전력기술 보통주
12551,52690,2018-03-27,0.0499108734402852,28050,29450,1400,230669,52690.0,한국전력기술 보통주
12552,52690,2018-03-19,0.0430879712746858,27850,29050,1200,795207,52690.0,한국전력기술 보통주
12553,52690,2018-03-15,0.0975609756097561,24600,27000,2400,841755,52690.0,한국전력기술 보통주
12554,52690,2018-03-09,0.0702127659574468,23500,25150,1650,280417,52690.0,한국전력기술 보통주
12555,52690,2018-03-08,0.0491071428571428,22400,23500,1100,89883,52690.0,한국전력기술 보통주
12556,52690,2018-02-05,0.0415800415800415,24050,23050,-1000,94270,52690.0,한국전력기술 보통주
12557,52690,2018-01-23,0.0427350427350427,23400,24400,1000,194262,52690.0,한국전력기술 보통주
12558,52690,2018-01-09,0.045662100456621,21900,22900,1000,187798,52690.0,한국전력기술 보통주
12559,52690,2017-12-21,0.0558882235528942,25050,23650,-1400,277378,52690.0,한국전력기술 보통주
12560,52690,2017-12-15,0.0413223140495867,24200,25200,1000,175198,52690.0,한국전력기술 보통주
12561,52690,2017-12-08,0.04375,24000,22950,-1050,774067,52690.0,한국전력기술 보통주
12562,52690,2017-12-05,0.149746192893401,19700,22650,2950,1107938,52690.0,한국전력기술 보통주
12563,52690,2017-12-04,0.0824175824175824,18200,19700,1500,412884,52690.0,한국전력기술 보통주
12564,52690,2017-11-24,0.0594900849858356,17650,18700,1050,291508,52690.0,한국전력기술 보통주
12565,52690,2017-10-23,0.0932400932400932,21450,19450,-2000,822119,52690.0,한국전력기술 보통주
12566,52690,2017-10-13,0.0697674418604651,19350,20700,1350,443231,52690.0,한국전력기술 보통주
12567,52690,2017-10-11,0.0760869565217391,18400,19800,1400,352000,52690.0,한국전력기술 보통주
12568,52690,2017-09-25,0.0501392757660167,17950,17050,-900,131048,52690.0,한국전력기술 보통주
12569,52690,2017-09-20,0.0586592178770949,17900,18950,1050,326898,52690.0,한국전력기술 보통주
12570,52690,2017-07-31,0.0477386934673366,19900,18950,-950,191978,52690.0,한국전력기술 보통주
12571,52690,2017-07-26,0.0578947368421052,19000,20100,1100,351535,52690.0,한국전력기술 보통주
12572,52690,2017-07-14,0.050632911392405,19750,18750,-1000,307731,52690.0,한국전력기술 보통주
12573,52690,2017-06-28,0.0675,20000,18650,-1350,569777,52690.0,한국전력기술 보통주
12574,52690,2017-06-20,0.04,21250,20400,-850,792640,52690.0,한국전력기술 보통주
12575,52690,2017-06-19,0.1090146750524109,23850,21250,-2600,921175,52690.0,한국전력기술 보통주
12576,52690,2017-06-01,0.040169133192389,23650,24600,950,701640,52690.0,한국전력기술 보통주
12577,52690,2017-05-02,0.0476190476190476,25200,24000,-1200,317302,52690.0,한국전력기술 보통주
12578,52690,2017-04-12,0.0423572744014733,27150,26000,-1150,201649,52690.0,한국전력기술 보통주
12579,52690,2017-03-23,0.0712871287128712,25250,27050,1800,417373,52690.0,한국전력기술 보통주
12580,52690,2017-03-08,0.0705244122965642,27650,25700,-1950,284543,52690.0,한국전력기술 보통주
12581,52690,2017-03-07,0.0675675675675675,25900,27650,1750,186554,52690.0,한국전력기술 보통주
12582,52690,2017-02-24,0.0410958904109589,25550,26600,1050,194781,52690.0,한국전력기술 보통주
12583,52690,2017-02-09,0.0911016949152542,23600,25750,2150,529464,52690.0,한국전력기술 보통주
12584,52690,2016-11-10,0.0475161987041036,23150,24250,1100,107660,52690.0,한국전력기술 보통주
12585,52690,2016-11-02,0.0405679513184584,24650,23650,-1000,189707,52690.0,한국전력기술 보통주
12586,52690,2016-10-31,0.0401529636711281,26150,25100,-1050,165049,52690.0,한국전력기술 보통주
12587,52690,2016-10-28,0.0644007155635062,27950,26150,-1800,516150,52690.0,한국전력기술 보통주
12588,52690,2016-10-20,0.0575539568345323,27800,29400,1600,172884,52690.0,한국전력기술 보통주
12589,52690,2016-08-18,0.0540958268933539,32350,34100,1750,288254,52690.0,한국전력기술 보통주
12590,55550,2021-05-12,0.0410798122065727,42600,40850,-1750,2328363,55550.0,신한금융지주회사보통주
12591,55550,2021-05-06,0.0445859872611464,39250,41000,1750,2721258,55550.0,신한금융지주회사보통주
12592,55550,2021-01-29,0.0481366459627329,32200,30650,-1550,3554121,55550.0,신한금융지주회사보통주
12593,55550,2021-01-07,0.0416666666666666,32400,33750,1350,6546753,55550.0,신한금융지주회사보통주
12594,55550,2020-12-29,0.044776119402985,33500,32000,-1500,3583691,55550.0,신한금융지주회사보통주
12595,55550,2020-11-30,0.0543318649045521,34050,32200,-1850,5779670,55550.0,신한금융지주회사보통주
12596,55550,2020-11-02,0.0461285008237232,30350,31750,1400,3894347,55550.0,신한금융지주회사보통주
12597,55550,2020-10-28,0.043046357615894,30200,31500,1300,4419345,55550.0,신한금융지주회사보통주
12598,55550,2020-08-11,0.0648298217179902,30850,32850,2000,5025552,55550.0,신한금융지주회사보통주
12599,55550,2020-06-16,0.0847457627118644,29500,32000,2500,2692975,55550.0,신한금융지주회사보통주
12600,55550,2020-06-15,0.0529695024077046,31150,29500,-1650,2915712,55550.0,신한금융지주회사보통주
12601,55550,2020-06-12,0.0415384615384615,32500,31150,-1350,2612741,55550.0,신한금융지주회사보통주
12602,55550,2020-06-03,0.1171875,32000,35750,3750,7122912,55550.0,신한금융지주회사보통주
12603,55550,2020-06-02,0.0423452768729641,30700,32000,1300,3416978,55550.0,신한금융지주회사보통주
12604,55550,2020-05-19,0.0518134715025906,28950,30450,1500,2602771,55550.0,신한금융지주회사보통주
12605,55550,2020-04-27,0.1049723756906077,27150,30000,2850,5258451,55550.0,신한금융지주회사보통주
12606,55550,2020-04-07,0.0420475319926873,27350,28500,1150,2830469,55550.0,신한금융지주회사보통주
12607,55550,2020-04-01,0.0646853146853146,28600,26750,-1850,2216202,55550.0,신한금융지주회사보통주
12608,55550,2020-03-31,0.04,27500,28600,1100,3312454,55550.0,신한금융지주회사보통주
12609,55550,2020-03-25,0.1419624217118998,23950,27350,3400,3088695,55550.0,신한금융지주회사보통주
12610,55550,2020-03-24,0.0788288288288288,22200,23950,1750,2261390,55550.0,신한금융지주회사보통주
12611,55550,2020-03-23,0.0826446280991735,24200,22200,-2000,2185885,55550.0,신한금융지주회사보통주
12612,55550,2020-03-20,0.0779510022271715,22450,24200,1750,3288066,55550.0,신한금융지주회사보통주
12613,55550,2020-03-19,0.0799180327868852,24400,22450,-1950,3227344,55550.0,신한금융지주회사보통주
12614,55550,2020-03-17,0.0597014925373134,26800,25200,-1600,3565928,55550.0,신한금융지주회사보통주
12615,55550,2020-03-13,0.0549828178694158,29100,27500,-1600,4971131,55550.0,신한금융지주회사보통주
12616,55550,2020-03-12,0.0411861614497528,30350,29100,-1250,3444605,55550.0,신한금융지주회사보통주
12617,55550,2020-03-09,0.0579937304075235,31900,30050,-1850,2147355,55550.0,신한금융지주회사보통주
12618,55550,2020-02-24,0.0462833099579242,35650,34000,-1650,2434887,55550.0,신한금융지주회사보통주
12619,55550,2019-05-29,0.0479166666666666,48000,45700,-2300,2069839,55550.0,신한금융지주회사보통주
12620,55550,2019-04-01,0.0416666666666666,42000,43750,1750,1184798,55550.0,신한금융지주회사보통주
12621,55550,2018-10-30,0.0440180586907449,44300,42350,-1950,1547119,55550.0,신한금융지주회사보통주
12622,55550,2018-10-22,0.0404624277456647,43250,45000,1750,823318,55550.0,신한금융지주회사보통주
12623,55550,2018-10-11,0.0487540628385698,46150,43900,-2250,1533359,55550.0,신한금융지주회사보통주
12624,55550,2017-08-11,0.0415162454873646,55400,53100,-2300,1227727,55550.0,신한금융지주회사보통주
12625,55550,2017-01-05,0.0404255319148936,47000,45100,-1900,10173319,55550.0,신한금융지주회사보통주
12626,55550,2016-12-08,0.0558035714285714,44800,47300,2500,2555332,55550.0,신한금융지주회사보통주
12627,55550,2016-12-07,0.041860465116279,43000,44800,1800,1575232,55550.0,신한금융지주회사보통주
12628,55550,2016-11-10,0.0451306413301662,42100,44000,1900,1108320,55550.0,신한금융지주회사보통주
12629,64350,2021-05-12,0.0425531914893617,21150,20250,-900,3478199,64350.0,현대로템보통주
12630,64350,2021-05-04,0.042079207920792,20200,19350,-850,3726812,64350.0,현대로템보통주
12631,64350,2021-04-21,0.0490654205607476,21400,20350,-1050,5430329,64350.0,현대로템보통주
12632,64350,2021-03-12,0.0452261306532663,19900,20800,900,3604091,64350.0,현대로템보통주
12633,64350,2021-02-24,0.0465686274509803,20400,19450,-950,1640361,64350.0,현대로템보통주
12634,64350,2021-02-04,0.0604534005037783,19850,21050,1200,3783708,64350.0,현대로템보통주
12635,64350,2021-01-21,0.0477326968973747,20950,21950,1000,4711591,64350.0,현대로템보통주
12636,64350,2021-01-19,0.0452261306532663,19900,20800,900,3400442,64350.0,현대로템보통주
12637,64350,2021-01-11,0.0604026845637583,22350,21000,-1350,11230469,64350.0,현대로템보통주
12638,64350,2021-01-05,0.1017811704834605,19650,21650,2000,52212004,64350.0,현대로템보통주
12639,64350,2021-01-04,0.1424418604651162,17200,19650,2450,21091762,64350.0,현대로템보통주
12640,64350,2020-12-15,0.0492307692307692,16250,17050,800,6412828,64350.0,현대로템보통주
12641,64350,2020-12-10,0.0448717948717948,15600,16300,700,5594169,64350.0,현대로템보통주
12642,64350,2020-09-25,0.0433333333333333,15000,15650,650,3985539,64350.0,현대로템보통주
12643,64350,2020-09-22,0.043076923076923,16250,15550,-700,2176110,64350.0,현대로템보통주
12644,64350,2020-09-21,0.0441176470588235,17000,16250,-750,2325709,64350.0,현대로템보통주
12645,64350,2020-09-14,0.0477611940298507,16750,17550,800,4671578,64350.0,현대로템보통주
12646,64350,2020-09-07,0.0483870967741935,15500,16250,750,5718522,64350.0,현대로템보통주
12647,64350,2020-08-18,0.0835913312693498,16150,14800,-1350,3387147,64350.0,현대로템보통주
12648,64350,2020-08-12,0.1083333333333333,18000,16050,-1950,10458600,64350.0,현대로템보통주
12649,64350,2020-07-30,0.0455840455840455,17550,18350,800,4489560,64350.0,현대로템보통주
12650,64350,2020-07-28,0.1,16000,17600,1600,16865720,64350.0,현대로템보통주
12651,64350,2020-07-03,0.0403726708074534,16100,16750,650,2586105,64350.0,현대로템보통주
12652,64350,2020-06-25,0.0798816568047337,16900,15550,-1350,4420102,64350.0,현대로템보통주
12653,64350,2020-06-24,0.1695501730103806,14450,16900,2450,34078554,64350.0,현대로템보통주
12654,64350,2020-06-17,0.0562913907284768,15100,14250,-850,1513292,64350.0,현대로템보통주
12655,64350,2020-06-16,0.1185185185185185,13500,15100,1600,2317609,64350.0,현대로템보통주
12656,64350,2020-06-15,0.1029900332225913,15050,13500,-1550,1536731,64350.0,현대로템보통주
12657,64350,2020-06-09,0.047923322683706,15650,14900,-750,1704327,64350.0,현대로템보통주
12658,64350,2020-06-08,0.0428134556574923,16350,15650,-700,1394490,64350.0,현대로템보통주
12659,64350,2020-05-15,0.0473372781065088,16900,16100,-800,1847388,64350.0,현대로템보통주
12660,64350,2020-05-14,0.0611111111111111,18000,16900,-1100,2203727,64350.0,현대로템보통주
12661,64350,2020-05-11,0.054054054054054,18500,17500,-1000,1859475,64350.0,현대로템보통주
12662,64350,2020-04-21,0.0560471976401179,16950,17900,950,28378145,64350.0,현대로템보통주
12663,64350,2020-04-20,0.2150537634408602,13950,16950,3000,14275707,64350.0,현대로템보통주
12664,64350,2020-04-16,0.136,12500,14200,1700,5625847,64350.0,현대로템보통주
12665,64350,2020-04-14,0.0504201680672268,11900,12500,600,1634848,64350.0,현대로템보통주
12666,64350,2020-04-07,0.0416666666666666,12000,12500,500,1764690,64350.0,현대로템보통주
12667,64350,2020-04-01,0.0682730923694779,12450,11600,-850,1773579,64350.0,현대로템보통주
12668,64350,2020-03-31,0.1581395348837209,10750,12450,1700,6482964,64350.0,현대로템보통주
12669,64350,2020-03-25,0.0841584158415841,10100,10950,850,1278832,64350.0,현대로템보통주
12670,64350,2020-03-24,0.0871905274488697,9290,10100,810,979252,64350.0,현대로템보통주
12671,64350,2020-03-23,0.0422680412371134,9700,9290,-410,836533,64350.0,현대로템보통주
12672,64350,2020-03-20,0.096045197740113,8850,9700,850,1394067,64350.0,현대로템보통주
12673,64350,2020-03-19,0.1087613293051359,9930,8850,-1080,1620007,64350.0,현대로템보통주
12674,64350,2020-03-18,0.0405797101449275,10350,9930,-420,854284,64350.0,현대로템보통주
12675,64350,2020-03-13,0.0748898678414096,11350,10500,-850,2102875,64350.0,현대로템보통주
12676,64350,2020-03-12,0.092,12500,11350,-1150,1295822,64350.0,현대로템보통주
12677,64350,2020-03-11,0.0421455938697318,13050,12500,-550,725031,64350.0,현대로템보통주
12678,64350,2020-02-24,0.0588235294117647,14450,13600,-850,847340,64350.0,현대로템보통주
12679,64350,2020-02-10,0.0496688741721854,15100,15850,750,633716,64350.0,현대로템보통주
12680,64350,2020-01-28,0.0683229813664596,16100,15000,-1100,958055,64350.0,현대로템보통주
12681,64350,2020-01-16,0.0487106017191977,17450,16600,-850,1096929,64350.0,현대로템보통주
12682,64350,2020-01-13,0.1057692307692307,15600,17250,1650,3474466,64350.0,현대로템보통주
12683,64350,2020-01-09,0.0769230769230769,14300,15400,1100,694244,64350.0,현대로템보통주
12684,64350,2020-01-08,0.0498338870431893,15050,14300,-750,792494,64350.0,현대로템보통주
12685,64350,2019-12-18,0.0424836601307189,15300,15950,650,555849,64350.0,현대로템보통주
12686,64350,2019-11-21,0.0467289719626168,16050,15300,-750,732303,64350.0,현대로템보통주
12687,64350,2019-10-28,0.0542857142857142,17500,16550,-950,1022584,64350.0,현대로템보통주
12688,64350,2019-10-23,0.0469613259668508,18100,17250,-850,584562,64350.0,현대로템보통주
12689,64350,2019-10-21,0.0434782608695652,18400,17600,-800,516760,64350.0,현대로템보통주
12690,64350,2019-10-07,0.0824742268041237,19400,17800,-1600,1288807,64350.0,현대로템보통주
12691,64350,2019-09-25,0.0581113801452784,20650,19450,-1200,1046381,64350.0,현대로템보통주
12692,64350,2019-09-16,0.0583554376657824,18850,19950,1100,1683927,64350.0,현대로템보통주
12693,64350,2019-09-10,0.0782608695652174,17250,18600,1350,1418860,64350.0,현대로템보통주
12694,64350,2019-08-19,0.0660377358490566,15900,16950,1050,650250,64350.0,현대로템보통주
12695,64350,2019-08-05,0.077639751552795,16100,14850,-1250,931951,64350.0,현대로템보통주
12696,64350,2019-07-29,0.0660919540229885,17400,16250,-1150,1013290,64350.0,현대로템보통주
12697,64350,2019-07-08,0.0504807692307692,20800,19750,-1050,651714,64350.0,현대로템보통주
12698,64350,2019-07-03,0.0504587155963302,21800,20700,-1100,964840,64350.0,현대로템보통주
12699,64350,2019-07-01,0.0593824228028503,21050,22300,1250,1471852,64350.0,현대로템보통주
12700,64350,2019-06-24,0.04,21250,22100,850,889395,64350.0,현대로템보통주
12701,64350,2019-06-12,0.0567901234567901,20250,21400,1150,3223226,64350.0,현대로템보통주
12702,64350,2019-06-10,0.044041450777202,19300,20150,850,771690,64350.0,현대로템보통주
12703,64350,2019-05-28,0.0463917525773195,19400,20300,900,927229,64350.0,현대로템보통주
12704,64350,2019-03-29,0.0616438356164383,21900,23250,1350,1547241,64350.0,현대로템보통주
12705,64350,2019-03-15,0.0554323725055432,22550,21300,-1250,2406980,64350.0,현대로템보통주
12706,64350,2019-03-06,0.041407867494824,24150,23150,-1000,1732762,64350.0,현대로템보통주
12707,64350,2019-03-04,0.0714285714285714,25900,24050,-1850,4811634,64350.0,현대로템보통주
12708,64350,2019-02-28,0.1220338983050847,29500,25900,-3600,4488599,64350.0,현대로템보통주
12709,64350,2019-02-26,0.0447227191413237,27950,29200,1250,2774389,64350.0,현대로템보통주
12710,64350,2019-02-01,0.0737240075614366,26450,28400,1950,3329269,64350.0,현대로템보통주
12711,64350,2019-01-29,0.0473588342440801,27450,26150,-1300,1766229,64350.0,현대로템보통주
12712,64350,2019-01-14,0.0477031802120141,28300,29650,1350,2351486,64350.0,현대로템보통주
12713,64350,2019-01-03,0.0635514018691588,26750,28450,1700,2698290,64350.0,현대로템보통주
12714,64350,2018-12-26,0.051056338028169,28400,26950,-1450,1892995,64350.0,현대로템보통주
12715,64350,2018-12-17,0.0492091388400703,28450,27050,-1400,1514710,64350.0,현대로템보통주
12716,64350,2018-12-12,0.0506108202443281,28650,27200,-1450,2568205,64350.0,현대로템보통주
12717,64350,2018-12-10,0.044776119402985,30150,28800,-1350,2254414,64350.0,현대로템보통주
12718,64350,2018-12-07,0.046875,28800,30150,1350,2463205,64350.0,현대로템보통주
12719,64350,2018-12-03,0.0719557195571955,27100,29050,1950,3583199,64350.0,현대로템보통주
12720,64350,2018-11-19,0.0535331905781584,23350,24600,1250,1918888,64350.0,현대로템보통주
12721,64350,2018-11-15,0.0539325842696629,22250,23450,1200,1257600,64350.0,현대로템보통주
12722,64350,2018-11-07,0.0625,24000,22500,-1500,3366815,64350.0,현대로템보통주
12723,64350,2018-11-02,0.0734966592427616,22450,24100,1650,2107592,64350.0,현대로템보통주
12724,64350,2018-10-31,0.0458515283842794,22900,21850,-1050,2023114,64350.0,현대로템보통주
12725,64350,2018-10-30,0.1036144578313253,20750,22900,2150,6250226,64350.0,현대로템보통주
12726,64350,2018-10-29,0.0777777777777777,22500,20750,-1750,2677472,64350.0,현대로템보통주
12727,64350,2018-10-26,0.0816326530612244,24500,22500,-2000,2878225,64350.0,현대로템보통주
12728,64350,2018-10-24,0.0478927203065134,26100,24850,-1250,1820489,64350.0,현대로템보통주
12729,64350,2018-10-22,0.052064631956912,27850,26400,-1450,1551368,64350.0,현대로템보통주
12730,64350,2018-10-11,0.0646950092421441,27050,25300,-1750,3652567,64350.0,현대로템보통주
12731,64350,2018-10-10,0.1493710691823899,31800,27050,-4750,4867261,64350.0,현대로템보통주
12732,64350,2018-09-21,0.0691927512355848,30350,32450,2100,6477907,64350.0,현대로템보통주
12733,64350,2018-09-10,0.0542372881355932,29500,31100,1600,4359753,64350.0,현대로템보통주
12734,64350,2018-09-07,0.059245960502693,27850,29500,1650,3992315,64350.0,현대로템보통주
12735,64350,2018-08-27,0.1159420289855072,31050,27450,-3600,7069043,64350.0,현대로템보통주
12736,64350,2018-08-17,0.0416666666666666,30000,31250,1250,3414181,64350.0,현대로템보통주
12737,64350,2018-08-16,0.0714285714285714,28000,30000,2000,7890644,64350.0,현대로템보통주
12738,64350,2018-08-10,0.0451127819548872,26600,27800,1200,7301917,64350.0,현대로템보통주
12739,64350,2018-07-24,0.1885964912280701,22800,27100,4300,13644316,64350.0,현대로템보통주
12740,64350,2018-07-23,0.0480167014613778,23950,22800,-1150,1674533,64350.0,현대로템보통주
12741,64350,2018-07-18,0.0568627450980392,25500,24050,-1450,2179799,64350.0,현대로템보통주
12742,64350,2018-07-11,0.0791666666666666,24000,25900,1900,5859169,64350.0,현대로템보통주
12743,64350,2018-07-09,0.1017274472168906,26050,23400,-2650,3472571,64350.0,현대로템보통주
12744,64350,2018-07-06,0.0440881763527054,24950,26050,1100,3657462,64350.0,현대로템보통주
12745,64350,2018-07-02,0.089126559714795,28050,25550,-2500,3464850,64350.0,현대로템보통주
12746,64350,2018-06-28,0.0586206896551724,29000,27300,-1700,3692093,64350.0,현대로템보통주
12747,64350,2018-06-21,0.0528771384136858,32150,30450,-1700,3202594,64350.0,현대로템보통주
12748,64350,2018-06-19,0.0518292682926829,32800,31100,-1700,4483046,64350.0,현대로템보통주
12749,64350,2018-06-14,0.1256830601092896,36600,32000,-4600,8252137,64350.0,현대로템보통주
12750,64350,2018-06-12,0.046875,38400,36600,-1800,12616070,64350.0,현대로템보통주
12751,64350,2018-06-11,0.0491803278688524,36600,38400,1800,6441650,64350.0,현대로템보통주
12752,64350,2018-06-05,0.0419235511713933,40550,38850,-1700,22245556,64350.0,현대로템보통주
12753,64350,2018-06-01,0.0413971539456662,38650,40250,1600,22001937,64350.0,현대로템보통주
12754,64350,2018-05-29,0.0645604395604395,36400,38750,2350,15113382,64350.0,현대로템보통주
12755,64350,2018-05-28,0.3,28000,36400,8400,3131890,64350.0,현대로템보통주
12756,64350,2018-05-25,0.1919191919191919,34650,28000,-6650,10079385,64350.0,현대로템보통주
12757,64350,2018-05-18,0.0484330484330484,35100,36800,1700,4923482,64350.0,현대로템보통주
12758,64350,2018-05-16,0.1569115815691158,40150,33850,-6300,13631799,64350.0,현대로템보통주
12759,64350,2018-05-14,0.1659388646288209,34350,40050,5700,4645879,64350.0,현대로템보통주
12760,64350,2018-05-09,0.0695102685624012,31650,33850,2200,19345621,64350.0,현대로템보통주
12761,64350,2018-05-04,0.1777777777777777,27000,31800,4800,22579694,64350.0,현대로템보통주
12762,64350,2018-05-03,0.1717791411042944,32600,27000,-5600,25997078,64350.0,현대로템보통주
12763,64350,2018-05-02,0.2209737827715356,26700,32600,5900,18670217,64350.0,현대로템보통주
12764,64350,2018-04-30,0.2992700729927007,20550,26700,6150,11232336,64350.0,현대로템보통주
12765,64350,2018-04-27,0.0431472081218274,19700,20550,850,4958797,64350.0,현대로템보통주
12766,64350,2018-04-23,0.0783783783783783,18500,19950,1450,3036339,64350.0,현대로템보통주
12767,64350,2018-04-04,0.0473186119873817,15850,16600,750,1004986,64350.0,현대로템보통주
12768,64350,2018-03-27,0.0422077922077922,15400,16050,650,325645,64350.0,현대로템보통주
12769,64350,2018-03-23,0.0412698412698412,15750,15100,-650,305683,64350.0,현대로템보통주
12770,64350,2018-02-05,0.0471976401179941,16950,16150,-800,509303,64350.0,현대로템보통주
12771,64350,2018-01-12,0.0828877005347593,18700,17150,-1550,4165872,64350.0,현대로템보통주
12772,64350,2017-12-15,0.0722222222222222,18000,19300,1300,177340,64350.0,현대로템보통주
12773,64350,2017-12-14,0.0839694656488549,19650,18000,-1650,256665,64350.0,현대로템보통주
12774,64350,2017-10-30,0.0704225352112676,17750,19000,1250,482072,64350.0,현대로템보통주
12775,64350,2017-09-26,0.069069069069069,16650,17800,1150,151924,64350.0,현대로템보통주
12776,64350,2017-06-20,0.04,22500,21600,-900,578347,64350.0,현대로템보통주
12777,64350,2017-04-26,0.0488997555012225,20450,21450,1000,341537,64350.0,현대로템보통주
12778,64350,2017-04-07,0.0427553444180522,21050,21950,900,502697,64350.0,현대로템보통주
12779,64350,2017-03-07,0.0429292929292929,19800,20650,850,172283,64350.0,현대로템보통주
12780,64350,2017-02-09,0.0458937198067632,20700,21650,950,387644,64350.0,현대로템보통주
12781,64350,2017-02-02,0.0652741514360313,19150,20400,1250,623017,64350.0,현대로템보통주
12782,64350,2016-12-02,0.0598958333333333,19200,18050,-1150,250508,64350.0,현대로템보통주
12783,64350,2016-11-14,0.0514138817480719,19450,20450,1000,723810,64350.0,현대로템보통주
12784,64350,2016-11-11,0.0456989247311828,18600,19450,850,323657,64350.0,현대로템보통주
12785,64350,2016-11-10,0.0720461095100864,17350,18600,1250,281881,64350.0,현대로템보통주
12786,64350,2016-11-07,0.059880239520958,16700,17700,1000,147689,64350.0,현대로템보통주
12787,64350,2016-11-01,0.0855614973262032,18700,17100,-1600,353273,64350.0,현대로템보통주
12788,64350,2016-10-24,0.0439560439560439,18200,19000,800,276664,64350.0,현대로템보통주
12789,64350,2016-10-17,0.0478589420654911,19850,18900,-950,441768,64350.0,현대로템보통주
12790,64350,2016-10-14,0.0433734939759036,20750,19850,-900,284362,64350.0,현대로템보통주
12791,64350,2016-09-07,0.0429184549356223,23300,22300,-1000,627695,64350.0,현대로템보통주
12792,64350,2016-08-18,0.06,22500,23850,1350,1068880,64350.0,현대로템보통주
12793,64350,2016-08-09,0.0400943396226415,21200,22050,850,483546,64350.0,현대로템보통주
12794,66570,2021-04-15,0.0650154798761609,161500,172000,10500,5009228,66570.0,LG전자보통주
12795,66570,2021-04-01,0.06,150000,159000,9000,3574578,66570.0,LG전자보통주
12796,66570,2021-03-30,0.0818505338078291,140500,152000,11500,3244882,66570.0,LG전자보통주
12797,66570,2021-03-23,0.0612903225806451,155000,145500,-9500,2053555,66570.0,LG전자보통주
12798,66570,2021-03-16,0.0429042904290429,151500,158000,6500,1996472,66570.0,LG전자보통주
12799,66570,2021-02-26,0.0487012987012987,154000,146500,-7500,2453529,66570.0,LG전자보통주
12800,66570,2021-02-24,0.0476190476190476,157500,150000,-7500,3061646,66570.0,LG전자보통주
12801,66570,2021-02-23,0.0512048192771084,166000,157500,-8500,2897046,66570.0,LG전자보통주
12802,66570,2021-02-16,0.0454545454545454,165000,172500,7500,3199701,66570.0,LG전자보통주
12803,66570,2021-02-10,0.0403726708074534,161000,167500,6500,3256875,66570.0,LG전자보통주
12804,66570,2021-02-04,0.0454545454545454,165000,157500,-7500,2660265,66570.0,LG전자보통주
12805,66570,2021-02-03,0.0443037974683544,158000,165000,7000,3179393,66570.0,LG전자보통주
12806,66570,2021-01-29,0.0699088145896656,164500,153000,-11500,5396272,66570.0,LG전자보통주
12807,66570,2021-01-26,0.0449438202247191,178000,170000,-8000,3706727,66570.0,LG전자보통주
12808,66570,2021-01-22,0.0405405405405405,185000,177500,-7500,7015098,66570.0,LG전자보통주
12809,66570,2021-01-21,0.1077844311377245,167000,185000,18000,16304954,66570.0,LG전자보통주
12810,66570,2021-01-20,0.1283783783783783,148000,167000,19000,10340439,66570.0,LG전자보통주
12811,66570,2021-01-19,0.0647482014388489,139000,148000,9000,4114713,66570.0,LG전자보통주
12812,66570,2021-01-15,0.0476190476190476,147000,140000,-7000,3051738,66570.0,LG전자보통주
12813,66570,2021-01-14,0.05,140000,147000,7000,5618859,66570.0,LG전자보통주
12814,66570,2021-01-07,0.0909090909090909,137500,150000,12500,9782722,66570.0,LG전자보통주
12815,66570,2021-01-04,0.0518518518518518,135000,142000,7000,1868234,66570.0,LG전자보통주
12816,66570,2020-12-29,0.0562248995983935,124500,131500,7000,7476122,66570.0,LG전자보통주
12817,66570,2020-12-28,0.1116071428571428,112000,124500,12500,21982050,66570.0,LG전자보통주
12818,66570,2020-12-24,0.0627615062761506,119500,112000,-7500,11918248,66570.0,LG전자보통주
12819,66570,2020-12-23,0.2960954446854664,92200,119500,27300,16565841,66570.0,LG전자보통주
12820,66570,2020-12-16,0.0417558886509636,93400,97300,3900,1785477,66570.0,LG전자보통주
12821,66570,2020-12-08,0.0650224215246636,89200,95000,5800,4702429,66570.0,LG전자보통주
12822,66570,2020-12-03,0.0512223515715948,85900,90300,4400,2391369,66570.0,LG전자보통주
12823,66570,2020-11-18,0.0447058823529411,85000,88800,3800,2116015,66570.0,LG전자보통주
12824,66570,2020-09-09,0.0512820512820512,85800,90200,4400,3555936,66570.0,LG전자보통주
12825,66570,2020-09-01,0.0415676959619952,84200,87700,3500,1133236,66570.0,LG전자보통주
12826,66570,2020-08-21,0.0636042402826855,84900,90300,5400,2978055,66570.0,LG전자보통주
12827,66570,2020-08-18,0.0529875986471251,88700,84000,-4700,1462971,66570.0,LG전자보통주
12828,66570,2020-08-12,0.0518072289156626,83000,87300,4300,2704977,66570.0,LG전자보통주
12829,66570,2020-08-10,0.1101036269430051,77200,85700,8500,3706582,66570.0,LG전자보통주
12830,66570,2020-08-04,0.0527027027027027,74000,77900,3900,1738014,66570.0,LG전자보통주
12831,66570,2020-08-03,0.0466760961810466,70700,74000,3300,1183563,66570.0,LG전자보통주
12832,66570,2020-07-15,0.057909604519774,70800,74900,4100,2504840,66570.0,LG전자보통주
12833,66570,2020-07-06,0.0476923076923076,65000,68100,3100,1461414,66570.0,LG전자보통주
12834,66570,2020-06-17,0.0460122699386503,65200,68200,3000,1576915,66570.0,LG전자보통주
12835,66570,2020-06-15,0.0722713864306784,67800,62900,-4900,1545344,66570.0,LG전자보통주
12836,66570,2020-06-10,0.0525525525525525,66600,70100,3500,2744224,66570.0,LG전자보통주
12837,66570,2020-06-09,0.040625,64000,66600,2600,1897513,66570.0,LG전자보통주
12838,66570,2020-05-27,0.042031523642732,57100,59500,2400,1707086,66570.0,LG전자보통주
12839,66570,2020-04-07,0.0665362035225048,51100,54500,3400,2123508,66570.0,LG전자보통주
12840,66570,2020-03-25,0.0923423423423423,44400,48500,4100,1506779,66570.0,LG전자보통주
12841,66570,2020-03-24,0.060931899641577,41850,44400,2550,1316623,66570.0,LG전자보통주
12842,66570,2020-03-23,0.0720620842572062,45100,41850,-3250,1186795,66570.0,LG전자보통주
12843,66570,2020-03-19,0.090625,48000,43650,-4350,1601945,66570.0,LG전자보통주
12844,66570,2020-03-16,0.04,52500,50400,-2100,948845,66570.0,LG전자보통주
12845,66570,2020-03-13,0.054054054054054,55500,52500,-3000,1968749,66570.0,LG전자보통주
12846,66570,2020-03-12,0.059322033898305,59000,55500,-3500,1649095,66570.0,LG전자보통주
12847,66570,2020-03-09,0.0414593698175787,60300,57800,-2500,1001568,66570.0,LG전자보통주
12848,66570,2020-02-24,0.0423600605143721,66100,63300,-2800,874557,66570.0,LG전자보통주
12849,66570,2019-10-07,0.0451807228915662,66400,69400,3000,955986,66570.0,LG전자보통주
12850,66570,2019-09-10,0.0587275693311582,61300,64900,3600,1293106,66570.0,LG전자보통주
12851,66570,2019-07-05,0.052219321148825,76600,72600,-4000,1835388,66570.0,LG전자보통주
12852,66570,2019-06-11,0.0603337612323491,77900,82600,4700,1765695,66570.0,LG전자보통주
12853,66570,2019-04-25,0.044776119402985,73700,77000,3300,1382565,66570.0,LG전자보통주
12854,66570,2019-03-29,0.0401662049861495,72200,75100,2900,1064758,66570.0,LG전자보통주
12855,66570,2019-03-25,0.0407358738501971,76100,73000,-3100,806732,66570.0,LG전자보통주
12856,66570,2019-03-21,0.0426356589147286,77400,74100,-3300,1570980,66570.0,LG전자보통주
12857,66570,2019-03-06,0.0434782608695652,71300,74400,3100,1630920,66570.0,LG전자보통주
12858,66570,2019-02-11,0.0694444444444444,64800,69300,4500,1987125,66570.0,LG전자보통주
12859,66570,2019-01-25,0.0659509202453987,65200,69500,4300,1749374,66570.0,LG전자보통주
12860,66570,2018-12-20,0.0413476263399693,65300,62600,-2700,1670644,66570.0,LG전자보통주
12861,66570,2018-12-06,0.0432357043235704,71700,68600,-3100,1054851,66570.0,LG전자보통주
12862,66570,2018-11-01,0.0426540284360189,63300,66000,2700,1056023,66570.0,LG전자보통주
12863,66570,2018-10-11,0.0444785276073619,65200,62300,-2900,1441637,66570.0,LG전자보통주
12864,66570,2018-09-18,0.0403337969401947,71900,69000,-2900,2606048,66570.0,LG전자보통주
12865,66570,2018-08-29,0.0474898236092265,73700,77200,3500,1417794,66570.0,LG전자보통주
12866,66570,2018-08-09,0.0592885375494071,75900,80400,4500,2132947,66570.0,LG전자보통주
12867,66570,2018-07-27,0.0709046454767726,81800,76000,-5800,2544391,66570.0,LG전자보통주
12868,66570,2018-06-21,0.0487238979118329,86200,82000,-4200,1395643,66570.0,LG전자보통주
12869,66570,2018-06-19,0.0448430493273542,89200,85200,-4000,1012856,66570.0,LG전자보통주
12870,66570,2018-06-14,0.04,90000,93600,3600,1444370,66570.0,LG전자보통주
12871,66570,2018-06-01,0.0475161987041036,92600,88200,-4400,2401034,66570.0,LG전자보통주
12872,66570,2018-05-08,0.0414141414141414,99000,94900,-4100,1398768,66570.0,LG전자보통주
12873,66570,2018-04-23,0.0412844036697247,109000,104500,-4500,1135766,66570.0,LG전자보통주
12874,66570,2018-04-06,0.0571428571428571,105000,111000,6000,1519548,66570.0,LG전자보통주
12875,66570,2018-04-04,0.0542986425339366,110500,104500,-6000,909945,66570.0,LG전자보통주
12876,66570,2018-03-23,0.0448430493273542,111500,106500,-5000,696815,66570.0,LG전자보통주
12877,66570,2018-02-19,0.0545267489711934,97200,102500,5300,893618,66570.0,LG전자보통주
12878,66570,2018-01-24,0.0639269406392694,109500,102500,-7000,1406328,66570.0,LG전자보통주
12879,66570,2018-01-08,0.054054054054054,111000,105000,-6000,2480029,66570.0,LG전자보통주
12880,66570,2018-01-05,0.0471698113207547,106000,111000,5000,883832,66570.0,LG전자보통주
12881,66570,2017-12-27,0.0786290322580645,99200,107000,7800,1187463,66570.0,LG전자보통주
12882,66570,2017-10-31,0.040084388185654,94800,91000,-3800,2091668,66570.0,LG전자보통주
12883,66570,2017-10-19,0.0674778761061946,90400,96500,6100,4384919,66570.0,LG전자보통주
12884,66570,2017-10-11,0.0816831683168316,80800,87400,6600,3091409,66570.0,LG전자보통주
12885,66570,2017-09-13,0.053012048192771,83000,87400,4400,2808612,66570.0,LG전자보통주
12886,66570,2017-09-05,0.0459492140266021,82700,86500,3800,2612281,66570.0,LG전자보통주
12887,66570,2017-08-30,0.1061827956989247,74400,82300,7900,3932544,66570.0,LG전자보통주
12888,66570,2017-08-04,0.0497076023391812,68400,71800,3400,1976833,66570.0,LG전자보통주
12889,66570,2017-07-10,0.0419485791610284,73900,70800,-3100,3056226,66570.0,LG전자보통주
12890,66570,2017-07-07,0.0415045395590142,77100,73900,-3200,2330893,66570.0,LG전자보통주
12891,66570,2017-06-22,0.0465657741559953,85900,81900,-4000,2179462,66570.0,LG전자보통주
12892,66570,2017-06-02,0.065190651906519,81300,86600,5300,1869364,66570.0,LG전자보통주
12893,66570,2017-05-11,0.0458715596330275,76300,79800,3500,1876649,66570.0,LG전자보통주
12894,66570,2017-05-08,0.0739191073919107,71700,77000,5300,2624129,66570.0,LG전자보통주
12895,66570,2017-04-28,0.0442600276625172,72300,69100,-3200,2295287,66570.0,LG전자보통주
12896,66570,2017-04-10,0.0423131170662905,70900,67900,-3000,1306155,66570.0,LG전자보통주
12897,66570,2017-04-06,0.050595238095238,67200,70600,3400,1571616,66570.0,LG전자보통주
12898,66570,2017-03-23,0.0404624277456647,69200,72000,2800,2098932,66570.0,LG전자보통주
12899,66570,2017-03-07,0.0497512437810945,60300,63300,3000,1734620,66570.0,LG전자보통주
12900,66570,2017-02-27,0.0590111642743221,62700,59000,-3700,2350933,66570.0,LG전자보통주
12901,66570,2017-02-01,0.0451263537906137,55400,57900,2500,2286272,66570.0,LG전자보통주
12902,66570,2017-01-31,0.0413533834586466,53200,55400,2200,1376669,66570.0,LG전자보통주
12903,66570,2017-01-03,0.0523255813953488,51600,54300,2700,1715000,66570.0,LG전자보통주
12904,66570,2016-11-09,0.0429319371727748,47750,45700,-2050,1461344,66570.0,LG전자보통주
12905,66570,2016-10-11,0.0510805500982318,50900,53500,2600,2898941,66570.0,LG전자보통주
12906,66570,2016-10-10,0.0516528925619834,48400,50900,2500,1730902,66570.0,LG전자보통주
12907,66575,2021-06-03,0.0540915395284327,72100,76000,3900,337838,66575.0,LG전자1우선주
12908,66575,2021-04-15,0.053763440860215,74400,78400,4000,633100,66575.0,LG전자1우선주
12909,66575,2021-04-01,0.0482269503546099,70500,73900,3400,432366,66575.0,LG전자1우선주
12910,66575,2021-03-30,0.0676691729323308,66500,71000,4500,356761,66575.0,LG전자1우선주
12911,66575,2021-02-24,0.0498652291105121,74200,70500,-3700,412946,66575.0,LG전자1우선주
12912,66575,2021-02-23,0.0511508951406649,78200,74200,-4000,380406,66575.0,LG전자1우선주
12913,66575,2021-01-29,0.058472553699284,83800,78900,-4900,965102,66575.0,LG전자1우선주
12914,66575,2021-01-21,0.2838801711840228,70100,90000,19900,8780291,66575.0,LG전자1우선주
12915,66575,2021-01-20,0.0801232665639445,64900,70100,5200,1572269,66575.0,LG전자1우선주
12916,66575,2021-01-14,0.0434056761268781,59900,62500,2600,551583,66575.0,LG전자1우선주
12917,66575,2021-01-11,0.0492307692307692,65000,61800,-3200,956353,66575.0,LG전자1우선주
12918,66575,2021-01-06,0.0543633762517882,69900,66100,-3800,1350573,66575.0,LG전자1우선주
12919,66575,2021-01-04,0.1112852664576802,63800,70900,7100,1074522,66575.0,LG전자1우선주
12920,66575,2020-12-30,0.0493421052631578,60800,63800,3000,950246,66575.0,LG전자1우선주
12921,66575,2020-12-29,0.0455259026687598,63700,60800,-2900,1321531,66575.0,LG전자1우선주
12922,66575,2020-12-28,0.2539370078740157,50800,63700,12900,11126669,66575.0,LG전자1우선주
12923,66575,2020-12-24,0.0694736842105263,47500,50800,3300,9349508,66575.0,LG전자1우선주
12924,66575,2020-12-23,0.2995896032831737,36550,47500,10950,3097329,66575.0,LG전자1우선주
12925,66575,2020-12-16,0.0493150684931506,36500,38300,1800,256386,66575.0,LG전자1우선주
12926,66575,2020-12-08,0.0432190760059612,33550,35000,1450,447691,66575.0,LG전자1우선주
12927,66575,2020-09-25,0.0438871473354232,31900,33300,1400,142482,66575.0,LG전자1우선주
12928,66575,2020-09-09,0.0455235204855842,32950,34450,1500,340028,66575.0,LG전자1우선주
12929,66575,2020-08-21,0.0769230769230769,32500,35000,2500,376135,66575.0,LG전자1우선주
12930,66575,2020-08-18,0.0686131386861313,34250,31900,-2350,212543,66575.0,LG전자1우선주
12931,66575,2020-08-10,0.1799307958477508,28900,34100,5200,1166308,66575.0,LG전자1우선주
12932,66575,2020-07-15,0.0410447761194029,26800,27900,1100,165289,66575.0,LG전자1우선주
12933,66575,2020-07-06,0.0497017892644135,25150,26400,1250,138924,66575.0,LG전자1우선주
12934,66575,2020-06-22,0.047451669595782,28450,27100,-1350,166911,66575.0,LG전자1우선주
12935,66575,2020-06-17,0.0469924812030075,26600,27850,1250,323046,66575.0,LG전자1우선주
12936,66575,2020-06-16,0.0725806451612903,24800,26600,1800,198969,66575.0,LG전자1우선주
12937,66575,2020-06-15,0.0865561694290976,27150,24800,-2350,226314,66575.0,LG전자1우선주
12938,66575,2020-06-10,0.0608365019011406,26300,27900,1600,353413,66575.0,LG전자1우선주
12939,66575,2020-06-09,0.052,25000,26300,1300,245578,66575.0,LG전자1우선주
12940,66575,2020-06-08,0.0482180293501048,23850,25000,1150,172571,66575.0,LG전자1우선주
12941,66575,2020-04-07,0.0887096774193548,18600,20250,1650,157293,66575.0,LG전자1우선주
12942,66575,2020-04-06,0.042016806722689,17850,18600,750,67066,66575.0,LG전자1우선주
12943,66575,2020-03-25,0.0668789808917197,15700,16750,1050,144934,66575.0,LG전자1우선주
12944,66575,2020-03-24,0.0572390572390572,14850,15700,850,76866,66575.0,LG전자1우선주
12945,66575,2020-03-23,0.0804953560371517,16150,14850,-1300,91262,66575.0,LG전자1우선주
12946,66575,2020-03-19,0.1123595505617977,17800,15800,-2000,148290,66575.0,LG전자1우선주
12947,66575,2020-03-18,0.0455764075067024,18650,17800,-850,131896,66575.0,LG전자1우선주
12948,66575,2020-03-16,0.0565110565110565,20350,19200,-1150,98894,66575.0,LG전자1우선주
12949,66575,2020-03-12,0.0620842572062084,22550,21150,-1400,111056,66575.0,LG전자1우선주
12950,66575,2020-02-24,0.0497131931166348,26150,24850,-1300,56054,66575.0,LG전자1우선주
12951,66575,2019-07-05,0.0540958268933539,32350,30600,-1750,47870,66575.0,LG전자1우선주
12952,66575,2019-06-11,0.0596330275229357,32700,34650,1950,72346,66575.0,LG전자1우선주
12953,66575,2019-04-25,0.0402684563758389,29800,31000,1200,48606,66575.0,LG전자1우선주
12954,66575,2019-03-25,0.0445544554455445,30300,28950,-1350,33312,66575.0,LG전자1우선주
12955,66575,2019-03-06,0.047787610619469,28250,29600,1350,67001,66575.0,LG전자1우선주
12956,66575,2019-02-11,0.0491493383742911,26450,27750,1300,50003,66575.0,LG전자1우선주
12957,66575,2019-01-25,0.0524344569288389,26700,28100,1400,61028,66575.0,LG전자1우선주
12958,66575,2018-11-02,0.0416666666666666,26400,27500,1100,28907,66575.0,LG전자1우선주
12959,66575,2018-10-23,0.0461254612546125,27100,25850,-1250,18893,66575.0,LG전자1우선주
12960,66575,2018-10-11,0.056672760511883,27350,25800,-1550,51005,66575.0,LG전자1우선주
12961,66575,2018-07-27,0.0631578947368421,33250,31150,-2100,109051,66575.0,LG전자1우선주
12962,66575,2018-07-02,0.0482456140350877,34200,32550,-1650,44866,66575.0,LG전자1우선주
12963,66575,2018-06-21,0.047486033519553,35800,34100,-1700,45447,66575.0,LG전자1우선주
12964,66575,2018-06-01,0.047808764940239,37650,35850,-1800,119911,66575.0,LG전자1우선주
12965,66575,2018-04-06,0.0435806831566548,42450,44300,1850,59592,66575.0,LG전자1우선주
12966,66575,2018-04-04,0.0509977827050997,45100,42800,-2300,38518,66575.0,LG전자1우선주
12967,66575,2018-03-27,0.0417633410672853,43100,44900,1800,47935,66575.0,LG전자1우선주
12968,66575,2018-03-23,0.0427446569178852,44450,42550,-1900,31563,66575.0,LG전자1우선주
12969,66575,2018-01-24,0.0411255411255411,46200,44300,-1900,88695,66575.0,LG전자1우선주
12970,66575,2018-01-05,0.0438972162740899,46700,48750,2050,79119,66575.0,LG전자1우선주
12971,66575,2017-12-27,0.0564334085778781,44300,46800,2500,79475,66575.0,LG전자1우선주
12972,66575,2017-12-15,0.048087431693989,45750,47950,2200,163669,66575.0,LG전자1우선주
12973,66575,2017-12-14,0.0493119266055045,43600,45750,2150,279826,66575.0,LG전자1우선주
12974,66575,2017-10-19,0.059090909090909,44000,46600,2600,167304,66575.0,LG전자1우선주
12975,66575,2017-10-11,0.0570719602977667,40300,42600,2300,90382,66575.0,LG전자1우선주
12976,66575,2017-09-13,0.0460992907801418,42300,44250,1950,175825,66575.0,LG전자1우선주
12977,66575,2017-09-05,0.0464547677261613,40900,42800,1900,119715,66575.0,LG전자1우선주
12978,66575,2017-08-30,0.0936227951153324,36850,40300,3450,220722,66575.0,LG전자1우선주
12979,66575,2017-08-04,0.0459110473457675,34850,36450,1600,63798,66575.0,LG전자1우선주
12980,66575,2017-07-10,0.0522088353413654,37350,35400,-1950,214427,66575.0,LG전자1우선주
12981,66575,2017-07-07,0.0423076923076923,39000,37350,-1650,102996,66575.0,LG전자1우선주
12982,66575,2017-06-28,0.0413625304136253,41100,39400,-1700,124531,66575.0,LG전자1우선주
12983,66575,2017-06-02,0.0719131614654002,36850,39500,2650,204716,66575.0,LG전자1우선주
12984,66575,2017-05-29,0.0462184873949579,35700,37350,1650,158700,66575.0,LG전자1우선주
12985,66575,2017-05-19,0.0419161676646706,33400,34800,1400,67525,66575.0,LG전자1우선주
12986,66575,2017-05-11,0.062111801242236,32200,34200,2000,158064,66575.0,LG전자1우선주
12987,66575,2017-05-08,0.0616883116883116,30800,32700,1900,108579,66575.0,LG전자1우선주
12988,66575,2017-03-23,0.0516351118760757,29050,30550,1500,169596,66575.0,LG전자1우선주
12989,66575,2017-03-14,0.0460992907801418,28200,29500,1300,137621,66575.0,LG전자1우선주
12990,66575,2017-02-27,0.0505415162454873,27700,26300,-1400,52300,66575.0,LG전자1우선주
12991,66575,2016-10-11,0.048,25000,26200,1200,50715,66575.0,LG전자1우선주
12992,66575,2016-10-10,0.0438413361169102,23950,25000,1050,34438,66575.0,LG전자1우선주
12993,68270,2021-05-07,0.0554455445544554,252500,266500,14000,1301011,68270.0,셀트리온보통주
12994,68270,2021-05-04,0.0420841683366733,249500,260000,10500,1828139,68270.0,셀트리온보통주
12995,68270,2021-05-03,0.0620300751879699,266000,249500,-16500,1931130,68270.0,셀트리온보통주
12996,68270,2021-03-29,0.0525477707006369,314000,330500,16500,1786627,68270.0,셀트리온보통주
12997,68270,2021-02-25,0.0921985815602836,282000,308000,26000,1378139,68270.0,셀트리온보통주
12998,68270,2021-02-24,0.0472972972972973,296000,282000,-14000,1494863,68270.0,셀트리온보통주
12999,68270,2021-02-23,0.0436187399030694,309500,296000,-13500,1261921,68270.0,셀트리온보통주
13000,68270,2021-02-02,0.0417789757412398,371000,355500,-15500,2321590,68270.0,셀트리온보통주
13001,68270,2021-02-01,0.1450617283950617,324000,371000,47000,6018601,68270.0,셀트리온보통주
13002,68270,2021-01-18,0.0455927051671732,329000,314000,-15000,2601181,68270.0,셀트리온보통주
13003,68270,2021-01-15,0.0666666666666666,352500,329000,-23500,3398281,68270.0,셀트리온보통주
13004,68270,2021-01-14,0.0760157273918741,381500,352500,-29000,3425555,68270.0,셀트리온보통주
13005,68270,2020-12-29,0.0989505247376311,333500,360500,27000,5725005,68270.0,셀트리온보통주
13006,68270,2020-12-28,0.0402877697841726,347500,333500,-14000,7295632,68270.0,셀트리온보통주
13007,68270,2020-12-08,0.1325898389095415,403500,350000,-53500,4600980,68270.0,셀트리온보통주
13008,68270,2020-12-07,0.0618421052631578,380000,403500,23500,3465337,68270.0,셀트리온보통주
13009,68270,2020-12-04,0.0826210826210826,351000,380000,29000,4734606,68270.0,셀트리온보통주
13010,68270,2020-11-25,0.0945273631840796,301500,330000,28500,10726012,68270.0,셀트리온보통주
13011,68270,2020-11-11,0.0723327305605786,276500,296500,20000,2765598,68270.0,셀트리온보통주
13012,68270,2020-11-04,0.0444015444015444,259000,270500,11500,1326699,68270.0,셀트리온보통주
13013,68270,2020-11-03,0.0593047034764826,244500,259000,14500,1016373,68270.0,셀트리온보통주
13014,68270,2020-10-30,0.0474308300395256,253000,241000,-12000,825115,68270.0,셀트리온보통주
13015,68270,2020-10-29,0.0432989690721649,242500,253000,10500,986149,68270.0,셀트리온보통주
13016,68270,2020-10-12,0.0438931297709923,262000,273500,11500,774825,68270.0,셀트리온보통주
13017,68270,2020-09-24,0.0601503759398496,266000,250000,-16000,1321525,68270.0,셀트리온보통주
13018,68270,2020-09-21,0.0445969125214408,291500,278500,-13000,1074281,68270.0,셀트리온보통주
13019,68270,2020-09-09,0.0613207547169811,318000,298500,-19500,2482466,68270.0,셀트리온보통주
13020,68270,2020-09-08,0.0426229508196721,305000,318000,13000,2698135,68270.0,셀트리온보통주
13021,68270,2020-08-05,0.043046357615894,302000,315000,13000,1063211,68270.0,셀트리온보통주
13022,68270,2020-07-29,0.0503937007874015,317500,301500,-16000,1903406,68270.0,셀트리온보통주
13023,68270,2020-07-17,0.0412698412698412,315000,328000,13000,1241089,68270.0,셀트리온보통주
13024,68270,2020-07-09,0.0401284109149277,311500,324000,12500,1637528,68270.0,셀트리온보통주
13025,68270,2020-06-23,0.0723905723905724,297000,318500,21500,4485322,68270.0,셀트리온보통주
13026,68270,2020-06-16,0.0711678832116788,274000,293500,19500,2041007,68270.0,셀트리온보통주
13027,68270,2020-06-15,0.0789915966386554,297500,274000,-23500,3141867,68270.0,셀트리온보통주
13028,68270,2020-06-11,0.0726256983240223,268500,288000,19500,3934710,68270.0,셀트리온보통주
13029,68270,2020-06-04,0.0857142857142857,227500,247000,19500,3037387,68270.0,셀트리온보통주
13030,68270,2020-06-01,0.0655737704918032,213500,227500,14000,3410255,68270.0,셀트리온보통주
13031,68270,2020-04-06,0.0663265306122449,196000,209000,13000,2778989,68270.0,셀트리온보통주
13032,68270,2020-04-01,0.1353711790393013,229000,198000,-31000,5208192,68270.0,셀트리온보통주
13033,68270,2020-03-31,0.2378378378378378,185000,229000,44000,11131989,68270.0,셀트리온보통주
13034,68270,2020-03-24,0.0514285714285714,175000,184000,9000,3903710,68270.0,셀트리온보통주
13035,68270,2020-03-23,0.1475409836065573,152500,175000,22500,6685918,68270.0,셀트리온보통주
13036,68270,2020-03-20,0.0892857142857142,140000,152500,12500,2019176,68270.0,셀트리온보통주
13037,68270,2020-03-19,0.10828025477707,157000,140000,-17000,2890238,68270.0,셀트리온보통주
13038,68270,2020-03-18,0.0654761904761904,168000,157000,-11000,1214771,68270.0,셀트리온보통주
13039,68270,2020-03-10,0.0402298850574712,174000,181000,7000,1203990,68270.0,셀트리온보통주
13040,68270,2020-03-05,0.0429799426934097,174500,182000,7500,908489,68270.0,셀트리온보통주
13041,68270,2020-02-24,0.0451977401129943,177000,169000,-8000,768670,68270.0,셀트리온보통주
13042,68270,2020-02-06,0.0486322188449848,164500,172500,8000,831467,68270.0,셀트리온보통주
13043,68270,2019-12-17,0.0529411764705882,170000,179000,9000,956542,68270.0,셀트리온보통주
13044,68270,2019-11-21,0.040650406504065,184500,177000,-7500,865834,68270.0,셀트리온보통주
13045,68270,2019-10-22,0.0521978021978022,182000,191500,9500,1075991,68270.0,셀트리온보통주
13046,68270,2019-10-01,0.0579268292682926,164000,173500,9500,1232784,68270.0,셀트리온보통주
13047,68270,2019-09-20,0.0415430267062314,168500,175500,7000,595515,68270.0,셀트리온보통주
13048,68270,2019-09-04,0.043613707165109,160500,167500,7000,809996,68270.0,셀트리온보통주
13049,68270,2019-08-28,0.0758620689655172,145000,156000,11000,1109554,68270.0,셀트리온보통주
13050,68270,2019-08-26,0.066006600660066,151500,141500,-10000,1170629,68270.0,셀트리온보통주
13051,68270,2019-08-05,0.110091743119266,163500,145500,-18000,3101964,68270.0,셀트리온보통주
13052,68270,2019-08-02,0.0410557184750733,170500,163500,-7000,1247036,68270.0,셀트리온보통주
13053,68270,2019-07-09,0.0655339805825242,206000,192500,-13500,1473892,68270.0,셀트리온보통주
13054,68270,2019-05-28,0.0689655172413793,174000,186000,12000,932491,68270.0,셀트리온보통주
13055,68270,2019-05-10,0.0404761904761904,210000,201500,-8500,698530,68270.0,셀트리온보통주
13056,68270,2019-04-19,0.0712530712530712,203500,218000,14500,1295363,68270.0,셀트리온보통주
13057,68270,2019-04-09,0.0460358056265984,195500,204500,9000,1026289,68270.0,셀트리온보통주
13058,68270,2019-04-02,0.0439560439560439,182000,190000,8000,668630,68270.0,셀트리온보통주
13059,68270,2019-03-27,0.0493506493506493,192500,183000,-9500,1552642,68270.0,셀트리온보통주
13060,68270,2019-01-24,0.04,200000,208000,8000,969990,68270.0,셀트리온보통주
13061,68270,2019-01-04,0.0451306413301662,210500,220000,9500,1132255,68270.0,셀트리온보통주
13062,68270,2018-12-26,0.0831353919239905,210500,228000,17500,3780004,68270.0,셀트리온보통주
13063,68270,2018-12-24,0.0431818181818181,220000,210500,-9500,1606964,68270.0,셀트리온보통주
13064,68270,2018-12-14,0.0436781609195402,217500,208000,-9500,1178385,68270.0,셀트리온보통주
13065,68270,2018-12-11,0.1002044989775051,244500,220000,-24500,2243098,68270.0,셀트리온보통주
13066,68270,2018-12-07,0.0424628450106157,235500,245500,10000,773137,68270.0,셀트리온보통주
13067,68270,2018-11-26,0.088235294117647,221000,240500,19500,1063237,68270.0,셀트리온보통주
13068,68270,2018-11-15,0.0504807692307692,208000,218500,10500,1313803,68270.0,셀트리온보통주
13069,68270,2018-11-12,0.1198257080610021,229500,202000,-27500,3313401,68270.0,셀트리온보통주
13070,68270,2018-11-01,0.0459770114942528,217500,227500,10000,1902740,68270.0,셀트리온보통주
13071,68270,2018-10-29,0.043859649122807,228000,218000,-10000,1450889,68270.0,셀트리온보통주
13072,68270,2018-10-25,0.048780487804878,225500,236500,11000,3582663,68270.0,셀트리온보통주
13073,68270,2018-10-24,0.0851926977687626,246500,225500,-21000,2674768,68270.0,셀트리온보통주
13074,68270,2018-10-23,0.0819366852886405,268500,246500,-22000,7124769,68270.0,셀트리온보통주
13075,68270,2018-10-19,0.0479846449136276,260500,273000,12500,787000,68270.0,셀트리온보통주
13076,68270,2018-10-15,0.0473588342440801,274500,261500,-13000,948682,68270.0,셀트리온보통주
13077,68270,2018-10-11,0.0523560209424083,286500,271500,-15000,1789042,68270.0,셀트리온보통주
13078,68270,2018-09-04,0.048689138576779,267000,280000,13000,994506,68270.0,셀트리온보통주
13079,68270,2018-08-13,0.0422794117647058,272000,260500,-11500,988487,68270.0,셀트리온보통주
13080,68270,2018-07-31,0.0523255813953488,258000,271500,13500,725339,68270.0,셀트리온보통주
13081,68270,2018-07-25,0.0528301886792452,265000,251000,-14000,1947928,68270.0,셀트리온보통주
13082,68270,2018-07-23,0.063047285464098,285500,267500,-18000,1208156,68270.0,셀트리온보통주
13083,68270,2018-07-12,0.0415913200723327,276500,288000,11500,779938,68270.0,셀트리온보통주
13084,68270,2018-06-19,0.0573770491803278,305000,287500,-17500,1278723,68270.0,셀트리온보통주
13085,68270,2018-06-15,0.0660714285714285,280000,298500,18500,1851466,68270.0,셀트리온보통주
13086,68270,2018-05-23,0.0462962962962962,270000,257500,-12500,997007,68270.0,셀트리온보통주
13087,68270,2018-05-15,0.0509803921568627,255000,268000,13000,1489555,68270.0,셀트리온보통주
13088,68270,2018-05-09,0.097457627118644,236000,259000,23000,2553475,68270.0,셀트리온보통주
13089,68270,2018-05-08,0.056,250000,236000,-14000,1422120,68270.0,셀트리온보통주
13090,68270,2018-05-04,0.0458015267175572,262000,250000,-12000,1087480,68270.0,셀트리온보통주
13091,68270,2018-05-02,0.044280442804428,271000,259000,-12000,1284374,68270.0,셀트리온보통주
13092,68270,2018-04-27,0.0758754863813229,257000,276500,19500,1351327,68270.0,셀트리온보통주
13093,68270,2018-04-23,0.0687732342007435,269000,250500,-18500,1984284,68270.0,셀트리온보통주
13094,68270,2018-04-19,0.0632688927943761,284500,266500,-18000,2211139,68270.0,셀트리온보통주
13095,68270,2018-04-09,0.047945205479452,292000,306000,14000,1134927,68270.0,셀트리온보통주
13096,68270,2018-03-29,0.0949913644214162,289500,317000,27500,1955696,68270.0,셀트리온보통주
13097,68270,2018-03-15,0.0522022838499184,306500,322500,16000,2002241,68270.0,셀트리온보통주
13098,68270,2018-03-09,0.0790960451977401,354000,326000,-28000,3558669,68270.0,셀트리온보통주
13099,68270,2018-03-08,0.0892307692307692,325000,354000,29000,7741422,68270.0,셀트리온보통주
13100,68270,2018-03-07,0.1216216216216216,370000,325000,-45000,7588080,68270.0,셀트리온보통주
13101,68270,2018-03-02,0.0538243626062322,353000,372000,19000,1964092,68270.0,셀트리온보통주
13102,68270,2018-02-27,0.0750382848392036,326500,351000,24500,2097880,68270.0,셀트리온보통주
13103,68270,2018-02-14,0.0629251700680272,294000,312500,18500,1715961,68270.0,셀트리온보통주
13104,68270,2018-02-12,0.0503472222222222,288000,302500,14500,2112316,68270.0,셀트리온보통주
13105,68270,2018-02-09,0.0607958732498157,271400,288000,16600,2965646,68270.0,셀트리온보통주
13106,68270,2018-02-08,0.06015625,256000,271400,15400,7760386,68270.0,셀트리온보통주
13107,68270,2018-02-07,0.0992258972554539,284200,256000,-28200,3326704,68270.0,셀트리온보통주
13108,68270,2018-02-05,0.0510948905109489,301400,286000,-15400,1378628,68270.0,셀트리온보통주
13109,68270,2018-02-01,0.050364269876465,315700,299800,-15900,1909895,68270.0,셀트리온보통주
13110,68270,2018-01-29,0.0943333333333333,300000,328300,28300,2153908,68270.0,셀트리온보통주
13111,68270,2018-01-23,0.0655737704918032,280600,299000,18400,2243840,68270.0,셀트리온보통주
13112,68270,2018-01-19,0.0986533041027247,319300,287800,-31500,3755567,68270.0,셀트리온보통주
13113,68270,2018-01-17,0.0975820379965457,347400,313500,-33900,3483413,68270.0,셀트리온보통주
13114,68270,2018-01-12,0.1123778501628664,307000,341500,34500,5792144,68270.0,셀트리온보통주
13115,68270,2018-01-08,0.1333832896215811,266900,302500,35600,4298770,68270.0,셀트리온보통주
13116,68270,2018-01-05,0.0676,250000,266900,16900,1920918,68270.0,셀트리온보통주
13117,68270,2018-01-03,0.0920761398849048,225900,246700,20800,2411162,68270.0,셀트리온보통주
13118,68270,2017-12-27,0.1476923076923077,195000,220000,25000,4011320,68270.0,셀트리온보통주
13119,68270,2017-12-11,0.0453850076491585,196100,205000,8900,950807,68270.0,셀트리온보통주
13120,68270,2017-12-01,0.056471764117941,200100,211400,11300,1390393,68270.0,셀트리온보통주
13121,68270,2017-11-16,0.0503597122302158,208500,219000,10500,3714562,68270.0,셀트리온보통주
13122,68270,2017-11-15,0.0808709175738724,192900,208500,15600,4800414,68270.0,셀트리온보통주
13123,68270,2017-11-13,0.0777084515031196,176300,190000,13700,2963242,68270.0,셀트리온보통주
13124,68270,2017-11-07,0.0468571428571428,175000,166800,-8200,2577921,68270.0,셀트리온보통주
13125,68270,2017-10-26,0.049171270718232,181000,172100,-8900,2263821,68270.0,셀트리온보통주
13126,68270,2017-10-25,0.0518596123624934,190900,181000,-9900,2864225,68270.0,셀트리온보통주
13127,68270,2017-10-24,0.0706674144699943,178300,190900,12600,2191965,68270.0,셀트리온보통주
13128,68270,2017-10-19,0.0879750130140551,192100,175200,-16900,4579716,68270.0,셀트리온보통주
13129,68270,2017-10-17,0.0898237635019897,175900,191700,15800,4993268,68270.0,셀트리온보통주
13130,68270,2017-10-13,0.0908505154639175,155200,169300,14100,5130496,68270.0,셀트리온보통주
13131,68270,2017-10-12,0.0630136986301369,146000,155200,9200,1972627,68270.0,셀트리온보통주
13132,68270,2017-09-27,0.0470175438596491,142500,149200,6700,1625868,68270.0,셀트리온보통주
13133,68270,2017-09-20,0.0516129032258064,139500,146700,7200,2764852,68270.0,셀트리온보통주
13134,68270,2017-09-18,0.0837901331245105,127700,138400,10700,4023490,68270.0,셀트리온보통주
13135,68270,2017-09-15,0.0686192468619246,119500,127700,8200,3049757,68270.0,셀트리온보통주
13136,68270,2017-08-22,0.0588235294117647,110500,117000,6500,1920005,68270.0,셀트리온보통주
13137,68270,2017-08-07,0.0545808966861598,102600,108200,5600,1206218,68270.0,셀트리온보통주
13138,68270,2017-06-20,0.0534562211981566,108500,114300,5800,2484286,68270.0,셀트리온보통주
13139,68270,2017-06-19,0.0402684563758389,104300,108500,4200,1270529,68270.0,셀트리온보통주
13140,68270,2017-05-08,0.0521642619311875,90100,94800,4700,1203072,68270.0,셀트리온보통주
13141,68270,2017-03-17,0.043613707165109,96300,92100,-4200,1176971,68270.0,셀트리온보통주
13142,68270,2016-12-28,0.0489181561618062,106300,106500,200,1624840,68270.0,셀트리온보통주
13143,68270,2016-11-10,0.046078431372549,102000,106700,4700,928468,68270.0,셀트리온보통주
13144,68270,2016-11-09,0.0546802594995366,107900,102000,-5900,2248235,68270.0,셀트리온보통주
13145,68270,2016-10-18,0.07,100000,107000,7000,1023872,68270.0,셀트리온보통주
13146,68270,2016-08-10,0.0504201680672268,107100,112500,5400,2025488,68270.0,셀트리온보통주
13147,69500,2021-01-08,0.0442446043165467,41700,43545,1845,11521190,,
13148,69500,2020-06-16,0.0614232209737827,26700,28340,1640,13674388,,
13149,69500,2020-06-15,0.0503290058687533,28115,26700,-1415,19839278,,
13150,69500,2020-04-01,0.046917168362051,24085,22955,-1130,18755243,,
13151,69500,2020-03-25,0.057314897413024,22420,23705,1285,35369755,,
13152,69500,2020-03-24,0.0928588837436022,20515,22420,1905,19045947,,
13153,69500,2020-03-23,0.05872906629961,21795,20515,-1280,22468822,,
13154,69500,2020-03-20,0.0768280632411067,20240,21795,1555,40017034,,
13155,69500,2020-03-19,0.0732600732600732,21840,20240,-1600,58833336,,
13156,69500,2020-03-18,0.0549545651233232,23110,21840,-1270,28297687,,
13157,69500,2020-03-09,0.042144906743185,27880,26705,-1175,14239886,,
13158,69500,2018-10-11,0.0413280304340307,28915,27720,-1195,11753699,,
13159,69620,2021-05-18,0.0758620689655172,145000,156000,11000,284230,69620.0,대웅제약보통주
13160,69620,2021-05-10,0.048780487804878,143500,150500,7000,163718,69620.0,대웅제약보통주
13161,69620,2021-05-07,0.0551470588235294,136000,143500,7500,336066,69620.0,대웅제약보통주
13162,69620,2021-05-04,0.0592885375494071,126500,134000,7500,102813,69620.0,대웅제약보통주
13163,69620,2021-05-03,0.0524344569288389,133500,126500,-7000,62429,69620.0,대웅제약보통주
13164,69620,2021-04-30,0.0498220640569395,140500,133500,-7000,125749,69620.0,대웅제약보통주
13165,69620,2021-03-17,0.0515873015873015,126000,132500,6500,242044,69620.0,대웅제약보통주
13166,69620,2021-03-04,0.0404411764705882,136000,130500,-5500,108826,69620.0,대웅제약보통주
13167,69620,2021-02-24,0.048780487804878,143500,136500,-7000,144610,69620.0,대웅제약보통주
13168,69620,2021-02-23,0.0771704180064308,155500,143500,-12000,235270,69620.0,대웅제약보통주
13169,69620,2021-02-22,0.1433823529411764,136000,155500,19500,1150456,69620.0,대웅제약보통주
13170,69620,2021-02-16,0.0440677966101694,147500,141000,-6500,319703,69620.0,대웅제약보통주
13171,69620,2021-02-04,0.0564263322884012,159500,150500,-9000,199368,69620.0,대웅제약보통주
13172,69620,2021-01-18,0.0459770114942528,174000,166000,-8000,250259,69620.0,대웅제약보통주
13173,69620,2021-01-11,0.0427350427350427,175500,168000,-7500,330545,69620.0,대웅제약보통주
13174,69620,2021-01-05,0.1075581395348837,172000,190500,18500,2903141,69620.0,대웅제약보통주
13175,69620,2021-01-04,0.0424242424242424,165000,172000,7000,787288,69620.0,대웅제약보통주
13176,69620,2020-12-29,0.0647249190938511,154500,164500,10000,541837,69620.0,대웅제약보통주
13177,69620,2020-12-24,0.059880239520958,167000,157000,-10000,1855893,69620.0,대웅제약보통주
13178,69620,2020-12-23,0.29979035639413,238500,167000,-71500,612231,69620.0,대웅제약보통주
13179,69620,2020-12-22,0.1343012704174228,275500,238500,-37000,633248,69620.0,대웅제약보통주
13180,69620,2020-12-21,0.2995283018867924,212000,275500,63500,314609,69620.0,대웅제약보통주
13181,69620,2020-12-18,0.2079772079772079,175500,212000,36500,5918965,69620.0,대웅제약보통주
13182,69620,2020-12-17,0.3,135000,175500,40500,6454045,69620.0,대웅제약보통주
13183,69620,2020-12-14,0.0631578947368421,142500,133500,-9000,1616439,69620.0,대웅제약보통주
13184,69620,2020-12-10,0.188034188034188,117000,139000,22000,4850359,69620.0,대웅제약보통주
13185,69620,2020-12-09,0.054054054054054,111000,117000,6000,696234,69620.0,대웅제약보통주
13186,69620,2020-12-08,0.0672268907563025,119000,111000,-8000,211472,69620.0,대웅제약보통주
13187,69620,2020-12-04,0.0440528634361233,113500,118500,5000,835147,69620.0,대웅제약보통주
13188,69620,2020-12-01,0.072463768115942,103500,111000,7500,2574960,69620.0,대웅제약보통주
13189,69620,2020-11-25,0.05344295991778,97300,102500,5200,753229,69620.0,대웅제약보통주
13190,69620,2020-10-26,0.081,100000,91900,-8100,170724,69620.0,대웅제약보통주
13191,69620,2020-09-24,0.0647887323943662,106500,99600,-6900,131310,69620.0,대웅제약보통주
13192,69620,2020-08-18,0.0555555555555555,117000,110500,-6500,167645,69620.0,대웅제약보통주
13193,69620,2020-08-07,0.1333333333333333,135000,117000,-18000,1135774,69620.0,대웅제약보통주
13194,69620,2020-08-06,0.1946902654867256,113000,135000,22000,3434964,69620.0,대웅제약보통주
13195,69620,2020-07-07,0.1722846441947565,133500,110500,-23000,1522642,69620.0,대웅제약보통주
13196,69620,2020-07-06,0.0637450199203187,125500,133500,8000,698865,69620.0,대웅제약보통주
13197,69620,2020-07-01,0.0528301886792452,132500,125500,-7000,142610,69620.0,대웅제약보통주
13198,69620,2020-06-30,0.0467625899280575,139000,132500,-6500,181349,69620.0,대웅제약보통주
13199,69620,2020-06-16,0.0401459854014598,137000,142500,5500,206033,69620.0,대웅제약보통주
13200,69620,2020-06-15,0.0711864406779661,147500,137000,-10500,459438,69620.0,대웅제약보통주
13201,69620,2020-06-10,0.0437710437710437,148500,142000,-6500,989282,69620.0,대웅제약보통주
13202,69620,2020-06-09,0.1,135000,148500,13500,2893201,69620.0,대웅제약보통주
13203,69620,2020-06-08,0.0559440559440559,143000,135000,-8000,1061157,69620.0,대웅제약보통주
13204,69620,2020-06-05,0.3,110000,143000,33000,2887016,69620.0,대웅제약보통주
13205,69620,2020-05-29,0.0509259259259259,108000,102500,-5500,201878,69620.0,대웅제약보통주
13206,69620,2020-05-15,0.0485436893203883,103000,108000,5000,469229,69620.0,대웅제약보통주
13207,69620,2020-04-22,0.0841121495327102,107000,116000,9000,1405651,69620.0,대웅제약보통주
13208,69620,2020-04-21,0.0572687224669603,113500,107000,-6500,251208,69620.0,대웅제약보통주
13209,69620,2020-04-20,0.0861244019138756,104500,113500,9000,661028,69620.0,대웅제약보통주
13210,69620,2020-04-14,0.1146161934805467,95100,106000,10900,1515356,69620.0,대웅제약보통주
13211,69620,2020-04-07,0.0532150776053215,90200,95000,4800,97760,69620.0,대웅제약보통주
13212,69620,2020-04-06,0.0488372093023255,86000,90200,4200,94122,69620.0,대웅제약보통주
13213,69620,2020-03-25,0.0693877551020408,73500,78600,5100,356719,69620.0,대웅제약보통주
13214,69620,2020-03-24,0.0824742268041237,67900,73500,5600,597131,69620.0,대웅제약보통주
13215,69620,2020-03-20,0.040625,64000,66600,2600,186584,69620.0,대웅제약보통주
13216,69620,2020-03-19,0.1280653950953678,73400,64000,-9400,205635,69620.0,대웅제약보통주
13217,69620,2020-03-17,0.0525,80000,75800,-4200,229001,69620.0,대웅제약보통주
13218,69620,2020-03-16,0.0950226244343891,88400,80000,-8400,613322,69620.0,대웅제약보통주
13219,69620,2020-03-13,0.0523809523809523,84000,88400,4400,1429800,69620.0,대웅제약보통주
13220,69620,2020-03-12,0.0849673202614379,91800,84000,-7800,136618,69620.0,대웅제약보통주
13221,69620,2020-03-11,0.0516528925619834,96800,91800,-5000,71574,69620.0,대웅제약보통주
13222,69620,2020-03-04,0.0990990990990991,111000,100000,-11000,655362,69620.0,대웅제약보통주
13223,69620,2020-03-02,0.0952380952380952,105000,115000,10000,81021,69620.0,대웅제약보통주
13224,69620,2020-02-24,0.0638297872340425,117500,110000,-7500,35045,69620.0,대웅제약보통주
13225,69620,2020-01-21,0.088235294117647,136000,124000,-12000,225484,69620.0,대웅제약보통주
13226,69620,2020-01-10,0.0651340996168582,130500,139000,8500,105691,69620.0,대웅제약보통주
13227,69620,2019-10-01,0.0536912751677852,149000,157000,8000,52957,69620.0,대웅제약보통주
13228,69620,2019-09-26,0.0416666666666666,156000,149500,-6500,169364,69620.0,대웅제약보통주
13229,69620,2019-09-25,0.0602409638554216,166000,156000,-10000,96925,69620.0,대웅제약보통주
13230,69620,2019-08-30,0.0634920634920634,157500,167500,10000,212942,69620.0,대웅제약보통주
13231,69620,2019-08-12,0.0550161812297734,154500,163000,8500,42931,69620.0,대웅제약보통주
13232,69620,2019-08-08,0.0699300699300699,143000,153000,10000,55206,69620.0,대웅제약보통주
13233,69620,2019-08-05,0.0643086816720257,155500,145500,-10000,49747,69620.0,대웅제약보통주
13234,69620,2019-07-19,0.0404984423676012,160500,167000,6500,57500,69620.0,대웅제약보통주
13235,69620,2019-07-11,0.0465116279069767,150500,157500,7000,61974,69620.0,대웅제약보통주
13236,69620,2019-07-08,0.0411392405063291,158000,151500,-6500,29753,69620.0,대웅제약보통주
13237,69620,2019-06-25,0.0410094637223974,158500,152000,-6500,45592,69620.0,대웅제약보통주
13238,69620,2019-05-29,0.048076923076923,156000,148500,-7500,91372,69620.0,대웅제약보통주
13239,69620,2019-05-21,0.0448717948717948,156000,163000,7000,64714,69620.0,대웅제약보통주
13240,69620,2019-05-20,0.0458715596330275,163500,156000,-7500,79919,69620.0,대웅제약보통주
13241,69620,2019-05-13,0.0793650793650793,189000,174000,-15000,181013,69620.0,대웅제약보통주
13242,69620,2019-03-21,0.0438144329896907,194000,185500,-8500,76739,69620.0,대웅제약보통주
13243,69620,2019-02-07,0.0569948186528497,193000,204000,11000,401670,69620.0,대웅제약보통주
13244,69620,2019-01-31,0.0459459459459459,185000,193500,8500,123091,69620.0,대웅제약보통주
13245,69620,2019-01-08,0.0435967302452316,183500,191500,8000,82656,69620.0,대웅제약보통주
13246,69620,2018-12-27,0.0596590909090909,176000,186500,10500,75120,69620.0,대웅제약보통주
13247,69620,2018-11-08,0.042042042042042,166500,173500,7000,66279,69620.0,대웅제약보통주
13248,69620,2018-11-06,0.0658307210031347,159500,170000,10500,99055,69620.0,대웅제약보통주
13249,69620,2018-11-02,0.0763888888888889,144000,155000,11000,72982,69620.0,대웅제약보통주
13250,69620,2018-10-30,0.0434782608695652,138000,144000,6000,82352,69620.0,대웅제약보통주
13251,69620,2018-10-26,0.0476190476190476,147000,140000,-7000,68017,69620.0,대웅제약보통주
13252,69620,2018-10-23,0.0509554140127388,157000,149000,-8000,66209,69620.0,대웅제약보통주
13253,69620,2018-10-15,0.0516717325227963,164500,156000,-8500,88871,69620.0,대웅제약보통주
13254,69620,2018-10-11,0.0562130177514792,169000,159500,-9500,67473,69620.0,대웅제약보통주
13255,69620,2018-10-05,0.0564516129032258,186000,175500,-10500,96522,69620.0,대웅제약보통주
13256,69620,2018-08-03,0.0720221606648199,180500,193500,13000,181616,69620.0,대웅제약보통주
13257,69620,2018-07-03,0.0431472081218274,197000,205500,8500,77869,69620.0,대웅제약보통주
13258,69620,2018-06-22,0.0729166666666666,192000,206000,14000,91305,69620.0,대웅제약보통주
13259,69620,2018-06-20,0.0558659217877094,179000,189000,10000,55799,69620.0,대웅제약보통주
13260,69620,2018-06-19,0.0529100529100529,189000,179000,-10000,68832,69620.0,대웅제약보통주
13261,69620,2018-05-21,0.0675324675324675,192500,205500,13000,186544,69620.0,대웅제약보통주
13262,69620,2018-05-17,0.072139303482587,201000,186500,-14500,390265,69620.0,대웅제약보통주
13263,69620,2018-05-16,0.0606860158311345,189500,201000,11500,168667,69620.0,대웅제약보통주
13264,69620,2018-05-11,0.056910569105691,184500,195000,10500,104370,69620.0,대웅제약보통주
13265,69620,2018-05-04,0.040983606557377,183000,175500,-7500,62099,69620.0,대웅제약보통주
13266,69620,2018-04-30,0.043010752688172,186000,178000,-8000,106004,69620.0,대웅제약보통주
13267,69620,2018-04-19,0.0534351145038167,196500,186000,-10500,125119,69620.0,대웅제약보통주
13268,69620,2018-04-12,0.0616438356164383,219000,205500,-13500,136025,69620.0,대웅제약보통주
13269,69620,2018-04-06,0.0483091787439613,207000,217000,10000,93636,69620.0,대웅제약보통주
13270,69620,2018-04-04,0.0478589420654911,198500,208000,9500,122407,69620.0,대웅제약보통주
13271,69620,2018-03-23,0.047029702970297,202000,192500,-9500,104439,69620.0,대웅제약보통주
13272,69620,2018-03-21,0.0519480519480519,192500,202500,10000,118612,69620.0,대웅제약보통주
13273,69620,2018-02-28,0.0418848167539267,191000,183000,-8000,120228,69620.0,대웅제약보통주
13274,69620,2018-02-27,0.0465753424657534,182500,191000,8500,158928,69620.0,대웅제약보통주
13275,69620,2018-02-19,0.0473372781065088,169000,177000,8000,116082,69620.0,대웅제약보통주
13276,69620,2018-02-08,0.043613707165109,160500,167500,7000,89874,69620.0,대웅제약보통주
13277,69620,2018-02-07,0.0530973451327433,169500,160500,-9000,114133,69620.0,대웅제약보통주
13278,69620,2018-02-01,0.0415512465373961,180500,173000,-7500,143065,69620.0,대웅제약보통주
13279,69620,2018-01-30,0.0787172011661807,171500,185000,13500,446027,69620.0,대웅제약보통주
13280,69620,2018-01-24,0.1119791666666666,192000,170500,-21500,1136644,69620.0,대웅제약보통주
13281,69620,2018-01-19,0.0408163265306122,196000,188000,-8000,108498,69620.0,대웅제약보통주
13282,69620,2018-01-17,0.0558252427184466,206000,194500,-11500,140081,69620.0,대웅제약보통주
13283,69620,2018-01-12,0.1480446927374301,179000,205500,26500,599894,69620.0,대웅제약보통주
13284,69620,2018-01-10,0.0727272727272727,165000,177000,12000,152420,69620.0,대웅제약보통주
13285,69620,2018-01-04,0.0473372781065088,169000,161000,-8000,142318,69620.0,대웅제약보통주
13286,69620,2017-12-27,0.0921052631578947,152000,166000,14000,162279,69620.0,대웅제약보통주
13287,69620,2017-12-15,0.0669014084507042,142000,151500,9500,163147,69620.0,대웅제약보통주
13288,69620,2017-12-13,0.044280442804428,135500,141500,6000,75029,69620.0,대웅제약보통주
13289,69620,2017-12-11,0.0625,128000,136000,8000,88662,69620.0,대웅제약보통주
13290,69620,2017-11-22,0.0424028268551236,141500,135500,-6000,132795,69620.0,대웅제약보통주
13291,69620,2017-11-20,0.047970479704797,135500,142000,6500,79176,69620.0,대웅제약보통주
13292,69620,2017-11-08,0.068825910931174,123500,132000,8500,115868,69620.0,대웅제약보통주
13293,69620,2017-11-03,0.0641025641025641,117000,124500,7500,151756,69620.0,대웅제약보통주
13294,69620,2017-10-13,0.1,115000,126500,11500,478177,69620.0,대웅제약보통주
13295,69620,2017-10-11,0.0817307692307692,104000,112500,8500,230674,69620.0,대웅제약보통주
13296,69620,2017-09-26,0.0476190476190476,105000,110000,5000,83811,69620.0,대웅제약보통주
13297,69620,2017-09-25,0.0454545454545454,110000,105000,-5000,94315,69620.0,대웅제약보통주
13298,69620,2017-09-22,0.0476190476190476,115500,110000,-5500,127727,69620.0,대웅제약보통주
13299,69620,2017-09-21,0.05,110000,115500,5500,164593,69620.0,대웅제약보통주
13300,69620,2017-09-19,0.073170731707317,102500,110000,7500,231554,69620.0,대웅제약보통주
13301,69620,2017-07-26,0.0550561797752809,89000,93900,4900,231800,69620.0,대웅제약보통주
13302,69620,2017-07-20,0.0593824228028503,84200,89200,5000,161173,69620.0,대웅제약보통주
13303,69620,2017-06-16,0.0666666666666666,93000,86800,-6200,382445,69620.0,대웅제약보통주
13304,69620,2017-06-15,0.07,100000,93000,-7000,448827,69620.0,대웅제약보통주
13305,69620,2017-06-05,0.0639412997903564,95400,101500,6100,217637,69620.0,대웅제약보통주
13306,69620,2017-05-08,0.054525627044711,91700,96700,5000,148374,69620.0,대웅제약보통주
13307,69620,2017-04-03,0.0523186682520808,84100,88500,4400,115620,69620.0,대웅제약보통주
13308,69620,2017-03-27,0.0733249051833122,79100,84900,5800,144816,69620.0,대웅제약보통주
13309,69620,2017-02-10,0.0415094339622641,79500,82800,3300,113027,69620.0,대웅제약보통주
13310,69620,2017-02-07,0.0474358974358974,78000,81700,3700,154725,69620.0,대웅제약보통주
13311,69620,2017-02-03,0.0454545454545454,72600,75900,3300,136745,69620.0,대웅제약보통주
13312,69620,2017-02-01,0.0733137829912023,68200,73200,5000,106238,69620.0,대웅제약보통주
13313,69620,2017-01-05,0.0584795321637426,68400,72400,4000,143234,69620.0,대웅제약보통주
13314,69620,2016-12-13,0.0418535127055306,66900,69700,2800,68406,69620.0,대웅제약보통주
13315,69620,2016-12-12,0.0485893416927899,63800,66900,3100,76104,69620.0,대웅제약보통주
13316,69620,2016-11-18,0.047808764940239,75300,71700,-3600,54396,69620.0,대웅제약보통주
13317,69620,2016-11-10,0.0837988826815642,71600,77600,6000,107898,69620.0,대웅제약보통주
13318,69620,2016-11-04,0.0411931818181818,70400,73300,2900,71763,69620.0,대웅제약보통주
13319,69620,2016-10-28,0.0409276944065484,73300,70300,-3000,59717,69620.0,대웅제약보통주
13320,69620,2016-10-06,0.0443896424167694,81100,77500,-3600,112312,69620.0,대웅제약보통주
13321,69620,2016-09-30,0.0602549246813441,86300,81100,-5200,157527,69620.0,대웅제약보통주
13322,69620,2016-09-23,0.0545905707196029,80600,85000,4400,180994,69620.0,대웅제약보통주
13323,69620,2016-09-20,0.0641711229946524,74800,79600,4800,169427,69620.0,대웅제약보통주
13324,69620,2016-08-22,0.041147132169576,80200,76900,-3300,132162,69620.0,대웅제약보통주
13325,69620,2016-08-18,0.0438908659549228,84300,80600,-3700,207073,69620.0,대웅제약보통주
13326,69620,2016-08-17,0.0674778761061946,90400,84300,-6100,212473,69620.0,대웅제약보통주
13327,69960,2021-03-03,0.0656934306569343,82200,87600,5400,1108512,69960.0,현대백화점보통주
13328,69960,2021-02-05,0.0446998722860791,78300,81800,3500,376046,69960.0,현대백화점보통주
13329,69960,2021-01-08,0.0575635876840696,74700,79000,4300,614195,69960.0,현대백화점보통주
13330,69960,2020-12-02,0.0546984572230014,71300,75200,3900,459696,69960.0,현대백화점보통주
13331,69960,2020-11-10,0.0488188976377952,63500,66600,3100,518723,69960.0,현대백화점보통주
13332,69960,2020-10-27,0.0496124031007751,64500,61300,-3200,344771,69960.0,현대백화점보통주
13333,69960,2020-10-19,0.0726978998384491,61900,66400,4500,959062,69960.0,현대백화점보통주
13334,69960,2020-10-16,0.0473773265651438,59100,61900,2800,339334,69960.0,현대백화점보통주
13335,69960,2020-08-18,0.0552050473186119,63400,59900,-3500,239499,69960.0,현대백화점보통주
13336,69960,2020-06-15,0.0504885993485342,61400,58300,-3100,155869,69960.0,현대백화점보통주
13337,69960,2020-05-19,0.0435435435435435,66600,69500,2900,127911,69960.0,현대백화점보통주
13338,69960,2020-04-28,0.065155807365439,70600,75200,4600,169476,69960.0,현대백화점보통주
13339,69960,2020-04-27,0.0459259259259259,67500,70600,3100,144374,69960.0,현대백화점보통주
13340,69960,2020-04-06,0.0689655172413793,58000,62000,4000,85458,69960.0,현대백화점보통주
13341,69960,2020-04-01,0.042517006802721,58800,56300,-2500,75960,69960.0,현대백화점보통주
13342,69960,2020-03-25,0.0451263537906137,55400,57900,2500,140043,69960.0,현대백화점보통주
13343,69960,2020-03-24,0.0452830188679245,53000,55400,2400,114552,69960.0,현대백화점보통주
13344,69960,2020-03-23,0.1282894736842105,60800,53000,-7800,120557,69960.0,현대백화점보통주
13345,69960,2020-03-19,0.0680061823802163,64700,60300,-4400,112405,69960.0,현대백화점보통주
13346,69960,2020-03-13,0.0713224368499257,67300,62500,-4800,158498,69960.0,현대백화점보통주
13347,69960,2020-02-24,0.0510344827586206,72500,68800,-3700,171429,69960.0,현대백화점보통주
13348,69960,2020-02-20,0.0521628498727735,78600,74500,-4100,137671,69960.0,현대백화점보통주
13349,69960,2020-02-06,0.0463917525773195,77600,81200,3600,70942,69960.0,현대백화점보통주
13350,69960,2020-01-28,0.1062857142857142,87500,78200,-9300,189520,69960.0,현대백화점보통주
13351,69960,2020-01-22,0.0472813238770685,84600,88600,4000,82944,69960.0,현대백화점보통주
13352,69960,2020-01-07,0.0583333333333333,84000,88900,4900,183531,69960.0,현대백화점보통주
13353,69960,2019-09-11,0.0406824146981627,76200,79300,3100,109207,69960.0,현대백화점보통주
13354,69960,2019-08-29,0.0619718309859154,71000,75400,4400,138765,69960.0,현대백화점보통주
13355,69960,2019-02-08,0.0427528675703858,95900,91800,-4100,129677,69960.0,현대백화점보통주
13356,69960,2018-11-15,0.0694117647058823,85000,90900,5900,147946,69960.0,현대백화점보통주
13357,69960,2018-10-11,0.0567451820128479,93400,88100,-5300,183703,69960.0,현대백화점보통주
13358,69960,2018-10-04,0.0504032258064516,99200,94200,-5000,185126,69960.0,현대백화점보통주
13359,69960,2018-07-03,0.0403587443946188,111500,107000,-4500,258049,69960.0,현대백화점보통주
13360,69960,2018-06-29,0.0405405405405405,111000,115500,4500,82375,69960.0,현대백화점보통주
13361,69960,2018-06-19,0.043859649122807,114000,109000,-5000,213099,69960.0,현대백화점보통주
13362,69960,2018-05-31,0.056338028169014,106500,112500,6000,349391,69960.0,현대백화점보통주
13363,69960,2018-05-11,0.0682926829268292,102500,109500,7000,296649,69960.0,현대백화점보통주
13364,69960,2018-05-08,0.0528992878942014,98300,103500,5200,341424,69960.0,현대백화점보통주
13365,69960,2018-04-25,0.0693069306930693,90900,97200,6300,362122,69960.0,현대백화점보통주
13366,69960,2018-02-09,0.0672782874617737,98100,91500,-6600,364482,69960.0,현대백화점보통주
13367,69960,2018-01-08,0.0528846153846153,104000,109500,5500,215093,69960.0,현대백화점보통주
13368,69960,2017-12-15,0.0495049504950495,101000,106000,5000,220359,69960.0,현대백화점보통주
13369,69960,2017-11-10,0.0402173913043478,92000,88300,-3700,333161,69960.0,현대백화점보통주
13370,69960,2017-10-26,0.040137614678899,87200,90700,3500,248297,69960.0,현대백화점보통주
13371,69960,2017-08-10,0.0471698113207547,106000,101000,-5000,232790,69960.0,현대백화점보통주
13372,69960,2017-05-26,0.0514018691588785,107000,112500,5500,257177,69960.0,현대백화점보통주
13373,69960,2017-05-11,0.045045045045045,111000,106000,-5000,344533,69960.0,현대백화점보통주
13374,69960,2017-03-24,0.0548086866597724,96700,102000,5300,475082,69960.0,현대백화점보통주
13375,71050,2021-05-12,0.0409090909090909,110000,105500,-4500,573857,71050.0,한국투자금융지주보통주
13376,71050,2021-05-03,0.0491071428571428,112000,106500,-5500,577530,71050.0,한국투자금융지주보통주
13377,71050,2021-04-29,0.0711297071129707,119500,111000,-8500,724660,71050.0,한국투자금융지주보통주
13378,71050,2021-04-26,0.0555555555555555,108000,114000,6000,522174,71050.0,한국투자금융지주보통주
13379,71050,2021-04-20,0.0576923076923076,104000,110000,6000,584101,71050.0,한국투자금융지주보통주
13380,71050,2021-04-08,0.0423728813559322,94400,98400,4000,1190539,71050.0,한국투자금융지주보통주
13381,71050,2021-04-02,0.050233644859813,85600,89900,4300,668505,71050.0,한국투자금융지주보통주
13382,71050,2021-02-26,0.0510869565217391,92000,87300,-4700,952376,71050.0,한국투자금융지주보통주
13383,71050,2021-02-15,0.0588914549653579,86600,91700,5100,920239,71050.0,한국투자금융지주보통주
13384,71050,2021-02-01,0.040590405904059,81300,84600,3300,378764,71050.0,한국투자금융지주보통주
13385,71050,2021-01-29,0.0546511627906976,86000,81300,-4700,761747,71050.0,한국투자금융지주보통주
13386,71050,2021-01-28,0.042316258351893,89800,86000,-3800,794811,71050.0,한국투자금융지주보통주
13387,71050,2021-01-19,0.0402843601895734,84400,87800,3400,404137,71050.0,한국투자금융지주보통주
13388,71050,2021-01-06,0.0481927710843373,83000,87000,4000,1626783,71050.0,한국투자금융지주보통주
13389,71050,2021-01-04,0.0417721518987341,79000,82300,3300,736512,71050.0,한국투자금융지주보통주
13390,71050,2020-11-16,0.0432432432432432,74000,77200,3200,688676,71050.0,한국투자금융지주보통주
13391,71050,2020-11-11,0.0648275862068965,72500,77200,4700,1057131,71050.0,한국투자금융지주보통주
13392,71050,2020-10-21,0.0556368960468521,68300,72100,3800,467790,71050.0,한국투자금융지주보통주
13393,71050,2020-09-22,0.0488771466314399,75700,72000,-3700,840493,71050.0,한국투자금융지주보통주
13394,71050,2020-09-10,0.0512483574244415,76100,80000,3900,1103534,71050.0,한국투자금융지주보통주
13395,71050,2020-09-08,0.0462287104622871,82200,78400,-3800,1534809,71050.0,한국투자금융지주보통주
13396,71050,2020-09-07,0.1913043478260869,69000,82200,13200,3486985,71050.0,한국투자금융지주보통주
13397,71050,2020-09-02,0.0507936507936507,63000,66200,3200,914269,71050.0,한국투자금융지주보통주
13398,71050,2020-08-27,0.0414673046251993,62700,60100,-2600,452250,71050.0,한국투자금융지주보통주
13399,71050,2020-08-25,0.0782312925170068,58800,63400,4600,602646,71050.0,한국투자금융지주보통주
13400,71050,2020-08-20,0.0510708401976935,60700,57600,-3100,649718,71050.0,한국투자금융지주보통주
13401,71050,2020-08-18,0.0564263322884012,63800,60200,-3600,885028,71050.0,한국투자금융지주보통주
13402,71050,2020-08-10,0.1076158940397351,60400,66900,6500,1075156,71050.0,한국투자금융지주보통주
13403,71050,2020-08-07,0.0504347826086956,57500,60400,2900,589577,71050.0,한국투자금융지주보통주
13404,71050,2020-08-05,0.085820895522388,53600,58200,4600,1189232,71050.0,한국투자금융지주보통주
13405,71050,2020-08-04,0.046875,51200,53600,2400,606381,71050.0,한국투자금융지주보통주
13406,71050,2020-08-03,0.0513347022587269,48700,51200,2500,603757,71050.0,한국투자금융지주보통주
13407,71050,2020-07-21,0.0455486542443064,48300,50500,2200,653869,71050.0,한국투자금융지주보통주
13408,71050,2020-07-13,0.0538641686182669,42700,45000,2300,428892,71050.0,한국투자금융지주보통주
13409,71050,2020-06-16,0.0483042137718396,48650,51000,2350,336320,71050.0,한국투자금융지주보통주
13410,71050,2020-06-15,0.0715648854961832,52400,48650,-3750,458717,71050.0,한국투자금융지주보통주
13411,71050,2020-06-01,0.0455407969639468,52700,55100,2400,415894,71050.0,한국투자금융지주보통주
13412,71050,2020-05-26,0.0421377183967112,48650,50700,2050,380488,71050.0,한국투자금융지주보통주
13413,71050,2020-05-22,0.0487329434697855,51300,48800,-2500,398456,71050.0,한국투자금융지주보통주
13414,71050,2020-05-19,0.0788336933045356,46300,49950,3650,705386,71050.0,한국투자금융지주보통주
13415,71050,2020-05-04,0.0449101796407185,50100,47850,-2250,446697,71050.0,한국투자금융지주보통주
13416,71050,2020-04-29,0.0558482613277133,47450,50100,2650,648728,71050.0,한국투자금융지주보통주
13417,71050,2020-04-17,0.0803080308030803,45450,49100,3650,655648,71050.0,한국투자금융지주보통주
13418,71050,2020-04-06,0.0447427293064877,44700,46700,2000,246932,71050.0,한국투자금융지주보통주
13419,71050,2020-04-01,0.0954773869346733,49750,45000,-4750,363100,71050.0,한국투자금융지주보통주
13420,71050,2020-03-25,0.2535760728218466,38450,48200,9750,746504,71050.0,한국투자금융지주보통주
13421,71050,2020-03-24,0.2015625,32000,38450,6450,662454,71050.0,한국투자금융지주보통주
13422,71050,2020-03-23,0.136302294197031,37050,32000,-5050,721787,71050.0,한국투자금융지주보통주
13423,71050,2020-03-20,0.0560509554140127,39250,37050,-2200,899740,71050.0,한국투자금융지주보통주
13424,71050,2020-03-19,0.1383095499451152,45550,39250,-6300,410100,71050.0,한국투자금융지주보통주
13425,71050,2020-03-18,0.0588842975206611,48400,45550,-2850,232774,71050.0,한국투자금융지주보통주
13426,71050,2020-03-17,0.0601941747572815,51500,48400,-3100,332055,71050.0,한국투자금융지주보통주
13427,71050,2020-03-16,0.0602189781021897,54800,51500,-3300,308312,71050.0,한국투자금융지주보통주
13428,71050,2020-03-12,0.064039408866995,60900,57000,-3900,333966,71050.0,한국투자금융지주보통주
13429,71050,2020-03-09,0.0486656200941915,63700,60600,-3100,182042,71050.0,한국투자금융지주보통주
13430,71050,2020-02-24,0.0569715142428785,66700,62900,-3800,202661,71050.0,한국투자금융지주보통주
13431,71050,2020-02-06,0.0595419847328244,65500,69400,3900,252251,71050.0,한국투자금융지주보통주
13432,71050,2020-01-28,0.0633423180592991,74200,69500,-4700,299548,71050.0,한국투자금융지주보통주
13433,71050,2019-11-04,0.0534124629080118,67400,71000,3600,237029,71050.0,한국투자금융지주보통주
13434,71050,2019-09-16,0.0585885486018641,75100,79500,4400,480508,71050.0,한국투자금융지주보통주
13435,71050,2019-08-30,0.0478260869565217,69000,72300,3300,206692,71050.0,한국투자금융지주보통주
13436,71050,2019-07-19,0.04177545691906,76600,79800,3200,255920,71050.0,한국투자금융지주보통주
13437,71050,2019-06-19,0.0483221476510067,74500,78100,3600,204042,71050.0,한국투자금융지주보통주
13438,71050,2019-05-15,0.0482654600301659,66300,69500,3200,450492,71050.0,한국투자금융지주보통주
13439,71050,2019-04-03,0.0498442367601246,64200,67400,3200,301116,71050.0,한국투자금융지주보통주
13440,71050,2019-03-15,0.0434782608695652,62100,64800,2700,309458,71050.0,한국투자금융지주보통주
13441,71050,2019-02-08,0.0592705167173252,65800,61900,-3900,305090,71050.0,한국투자금융지주보통주
13442,71050,2019-01-24,0.0450885668276972,62100,64900,2800,242548,71050.0,한국투자금융지주보통주
13443,71050,2019-01-15,0.0686106346483705,58300,62300,4000,322675,71050.0,한국투자금융지주보통주
13444,71050,2019-01-07,0.0596491228070175,57000,60400,3400,261447,71050.0,한국투자금융지주보통주
13445,71050,2019-01-02,0.0436974789915966,59500,56900,-2600,215914,71050.0,한국투자금융지주보통주
13446,71050,2018-12-06,0.0412979351032448,67800,65000,-2800,210706,71050.0,한국투자금융지주보통주
13447,71050,2018-11-02,0.0764227642276422,61500,66200,4700,335114,71050.0,한국투자금융지주보통주
13448,71050,2018-10-23,0.0485893416927899,63800,60700,-3100,333163,71050.0,한국투자금융지주보통주
13449,71050,2018-10-11,0.0533536585365853,65600,62100,-3500,467888,71050.0,한국투자금융지주보통주
13450,71050,2018-10-10,0.0588235294117647,69700,65600,-4100,383586,71050.0,한국투자금융지주보통주
13451,71050,2018-10-02,0.041005291005291,75600,72500,-3100,197568,71050.0,한국투자금융지주보통주
13452,71050,2018-09-14,0.0423357664233576,68500,71400,2900,361384,71050.0,한국투자금융지주보통주
13453,71050,2018-08-27,0.0483870967741935,68200,71500,3300,361223,71050.0,한국투자금융지주보통주
13454,71050,2018-08-21,0.0474732006125574,65300,68400,3100,261581,71050.0,한국투자금융지주보통주
13455,71050,2018-08-02,0.0418410041841004,71700,68700,-3000,201064,71050.0,한국투자금융지주보통주
13456,71050,2018-07-16,0.0420382165605095,78500,75200,-3300,207663,71050.0,한국투자금융지주보통주
13457,71050,2018-06-18,0.0424581005586592,89500,85700,-3800,294059,71050.0,한국투자금융지주보통주
13458,71050,2018-06-14,0.0486257928118393,94600,90000,-4600,271973,71050.0,한국투자금융지주보통주
13459,71050,2018-05-28,0.0425079702444208,94100,98100,4000,147478,71050.0,한국투자금융지주보통주
13460,71050,2018-05-10,0.0469644902634593,87300,91400,4100,163452,71050.0,한국투자금융지주보통주
13461,71050,2018-04-24,0.049338146811071,83100,87200,4100,311711,71050.0,한국투자금융지주보통주
13462,71050,2018-04-13,0.0525,80000,84200,4200,326332,71050.0,한국투자금융지주보통주
13463,71050,2018-03-12,0.0423216444981862,82700,86200,3500,278920,71050.0,한국투자금융지주보통주
13464,71050,2018-03-09,0.0726329442282749,77100,82700,5600,349050,71050.0,한국투자금융지주보통주
13465,71050,2018-02-28,0.0530759951749095,82900,78500,-4400,342919,71050.0,한국투자금융지주보통주
13466,71050,2018-02-13,0.0430622009569378,83600,80000,-3600,354662,71050.0,한국투자금융지주보통주
13467,71050,2018-01-23,0.0688405797101449,82800,88500,5700,350365,71050.0,한국투자금융지주보통주
13468,71050,2018-01-12,0.0808344198174706,76700,82900,6200,498377,71050.0,한국투자금융지주보통주
13469,71050,2018-01-08,0.0896551724137931,72500,79000,6500,288808,71050.0,한국투자금융지주보통주
13470,71050,2018-01-05,0.0476878612716763,69200,72500,3300,239570,71050.0,한국투자금융지주보통주
13471,71050,2017-11-14,0.0414746543778801,65100,67800,2700,276205,71050.0,한국투자금융지주보통주
13472,71050,2017-10-12,0.0799347471451876,61300,66200,4900,441752,71050.0,한국투자금융지주보통주
13473,71050,2017-08-03,0.0541666666666666,72000,68100,-3900,425818,71050.0,한국투자금융지주보통주
13474,71050,2017-07-28,0.0613915416098226,73300,68800,-4500,491192,71050.0,한국투자금융지주보통주
13475,71050,2017-06-09,0.0584518167456556,63300,67000,3700,351730,71050.0,한국투자금융지주보통주
13476,71050,2017-05-16,0.0615671641791044,53600,56900,3300,473965,71050.0,한국투자금융지주보통주
13477,71050,2017-04-21,0.0410367170626349,46300,48200,1900,276883,71050.0,한국투자금융지주보통주
13478,71050,2016-11-18,0.0523255813953488,43000,40750,-2250,208463,71050.0,한국투자금융지주보통주
13479,71050,2016-08-05,0.0429378531073446,44250,42350,-1900,241330,71050.0,한국투자금융지주보통주
13480,73240,2021-05-17,0.1566901408450704,5680,4790,-890,5667051,73240.0,금호타이어보통주
13481,73240,2021-05-14,0.0402930402930402,5460,5680,220,2702780,73240.0,금호타이어보통주
13482,73240,2021-05-12,0.10546875,5120,5660,540,7214236,73240.0,금호타이어보통주
13483,73240,2021-05-11,0.1428571428571428,4480,5120,640,11106389,73240.0,금호타이어보통주
13484,73240,2021-05-10,0.086060606060606,4125,4480,355,2666990,73240.0,금호타이어보통주
13485,73240,2021-01-29,0.0574282147315855,4005,3775,-230,1091694,73240.0,금호타이어보통주
13486,73240,2021-01-28,0.0464285714285714,4200,4005,-195,859799,73240.0,금호타이어보통주
13487,73240,2021-01-21,0.0547588005215123,3835,4045,210,2414529,73240.0,금호타이어보통주
13488,73240,2021-01-11,0.0412371134020618,3880,3720,-160,1302925,73240.0,금호타이어보통주
13489,73240,2021-01-07,0.045822102425876,3710,3880,170,1142916,73240.0,금호타이어보통주
13490,73240,2020-11-11,0.0431472081218274,3940,4110,170,848595,73240.0,금호타이어보통주
13491,73240,2020-10-27,0.0403120936280884,3845,3690,-155,684547,73240.0,금호타이어보통주
13492,73240,2020-10-26,0.0563186813186813,3640,3845,205,1170298,73240.0,금호타이어보통주
13493,73240,2020-10-22,0.0403458213256484,3470,3610,140,666859,73240.0,금호타이어보통주
13494,73240,2020-09-22,0.0573566084788029,4010,3780,-230,873504,73240.0,금호타이어보통주
13495,73240,2020-09-17,0.089960886571056,3835,4180,345,3442418,73240.0,금호타이어보통주
13496,73240,2020-09-14,0.1106321839080459,3480,3865,385,2221176,73240.0,금호타이어보통주
13497,73240,2020-09-09,0.0441176470588235,3740,3575,-165,581447,73240.0,금호타이어보통주
13498,73240,2020-09-07,0.0442708333333333,3840,3670,-170,707458,73240.0,금호타이어보통주
13499,73240,2020-09-01,0.0876712328767123,3650,3970,320,2429167,73240.0,금호타이어보통주
13500,73240,2020-08-31,0.0610465116279069,3440,3650,210,1346069,73240.0,금호타이어보통주
13501,73240,2020-08-28,0.1205211726384364,3070,3440,370,3182275,73240.0,금호타이어보통주
13502,73240,2020-08-20,0.0425531914893617,3290,3150,-140,937501,73240.0,금호타이어보통주
13503,73240,2020-08-19,0.0647249190938511,3090,3290,200,1573416,73240.0,금호타이어보통주
13504,73240,2020-08-13,0.0490693739424703,2955,3100,145,1918317,73240.0,금호타이어보통주
13505,73240,2020-06-16,0.0489396411092985,3065,3215,150,433056,73240.0,금호타이어보통주
13506,73240,2020-06-15,0.0754147812971342,3315,3065,-250,624406,73240.0,금호타이어보통주
13507,73240,2020-06-12,0.0528571428571428,3500,3315,-185,748631,73240.0,금호타이어보통주
13508,73240,2020-06-03,0.0647249190938511,3090,3290,200,1686508,73240.0,금호타이어보통주
13509,73240,2020-05-29,0.0407166123778501,3070,2945,-125,884606,73240.0,금호타이어보통주
13510,73240,2020-05-12,0.0442338072669826,3165,3025,-140,770726,73240.0,금호타이어보통주
13511,73240,2020-05-11,0.0462809917355371,3025,3165,140,1038627,73240.0,금호타이어보통주
13512,73240,2020-03-24,0.0531135531135531,2730,2875,145,1030655,73240.0,금호타이어보통주
13513,73240,2020-03-23,0.099009900990099,3030,2730,-300,870369,73240.0,금호타이어보통주
13514,73240,2020-03-19,0.0819165378670788,3235,2970,-265,1292563,73240.0,금호타이어보통주
13515,73240,2020-03-12,0.056551724137931,3625,3420,-205,1087266,73240.0,금호타이어보통주
13516,73240,2020-02-24,0.0427135678391959,3980,3810,-170,499909,73240.0,금호타이어보통주
13517,73240,2019-09-11,0.0441001191895113,4195,4380,185,767686,73240.0,금호타이어보통주
13518,73240,2019-07-31,0.0631578947368421,4275,4005,-270,886393,73240.0,금호타이어보통주
13519,73240,2019-07-16,0.0521436848203939,4315,4540,225,699195,73240.0,금호타이어보통주
13520,73240,2019-07-11,0.0409207161125319,3910,4070,160,272736,73240.0,금호타이어보통주
13521,73240,2019-06-20,0.0541935483870967,3875,4085,210,530320,73240.0,금호타이어보통주
13522,73240,2019-04-16,0.0507968127490039,5020,4765,-255,1295212,73240.0,금호타이어보통주
13523,73240,2019-04-15,0.0669500531349628,4705,5020,315,4893725,73240.0,금호타이어보통주
13524,73240,2019-04-03,0.0414269275028768,4345,4525,180,438833,73240.0,금호타이어보통주
13525,73240,2019-03-25,0.0521920668058455,4790,4540,-250,666505,73240.0,금호타이어보통주
13526,73240,2018-12-27,0.05168986083499,5030,5290,260,711323,73240.0,금호타이어보통주
13527,73240,2018-12-24,0.0404411764705882,5440,5220,-220,648141,73240.0,금호타이어보통주
13528,73240,2018-12-12,0.0510805500982318,5090,5350,260,1070293,73240.0,금호타이어보통주
13529,73240,2018-11-19,0.0424242424242424,4950,5160,210,878546,73240.0,금호타이어보통주
13530,73240,2018-10-16,0.0723140495867768,4840,5190,350,865801,73240.0,금호타이어보통주
13531,73240,2018-10-11,0.059,5000,4705,-295,1147344,73240.0,금호타이어보통주
13532,73240,2018-06-27,0.044709388971684,6710,6410,-300,2249689,73240.0,금호타이어보통주
13533,73240,2018-06-26,0.0419254658385093,6440,6710,270,1787979,73240.0,금호타이어보통주
13534,73240,2018-06-18,0.0431547619047619,6720,6430,-290,1678408,73240.0,금호타이어보통주
13535,73240,2018-05-23,0.0616883116883116,6160,6540,380,5044505,73240.0,금호타이어보통주
13536,73240,2018-04-13,0.0408496732026143,6120,6370,250,9344590,73240.0,금호타이어보통주
13537,73240,2018-04-06,0.0770308123249299,7140,6590,-550,9204715,73240.0,금호타이어보통주
13538,73240,2018-04-05,0.0822622107969151,7780,7140,-640,14899172,73240.0,금호타이어보통주
13539,73240,2018-04-03,0.2988313856427379,5990,7780,1790,45131601,73240.0,금호타이어보통주
13540,73240,2018-04-02,0.2979414951245937,4615,5990,1375,1116449,73240.0,금호타이어보통주
13541,73240,2018-03-30,0.3,3550,4615,1065,41733612,73240.0,금호타이어보통주
13542,73240,2018-03-29,0.1234567901234567,4050,3550,-500,11391282,73240.0,금호타이어보통주
13543,73240,2018-03-28,0.1597510373443983,4820,4050,-770,12376729,73240.0,금호타이어보통주
13544,73240,2018-03-23,0.0660194174757281,5150,4810,-340,5791797,73240.0,금호타이어보통주
13545,73240,2018-03-22,0.0934182590233545,4710,5150,440,12550765,73240.0,금호타이어보통주
13546,73240,2018-03-20,0.049746192893401,4925,4680,-245,2334745,73240.0,금호타이어보통주
13547,73240,2018-03-19,0.0501066098081023,4690,4925,235,5873428,73240.0,금호타이어보통주
13548,73240,2018-03-08,0.0484988452655889,4330,4540,210,2846964,73240.0,금호타이어보통주
13549,73240,2018-03-07,0.0826271186440678,4720,4330,-390,3438521,73240.0,금호타이어보통주
13550,73240,2018-03-05,0.0998080614203454,5210,4690,-520,7531047,73240.0,금호타이어보통주
13551,73240,2018-03-02,0.0696428571428571,5600,5210,-390,10079139,73240.0,금호타이어보통주
13552,73240,2018-02-28,0.0526315789473684,5320,5600,280,12637923,73240.0,금호타이어보통주
13553,73240,2018-02-26,0.164274322169059,6270,5240,-1030,18964873,73240.0,금호타이어보통주
13554,73240,2018-02-19,0.0434056761268781,5990,6250,260,1748118,73240.0,금호타이어보통주
13555,73240,2018-02-12,0.0465116279069767,6450,6150,-300,2141948,73240.0,금호타이어보통주
13556,73240,2018-02-05,0.0498614958448753,7220,6860,-360,7060656,73240.0,금호타이어보통주
13557,73240,2018-02-02,0.0989345509893455,6570,7220,650,6976890,73240.0,금호타이어보통주
13558,73240,2018-02-01,0.1042016806722689,5950,6570,620,7788015,73240.0,금호타이어보통주
13559,73240,2018-01-18,0.0416666666666666,5040,5250,210,4882351,73240.0,금호타이어보통주
13560,73240,2018-01-08,0.0456349206349206,5040,4810,-230,2948902,73240.0,금호타이어보통주
13561,73240,2018-01-03,0.1901565995525727,4470,5320,850,22194916,73240.0,금호타이어보통주
13562,73240,2017-12-21,0.0466148723640399,4505,4295,-210,3116766,73240.0,금호타이어보통주
13563,73240,2017-12-15,0.1082089552238805,4020,4455,435,39413163,73240.0,금호타이어보통주
13564,73240,2017-12-13,0.0449029126213592,4120,3935,-185,5473559,73240.0,금호타이어보통주
13565,73240,2017-12-12,0.0757180156657963,3830,4120,290,16033682,73240.0,금호타이어보통주
13566,73240,2017-12-11,0.1314623338257016,3385,3830,445,18823881,73240.0,금호타이어보통주
13567,73240,2017-12-08,0.2991718426501035,4830,3385,-1445,32842145,73240.0,금호타이어보통주
13568,73240,2017-12-07,0.2989840348330914,6890,4830,-2060,30104679,73240.0,금호타이어보통주
13569,73240,2017-12-05,0.0526315789473684,6650,7000,350,3213552,73240.0,금호타이어보통주
13570,73240,2017-10-25,0.0594059405940594,6060,6420,360,2511082,73240.0,금호타이어보통주
13571,73240,2017-10-20,0.0807560137457044,5820,6290,470,3863757,73240.0,금호타이어보통주
13572,73240,2017-09-28,0.0569395017793594,5620,5940,320,5925060,73240.0,금호타이어보통주
13573,73240,2017-09-27,0.0643939393939393,5280,5620,340,4555630,73240.0,금호타이어보통주
13574,73240,2017-09-26,0.062374245472837,4970,5280,310,3150833,73240.0,금호타이어보통주
13575,73240,2017-09-25,0.0423892100192678,5190,4970,-220,1167394,73240.0,금호타이어보통주
13576,73240,2017-09-22,0.0614828209764918,5530,5190,-340,1881888,73240.0,금호타이어보통주
13577,73240,2017-09-21,0.0907297830374753,5070,5530,460,6261346,73240.0,금호타이어보통주
13578,73240,2017-09-13,0.0513307984790874,5260,4990,-270,3648047,73240.0,금호타이어보통주
13579,73240,2017-09-11,0.059040590405904,5420,5100,-320,3079893,73240.0,금호타이어보통주
13580,73240,2017-09-06,0.1869300911854103,6580,5350,-1230,11136955,73240.0,금호타이어보통주
13581,73240,2017-08-22,0.0402384500745156,6710,6440,-270,1703971,73240.0,금호타이어보통주
13582,73240,2017-08-18,0.0522598870056497,7080,6710,-370,2131067,73240.0,금호타이어보통주
13583,73240,2017-07-19,0.0518134715025906,7720,7320,-400,2326369,73240.0,금호타이어보통주
13584,73240,2017-07-18,0.0722222222222222,7200,7720,520,2769251,73240.0,금호타이어보통주
13585,73240,2017-07-13,0.0482573726541554,7460,7100,-360,3464089,73240.0,금호타이어보통주
13586,73240,2017-07-06,0.0600255427841634,7830,8300,470,6470258,73240.0,금호타이어보통주
13587,73240,2017-06-19,0.0428571428571428,7700,7370,-330,2078013,73240.0,금호타이어보통주
13588,73240,2017-06-14,0.0570652173913043,7360,7780,420,2165514,73240.0,금호타이어보통주
13589,73240,2017-05-26,0.046195652173913,7360,7020,-340,3533719,73240.0,금호타이어보통주
13590,73240,2017-04-20,0.0451306413301662,8420,8800,380,2388995,73240.0,금호타이어보통주
13591,73240,2017-03-22,0.0466257668711656,8150,8530,380,1487374,73240.0,금호타이어보통주
13592,73240,2017-03-13,0.0669099756690997,8220,8770,550,2918157,73240.0,금호타이어보통주
13593,73240,2017-02-13,0.0574412532637075,7660,8100,440,1737201,73240.0,금호타이어보통주
13594,73240,2017-02-09,0.0566265060240963,8300,7830,-470,2453862,73240.0,금호타이어보통주
13595,73240,2017-01-17,0.0456521739130434,9200,8780,-420,3149022,73240.0,금호타이어보통주
13596,73240,2017-01-13,0.0535917901938426,8770,9240,470,3264778,73240.0,금호타이어보통주
13597,73240,2017-01-06,0.0543093270365997,8470,8930,460,1863343,73240.0,금호타이어보통주
13598,73240,2016-12-29,0.0404907975460122,8150,8480,330,1093582,73240.0,금호타이어보통주
13599,73240,2016-11-28,0.0441176470588235,8840,8450,-390,1931442,73240.0,금호타이어보통주
13600,73240,2016-11-25,0.0511296076099881,8410,8840,430,1631394,73240.0,금호타이어보통주
13601,73240,2016-11-21,0.0472103004291845,9320,8880,-440,2068186,73240.0,금호타이어보통주
13602,73240,2016-11-18,0.0817733990147783,10150,9320,-830,3527079,73240.0,금호타이어보통주
13603,73240,2016-11-17,0.0424528301886792,10600,10150,-450,1146563,73240.0,금호타이어보통주
13604,73240,2016-11-10,0.0473933649289099,10550,10050,-500,3178826,73240.0,금호타이어보통주
13605,73240,2016-11-03,0.056338028169014,9940,10500,560,847484,73240.0,금호타이어보통주
13606,73240,2016-10-10,0.0465116279069767,10750,11250,500,2052557,73240.0,금호타이어보통주
13607,73240,2016-09-07,0.0845771144278607,10050,10900,850,4112941,73240.0,금호타이어보통주
13608,73240,2016-08-03,0.0432098765432098,9720,9300,-420,1222824,73240.0,금호타이어보통주
13609,78930,2021-06-01,0.0422993492407809,46100,48050,1950,595903,78930.0,GS보통주
13610,78930,2021-05-20,0.0448065173116089,49100,46900,-2200,719198,78930.0,GS보통주
13611,78930,2021-05-12,0.047,50000,47650,-2350,939668,78930.0,GS보통주
13612,78930,2021-05-10,0.0556745182012847,46700,49300,2600,1258898,78930.0,GS보통주
13613,78930,2021-05-06,0.0848837209302325,43000,46650,3650,1045093,78930.0,GS보통주
13614,78930,2021-04-26,0.050887573964497,42250,44400,2150,876231,78930.0,GS보통주
13615,78930,2021-04-14,0.0409731113956466,39050,40650,1600,1300171,78930.0,GS보통주
13616,78930,2021-02-24,0.0435835351089588,41300,39500,-1800,720116,78930.0,GS보통주
13617,78930,2021-02-22,0.0526315789473684,38950,41000,2050,922640,78930.0,GS보통주
13618,78930,2021-01-11,0.0408653846153846,41600,39900,-1700,1005777,78930.0,GS보통주
13619,78930,2021-01-08,0.0531645569620253,39500,41600,2100,1207880,78930.0,GS보통주
13620,78930,2020-12-01,0.0470756062767475,35050,36700,1650,520788,78930.0,GS보통주
13621,78930,2020-11-30,0.0615796519410977,37350,35050,-2300,1359600,78930.0,GS보통주
13622,78930,2020-11-16,0.0424657534246575,36500,38050,1550,441698,78930.0,GS보통주
13623,78930,2020-11-11,0.044776119402985,36850,38500,1650,1045977,78930.0,GS보통주
13624,78930,2020-11-10,0.0681159420289855,34500,36850,2350,1208620,78930.0,GS보통주
13625,78930,2020-10-12,0.0469483568075117,31950,33450,1500,632054,78930.0,GS보통주
13626,78930,2020-08-20,0.0530846484935437,34850,33000,-1850,538532,78930.0,GS보통주
13627,78930,2020-06-16,0.0552486187845303,36200,38200,2000,248423,78930.0,GS보통주
13628,78930,2020-06-03,0.040764331210191,39250,40850,1600,496828,78930.0,GS보통주
13629,78930,2020-05-26,0.0435356200527704,37900,39550,1650,388595,78930.0,GS보통주
13630,78930,2020-05-06,0.0416107382550335,37250,38800,1550,382368,78930.0,GS보통주
13631,78930,2020-04-06,0.0601604278074866,37400,39650,2250,301095,78930.0,GS보통주
13632,78930,2020-04-02,0.0861581920903954,35400,38450,3050,364422,78930.0,GS보통주
13633,78930,2020-03-26,0.06265664160401,39900,37400,-2500,400721,78930.0,GS보통주
13634,78930,2020-03-25,0.1432664756446991,34900,39900,5000,484138,78930.0,GS보통주
13635,78930,2020-03-24,0.0705521472392638,32600,34900,2300,366497,78930.0,GS보통주
13636,78930,2020-03-23,0.0881118881118881,35750,32600,-3150,339139,78930.0,GS보통주
13637,78930,2020-03-13,0.0590551181102362,38100,35850,-2250,406795,78930.0,GS보통주
13638,78930,2020-03-12,0.0510585305105853,40150,38100,-2050,345886,78930.0,GS보통주
13639,78930,2020-03-10,0.0479896238651102,38550,40400,1850,361388,78930.0,GS보통주
13640,78930,2020-02-24,0.0534698521046643,43950,41600,-2350,229758,78930.0,GS보통주
13641,78930,2020-02-06,0.0432372505543237,45100,47050,1950,199039,78930.0,GS보통주
13642,78930,2019-08-30,0.0434782608695652,46000,48000,2000,209593,78930.0,GS보통주
13643,78930,2019-03-14,0.0428015564202334,51400,53600,2200,361757,78930.0,GS보통주
13644,78930,2019-01-02,0.0600775193798449,51600,48500,-3100,271228,78930.0,GS보통주
13645,78930,2018-10-26,0.0457256461232604,50300,48000,-2300,323772,78930.0,GS보통주
13646,78930,2018-10-11,0.0531135531135531,54600,51700,-2900,337683,78930.0,GS보통주
13647,78930,2018-07-02,0.0625,54400,51000,-3400,377965,78930.0,GS보통주
13648,78930,2018-06-19,0.0450606585788561,57700,55100,-2600,356047,78930.0,GS보통주
13649,78930,2018-04-04,0.0425867507886435,63400,60700,-2700,341186,78930.0,GS보통주
13650,78930,2018-02-07,0.0405405405405405,66600,63900,-2700,305362,78930.0,GS보통주
13651,78930,2018-01-10,0.0481540930979133,62300,65300,3000,423317,78930.0,GS보통주
13652,78930,2017-11-15,0.0448,62500,59700,-2800,829784,78930.0,GS보통주
13653,78930,2017-08-16,0.0453257790368272,70600,67400,-3200,535075,78930.0,GS보통주
13654,78930,2017-05-25,0.0406976744186046,68800,71600,2800,424534,78930.0,GS보통주
13655,78930,2017-05-22,0.0415384615384615,65000,67700,2700,471803,78930.0,GS보통주
13656,78930,2017-02-10,0.0569744597249508,50900,53800,2900,400745,78930.0,GS보통주
13657,81660,2021-06-01,0.0642201834862385,54500,58000,3500,888400,81660.0,휠라홀딩스보통주
13658,81660,2021-05-21,0.0508771929824561,57000,54100,-2900,939389,81660.0,휠라홀딩스보통주
13659,81660,2021-05-10,0.1324570273003033,49450,56000,6550,2832732,81660.0,휠라홀딩스보통주
13660,81660,2021-05-07,0.075,46000,49450,3450,2887823,81660.0,휠라홀딩스보통주
13661,81660,2021-04-16,0.0675990675990676,42900,45800,2900,1199897,81660.0,휠라홀딩스보통주
13662,81660,2021-03-23,0.0528789659224441,42550,44800,2250,976296,81660.0,휠라홀딩스보통주
13663,81660,2021-03-03,0.0475,40000,41900,1900,608403,81660.0,휠라홀딩스보통주
13664,81660,2021-02-25,0.0401002506265664,39900,41500,1600,251314,81660.0,휠라홀딩스보통주
13665,81660,2021-01-29,0.046875,44800,42700,-2100,1145558,81660.0,휠라홀딩스보통주
13666,81660,2021-01-19,0.0499445061043285,45050,47300,2250,336839,81660.0,휠라홀딩스보통주
13667,81660,2021-01-05,0.043173862310385,42850,44700,1850,664596,81660.0,휠라홀딩스보통주
13668,81660,2020-11-18,0.0419354838709677,46500,44550,-1950,573128,81660.0,휠라홀딩스보통주
13669,81660,2020-11-17,0.0472972972972973,44400,46500,2100,689121,81660.0,휠라홀딩스보통주
13670,81660,2020-11-12,0.0421052631578947,47500,45500,-2000,569478,81660.0,휠라홀딩스보통주
13671,81660,2020-11-10,0.074245939675174,43100,46300,3200,915615,81660.0,휠라홀딩스보통주
13672,81660,2020-11-02,0.0600522193211488,38300,40600,2300,338849,81660.0,휠라홀딩스보통주
13673,81660,2020-10-30,0.0401002506265664,39900,38300,-1600,322292,81660.0,휠라홀딩스보통주
13674,81660,2020-10-28,0.057544757033248,39100,41350,2250,405544,81660.0,휠라홀딩스보통주
13675,81660,2020-10-23,0.0461922596754057,40050,41900,1850,1425556,81660.0,휠라홀딩스보통주
13676,81660,2020-10-14,0.0426829268292682,41000,39250,-1750,535752,81660.0,휠라홀딩스보통주
13677,81660,2020-10-13,0.0459183673469387,39200,41000,1800,782399,81660.0,휠라홀딩스보통주
13678,81660,2020-10-12,0.0439414114513981,37550,39200,1650,448539,81660.0,휠라홀딩스보통주
13679,81660,2020-09-24,0.0436562073669849,36650,35050,-1600,298061,81660.0,휠라홀딩스보통주
13680,81660,2020-09-17,0.0422163588390501,37900,36300,-1600,304139,81660.0,휠라홀딩스보통주
13681,81660,2020-09-03,0.0604026845637583,37250,39500,2250,1230204,81660.0,휠라홀딩스보통주
13682,81660,2020-09-01,0.0662824207492795,34700,37000,2300,486193,81660.0,휠라홀딩스보통주
13683,81660,2020-08-31,0.0634278002699055,37050,34700,-2350,607832,81660.0,휠라홀딩스보통주
13684,81660,2020-08-24,0.0541353383458646,33250,35050,1800,824134,81660.0,휠라홀딩스보통주
13685,81660,2020-08-21,0.0973597359735973,30300,33250,2950,916405,81660.0,휠라홀딩스보통주
13686,81660,2020-08-18,0.0571847507331378,34100,32150,-1950,584434,81660.0,휠라홀딩스보통주
13687,81660,2020-08-11,0.049306625577812,32450,34050,1600,627559,81660.0,휠라홀딩스보통주
13688,81660,2020-08-03,0.0434131736526946,33400,31950,-1450,453075,81660.0,휠라홀딩스보통주
13689,81660,2020-07-10,0.0508474576271186,38350,36400,-1950,1038624,81660.0,휠라홀딩스보통주
13690,81660,2020-07-07,0.0610795454545454,35200,37350,2150,810162,81660.0,휠라홀딩스보통주
13691,81660,2020-06-22,0.0472972972972973,37000,35250,-1750,429270,81660.0,휠라홀딩스보통주
13692,81660,2020-06-15,0.0668414154652686,38150,35600,-2550,943048,81660.0,휠라홀딩스보통주
13693,81660,2020-06-12,0.0683760683760683,40950,38150,-2800,975775,81660.0,휠라홀딩스보통주
13694,81660,2020-06-04,0.0490196078431372,40800,42800,2000,1144284,81660.0,휠라홀딩스보통주
13695,81660,2020-05-28,0.0590452261306532,39800,37450,-2350,922656,81660.0,휠라홀딩스보통주
13696,81660,2020-05-27,0.0964187327823691,36300,39800,3500,1625527,81660.0,휠라홀딩스보통주
13697,81660,2020-05-20,0.0751104565537555,33950,36500,2550,1531949,81660.0,휠라홀딩스보통주
13698,81660,2020-05-19,0.0898876404494382,31150,33950,2800,1520235,81660.0,휠라홀딩스보통주
13699,81660,2020-05-12,0.0424242424242424,33000,31600,-1400,588971,81660.0,휠라홀딩스보통주
13700,81660,2020-04-17,0.040625,32000,33300,1300,997356,81660.0,휠라홀딩스보통주
13701,81660,2020-04-13,0.0602055800293685,34050,32000,-2050,561897,81660.0,휠라홀딩스보통주
13702,81660,2020-04-06,0.0888099467140319,28150,30650,2500,909791,81660.0,휠라홀딩스보통주
13703,81660,2020-03-26,0.1016635859519408,27050,29800,2750,2432110,81660.0,휠라홀딩스보통주
13704,81660,2020-03-25,0.2973621103117506,20850,27050,6200,1790185,81660.0,휠라홀딩스보통주
13705,81660,2020-03-24,0.0692307692307692,19500,20850,1350,1114439,81660.0,휠라홀딩스보통주
13706,81660,2020-03-23,0.0823529411764705,21250,19500,-1750,677460,81660.0,휠라홀딩스보통주
13707,81660,2020-03-19,0.1136842105263157,23750,21050,-2700,2363952,81660.0,휠라홀딩스보통주
13708,81660,2020-03-18,0.1782006920415225,28900,23750,-5150,1473486,81660.0,휠라홀딩스보통주
13709,81660,2020-03-13,0.0708782742681047,32450,30150,-2300,1174769,81660.0,휠라홀딩스보통주
13710,81660,2020-03-12,0.0621387283236994,34600,32450,-2150,672054,81660.0,휠라홀딩스보통주
13711,81660,2020-03-09,0.0525587828492392,36150,34250,-1900,645934,81660.0,휠라홀딩스보통주
13712,81660,2020-03-06,0.065891472868217,38700,36150,-2550,780457,81660.0,휠라홀딩스보통주
13713,81660,2020-02-28,0.0411985018726591,40050,38400,-1650,618422,81660.0,휠라홀딩스보통주
13714,81660,2020-02-24,0.0476758045292014,41950,39950,-2000,506391,81660.0,휠라홀딩스보통주
13715,81660,2020-01-28,0.0456521739130434,46000,43900,-2100,757715,81660.0,휠라홀딩스보통주
13716,81660,2020-01-09,0.0437743190661478,51400,49150,-2250,1723223,81660.0,휠라홀딩스보통주
13717,81660,2019-11-21,0.0422018348623853,54500,52200,-2300,1082792,81660.0,휠라홀딩스보통주
13718,81660,2019-11-20,0.0570934256055363,57800,54500,-3300,1082627,81660.0,휠라홀딩스보통주
13719,81660,2019-11-13,0.0404929577464788,56800,59100,2300,906553,81660.0,휠라홀딩스보통주
13720,81660,2019-11-12,0.0453781512605042,59500,56800,-2700,2383004,81660.0,휠라홀딩스보통주
13721,81660,2019-11-11,0.0418679549114331,62100,59500,-2600,626322,81660.0,휠라홀딩스보통주
13722,81660,2019-11-01,0.0572916666666666,57600,60900,3300,1104388,81660.0,휠라홀딩스보통주
13723,81660,2019-10-15,0.059625212947189,58700,55200,-3500,907538,81660.0,휠라홀딩스보통주
13724,81660,2019-10-04,0.0448275862068965,58000,55400,-2600,1324639,81660.0,휠라홀딩스보통주
13725,81660,2019-09-26,0.0492610837438423,60900,57900,-3000,928246,81660.0,휠라홀딩스보통주
13726,81660,2019-09-20,0.0466666666666666,60000,62800,2800,723920,81660.0,휠라홀딩스보통주
13727,81660,2019-09-16,0.0545774647887323,56800,59900,3100,962711,81660.0,휠라홀딩스보통주
13728,81660,2019-08-27,0.0994263862332696,52300,57500,5200,1400285,81660.0,휠라홀딩스보통주
13729,81660,2019-08-26,0.049090909090909,55000,52300,-2700,856511,81660.0,휠라홀딩스보통주
13730,81660,2019-08-21,0.0416666666666666,55200,52900,-2300,1562087,81660.0,휠라홀딩스보통주
13731,81660,2019-08-19,0.0795262267343485,59100,54400,-4700,2049829,81660.0,휠라홀딩스보통주
13732,81660,2019-08-14,0.0768049155145929,65100,60100,-5000,2705269,81660.0,휠라홀딩스보통주
13733,81660,2019-07-15,0.04,72500,69600,-2900,500145,81660.0,휠라홀딩스보통주
13734,81660,2019-06-14,0.0444444444444444,81000,84600,3600,662123,81660.0,휠라홀딩스보통주
13735,81660,2019-06-07,0.0508701472556894,74700,78500,3800,588681,81660.0,휠라홀딩스보통주
13736,81660,2019-05-17,0.0530864197530864,81000,85300,4300,784672,81660.0,휠라홀딩스보통주
13737,81660,2019-05-16,0.0411311053984575,77800,81000,3200,768416,81660.0,휠라홀딩스보통주
13738,81660,2019-04-17,0.0512195121951219,82000,77800,-4200,648141,81660.0,휠라홀딩스보통주
13739,81660,2019-04-03,0.0448548812664907,75800,72400,-3400,1172424,81660.0,휠라홀딩스보통주
13740,81660,2019-03-29,0.046979865771812,74500,78000,3500,437524,81660.0,휠라홀딩스보통주
13741,81660,2019-03-20,0.073394495412844,65400,70200,4800,1035493,81660.0,휠라홀딩스보통주
13742,81660,2019-03-07,0.044776119402985,60300,63000,2700,828139,81660.0,휠라홀딩스보통주
13743,81660,2019-03-06,0.0432525951557093,57800,60300,2500,1119552,81660.0,휠라홀딩스보통주
13744,81660,2019-02-26,0.0497131931166348,52300,54900,2600,900786,81660.0,휠라홀딩스보통주
13745,81660,2019-02-21,0.0612244897959183,49000,52000,3000,750851,81660.0,휠라홀딩스보통주
13746,81660,2019-02-14,0.0588876772082878,45850,48550,2700,891263,81660.0,휠라홀딩스보통주
13747,81660,2019-02-08,0.0797546012269938,48900,45000,-3900,1216176,81660.0,휠라홀딩스보통주
13748,81660,2019-01-02,0.0448598130841121,53500,51100,-2400,317655,81660.0,휠라홀딩스보통주
13749,81660,2018-12-28,0.0490196078431372,51000,53500,2500,511197,81660.0,휠라홀딩스보통주
13750,81660,2018-12-27,0.0408163265306122,49000,51000,2000,754655,81660.0,휠라홀딩스보통주
13751,81660,2018-12-20,0.0722222222222222,54000,50100,-3900,661207,81660.0,휠라홀딩스보통주
13752,81660,2018-12-18,0.0479041916167664,50100,52500,2400,626768,81660.0,휠라홀딩스보통주
13753,81660,2018-12-04,0.064,50000,53200,3200,1098228,81660.0,휠라홀딩스보통주
13754,81660,2018-11-29,0.0652173913043478,55200,51600,-3600,1712890,81660.0,휠라홀딩스보통주
13755,81660,2018-11-14,0.0513307984790874,52600,55300,2700,1697340,81660.0,휠라홀딩스보통주
13756,81660,2018-11-12,0.1141649048625792,47300,52700,5400,1672676,81660.0,휠라홀딩스보통주
13757,81660,2018-11-07,0.0416666666666666,46800,48750,1950,549905,81660.0,휠라홀딩스보통주
13758,81660,2018-11-06,0.0493273542600896,44600,46800,2200,700751,81660.0,휠라홀딩스보통주
13759,81660,2018-10-30,0.0822998872604284,44350,40700,-3650,1560869,81660.0,휠라홀딩스보통주
13760,81660,2018-10-12,0.0998735777496839,39550,43500,3950,754418,81660.0,휠라홀딩스보통주
13761,81660,2018-10-11,0.0469879518072289,41500,39550,-1950,600217,81660.0,휠라홀딩스보통주
13762,81660,2018-09-27,0.0898203592814371,41750,45500,3750,837411,81660.0,휠라홀딩스보통주
13763,81660,2018-09-07,0.049338146811071,41550,39500,-2050,921097,81660.0,휠라홀딩스보통주
13764,81660,2018-09-06,0.0439698492462311,39800,41550,1750,661505,81660.0,휠라홀딩스보통주
13765,81660,2018-09-03,0.0407185628742515,41750,40050,-1700,515454,81660.0,휠라홀딩스보통주
13766,81660,2018-08-16,0.0888252148997134,34900,38000,3100,1459504,81660.0,휠라홀딩스보통주
13767,81660,2018-08-14,0.0889235569422776,32050,34900,2850,1136999,81660.0,휠라홀딩스보통주
13768,81660,2018-08-09,0.0410509031198686,30450,31700,1250,293190,81660.0,휠라홀딩스보통주
13769,81660,2018-08-03,0.0509868421052631,30400,31950,1550,558546,81660.0,휠라홀딩스보통주
13770,81660,2018-08-02,0.0602782071097372,32350,30400,-1950,474991,81660.0,휠라홀딩스보통주
13771,81660,2018-07-24,0.0789049919484702,31050,33500,2450,849976,81660.0,휠라홀딩스보통주
13772,81660,2018-07-23,0.0446153846153846,32500,31050,-1450,358507,81660.0,휠라홀딩스보통주
13773,81660,2018-07-13,0.0451127819548872,33250,34750,1500,563944,81660.0,휠라홀딩스보통주
13774,81660,2018-07-11,0.0480349344978165,34350,32700,-1650,480423,81660.0,휠라홀딩스보통주
13775,81660,2018-07-03,0.04860088365243,33950,35600,1650,501535,81660.0,휠라홀딩스보통주
13776,81660,2018-06-26,0.0630136986301369,36500,34200,-2300,808481,81660.0,휠라홀딩스보통주
13777,81660,2018-06-25,0.0473457675753228,34850,36500,1650,569540,81660.0,휠라홀딩스보통주
13778,81660,2018-06-20,0.0482115085536547,32150,33700,1550,659044,81660.0,휠라홀딩스보통주
13779,81660,2018-06-12,0.0673234811165845,30450,32500,2050,656053,81660.0,휠라홀딩스보통주
13780,81660,2018-05-31,0.0448028673835125,27900,29150,1250,1021032,81660.0,휠라홀딩스보통주
13781,81660,2018-05-30,0.0449438202247191,26700,27900,1200,521422,81660.0,휠라홀딩스보통주
13782,81660,2018-05-21,0.0410714285714285,28000,26850,-1150,439938,81660.0,휠라홀딩스보통주
13783,81660,2018-05-11,0.0431372549019607,25500,26600,1100,555223,81660.0,휠라홀딩스보통주
13784,81660,2018-04-12,0.0418410041841004,119500,124500,5000,141950,81660.0,휠라홀딩스보통주
13785,81660,2018-04-10,0.0486725663716814,113000,118500,5500,117372,81660.0,휠라홀딩스보통주
13786,81660,2018-04-06,0.0407239819004524,110500,115000,4500,153500,81660.0,휠라홀딩스보통주
13787,81660,2018-03-20,0.0788177339901477,101500,109500,8000,157294,81660.0,휠라홀딩스보통주
13788,81660,2018-03-09,0.0424528301886792,106000,101500,-4500,77491,81660.0,휠라홀딩스보통주
13789,81660,2018-03-08,0.0663983903420523,99400,106000,6600,108996,81660.0,휠라홀딩스보통주
13790,81660,2018-02-26,0.0559662090813094,94700,100000,5300,301570,81660.0,휠라홀딩스보통주
13791,81660,2018-02-23,0.0676437429537767,88700,94700,6000,296775,81660.0,휠라홀딩스보통주
13792,81660,2018-01-03,0.0504201680672268,83300,87500,4200,78619,81660.0,휠라홀딩스보통주
13793,81660,2017-11-09,0.0761346998535871,68300,73500,5200,261397,81660.0,휠라홀딩스보통주
13794,81660,2017-08-16,0.044382801664355,72100,68900,-3200,142247,81660.0,휠라홀딩스보통주
13795,81660,2017-07-10,0.0418781725888324,78800,75500,-3300,73652,81660.0,휠라홀딩스보통주
13796,81660,2017-07-04,0.0483091787439613,82800,78800,-4000,81551,81660.0,휠라홀딩스보통주
13797,81660,2017-05-30,0.0489795918367346,73500,77100,3600,142239,81660.0,휠라홀딩스보통주
13798,81660,2017-02-20,0.0492040520984081,69100,72500,3400,44153,81660.0,휠라홀딩스보통주
13799,81660,2017-02-16,0.0539730134932533,66700,70300,3600,38653,81660.0,휠라홀딩스보통주
13800,81660,2016-12-12,0.0473933649289099,63300,66300,3000,81813,81660.0,휠라홀딩스보통주
13801,81660,2016-11-15,0.0527638190954773,79600,75400,-4200,94502,81660.0,휠라홀딩스보통주
13802,86280,2021-04-26,0.0401069518716577,187000,194500,7500,447871,86280.0,현대글로비스보통주
13803,86280,2021-02-24,0.0608272506082725,205500,193000,-12500,583894,86280.0,현대글로비스보통주
13804,86280,2021-02-19,0.0417690417690417,203500,212000,8500,648547,86280.0,현대글로비스보통주
13805,86280,2021-02-08,0.0950226244343891,221000,200000,-21000,908032,86280.0,현대글로비스보통주
13806,86280,2021-02-04,0.0541176470588235,212500,224000,11500,1000325,86280.0,현대글로비스보통주
13807,86280,2021-02-03,0.0545905707196029,201500,212500,11000,1308961,86280.0,현대글로비스보통주
13808,86280,2021-02-01,0.0447368421052631,190000,198500,8500,439416,86280.0,현대글로비스보통주
13809,86280,2021-01-29,0.05,200000,190000,-10000,610106,86280.0,현대글로비스보통주
13810,86280,2021-01-28,0.0543735224586288,211500,200000,-11500,539157,86280.0,현대글로비스보통주
13811,86280,2021-01-26,0.0439560439560439,227500,217500,-10000,619574,86280.0,현대글로비스보통주
13812,86280,2021-01-25,0.0781990521327014,211000,227500,16500,1443664,86280.0,현대글로비스보통주
13813,86280,2021-01-22,0.0452488687782805,221000,211000,-10000,827471,86280.0,현대글로비스보통주
13814,86280,2021-01-21,0.175531914893617,188000,221000,33000,2481191,86280.0,현대글로비스보통주
13815,86280,2021-01-19,0.0413223140495867,181500,189000,7500,323187,86280.0,현대글로비스보통주
13816,86280,2021-01-07,0.0754716981132075,185500,199500,14000,1593352,86280.0,현대글로비스보통주
13817,86280,2020-12-08,0.041343669250646,193500,185500,-8000,358624,86280.0,현대글로비스보통주
13818,86280,2020-12-07,0.0403225806451612,186000,193500,7500,436758,86280.0,현대글로비스보통주
13819,86280,2020-11-10,0.0543478260869565,184000,194000,10000,680423,86280.0,현대글로비스보통주
13820,86280,2020-11-05,0.0526315789473684,171000,180000,9000,381711,86280.0,현대글로비스보통주
13821,86280,2020-10-30,0.056338028169014,177500,167500,-10000,378881,86280.0,현대글로비스보통주
13822,86280,2020-10-26,0.053050397877984,188500,178500,-10000,765536,86280.0,현대글로비스보통주
13823,86280,2020-10-22,0.0448877805486284,200500,191500,-9000,658556,86280.0,현대글로비스보통주
13824,86280,2020-10-20,0.1432664756446991,174500,199500,25000,3238647,86280.0,현대글로비스보통주
13825,86280,2020-10-19,0.05420054200542,184500,174500,-10000,776935,86280.0,현대글로비스보통주
13826,86280,2020-10-15,0.0652818991097922,168500,179500,11000,942734,86280.0,현대글로비스보통주
13827,86280,2020-10-13,0.1,150000,165000,15000,718644,86280.0,현대글로비스보통주
13828,86280,2020-09-22,0.0442176870748299,147000,140500,-6500,160291,86280.0,현대글로비스보통주
13829,86280,2020-09-14,0.0567375886524822,141000,149000,8000,207148,86280.0,현대글로비스보통주
13830,86280,2020-09-04,0.0425531914893617,141000,135000,-6000,237503,86280.0,현대글로비스보통주
13831,86280,2020-08-28,0.1115384615384615,130000,144500,14500,736070,86280.0,현대글로비스보통주
13832,86280,2020-08-20,0.0551181102362204,127000,120000,-7000,167390,86280.0,현대글로비스보통주
13833,86280,2020-08-19,0.0495867768595041,121000,127000,6000,182671,86280.0,현대글로비스보통주
13834,86280,2020-08-18,0.0833333333333333,132000,121000,-11000,300421,86280.0,현대글로비스보통주
13835,86280,2020-08-14,0.073170731707317,123000,132000,9000,362789,86280.0,현대글로비스보통주
13836,86280,2020-08-10,0.0532786885245901,122000,128500,6500,431886,86280.0,현대글로비스보통주
13837,86280,2020-08-06,0.0444444444444444,112500,117500,5000,292493,86280.0,현대글로비스보통주
13838,86280,2020-07-22,0.040983606557377,122000,117000,-5000,230536,86280.0,현대글로비스보통주
13839,86280,2020-07-20,0.1008771929824561,114000,125500,11500,366083,86280.0,현대글로비스보통주
13840,86280,2020-07-13,0.0434782608695652,103500,108000,4500,87606,86280.0,현대글로비스보통주
13841,86280,2020-06-25,0.0495495495495495,111000,105500,-5500,77342,86280.0,현대글로비스보통주
13842,86280,2020-06-24,0.0571428571428571,105000,111000,6000,138719,86280.0,현대글로비스보통주
13843,86280,2020-06-17,0.0446428571428571,112000,107000,-5000,129708,86280.0,현대글로비스보통주
13844,86280,2020-06-16,0.0769230769230769,104000,112000,8000,131995,86280.0,현대글로비스보통주
13845,86280,2020-06-15,0.0545454545454545,110000,104000,-6000,168887,86280.0,현대글로비스보통주
13846,86280,2020-06-12,0.0476190476190476,115500,110000,-5500,212929,86280.0,현대글로비스보통주
13847,86280,2020-06-05,0.0632911392405063,118500,126000,7500,190843,86280.0,현대글로비스보통주
13848,86280,2020-05-19,0.1116856256463288,96700,107500,10800,355264,86280.0,현대글로비스보통주
13849,86280,2020-04-13,0.0476190476190476,105000,100000,-5000,110742,86280.0,현대글로비스보통주
13850,86280,2020-04-09,0.0710659898477157,98500,105500,7000,209037,86280.0,현대글로비스보통주
13851,86280,2020-04-06,0.1150837988826815,89500,99800,10300,175936,86280.0,현대글로비스보통주
13852,86280,2020-04-01,0.0485651214128035,90600,86200,-4400,120861,86280.0,현대글로비스보통주
13853,86280,2020-03-31,0.0413793103448275,87000,90600,3600,159249,86280.0,현대글로비스보통주
13854,86280,2020-03-25,0.1095890410958904,80300,89100,8800,253558,86280.0,현대글로비스보통주
13855,86280,2020-03-24,0.0954979536152796,73300,80300,7000,146516,86280.0,현대글로비스보통주
13856,86280,2020-03-23,0.0950617283950617,81000,73300,-7700,231152,86280.0,현대글로비스보통주
13857,86280,2020-03-19,0.0871559633027523,87200,79600,-7600,207059,86280.0,현대글로비스보통주
13858,86280,2020-03-18,0.044906900328587,91300,87200,-4100,187253,86280.0,현대글로비스보통주
13859,86280,2020-03-17,0.075910931174089,98800,91300,-7500,206253,86280.0,현대글로비스보통주
13860,86280,2020-03-13,0.0648148148148148,108000,101000,-7000,210940,86280.0,현대글로비스보통주
13861,86280,2020-03-09,0.0580912863070539,120500,113500,-7000,141332,86280.0,현대글로비스보통주
13862,86280,2020-02-24,0.047970479704797,135500,129000,-6500,87117,86280.0,현대글로비스보통주
13863,86280,2020-01-23,0.0684931506849315,146000,156000,10000,251701,86280.0,현대글로비스보통주
13864,86280,2019-07-19,0.0423452768729641,153500,160000,6500,66165,86280.0,현대글로비스보통주
13865,86280,2019-06-14,0.0416666666666666,168000,161000,-7000,133848,86280.0,현대글로비스보통주
13866,86280,2019-04-29,0.0714285714285714,147000,157500,10500,307584,86280.0,현대글로비스보통주
13867,86280,2019-04-16,0.0404411764705882,136000,141500,5500,102145,86280.0,현대글로비스보통주
13868,86280,2019-02-27,0.0627062706270627,151500,142000,-9500,354023,86280.0,현대글로비스보통주
13869,86280,2019-01-25,0.0546075085324232,146500,138500,-8000,251637,86280.0,현대글로비스보통주
13870,86280,2019-01-03,0.0597609561752988,125500,133000,7500,122377,86280.0,현대글로비스보통주
13871,86280,2018-12-12,0.0962343096234309,119500,131000,11500,231083,86280.0,현대글로비스보통주
13872,86280,2018-11-26,0.0401785714285714,112000,116500,4500,81449,86280.0,현대글로비스보통주
13873,86280,2018-11-22,0.0425531914893617,117500,112500,-5000,161507,86280.0,현대글로비스보통주
13874,86280,2018-11-06,0.04,112500,117000,4500,129436,86280.0,현대글로비스보통주
13875,86280,2018-10-31,0.0654205607476635,107000,114000,7000,168399,86280.0,현대글로비스보통주
13876,86280,2018-10-23,0.0405405405405405,111000,106500,-4500,95331,86280.0,현대글로비스보통주
13877,86280,2018-10-18,0.0577777777777777,112500,106000,-6500,180053,86280.0,현대글로비스보통주
13878,86280,2018-10-11,0.0474137931034482,116000,110500,-5500,140469,86280.0,현대글로비스보통주
13879,86280,2018-09-07,0.0509803921568627,127500,134000,6500,293505,86280.0,현대글로비스보통주
13880,86280,2018-09-06,0.0625,120000,127500,7500,204616,86280.0,현대글로비스보통주
13881,86280,2018-08-08,0.0404411764705882,136000,130500,-5500,471336,86280.0,현대글로비스보통주
13882,86280,2018-08-02,0.0543478260869565,138000,130500,-7500,131498,86280.0,현대글로비스보통주
13883,86280,2018-07-16,0.0532786885245901,122000,128500,6500,189013,86280.0,현대글로비스보통주
13884,86280,2018-07-12,0.0619469026548672,113000,120000,7000,207545,86280.0,현대글로비스보통주
13885,86280,2018-06-27,0.0411522633744856,121500,116500,-5000,174713,86280.0,현대글로비스보통주
13886,86280,2018-05-30,0.0402930402930402,136500,131000,-5500,374984,86280.0,현대글로비스보통주
13887,86280,2018-05-23,0.0498338870431893,150500,143000,-7500,638682,86280.0,현대글로비스보통주
13888,86280,2018-05-04,0.0470588235294117,170000,162000,-8000,213393,86280.0,현대글로비스보통주
13889,86280,2018-04-18,0.0425531914893617,188000,180000,-8000,260868,86280.0,현대글로비스보통주
13890,86280,2018-04-17,0.065155807365439,176500,188000,11500,366618,86280.0,현대글로비스보통주
13891,86280,2018-03-30,0.0714285714285714,182000,169000,-13000,1048094,86280.0,현대글로비스보통주
13892,86280,2018-03-29,0.0489913544668587,173500,182000,8500,1716544,86280.0,현대글로비스보통주
13893,86280,2018-03-28,0.1015873015873015,157500,173500,16000,1335794,86280.0,현대글로비스보통주
13894,86280,2018-03-22,0.0464396284829721,161500,154000,-7500,279717,86280.0,현대글로비스보통주
13895,86280,2018-03-14,0.0928571428571428,140000,153000,13000,537347,86280.0,현대글로비스보통주
13896,86280,2018-02-26,0.0510948905109489,137000,144000,7000,370812,86280.0,현대글로비스보통주
13897,86280,2017-08-09,0.0412698412698412,157500,164000,6500,134047,86280.0,현대글로비스보통주
13898,86280,2017-08-04,0.0588235294117647,153000,162000,9000,235249,86280.0,현대글로비스보통주
13899,86280,2017-03-21,0.0436241610738255,149000,155500,6500,381844,86280.0,현대글로비스보통주
13900,86280,2017-01-31,0.0489296636085626,163500,155500,-8000,164291,86280.0,현대글로비스보통주
13901,86280,2017-01-12,0.0543130990415335,156500,165000,8500,224605,86280.0,현대글로비스보통주
13902,86280,2017-01-02,0.0453074433656957,154500,161500,7000,177177,86280.0,현대글로비스보통주
13903,86280,2016-12-01,0.0566037735849056,159000,150000,-9000,242619,86280.0,현대글로비스보통주
13904,86280,2016-11-10,0.0534124629080118,168500,159500,-9000,432456,86280.0,현대글로비스보통주
13905,86280,2016-11-09,0.0453257790368272,176500,168500,-8000,154539,86280.0,현대글로비스보통주
13906,86280,2016-08-24,0.0746268656716417,167500,180000,12500,353531,86280.0,현대글로비스보통주
13907,86790,2021-05-06,0.0594285714285714,43750,46350,2600,1569158,86790.0,하나금융지주보통주
13908,86790,2021-02-18,0.0408432147562582,37950,36400,-1550,1528640,86790.0,하나금융지주보통주
13909,86790,2021-02-05,0.06480117820324,33950,36150,2200,2786900,86790.0,하나금융지주보통주
13910,86790,2021-02-01,0.0765696784073506,32650,35150,2500,2949278,86790.0,하나금융지주보통주
13911,86790,2021-01-29,0.0536231884057971,34500,32650,-1850,3128632,86790.0,하나금융지주보통주
13912,86790,2021-01-07,0.0589928057553956,34750,36800,2050,4379391,86790.0,하나금융지주보통주
13913,86790,2020-12-29,0.0488145048814504,35850,34100,-1750,2294951,86790.0,하나금융지주보통주
13914,86790,2020-11-30,0.0491573033707865,35600,33850,-1750,3275948,86790.0,하나금융지주보통주
13915,86790,2020-11-16,0.0533910533910533,34650,36500,1850,2553852,86790.0,하나금융지주보통주
13916,86790,2020-11-10,0.0575757575757575,33000,34900,1900,3233993,86790.0,하나금융지주보통주
13917,86790,2020-11-02,0.0608552631578947,30400,32250,1850,2057204,86790.0,하나금융지주보통주
13918,86790,2020-10-27,0.0474732006125574,32650,31100,-1550,3144245,86790.0,하나금융지주보통주
13919,86790,2020-10-05,0.0427046263345195,28100,29300,1200,2961211,86790.0,하나금융지주보통주
13920,86790,2020-08-20,0.0430292598967297,29050,27800,-1250,2282005,86790.0,하나금융지주보통주
13921,86790,2020-08-18,0.0568181818181818,30800,29050,-1750,2370890,86790.0,하나금융지주보통주
13922,86790,2020-07-20,0.0553571428571428,28000,29550,1550,2844468,86790.0,하나금융지주보통주
13923,86790,2020-07-13,0.0563106796116504,25750,27200,1450,1447994,86790.0,하나금융지주보통주
13924,86790,2020-06-16,0.0866290018832391,26550,28850,2300,2368001,86790.0,하나금융지주보통주
13925,86790,2020-06-15,0.0449640287769784,27800,26550,-1250,2631725,86790.0,하나금융지주보통주
13926,86790,2020-06-12,0.0413793103448275,29000,27800,-1200,2502641,86790.0,하나금융지주보통주
13927,86790,2020-06-10,0.0404530744336569,30900,29650,-1250,3333691,86790.0,하나금융지주보통주
13928,86790,2020-06-02,0.0498338870431893,30100,31600,1500,2627730,86790.0,하나금융지주보통주
13929,86790,2020-05-29,0.0456942003514938,28450,29750,1300,3900266,86790.0,하나금융지주보통주
13930,86790,2020-05-28,0.0459558823529411,27200,28450,1250,5036049,86790.0,하나금융지주보통주
13931,86790,2020-05-26,0.044921875,25600,26750,1150,2522700,86790.0,하나금융지주보통주
13932,86790,2020-05-19,0.0481927710843373,24900,26100,1200,3506962,86790.0,하나금융지주보통주
13933,86790,2020-05-04,0.0452898550724637,27600,26350,-1250,2747849,86790.0,하나금융지주보통주
13934,86790,2020-04-27,0.1684665226781857,23150,27050,3900,6692821,86790.0,하나금융지주보통주
13935,86790,2020-04-10,0.0563674321503131,23950,25300,1350,2977354,86790.0,하나금융지주보통주
13936,86790,2020-04-06,0.0625,22400,23800,1400,1971860,86790.0,하나금융지주보통주
13937,86790,2020-04-01,0.0541125541125541,23100,21850,-1250,2390120,86790.0,하나금융지주보통주
13938,86790,2020-03-27,0.0844748858447488,21900,23750,1850,3537522,86790.0,하나금융지주보통주
13939,86790,2020-03-25,0.1041666666666666,19200,21200,2000,4994511,86790.0,하나금융지주보통주
13940,86790,2020-03-24,0.040650406504065,18450,19200,750,3296990,86790.0,하나금융지주보통주
13941,86790,2020-03-23,0.1065375302663438,20650,18450,-2200,2660270,86790.0,하나금융지주보통주
13942,86790,2020-03-20,0.1132075471698113,18550,20650,2100,3413303,86790.0,하나금융지주보통주
13943,86790,2020-03-19,0.125,21200,18550,-2650,2790246,86790.0,하나금융지주보통주
13944,86790,2020-03-17,0.094017094017094,23400,21200,-2200,3142301,86790.0,하나금융지주보통주
13945,86790,2020-03-12,0.0877513711151736,27350,24950,-2400,3230934,86790.0,하나금융지주보통주
13946,86790,2020-03-09,0.0653266331658291,29850,27900,-1950,1581464,86790.0,하나금융지주보통주
13947,86790,2019-10-28,0.0424328147100424,35350,33850,-1500,2077624,86790.0,하나금융지주보통주
13948,86790,2019-10-14,0.0401188707280832,33650,35000,1350,1461750,86790.0,하나금융지주보통주
13949,86790,2019-09-20,0.0409026798307475,35450,36900,1450,1769383,86790.0,하나금융지주보통주
13950,86790,2019-01-15,0.0484330484330484,35100,36800,1700,1276452,86790.0,하나금융지주보통주
13951,86790,2018-12-27,0.0428954423592493,37300,35700,-1600,1074830,86790.0,하나금융지주보통주
13952,86790,2018-10-30,0.0481481481481481,40500,38550,-1950,1520453,86790.0,하나금융지주보통주
13953,86790,2018-10-25,0.0509259259259259,43200,41000,-2200,5334364,86790.0,하나금융지주보통주
13954,86790,2018-10-11,0.0577971646673936,45850,43200,-2650,1823297,86790.0,하나금융지주보통주
13955,86790,2018-06-21,0.0415263748597081,44550,42700,-1850,1188473,86790.0,하나금융지주보통주
13956,86790,2018-06-04,0.0572792362768496,41900,44300,2400,1402129,86790.0,하나금융지주보통주
13957,86790,2018-04-23,0.0727272727272727,44000,47200,3200,2206684,86790.0,하나금융지주보통주
13958,86790,2018-04-03,0.0556173526140155,44950,42450,-2500,2251301,86790.0,하나금융지주보통주
13959,86790,2018-03-13,0.044579533941236,49350,47150,-2200,1300496,86790.0,하나금융지주보통주
13960,86790,2018-03-12,0.0477707006369426,47100,49350,2250,928569,86790.0,하나금융지주보통주
13961,86790,2018-02-12,0.0505675954592363,48450,50900,2450,915286,86790.0,하나금융지주보통주
13962,86790,2018-02-06,0.0545112781954887,53200,50300,-2900,1339682,86790.0,하나금융지주보통주
13963,86790,2017-10-10,0.0454065469904963,47350,49500,2150,1575860,86790.0,하나금융지주보통주
13964,86790,2017-09-05,0.055613850996852,47650,45000,-2650,2791230,86790.0,하나금융지주보통주
13965,86790,2017-06-28,0.0583333333333333,42000,44450,2450,2519854,86790.0,하나금융지주보통주
13966,86790,2017-05-11,0.0449574726609963,41150,43000,1850,1917586,86790.0,하나금융지주보통주
13967,86790,2017-04-24,0.0725806451612903,37200,39900,2700,2735622,86790.0,하나금융지주보통주
13968,86790,2017-03-13,0.0508701472556894,37350,39250,1900,1710796,86790.0,하나금융지주보통주
13969,86790,2017-03-02,0.0411347517730496,35250,36700,1450,1799642,86790.0,하나금융지주보통주
13970,86790,2017-02-27,0.0455801104972375,36200,34550,-1650,1311347,86790.0,하나금융지주보통주
13971,86790,2016-11-10,0.0681114551083591,32300,34500,2200,2801451,86790.0,하나금융지주보통주
13972,88350,2021-05-14,0.062870699881376,4215,3950,-265,22731381,88350.0,한화생명보험보통주
13973,88350,2021-05-13,0.09765625,3840,4215,375,95937402,88350.0,한화생명보험보통주
13974,88350,2021-05-06,0.0813253012048192,3320,3590,270,16395863,88350.0,한화생명보험보통주
13975,88350,2021-04-29,0.0428769017980636,3615,3460,-155,9109931,88350.0,한화생명보험보통주
13976,88350,2021-04-23,0.0466165413533834,3325,3480,155,25581332,88350.0,한화생명보험보통주
13977,88350,2021-03-30,0.0436241610738255,2980,3110,130,6043182,88350.0,한화생명보험보통주
13978,88350,2021-03-05,0.0431309904153354,3130,3265,135,22716787,88350.0,한화생명보험보통주
13979,88350,2021-02-24,0.054054054054054,3330,3150,-180,14505095,88350.0,한화생명보험보통주
13980,88350,2021-02-23,0.0403458213256484,3470,3330,-140,27584870,88350.0,한화생명보험보통주
13981,88350,2021-02-22,0.0743034055727554,3230,3470,240,42329696,88350.0,한화생명보험보통주
13982,88350,2021-02-19,0.0453074433656957,3090,3230,140,46338632,88350.0,한화생명보험보통주
13983,88350,2021-02-18,0.0636363636363636,3300,3090,-210,14709721,88350.0,한화생명보험보통주
13984,88350,2021-02-17,0.1129848229342327,2965,3300,335,54971193,88350.0,한화생명보험보통주
13985,88350,2021-02-09,0.0671378091872791,2830,3020,190,17232609,88350.0,한화생명보험보통주
13986,88350,2021-02-04,0.0437062937062937,2860,2735,-125,6066963,88350.0,한화생명보험보통주
13987,88350,2021-02-02,0.0439560439560439,2730,2850,120,7919722,88350.0,한화생명보험보통주
13988,88350,2021-01-13,0.0486223662884927,3085,3235,150,41230989,88350.0,한화생명보험보통주
13989,88350,2021-01-12,0.0419254658385093,3220,3085,-135,16008777,88350.0,한화생명보험보통주
13990,88350,2021-01-11,0.0501474926253687,3390,3220,-170,34141623,88350.0,한화생명보험보통주
13991,88350,2021-01-07,0.2655367231638418,2655,3360,705,123286337,88350.0,한화생명보험보통주
13992,88350,2021-01-06,0.0662650602409638,2490,2655,165,20494002,88350.0,한화생명보험보통주
13993,88350,2021-01-05,0.0641025641025641,2340,2490,150,10319523,88350.0,한화생명보험보통주
13994,88350,2021-01-04,0.040983606557377,2440,2340,-100,8562131,88350.0,한화생명보험보통주
13995,88350,2020-12-21,0.0582706766917293,2660,2505,-155,11353408,88350.0,한화생명보험보통주
13996,88350,2020-12-16,0.0703125,2560,2740,180,15726769,88350.0,한화생명보험보통주
13997,88350,2020-12-14,0.0705128205128205,2340,2505,165,28429052,88350.0,한화생명보험보통주
13998,88350,2020-12-11,0.0783410138248847,2170,2340,170,17273889,88350.0,한화생명보험보통주
13999,88350,2020-12-02,0.0602409638554216,2075,2200,125,14192346,88350.0,한화생명보험보통주
14000,88350,2020-11-23,0.0666666666666666,2025,2160,135,14191499,88350.0,한화생명보험보통주
14001,88350,2020-11-16,0.0765171503957783,1895,2040,145,25517146,88350.0,한화생명보험보통주
14002,88350,2020-11-11,0.0614525139664804,1790,1900,110,33664086,88350.0,한화생명보험보통주
14003,88350,2020-11-10,0.1083591331269349,1615,1790,175,33851921,88350.0,한화생명보험보통주
14004,88350,2020-10-27,0.0619469026548672,1695,1590,-105,11722971,88350.0,한화생명보험보통주
14005,88350,2020-10-23,0.0725552050473186,1585,1700,115,52760323,88350.0,한화생명보험보통주
14006,88350,2020-09-01,0.0424836601307189,1530,1595,65,8784845,88350.0,한화생명보험보통주
14007,88350,2020-08-25,0.0745762711864406,1475,1585,110,8991797,88350.0,한화생명보험보통주
14008,88350,2020-08-20,0.047923322683706,1565,1490,-75,6870834,88350.0,한화생명보험보통주
14009,88350,2020-08-19,0.0538720538720538,1485,1565,80,6881325,88350.0,한화생명보험보통주
14010,88350,2020-08-18,0.0804953560371517,1615,1485,-130,8910391,88350.0,한화생명보험보통주
14011,88350,2020-08-10,0.047945205479452,1460,1530,70,11132167,88350.0,한화생명보험보통주
14012,88350,2020-07-23,0.0419354838709677,1550,1485,-65,6791906,88350.0,한화생명보험보통주
14013,88350,2020-07-22,0.0437710437710437,1485,1550,65,12391461,88350.0,한화생명보험보통주
14014,88350,2020-06-25,0.0424028268551236,1415,1355,-60,5394475,88350.0,한화생명보험보통주
14015,88350,2020-06-16,0.05,1400,1470,70,7784651,88350.0,한화생명보험보통주
14016,88350,2020-06-15,0.0697674418604651,1505,1400,-105,8520989,88350.0,한화생명보험보통주
14017,88350,2020-06-12,0.0474683544303797,1580,1505,-75,11357121,88350.0,한화생명보험보통주
14018,88350,2020-06-11,0.0424242424242424,1650,1580,-70,12032404,88350.0,한화생명보험보통주
14019,88350,2020-06-05,0.0403726708074534,1610,1675,65,13484864,88350.0,한화생명보험보통주
14020,88350,2020-05-29,0.0701219512195122,1640,1525,-115,40911723,88350.0,한화생명보험보통주
14021,88350,2020-05-14,0.0401234567901234,1620,1685,65,14694317,88350.0,한화생명보험보통주
14022,88350,2020-05-04,0.0472222222222222,1800,1715,-85,6242386,88350.0,한화생명보험보통주
14023,88350,2020-04-17,0.1,1650,1815,165,82203632,88350.0,한화생명보험보통주
14024,88350,2020-04-16,0.0489913544668587,1735,1650,-85,10398894,88350.0,한화생명보험보통주
14025,88350,2020-04-10,0.215547703180212,1415,1720,305,93431281,88350.0,한화생명보험보통주
14026,88350,2020-04-01,0.0503597122302158,1390,1320,-70,6519043,88350.0,한화생명보험보통주
14027,88350,2020-03-27,0.0562913907284768,1510,1425,-85,18146210,88350.0,한화생명보험보통주
14028,88350,2020-03-26,0.1843137254901961,1275,1510,235,33525362,88350.0,한화생명보험보통주
14029,88350,2020-03-25,0.2983706720977597,982,1275,293,19697553,88350.0,한화생명보험보통주
14030,88350,2020-03-24,0.0972067039106145,895,982,87,9443067,88350.0,한화생명보험보통주
14031,88350,2020-03-23,0.0657620041753653,958,895,-63,7377202,88350.0,한화생명보험보통주
14032,88350,2020-03-20,0.044711014176663,917,958,41,8514019,88350.0,한화생명보험보통주
14033,88350,2020-03-19,0.0546391752577319,970,917,-53,7519295,88350.0,한화생명보험보통주
14034,88350,2020-03-18,0.0628019323671497,1035,970,-65,6189787,88350.0,한화생명보험보통주
14035,88350,2020-03-17,0.08,1125,1035,-90,8088146,88350.0,한화생명보험보통주
14036,88350,2020-03-13,0.0530612244897959,1225,1160,-65,8116898,88350.0,한화생명보험보통주
14037,88350,2020-03-12,0.046692607003891,1285,1225,-60,6945957,88350.0,한화생명보험보통주
14038,88350,2020-03-11,0.0586080586080586,1365,1285,-80,8216151,88350.0,한화생명보험보통주
14039,88350,2020-03-09,0.0938511326860841,1545,1400,-145,7622905,88350.0,한화생명보험보통주
14040,88350,2020-03-06,0.0403726708074534,1610,1545,-65,3832325,88350.0,한화생명보험보통주
14041,88350,2020-02-24,0.0616621983914209,1865,1750,-115,3075294,88350.0,한화생명보험보통주
14042,88350,2020-02-21,0.0532994923857868,1970,1865,-105,5096605,88350.0,한화생명보험보통주
14043,88350,2020-01-28,0.0474040632054176,2215,2110,-105,2947261,88350.0,한화생명보험보통주
14044,88350,2019-12-13,0.0615384615384615,2275,2415,140,3951468,88350.0,한화생명보험보통주
14045,88350,2019-11-14,0.0478170478170478,2405,2290,-115,3374645,88350.0,한화생명보험보통주
14046,88350,2019-11-07,0.0404255319148936,2350,2445,95,2653843,88350.0,한화생명보험보통주
14047,88350,2019-10-02,0.0683229813664596,2415,2250,-165,4631897,88350.0,한화생명보험보통주
14048,88350,2019-09-11,0.0481927710843373,2490,2610,120,4182341,88350.0,한화생명보험보통주
14049,88350,2019-08-30,0.0539419087136929,2410,2540,130,2464881,88350.0,한화생명보험보통주
14050,88350,2019-08-19,0.0815850815850815,2145,2320,175,2810295,88350.0,한화생명보험보통주
14051,88350,2019-08-05,0.0506072874493927,2470,2345,-125,3419554,88350.0,한화생명보험보통주
14052,88350,2019-08-01,0.0419047619047619,2625,2515,-110,1513987,88350.0,한화생명보험보통주
14053,88350,2019-07-16,0.0516666666666666,3000,2845,-155,3811546,88350.0,한화생명보험보통주
14054,88350,2019-03-15,0.0460199004975124,4020,4205,185,4568164,88350.0,한화생명보험보통주
14055,88350,2018-10-11,0.0429141716566866,5010,4795,-215,1974208,88350.0,한화생명보험보통주
14056,88350,2018-04-16,0.0404721753794266,5930,6170,240,2310861,88350.0,한화생명보험보통주
14057,88350,2018-03-07,0.0459418070444104,6530,6230,-300,2527646,88350.0,한화생명보험보통주
14058,88350,2018-02-09,0.0488505747126436,6960,6620,-340,2128024,88350.0,한화생명보험보통주
14059,88350,2017-12-01,0.0402144772117962,7460,7160,-300,2188819,88350.0,한화생명보험보통주
14060,88350,2017-10-25,0.0729442970822281,7540,8090,550,7450591,88350.0,한화생명보험보통주
14061,88350,2017-10-20,0.0688705234159779,7260,7760,500,4881615,88350.0,한화생명보험보통주
14062,88350,2017-10-11,0.0641399416909621,6860,7300,440,3230835,88350.0,한화생명보험보통주
14063,88350,2017-07-10,0.0427586206896551,7250,7560,310,3234308,88350.0,한화생명보험보통주
14064,88350,2017-07-07,0.0476878612716763,6920,7250,330,1322558,88350.0,한화생명보험보통주
14065,88350,2016-11-17,0.056338028169014,6390,6750,360,3761159,88350.0,한화생명보험보통주
14066,88350,2016-11-11,0.0619765494137353,5970,6340,370,1998487,88350.0,한화생명보험보통주
14067,88350,2016-11-03,0.0405186385737439,6170,5920,-250,1389552,88350.0,한화생명보험보통주
14068,88350,2016-10-26,0.0465116279069767,6450,6150,-300,1281970,88350.0,한화생명보험보통주
14069,88980,2020-03-19,0.0514563106796116,10300,9770,-530,4075089,88980.0,맥쿼리한국인프라투융자회사 보통주
14070,90430,2021-04-28,0.0444874274661508,258500,270000,11500,635279,90430.0,아모레퍼시픽 보통주
14071,90430,2021-04-13,0.0489236790606653,255500,268000,12500,300061,90430.0,아모레퍼시픽 보통주
14072,90430,2021-03-31,0.0496323529411764,272000,258500,-13500,264737,90430.0,아모레퍼시픽 보통주
14073,90430,2021-03-17,0.0461538461538461,227500,238000,10500,263349,90430.0,아모레퍼시픽 보통주
14074,90430,2021-01-29,0.0429184549356223,233000,223000,-10000,283625,90430.0,아모레퍼시픽 보통주
14075,90430,2021-01-19,0.0593824228028503,210500,223000,12500,311506,90430.0,아모레퍼시픽 보통주
14076,90430,2021-01-18,0.0453514739229024,220500,210500,-10000,366406,90430.0,아모레퍼시픽 보통주
14077,90430,2021-01-13,0.041871921182266,203000,211500,8500,553390,90430.0,아모레퍼시픽 보통주
14078,90430,2020-12-09,0.1071428571428571,196000,217000,21000,909898,90430.0,아모레퍼시픽 보통주
14079,90430,2020-12-01,0.047486033519553,179000,187500,8500,340875,90430.0,아모레퍼시픽 보통주
14080,90430,2020-11-20,0.0478723404255319,188000,197000,9000,894303,90430.0,아모레퍼시픽 보통주
14081,90430,2020-11-17,0.0601719197707736,174500,185000,10500,1072147,90430.0,아모레퍼시픽 보통주
14082,90430,2020-10-30,0.0424242424242424,165000,158000,-7000,362898,90430.0,아모레퍼시픽 보통주
14083,90430,2020-08-20,0.0521978021978022,182000,172500,-9500,475380,90430.0,아모레퍼시픽 보통주
14084,90430,2020-08-18,0.1017811704834605,196500,176500,-20000,867824,90430.0,아모레퍼시픽 보통주
14085,90430,2020-08-14,0.048,187500,196500,9000,795049,90430.0,아모레퍼시픽 보통주
14086,90430,2020-08-12,0.0459770114942528,174000,182000,8000,894705,90430.0,아모레퍼시픽 보통주
14087,90430,2020-06-30,0.0947712418300653,153000,167500,14500,3896837,90430.0,아모레퍼시픽 보통주
14088,90430,2020-06-26,0.0533333333333333,150000,158000,8000,374777,90430.0,아모레퍼시픽 보통주
14089,90430,2020-06-16,0.043613707165109,160500,167500,7000,193585,90430.0,아모레퍼시픽 보통주
14090,90430,2020-06-15,0.0446428571428571,168000,160500,-7500,321454,90430.0,아모레퍼시픽 보통주
14091,90430,2020-04-17,0.0463768115942029,172500,180500,8000,658064,90430.0,아모레퍼시픽 보통주
14092,90430,2020-04-01,0.0623145400593471,168500,158000,-10500,422750,90430.0,아모레퍼시픽 보통주
14093,90430,2020-03-24,0.0721003134796238,159500,171000,11500,433417,90430.0,아모레퍼시픽 보통주
14094,90430,2020-03-17,0.0508474576271186,147500,155000,7500,412149,90430.0,아모레퍼시픽 보통주
14095,90430,2020-03-11,0.0479041916167664,167000,159000,-8000,310982,90430.0,아모레퍼시픽 보통주
14096,90430,2020-02-28,0.0445103857566765,168500,161000,-7500,597683,90430.0,아모레퍼시픽 보통주
14097,90430,2020-02-24,0.0494505494505494,182000,173000,-9000,495760,90430.0,아모레퍼시픽 보통주
14098,90430,2020-02-05,0.0761421319796954,197000,182000,-15000,1075027,90430.0,아모레퍼시픽 보통주
14099,90430,2020-01-30,0.0419753086419753,202500,194000,-8500,501382,90430.0,아모레퍼시픽 보통주
14100,90430,2020-01-29,0.0411311053984575,194500,202500,8000,639606,90430.0,아모레퍼시픽 보통주
14101,90430,2020-01-28,0.0847058823529411,212500,194500,-18000,836404,90430.0,아모레퍼시픽 보통주
14102,90430,2020-01-23,0.0492170022371364,223500,212500,-11000,467540,90430.0,아모레퍼시픽 보통주
14103,90430,2020-01-20,0.0486257928118393,236500,225000,-11500,567605,90430.0,아모레퍼시픽 보통주
14104,90430,2020-01-13,0.0521541950113378,220500,232000,11500,561971,90430.0,아모레퍼시픽 보통주
14105,90430,2020-01-10,0.0400943396226415,212000,220500,8500,309458,90430.0,아모레퍼시픽 보통주
14106,90430,2020-01-07,0.0748792270531401,207000,222500,15500,487251,90430.0,아모레퍼시픽 보통주
14107,90430,2019-11-08,0.0635696821515892,204500,191500,-13000,731956,90430.0,아모레퍼시픽 보통주
14108,90430,2019-10-31,0.0434782608695652,184000,192000,8000,1116590,90430.0,아모레퍼시픽 보통주
14109,90430,2019-10-30,0.1428571428571428,161000,184000,23000,1310133,90430.0,아모레퍼시픽 보통주
14110,90430,2019-09-27,0.0507246376811594,138000,145000,7000,547888,90430.0,아모레퍼시픽 보통주
14111,90430,2019-09-03,0.0760456273764258,131500,141500,10000,838557,90430.0,아모레퍼시픽 보통주
14112,90430,2019-08-30,0.0483870967741935,124000,130000,6000,517046,90430.0,아모레퍼시픽 보통주
14113,90430,2019-08-05,0.0498084291187739,130500,124000,-6500,452317,90430.0,아모레퍼시픽 보통주
14114,90430,2019-08-01,0.0464285714285714,140000,133500,-6500,710909,90430.0,아모레퍼시픽 보통주
14115,90430,2019-07-31,0.0604026845637583,149000,140000,-9000,695519,90430.0,아모레퍼시픽 보통주
14116,90430,2019-07-08,0.0414201183431952,169000,162000,-7000,237813,90430.0,아모레퍼시픽 보통주
14117,90430,2019-07-05,0.0464396284829721,161500,169000,7500,421907,90430.0,아모레퍼시픽 보통주
14118,90430,2019-05-24,0.0402144772117962,186500,179000,-7500,254547,90430.0,아모레퍼시픽 보통주
14119,90430,2019-04-30,0.0588235294117647,221000,208000,-13000,536054,90430.0,아모레퍼시픽 보통주
14120,90430,2019-04-15,0.0756880733944954,218000,234500,16500,827285,90430.0,아모레퍼시픽 보통주
14121,90430,2019-04-12,0.0660146699266503,204500,218000,13500,506191,90430.0,아모레퍼시픽 보통주
14122,90430,2019-03-18,0.0408163265306122,196000,204000,8000,355270,90430.0,아모레퍼시픽 보통주
14123,90430,2019-03-15,0.0509383378016085,186500,196000,9500,280392,90430.0,아모레퍼시픽 보통주
14124,90430,2019-03-11,0.0455696202531645,197500,188500,-9000,285609,90430.0,아모레퍼시픽 보통주
14125,90430,2019-02-20,0.086021505376344,186000,202000,16000,808568,90430.0,아모레퍼시픽 보통주
14126,90430,2019-02-15,0.0405797101449275,172500,179500,7000,297262,90430.0,아모레퍼시픽 보통주
14127,90430,2019-02-08,0.0422535211267605,177500,170000,-7500,352057,90430.0,아모레퍼시픽 보통주
14128,90430,2019-01-17,0.0464480874316939,183000,174500,-8500,446966,90430.0,아모레퍼시픽 보통주
14129,90430,2019-01-04,0.0437017994858611,194500,186000,-8500,553488,90430.0,아모레퍼시픽 보통주
14130,90430,2019-01-02,0.0763723150357995,209500,193500,-16000,404377,90430.0,아모레퍼시픽 보통주
14131,90430,2018-12-27,0.0475,200000,209500,9500,243557,90430.0,아모레퍼시픽 보통주
14132,90430,2018-12-18,0.0552631578947368,190000,200500,10500,434394,90430.0,아모레퍼시픽 보통주
14133,90430,2018-12-12,0.0802292263610315,174500,188500,14000,673079,90430.0,아모레퍼시픽 보통주
14134,90430,2018-12-07,0.0527950310559006,161000,169500,8500,329600,90430.0,아모레퍼시픽 보통주
14135,90430,2018-12-06,0.0529411764705882,170000,161000,-9000,315289,90430.0,아모레퍼시픽 보통주
14136,90430,2018-11-28,0.0495356037151702,161500,169500,8000,664561,90430.0,아모레퍼시픽 보통주
14137,90430,2018-11-27,0.0419354838709677,155000,161500,6500,735347,90430.0,아모레퍼시픽 보통주
14138,90430,2018-11-20,0.050632911392405,158000,150000,-8000,532991,90430.0,아모레퍼시픽 보통주
14139,90430,2018-11-15,0.0555555555555555,153000,161500,8500,1820365,90430.0,아모레퍼시픽 보통주
14140,90430,2018-11-02,0.0606060606060606,165000,175000,10000,474916,90430.0,아모레퍼시픽 보통주
14141,90430,2018-11-01,0.0784313725490196,153000,165000,12000,474875,90430.0,아모레퍼시픽 보통주
14142,90430,2018-10-29,0.1280653950953678,183500,160000,-23500,765730,90430.0,아모레퍼시픽 보통주
14143,90430,2018-10-26,0.04177545691906,191500,183500,-8000,272386,90430.0,아모레퍼시픽 보통주
14144,90430,2018-10-15,0.0457831325301204,207500,198000,-9500,267688,90430.0,아모레퍼시픽 보통주
14145,90430,2018-10-12,0.050632911392405,197500,207500,10000,248467,90430.0,아모레퍼시픽 보통주
14146,90430,2018-10-11,0.0683962264150943,212000,197500,-14500,464105,90430.0,아모레퍼시픽 보통주
14147,90430,2018-10-10,0.0493273542600896,223000,212000,-11000,349662,90430.0,아모레퍼시픽 보통주
14148,90430,2018-10-04,0.1398865784499054,264500,227500,-37000,994561,90430.0,아모레퍼시픽 보통주
14149,90430,2018-08-23,0.0544747081712062,257000,271000,14000,320901,90430.0,아모레퍼시픽 보통주
14150,90430,2018-07-26,0.0411449016100178,279500,268000,-11500,403475,90430.0,아모레퍼시픽 보통주
14151,90430,2018-07-04,0.0403877221324717,309500,297000,-12500,155684,90430.0,아모레퍼시픽 보통주
14152,90430,2018-06-15,0.0404984423676012,321000,308000,-13000,254526,90430.0,아모레퍼시픽 보통주
14153,90430,2018-04-30,0.0433482810164424,334500,349000,14500,202938,90430.0,아모레퍼시픽 보통주
14154,90430,2018-04-02,0.0504731861198738,317000,333000,16000,489376,90430.0,아모레퍼시픽 보통주
14155,90430,2018-03-09,0.0415224913494809,289000,301000,12000,563866,90430.0,아모레퍼시픽 보통주
14156,90430,2018-02-28,0.0408858603066439,293500,281500,-12000,191531,90430.0,아모레퍼시픽 보통주
14157,90430,2018-02-21,0.0689655172413793,275500,294500,19000,273540,90430.0,아모레퍼시픽 보통주
14158,90430,2018-02-07,0.0489864864864864,296000,281500,-14500,208904,90430.0,아모레퍼시픽 보통주
14159,90430,2018-01-04,0.0401284109149277,311500,299000,-12500,199790,90430.0,아모레퍼시픽 보통주
14160,90430,2017-12-12,0.0400616332819722,324500,311500,-13000,334464,90430.0,아모레퍼시픽 보통주
14161,90430,2017-12-04,0.0784,312500,337000,24500,606655,90430.0,아모레퍼시픽 보통주
14162,90430,2017-10-26,0.0723905723905724,297000,318500,21500,720822,90430.0,아모레퍼시픽 보통주
14163,90430,2017-10-16,0.051660516605166,271000,285000,14000,581424,90430.0,아모레퍼시픽 보통주
14164,90430,2017-10-13,0.0648330058939096,254500,271000,16500,681271,90430.0,아모레퍼시픽 보통주
14165,90430,2017-09-08,0.0463458110516934,280500,267500,-13000,446767,90430.0,아모레퍼시픽 보통주
14166,90430,2017-08-24,0.0516934046345811,280500,295000,14500,305933,90430.0,아모레퍼시픽 보통주
14167,90430,2017-05-12,0.0443213296398892,361000,345000,-16000,337452,90430.0,아모레퍼시픽 보통주
14168,90430,2017-05-11,0.0478955007256894,344500,361000,16500,437736,90430.0,아모레퍼시픽 보통주
14169,90430,2017-05-08,0.0638977635782747,313000,333000,20000,504682,90430.0,아모레퍼시픽 보통주
14170,90430,2017-05-04,0.081174438687392,289500,313000,23500,338626,90430.0,아모레퍼시픽 보통주
14171,90430,2017-04-25,0.0439739413680781,307000,293500,-13500,305126,90430.0,아모레퍼시픽 보통주
14172,90430,2017-04-17,0.0535055350553505,271000,285500,14500,309494,90430.0,아모레퍼시픽 보통주
14173,90430,2017-03-03,0.1267361111111111,288000,251500,-36500,1060753,90430.0,아모레퍼시픽 보통주
14174,90430,2017-03-02,0.0431893687707641,301000,288000,-13000,331092,90430.0,아모레퍼시픽 보통주
14175,90430,2017-02-24,0.0640138408304498,289000,307500,18500,306334,90430.0,아모레퍼시픽 보통주
14176,90430,2017-02-02,0.045958795562599,315500,301000,-14500,488349,90430.0,아모레퍼시픽 보통주
14177,90430,2017-01-13,0.0413907284768211,302000,314500,12500,192048,90430.0,아모레퍼시픽 보통주
14178,90430,2017-01-02,0.0497667185069984,321500,305500,-16000,94147,90430.0,아모레퍼시픽 보통주
14179,90430,2016-11-29,0.0556414219474497,323500,341500,18000,196781,90430.0,아모레퍼시픽 보통주
14180,90430,2016-11-10,0.0497237569060773,362000,380000,18000,202326,90430.0,아모레퍼시픽 보통주
14181,90430,2016-10-25,0.0712365591397849,372000,345500,-26500,762672,90430.0,아모레퍼시픽 보통주
14182,90430,2016-10-07,0.0564304461942257,381000,359500,-21500,248561,90430.0,아모레퍼시픽 보통주
14183,90430,2016-08-10,0.046419098143236,377000,394500,17500,306998,90430.0,아모레퍼시픽 보통주
14184,90430,2016-08-08,0.0454545454545454,363000,379500,16500,344886,90430.0,아모레퍼시픽 보통주
14185,96770,2021-05-14,0.0426356589147286,258000,269000,11000,883903,96770.0,SK이노베이션 보통주
14186,96770,2021-05-04,0.0704500978473581,255500,273500,18000,1215923,96770.0,SK이노베이션 보통주
14187,96770,2021-05-03,0.055452865064695,270500,255500,-15000,1122359,96770.0,SK이노베이션 보통주
14188,96770,2021-04-12,0.1197478991596638,238000,266500,28500,4266364,96770.0,SK이노베이션 보통주
14189,96770,2021-04-08,0.0473118279569892,232500,243500,11000,1121741,96770.0,SK이노베이션 보통주
14190,96770,2021-04-01,0.1027397260273972,219000,241500,22500,3578846,96770.0,SK이노베이션 보통주
14191,96770,2021-03-30,0.0878048780487804,205000,223000,18000,1439750,96770.0,SK이노베이션 보통주
14192,96770,2021-03-16,0.0568927789934354,228500,215500,-13000,2124858,96770.0,SK이노베이션 보통주
14193,96770,2021-03-15,0.0577319587628866,242500,228500,-14000,1316842,96770.0,SK이노베이션 보통주
14194,96770,2021-03-11,0.0685840707964601,226000,241500,15500,1171776,96770.0,SK이노베이션 보통주
14195,96770,2021-03-08,0.0496031746031746,252000,239500,-12500,1043253,96770.0,SK이노베이션 보통주
14196,96770,2021-03-05,0.0454545454545454,264000,252000,-12000,1331646,96770.0,SK이노베이션 보통주
14197,96770,2021-02-24,0.0632688927943761,284500,266500,-18000,1188062,96770.0,SK이노베이션 보통주
14198,96770,2021-02-22,0.0405405405405405,296000,284000,-12000,1093541,96770.0,SK이노베이션 보통주
14199,96770,2021-02-17,0.0439367311072056,284500,297000,12500,1890952,96770.0,SK이노베이션 보통주
14200,96770,2021-02-15,0.042158516020236,296500,284000,-12500,3822679,96770.0,SK이노베이션 보통주
14201,96770,2021-02-08,0.0740131578947368,304000,281500,-22500,2914442,96770.0,SK이노베이션 보통주
14202,96770,2021-02-05,0.0410094637223974,317000,304000,-13000,2736810,96770.0,SK이노베이션 보통주
14203,96770,2021-02-01,0.1285714285714285,280000,316000,36000,3348470,96770.0,SK이노베이션 보통주
14204,96770,2021-01-19,0.0693069306930693,252500,270000,17500,1921736,96770.0,SK이노베이션 보통주
14205,96770,2021-01-14,0.0676156583629893,281000,262000,-19000,2611650,96770.0,SK이노베이션 보통주
14206,96770,2021-01-08,0.0760456273764258,263000,283000,20000,3408996,96770.0,SK이노베이션 보통주
14207,96770,2021-01-06,0.0532786885245901,244000,257000,13000,4279330,96770.0,SK이노베이션 보통주
14208,96770,2021-01-05,0.0562770562770562,231000,244000,13000,3195931,96770.0,SK이노베이션 보통주
14209,96770,2021-01-04,0.2157894736842105,190000,231000,41000,4269290,96770.0,SK이노베이션 보통주
14210,96770,2020-12-09,0.0511363636363636,176000,185000,9000,1818578,96770.0,SK이노베이션 보통주
14211,96770,2020-12-01,0.0549132947976878,173000,182500,9500,1433423,96770.0,SK이노베이션 보통주
14212,96770,2020-11-26,0.0703363914373088,163500,175000,11500,1984163,96770.0,SK이노베이션 보통주
14213,96770,2020-11-09,0.1095406360424028,141500,157000,15500,2099423,96770.0,SK이노베이션 보통주
14214,96770,2020-11-05,0.0454545454545454,132000,138000,6000,1075695,96770.0,SK이노베이션 보통주
14215,96770,2020-11-03,0.073469387755102,122500,131500,9000,831848,96770.0,SK이노베이션 보통주
14216,96770,2020-09-24,0.0641891891891891,148000,138500,-9500,872556,96770.0,SK이노베이션 보통주
14217,96770,2020-09-22,0.0412698412698412,157500,151000,-6500,801039,96770.0,SK이노베이션 보통주
14218,96770,2020-09-10,0.0821917808219178,146000,158000,12000,1781157,96770.0,SK이노베이션 보통주
14219,96770,2020-08-31,0.0764331210191082,157000,145000,-12000,2094753,96770.0,SK이노베이션 보통주
14220,96770,2020-08-27,0.0518292682926829,164000,155500,-8500,1783453,96770.0,SK이노베이션 보통주
14221,96770,2020-08-25,0.0721311475409836,152500,163500,11000,1600600,96770.0,SK이노베이션 보통주
14222,96770,2020-08-20,0.0548780487804878,164000,155000,-9000,1211612,96770.0,SK이노베이션 보통주
14223,96770,2020-08-18,0.066860465116279,172000,160500,-11500,1703952,96770.0,SK이노베이션 보통주
14224,96770,2020-08-14,0.0549450549450549,182000,172000,-10000,1615501,96770.0,SK이노베이션 보통주
14225,96770,2020-08-07,0.1253822629969418,163500,184000,20500,6000468,96770.0,SK이노베이션 보통주
14226,96770,2020-08-05,0.2045454545454545,132000,159000,27000,6130458,96770.0,SK이노베이션 보통주
14227,96770,2020-07-22,0.08,125000,135000,10000,2025022,96770.0,SK이노베이션 보통주
14228,96770,2020-06-29,0.0441176470588235,136000,130000,-6000,955726,96770.0,SK이노베이션 보통주
14229,96770,2020-06-24,0.06640625,128000,136500,8500,1754143,96770.0,SK이노베이션 보통주
14230,96770,2020-06-17,0.0815450643776824,116500,126000,9500,2417549,96770.0,SK이노베이션 보통주
14231,96770,2020-06-16,0.0938967136150234,106500,116500,10000,1091035,96770.0,SK이노베이션 보통주
14232,96770,2020-06-15,0.0739130434782608,115000,106500,-8500,1106675,96770.0,SK이노베이션 보통주
14233,96770,2020-06-12,0.0456431535269709,120500,115000,-5500,1153794,96770.0,SK이노베이션 보통주
14234,96770,2020-06-01,0.0464135021097046,118500,124000,5500,664521,96770.0,SK이노베이션 보통주
14235,96770,2020-05-26,0.1415094339622641,106000,121000,15000,2739083,96770.0,SK이노베이션 보통주
14236,96770,2020-05-19,0.0692148760330578,96800,103500,6700,1724747,96770.0,SK이노베이션 보통주
14237,96770,2020-04-13,0.0417910447761194,100500,96300,-4200,778610,96770.0,SK이노베이션 보통주
14238,96770,2020-04-09,0.047008547008547,93600,98000,4400,1180802,96770.0,SK이노베이션 보통주
14239,96770,2020-04-06,0.052396878483835,89700,94400,4700,1393130,96770.0,SK이노베이션 보통주
14240,96770,2020-04-02,0.0957575757575757,82500,90400,7900,2074973,96770.0,SK이노베이션 보통주
14241,96770,2020-04-01,0.0517241379310344,87000,82500,-4500,835614,96770.0,SK이노베이션 보통주
14242,96770,2020-03-26,0.0555555555555555,90000,85000,-5000,3277516,96770.0,SK이노베이션 보통주
14243,96770,2020-03-25,0.25,72000,90000,18000,2877009,96770.0,SK이노베이션 보통주
14244,96770,2020-03-24,0.1940298507462686,60300,72000,11700,1571585,96770.0,SK이노베이션 보통주
14245,96770,2020-03-23,0.0694444444444444,64800,60300,-4500,1162459,96770.0,SK이노베이션 보통주
14246,96770,2020-03-20,0.1308900523560209,57300,64800,7500,1719407,96770.0,SK이노베이션 보통주
14247,96770,2020-03-19,0.1918194640338505,70900,57300,-13600,2188651,96770.0,SK이노베이션 보통주
14248,96770,2020-03-18,0.0898587933247753,77900,70900,-7000,919817,96770.0,SK이노베이션 보통주
14249,96770,2020-03-16,0.0728323699421965,86500,80200,-6300,1113686,96770.0,SK이노베이션 보통주
14250,96770,2020-03-13,0.0638528138528138,92400,86500,-5900,1232107,96770.0,SK이노베이션 보통주
14251,96770,2020-03-12,0.0571428571428571,98000,92400,-5600,1006172,96770.0,SK이노베이션 보통주
14252,96770,2020-03-09,0.0824074074074074,108000,99100,-8900,1440983,96770.0,SK이노베이션 보통주
14253,96770,2020-03-06,0.0442477876106194,113000,108000,-5000,827288,96770.0,SK이노베이션 보통주
14254,96770,2020-02-24,0.053639846743295,130500,123500,-7000,531391,96770.0,SK이노베이션 보통주
14255,96770,2020-02-05,0.046875,128000,134000,6000,1477432,96770.0,SK이노베이션 보통주
14256,96770,2020-02-03,0.05,130000,123500,-6500,784715,96770.0,SK이노베이션 보통주
14257,96770,2020-01-31,0.04,125000,130000,5000,1239192,96770.0,SK이노베이션 보통주
14258,96770,2020-01-08,0.0519031141868512,144500,137000,-7500,703267,96770.0,SK이노베이션 보통주
14259,96770,2019-08-30,0.0576923076923076,156000,165000,9000,355730,96770.0,SK이노베이션 보통주
14260,96770,2019-07-11,0.0422960725075528,165500,172500,7000,384074,96770.0,SK이노베이션 보통주
14261,96770,2019-07-04,0.0586419753086419,162000,171500,9500,520983,96770.0,SK이노베이션 보통주
14262,96770,2019-04-15,0.0459459459459459,185000,193500,8500,487399,96770.0,SK이노베이션 보통주
14263,96770,2019-01-02,0.0584958217270195,179500,169000,-10500,475975,96770.0,SK이노베이션 보통주
14264,96770,2018-11-01,0.0515222482435597,213500,202500,-11000,308901,96770.0,SK이노베이션 보통주
14265,96770,2018-10-11,0.0462962962962962,216000,206000,-10000,280235,96770.0,SK이노베이션 보통주
14266,96770,2018-07-02,0.0693069306930693,202000,188000,-14000,613068,96770.0,SK이노베이션 보통주
14267,96770,2018-05-04,0.0435835351089588,206500,197500,-9000,390566,96770.0,SK이노베이션 보통주
14268,96770,2018-05-02,0.0610687022900763,196500,208500,12000,624815,96770.0,SK이노베이션 보통주
14269,96770,2018-03-12,0.0488997555012225,204500,214500,10000,377770,96770.0,SK이노베이션 보통주
14270,96770,2018-02-26,0.0476190476190476,199500,209000,9500,500147,96770.0,SK이노베이션 보통주
14271,96770,2018-01-29,0.0606060606060606,198000,210000,12000,633031,96770.0,SK이노베이션 보통주
14272,96770,2017-08-24,0.0409356725146198,171000,178000,7000,405005,96770.0,SK이노베이션 보통주
14273,96770,2017-08-04,0.0434782608695652,172500,180000,7500,313745,96770.0,SK이노베이션 보통주
14274,96770,2017-01-03,0.0544217687074829,147000,155000,8000,487764,96770.0,SK이노베이션 보통주
14275,96770,2016-11-10,0.0590163934426229,152500,161500,9000,382468,96770.0,SK이노베이션 보통주
14276,96770,2016-09-29,0.0521172638436482,153500,161500,8000,697944,96770.0,SK이노베이션 보통주
14277,96770,2016-08-23,0.0426229508196721,152500,146000,-6500,477003,96770.0,SK이노베이션 보통주
14278,97950,2021-05-25,0.0498338870431893,451500,474000,22500,119605,97950.0,씨제이제일제당 주식회사 보통주
14279,97950,2021-05-11,0.0436781609195402,435000,454000,19000,353489,97950.0,씨제이제일제당 주식회사 보통주
14280,97950,2021-05-07,0.0478527607361963,407500,427000,19500,199457,97950.0,씨제이제일제당 주식회사 보통주
14281,97950,2021-02-24,0.0410798122065727,426000,408500,-17500,124623,97950.0,씨제이제일제당 주식회사 보통주
14282,97950,2021-02-09,0.0517051705170517,454500,431000,-23500,221723,97950.0,씨제이제일제당 주식회사 보통주
14283,97950,2021-01-29,0.0533333333333333,450000,426000,-24000,113415,97950.0,씨제이제일제당 주식회사 보통주
14284,97950,2021-01-25,0.0620067643742953,443500,471000,27500,156650,97950.0,씨제이제일제당 주식회사 보통주
14285,97950,2021-01-08,0.0679012345679012,405000,432500,27500,288067,97950.0,씨제이제일제당 주식회사 보통주
14286,97950,2021-01-05,0.0780234070221066,384500,414500,30000,334236,97950.0,씨제이제일제당 주식회사 보통주
14287,97950,2020-11-04,0.0661157024793388,363000,387000,24000,93504,97950.0,씨제이제일제당 주식회사 보통주
14288,97950,2020-09-10,0.0692410119840213,375500,401500,26000,172970,97950.0,씨제이제일제당 주식회사 보통주
14289,97950,2020-08-12,0.0653889515219842,443500,414500,-29000,277899,97950.0,씨제이제일제당 주식회사 보통주
14290,97950,2020-08-03,0.0725388601036269,386000,414000,28000,216845,97950.0,씨제이제일제당 주식회사 보통주
14291,97950,2020-07-31,0.0517711171662125,367000,386000,19000,147404,97950.0,씨제이제일제당 주식회사 보통주
14292,97950,2020-07-09,0.0552486187845303,362000,382000,20000,137719,97950.0,씨제이제일제당 주식회사 보통주
14293,97950,2020-07-02,0.051622418879056,339000,356500,17500,107583,97950.0,씨제이제일제당 주식회사 보통주
14294,97950,2020-06-16,0.0631911532385466,316500,336500,20000,130120,97950.0,씨제이제일제당 주식회사 보통주
14295,97950,2020-06-10,0.0785597381342062,305500,329500,24000,207335,97950.0,씨제이제일제당 주식회사 보통주
14296,97950,2020-05-19,0.0438311688311688,308000,294500,-13500,159699,97950.0,씨제이제일제당 주식회사 보통주
14297,97950,2020-05-12,0.0511882998171846,273500,287500,14000,115839,97950.0,씨제이제일제당 주식회사 보통주
14298,97950,2020-05-06,0.0571955719557195,271000,286500,15500,106384,97950.0,씨제이제일제당 주식회사 보통주
14299,97950,2020-04-27,0.0579150579150579,259000,274000,15000,122239,97950.0,씨제이제일제당 주식회사 보통주
14300,97950,2020-04-23,0.059322033898305,236000,250000,14000,103721,97950.0,씨제이제일제당 주식회사 보통주
14301,97950,2020-04-06,0.0650759219088937,230500,245500,15000,83605,97950.0,씨제이제일제당 주식회사 보통주
14302,97950,2020-04-02,0.0654205607476635,214000,228000,14000,80386,97950.0,씨제이제일제당 주식회사 보통주
14303,97950,2020-03-30,0.0491400491400491,203500,213500,10000,65338,97950.0,씨제이제일제당 주식회사 보통주
14304,97950,2020-03-25,0.06282722513089,191000,203000,12000,98228,97950.0,씨제이제일제당 주식회사 보통주
14305,97950,2020-03-24,0.1072463768115942,172500,191000,18500,97920,97950.0,씨제이제일제당 주식회사 보통주
14306,97950,2020-03-23,0.0824468085106382,188000,172500,-15500,84035,97950.0,씨제이제일제당 주식회사 보통주
14307,97950,2020-03-20,0.2129032258064516,155000,188000,33000,191267,97950.0,씨제이제일제당 주식회사 보통주
14308,97950,2020-03-19,0.2619047619047619,210000,155000,-55000,263704,97950.0,씨제이제일제당 주식회사 보통주
14309,97950,2020-03-13,0.0553191489361702,235000,222000,-13000,108516,97950.0,씨제이제일제당 주식회사 보통주
14310,97950,2020-03-12,0.0447154471544715,246000,235000,-11000,83591,97950.0,씨제이제일제당 주식회사 보통주
14311,97950,2020-02-28,0.0579150579150579,259000,244000,-15000,75193,97950.0,씨제이제일제당 주식회사 보통주
14312,97950,2020-02-12,0.0450980392156862,255000,266500,11500,92748,97950.0,씨제이제일제당 주식회사 보통주
14313,97950,2020-02-11,0.0450819672131147,244000,255000,11000,85958,97950.0,씨제이제일제당 주식회사 보통주
14314,97950,2019-12-10,0.0584551148225469,239500,253500,14000,94999,97950.0,씨제이제일제당 주식회사 보통주
14315,97950,2019-11-12,0.0756302521008403,238000,256000,18000,151898,97950.0,씨제이제일제당 주식회사 보통주
14316,97950,2019-10-02,0.0453563714902807,231500,221000,-10500,90728,97950.0,씨제이제일제당 주식회사 보통주
14317,97950,2019-08-09,0.088235294117647,272000,248000,-24000,226654,97950.0,씨제이제일제당 주식회사 보통주
14318,97950,2019-01-04,0.0426829268292682,328000,342000,14000,51429,97950.0,씨제이제일제당 주식회사 보통주
14319,97950,2018-11-15,0.0585651537335285,341500,361500,20000,82231,97950.0,씨제이제일제당 주식회사 보통주
14320,97950,2018-10-11,0.04,325000,312000,-13000,64661,97950.0,씨제이제일제당 주식회사 보통주
14321,97950,2018-06-07,0.0412087912087912,364000,379000,15000,164708,97950.0,씨제이제일제당 주식회사 보통주
14322,97950,2018-05-10,0.0511695906432748,342000,359500,17500,188281,97950.0,씨제이제일제당 주식회사 보통주
14323,97950,2018-02-23,0.052160953800298,335500,353000,17500,116816,97950.0,씨제이제일제당 주식회사 보통주
14324,97950,2018-02-09,0.0486725663716814,339000,322500,-16500,134942,97950.0,씨제이제일제당 주식회사 보통주
14325,97950,2017-12-19,0.0702634880803011,398500,370500,-28000,231869,97950.0,씨제이제일제당 주식회사 보통주
14326,97950,2017-12-15,0.059445178335535,378500,401000,22500,45427,97950.0,씨제이제일제당 주식회사 보통주
14327,97950,2017-12-14,0.0561097256857855,401000,378500,-22500,62211,97950.0,씨제이제일제당 주식회사 보통주
14328,97950,2017-11-20,0.041405269761606,398500,415000,16500,110912,97950.0,씨제이제일제당 주식회사 보통주
14329,97950,2017-11-09,0.0738255033557047,372500,400000,27500,271286,97950.0,씨제이제일제당 주식회사 보통주
14330,97950,2017-11-03,0.0476858345021037,356500,373500,17000,57673,97950.0,씨제이제일제당 주식회사 보통주
14331,97950,2017-02-10,0.051063829787234,352500,370500,18000,78725,97950.0,씨제이제일제당 주식회사 보통주
14332,97950,2017-02-06,0.0421348314606741,356000,371000,15000,92238,97950.0,씨제이제일제당 주식회사 보통주
14333,97950,2016-11-29,0.0437756497948016,365500,381500,16000,83067,97950.0,씨제이제일제당 주식회사 보통주
14334,97950,2016-11-03,0.069423929098966,338500,362000,23500,92023,97950.0,씨제이제일제당 주식회사 보통주
14335,102110,2021-01-08,0.044788664745437,41640,43505,1865,1804424,,
14336,102110,2020-06-16,0.0591317365269461,26720,28300,1580,2262732,,
14337,102110,2020-06-15,0.0487718049127803,28090,26720,-1370,3034165,,
14338,102110,2020-04-01,0.0484271523178807,24160,22990,-1170,3564858,,
14339,102110,2020-03-25,0.0572510581421251,22445,23730,1285,7160876,,
14340,102110,2020-03-24,0.0919484310386767,20555,22445,1890,7093950,,
14341,102110,2020-03-23,0.0558107487367937,21770,20555,-1215,7835339,,
14342,102110,2020-03-20,0.0742659758203799,20265,21770,1505,8407183,,
14343,102110,2020-03-19,0.0693455797933409,21775,20265,-1510,10104416,,
14344,102110,2020-03-18,0.0569510610653962,23090,21775,-1315,6252936,,
14345,102110,2020-03-09,0.0422939068100358,27900,26720,-1180,3631544,,
14346,102110,2018-10-11,0.0414937759336099,28920,27720,-1200,2500049,,
14347,102780,2021-01-08,0.0442095146564151,10405,10865,460,1636350,,
14348,102780,2020-08-20,0.05,7800,7410,-390,376886,,
14349,102780,2020-06-16,0.0546369518332135,6955,7335,380,1196646,,
14350,102780,2020-04-01,0.0441176470588235,5780,5525,-255,152789,,
14351,102780,2020-03-25,0.0524886877828054,5525,5815,290,1978345,,
14352,102780,2020-03-24,0.0897435897435897,5070,5525,455,1116216,,
14353,102780,2020-03-20,0.0831622176591375,4870,5275,405,548586,,
14354,102780,2020-03-19,0.088868101028999,5345,4870,-475,226223,,
14355,102780,2020-03-18,0.0573192239858906,5670,5345,-325,1059464,,
14356,102780,2020-03-16,0.0489396411092985,6130,5830,-300,245912,,
14357,102780,2020-03-09,0.0450321658327376,6995,6680,-315,320133,,
14358,102780,2018-10-11,0.0442028985507246,6900,6595,-305,268685,,
14359,102780,2016-08-18,0.0412272291466922,5215,5430,215,305710,,
14360,105560,2021-05-06,0.0787992495309568,53300,57500,4200,3197803,105560.0,KB금융지주 보통주
14361,105560,2021-03-09,0.053053053053053,49950,52600,2650,7203435,105560.0,KB금융지주 보통주
14362,105560,2021-03-08,0.0627659574468085,47000,49950,2950,5184062,105560.0,KB금융지주 보통주
14363,105560,2021-02-05,0.0546967895362663,42050,44350,2300,3557203,105560.0,KB금융지주 보통주
14364,105560,2021-02-01,0.0446650124069478,40300,42100,1800,1995656,105560.0,KB금융지주 보통주
14365,105560,2021-01-07,0.0454545454545454,44000,46000,2000,4683821,105560.0,KB금융지주 보통주
14366,105560,2020-12-29,0.0482456140350877,45600,43400,-2200,2666286,105560.0,KB금융지주 보통주
14367,105560,2020-11-30,0.05422314911366,47950,45350,-2600,3803160,105560.0,KB금융지주 보통주
14368,105560,2020-11-25,0.0409482758620689,46400,48300,1900,3209922,105560.0,KB금융지주 보통주
14369,105560,2020-11-11,0.0570469798657718,44700,47250,2550,3407691,105560.0,KB금융지주 보통주
14370,105560,2020-11-10,0.0407450523864959,42950,44700,1750,2913985,105560.0,KB금융지주 보통주
14371,105560,2020-11-02,0.0473815461346633,40100,42000,1900,1789683,105560.0,KB금융지주 보통주
14372,105560,2020-08-20,0.0407894736842105,38000,36450,-1550,2376891,105560.0,KB금융지주 보통주
14373,105560,2020-08-18,0.0414572864321608,39800,38150,-1650,2848865,105560.0,KB금융지주 보통주
14374,105560,2020-08-14,0.0409638554216867,41500,39800,-1700,2859261,105560.0,KB금융지주 보통주
14375,105560,2020-08-11,0.044414535666218,37150,38800,1650,4668361,105560.0,KB금융지주 보통주
14376,105560,2020-07-13,0.0412371134020618,33950,35350,1400,1765624,105560.0,KB금융지주 보통주
14377,105560,2020-06-16,0.0736842105263157,33250,35700,2450,2255201,105560.0,KB금융지주 보통주
14378,105560,2020-06-15,0.0404040404040404,34650,33250,-1400,3388071,105560.0,KB금융지주 보통주
14379,105560,2020-06-12,0.046767537826685,36350,34650,-1700,3806558,105560.0,KB금융지주 보통주
14380,105560,2020-06-04,0.0414507772020725,38600,37000,-1600,6220789,105560.0,KB금융지주 보통주
14381,105560,2020-06-03,0.0648275862068965,36250,38600,2350,5291169,105560.0,KB금융지주 보통주
14382,105560,2020-06-02,0.0476878612716763,34600,36250,1650,3992096,105560.0,KB금융지주 보통주
14383,105560,2020-05-04,0.0503597122302158,34750,33000,-1750,3135974,105560.0,KB금융지주 보통주
14384,105560,2020-04-27,0.0996784565916398,31100,34200,3100,6297287,105560.0,KB금융지주 보통주
14385,105560,2020-04-06,0.0545746388443017,31150,32850,1700,1998703,105560.0,KB금융지주 보통주
14386,105560,2020-04-01,0.085383502170767,34550,31600,-2950,2918796,105560.0,KB금융지주 보통주
14387,105560,2020-03-27,0.0866261398176291,32900,35750,2850,3789110,105560.0,KB금융지주 보통주
14388,105560,2020-03-25,0.0977701543739279,29150,32000,2850,4002728,105560.0,KB금융지주 보통주
14389,105560,2020-03-24,0.0542495479204339,27650,29150,1500,2766834,105560.0,KB금융지주 보통주
14390,105560,2020-03-23,0.1037277147487844,30850,27650,-3200,2779005,105560.0,KB금융지주 보통주
14391,105560,2020-03-20,0.1842610364683301,26050,30850,4800,2772947,105560.0,KB금융지주 보통주
14392,105560,2020-03-19,0.1032702237521514,29050,26050,-3000,3226552,105560.0,KB금융지주 보통주
14393,105560,2020-03-17,0.0700934579439252,32100,29850,-2250,2376047,105560.0,KB금융지주 보통주
14394,105560,2020-03-12,0.0524079320113314,35300,33450,-1850,2428039,105560.0,KB금융지주 보통주
14395,105560,2020-03-09,0.0614152202937249,37450,35150,-2300,2015102,105560.0,KB금융지주 보통주
14396,105560,2020-02-24,0.0510328068043742,41150,39050,-2100,1872964,105560.0,KB금융지주 보통주
14397,105560,2020-01-28,0.0471092077087794,46700,44500,-2200,1494047,105560.0,KB금융지주 보통주
14398,105560,2019-04-01,0.051373954599761,41850,44000,2150,2419101,105560.0,KB금융지주 보통주
14399,105560,2019-01-15,0.0493827160493827,44550,46750,2200,1317274,105560.0,KB금융지주 보통주
14400,105560,2018-12-27,0.0491631799163179,47800,45450,-2350,1336622,105560.0,KB금융지주 보통주
14401,105560,2018-10-30,0.0552325581395348,51600,48750,-2850,1898563,105560.0,KB금융지주 보통주
14402,105560,2018-10-11,0.0469314079422382,55400,52800,-2600,1625520,105560.0,KB금융지주 보통주
14403,105560,2018-07-13,0.0453686200378071,52900,55300,2400,1019107,105560.0,KB금융지주 보통주
14404,105560,2018-06-21,0.043557168784029,55100,52700,-2400,1321931,105560.0,KB금융지주 보통주
14405,105560,2018-06-04,0.0401529636711281,52300,54400,2100,1480544,105560.0,KB금융지주 보통주
14406,105560,2018-05-30,0.0402930402930402,54600,52400,-2200,2116671,105560.0,KB금융지주 보통주
14407,105560,2018-02-12,0.0540983606557377,61000,64300,3300,1222428,105560.0,KB금융지주 보통주
14408,105560,2018-02-06,0.051698670605613,67700,64200,-3500,1777390,105560.0,KB금융지주 보통주
14409,105560,2018-01-23,0.0441400304414003,65700,68600,2900,899249,105560.0,KB금융지주 보통주
14410,105560,2017-12-13,0.0428816466552315,58300,60800,2500,1319487,105560.0,KB금융지주 보통주
14411,105560,2017-09-05,0.0519480519480519,53900,51100,-2800,2245667,105560.0,KB금융지주 보통주
14412,105560,2017-07-21,0.0418118466898954,57400,59800,2400,2680425,105560.0,KB금융지주 보통주
14413,105560,2017-04-17,0.0445595854922279,48250,50400,2150,2192191,105560.0,KB금융지주 보통주
14414,105560,2016-12-08,0.060931899641577,41850,44400,2550,2204792,105560.0,KB금융지주 보통주
14415,111770,2021-05-21,0.0590030518819938,49150,46250,-2900,294400,111770.0,영원무역보통주
14416,111770,2021-05-18,0.0403397027600849,47100,49000,1900,282454,111770.0,영원무역보통주
14417,111770,2021-05-13,0.0404564315352697,48200,46250,-1950,262358,111770.0,영원무역보통주
14418,111770,2021-05-10,0.0985915492957746,42600,46800,4200,455571,111770.0,영원무역보통주
14419,111770,2021-05-06,0.0410447761194029,40200,41850,1650,167514,111770.0,영원무역보통주
14420,111770,2021-05-03,0.0637813211845102,43900,41100,-2800,205924,111770.0,영원무역보통주
14421,111770,2021-04-20,0.0572139303482587,40200,42500,2300,340471,111770.0,영원무역보통주
14422,111770,2021-03-18,0.0417721518987341,39500,41150,1650,232643,111770.0,영원무역보통주
14423,111770,2021-03-08,0.0594405594405594,42900,40350,-2550,232670,111770.0,영원무역보통주
14424,111770,2021-02-25,0.0674448767833981,38550,41150,2600,200938,111770.0,영원무역보통주
14425,111770,2021-02-24,0.0469715698393077,40450,38550,-1900,227133,111770.0,영원무역보통주
14426,111770,2021-01-05,0.0418006430868167,31100,32400,1300,273065,111770.0,영원무역보통주
14427,111770,2020-12-11,0.0702875399361022,31300,33500,2200,465279,111770.0,영원무역보통주
14428,111770,2020-12-02,0.0444810543657331,30350,31700,1350,280376,111770.0,영원무역보통주
14429,111770,2020-11-16,0.0649572649572649,29250,31150,1900,456654,111770.0,영원무역보통주
14430,111770,2020-11-10,0.0642361111111111,28800,30650,1850,353762,111770.0,영원무역보통주
14431,111770,2020-10-29,0.0456026058631921,30700,29300,-1400,174323,111770.0,영원무역보통주
14432,111770,2020-10-28,0.0531732418524871,29150,30700,1550,122942,111770.0,영원무역보통주
14433,111770,2020-10-26,0.0495207667731629,31300,29750,-1550,93331,111770.0,영원무역보통주
14434,111770,2020-10-21,0.0567986230636833,29050,30700,1650,551189,111770.0,영원무역보통주
14435,111770,2020-09-24,0.0661896243291592,27950,26100,-1850,304494,111770.0,영원무역보통주
14436,111770,2020-09-08,0.0404354587869362,32150,30850,-1300,177654,111770.0,영원무역보통주
14437,111770,2020-09-07,0.0788590604026845,29800,32150,2350,357587,111770.0,영원무역보통주
14438,111770,2020-08-31,0.0644067796610169,29500,31400,1900,546551,111770.0,영원무역보통주
14439,111770,2020-08-26,0.0402010050251256,29850,28650,-1200,293326,111770.0,영원무역보통주
14440,111770,2020-08-24,0.0714285714285714,28000,30000,2000,659663,111770.0,영원무역보통주
14441,111770,2020-08-21,0.1336032388663967,24700,28000,3300,788018,111770.0,영원무역보통주
14442,111770,2020-08-20,0.0608365019011406,26300,24700,-1600,242358,111770.0,영원무역보통주
14443,111770,2020-08-12,0.0428849902534113,25650,26750,1100,347891,111770.0,영원무역보통주
14444,111770,2020-08-10,0.0528541226215644,23650,24900,1250,320605,111770.0,영원무역보통주
14445,111770,2020-06-25,0.0462962962962962,27000,25750,-1250,230078,111770.0,영원무역보통주
14446,111770,2020-06-22,0.0400696864111498,28700,27550,-1150,186822,111770.0,영원무역보통주
14447,111770,2020-06-16,0.0583941605839416,27400,29000,1600,136033,111770.0,영원무역보통주
14448,111770,2020-06-15,0.0711864406779661,29500,27400,-2100,190305,111770.0,영원무역보통주
14449,111770,2020-06-12,0.0453074433656957,30900,29500,-1400,171598,111770.0,영원무역보통주
14450,111770,2020-06-04,0.0411160058737151,34050,32650,-1400,282341,111770.0,영원무역보통주
14451,111770,2020-06-02,0.064516129032258,32550,34650,2100,338659,111770.0,영원무역보통주
14452,111770,2020-06-01,0.0619902120717781,30650,32550,1900,272410,111770.0,영원무역보통주
14453,111770,2020-05-28,0.0589171974522293,31400,29550,-1850,246544,111770.0,영원무역보통주
14454,111770,2020-05-22,0.0404929577464788,28400,29550,1150,572141,111770.0,영원무역보통주
14455,111770,2020-05-21,0.0798479087452471,26300,28400,2100,507400,111770.0,영원무역보통주
14456,111770,2020-05-18,0.0733197556008146,24550,26350,1800,320305,111770.0,영원무역보통주
14457,111770,2020-05-12,0.0408560311284046,25700,24650,-1050,142304,111770.0,영원무역보통주
14458,111770,2020-04-28,0.0419847328244274,26200,27300,1100,230126,111770.0,영원무역보통주
14459,111770,2020-04-27,0.0672097759674134,24550,26200,1650,274391,111770.0,영원무역보통주
14460,111770,2020-04-16,0.0493827160493827,24300,23100,-1200,328044,111770.0,영원무역보통주
14461,111770,2020-04-09,0.0597014925373134,23450,24850,1400,154214,111770.0,영원무역보통주
14462,111770,2020-04-07,0.0411255411255411,23100,24050,950,178703,111770.0,영원무역보통주
14463,111770,2020-03-26,0.052896725440806,19850,20900,1050,295158,111770.0,영원무역보통주
14464,111770,2020-03-25,0.0672043010752688,18600,19850,1250,337818,111770.0,영원무역보통주
14465,111770,2020-03-23,0.1151079136690647,20850,18450,-2400,147012,111770.0,영원무역보통주
14466,111770,2020-03-20,0.188034188034188,17550,20850,3300,250659,111770.0,영원무역보통주
14467,111770,2020-03-19,0.1779859484777517,21350,17550,-3800,403089,111770.0,영원무역보통주
14468,111770,2020-03-17,0.055793991416309,23300,22000,-1300,168940,111770.0,영원무역보통주
14469,111770,2020-03-12,0.059047619047619,26250,24700,-1550,284438,111770.0,영원무역보통주
14470,111770,2020-03-09,0.0809443507588532,29650,27250,-2400,319714,111770.0,영원무역보통주
14471,111770,2020-03-06,0.0450885668276972,31050,29650,-1400,204749,111770.0,영원무역보통주
14472,111770,2020-02-06,0.0644067796610169,29500,31400,1900,225387,111770.0,영원무역보통주
14473,111770,2020-01-28,0.0520673813169984,32650,30950,-1700,183164,111770.0,영원무역보통주
14474,111770,2020-01-09,0.0416024653312788,32450,33800,1350,209342,111770.0,영원무역보통주
14475,111770,2019-12-09,0.042016806722689,35700,34200,-1500,196935,111770.0,영원무역보통주
14476,111770,2019-11-15,0.0473457675753228,34850,36500,1650,247600,111770.0,영원무역보통주
14477,111770,2019-11-04,0.0478199718706047,35550,37250,1700,124979,111770.0,영원무역보통주
14478,111770,2019-09-20,0.0472779369627507,34900,36550,1650,166831,111770.0,영원무역보통주
14479,111770,2019-08-14,0.0423728813559322,35400,36900,1500,183874,111770.0,영원무역보통주
14480,111770,2019-08-13,0.0614692653673163,33350,35400,2050,120538,111770.0,영원무역보통주
14481,111770,2019-06-05,0.0577427821522309,38100,40300,2200,145244,111770.0,영원무역보통주
14482,111770,2019-05-30,0.0434782608695652,40250,38500,-1750,301954,111770.0,영원무역보통주
14483,111770,2019-05-20,0.047029702970297,40400,42300,1900,323929,111770.0,영원무역보통주
14484,111770,2019-05-16,0.1135430916552667,36550,40700,4150,626016,111770.0,영원무역보통주
14485,111770,2019-05-09,0.0458015267175572,39300,37500,-1800,143136,111770.0,영원무역보통주
14486,111770,2019-05-08,0.0410596026490066,37750,39300,1550,219293,111770.0,영원무역보통주
14487,111770,2019-04-11,0.0506155950752394,36550,38400,1850,298096,111770.0,영원무역보통주
14488,111770,2019-04-05,0.0478260869565217,34500,36150,1650,296726,111770.0,영원무역보통주
14489,111770,2019-04-04,0.0438729198184568,33050,34500,1450,220323,111770.0,영원무역보통주
14490,111770,2019-03-12,0.0557324840764331,31400,33150,1750,188229,111770.0,영원무역보통주
14491,111770,2019-03-08,0.0659670164917541,33350,31150,-2200,463817,111770.0,영원무역보통주
14492,111770,2019-03-05,0.0732044198895027,36200,33550,-2650,435959,111770.0,영원무역보통주
14493,111770,2019-02-13,0.0609579100145137,34450,36550,2100,205905,111770.0,영원무역보통주
14494,111770,2019-01-11,0.0557667934093789,39450,37250,-2200,198573,111770.0,영원무역보통주
14495,111770,2019-01-09,0.0492676431424767,37550,39400,1850,209262,111770.0,영원무역보통주
14496,111770,2019-01-08,0.0532959326788218,35650,37550,1900,127837,111770.0,영원무역보통주
14497,111770,2019-01-03,0.0607661822985469,37850,35550,-2300,159117,111770.0,영원무역보통주
14498,111770,2018-12-28,0.0463847203274215,36650,38350,1700,151588,111770.0,영원무역보통주
14499,111770,2018-11-27,0.057810578105781,40650,38300,-2350,219994,111770.0,영원무역보통주
14500,111770,2018-11-19,0.0460081190798376,36950,38650,1700,162299,111770.0,영원무역보통주
14501,111770,2018-11-15,0.0502092050209205,35850,37650,1800,175496,111770.0,영원무역보통주
14502,111770,2018-10-31,0.0468521229868228,34150,35750,1600,229730,111770.0,영원무역보통주
14503,111770,2018-10-29,0.0568181818181818,35200,33200,-2000,117101,111770.0,영원무역보통주
14504,111770,2018-10-05,0.04,40000,38400,-1600,161991,111770.0,영원무역보통주
14505,111770,2018-10-04,0.0484927916120576,38150,40000,1850,220422,111770.0,영원무역보통주
14506,111770,2018-09-11,0.080110497237569,36200,39100,2900,385990,111770.0,영원무역보통주
14507,111770,2018-08-16,0.0532915360501567,31900,33600,1700,464302,111770.0,영원무역보통주
14508,111770,2018-08-14,0.0850340136054421,29400,31900,2500,360984,111770.0,영원무역보통주
14509,111770,2018-07-19,0.0470016207455429,30850,29400,-1450,193064,111770.0,영원무역보통주
14510,111770,2018-06-20,0.0467153284671532,34250,35850,1600,296561,111770.0,영원무역보통주
14511,111770,2018-06-11,0.0596026490066225,30200,32000,1800,141465,111770.0,영원무역보통주
14512,111770,2018-05-16,0.046031746031746,31500,32950,1450,249134,111770.0,영원무역보통주
14513,111770,2018-03-23,0.0456942003514938,28450,27150,-1300,85283,111770.0,영원무역보통주
14514,111770,2018-03-05,0.0594405594405594,28600,26900,-1700,158903,111770.0,영원무역보통주
14515,111770,2018-02-01,0.0423197492163009,31900,33250,1350,237360,111770.0,영원무역보통주
14516,111770,2017-11-15,0.0576070901033973,33850,31900,-1950,399443,111770.0,영원무역보통주
14517,111770,2017-10-31,0.0765100671140939,37250,34400,-2850,326984,111770.0,영원무역보통주
14518,111770,2017-10-30,0.0478199718706047,35550,37250,1700,207644,111770.0,영원무역보통주
14519,111770,2017-10-24,0.0975232198142414,32300,35450,3150,340727,111770.0,영원무역보통주
14520,111770,2017-10-11,0.0493827160493827,32400,34000,1600,152179,111770.0,영원무역보통주
14521,111770,2017-09-26,0.0421393841166936,30850,32150,1300,70424,111770.0,영원무역보통주
14522,111770,2017-08-09,0.0403225806451612,31000,32250,1250,245026,111770.0,영원무역보통주
14523,111770,2017-07-21,0.0414285714285714,35000,33550,-1450,158460,111770.0,영원무역보통주
14524,111770,2017-05-30,0.0594202898550724,34500,36550,2050,383471,111770.0,영원무역보통주
14525,111770,2017-04-11,0.0471841704718417,32850,34400,1550,183758,111770.0,영원무역보통주
14526,111770,2017-04-07,0.0496894409937888,32200,33800,1600,229615,111770.0,영원무역보통주
14527,111770,2017-03-07,0.0504885993485342,30700,32250,1550,224308,111770.0,영원무역보통주
14528,111770,2017-02-27,0.044776119402985,30150,31500,1350,626942,111770.0,영원무역보통주
14529,111770,2017-02-13,0.0686106346483705,29150,31150,2000,541963,111770.0,영원무역보통주
14530,111770,2017-02-10,0.0504504504504504,27750,29150,1400,660921,111770.0,영원무역보통주
14531,111770,2017-02-07,0.0426716141001855,26950,28100,1150,280074,111770.0,영원무역보통주
14532,111770,2017-01-03,0.0496,31250,29700,-1550,260688,111770.0,영원무역보통주
14533,111770,2016-12-23,0.0773195876288659,29100,31350,2250,283024,111770.0,영원무역보통주
14534,111770,2016-12-13,0.0549645390070922,28200,29750,1550,357092,111770.0,영원무역보통주
14535,111770,2016-12-12,0.040590405904059,27100,28200,1100,272622,111770.0,영원무역보통주
14536,111770,2016-11-09,0.0409252669039145,28100,26950,-1150,723942,111770.0,영원무역보통주
14537,111770,2016-11-07,0.1393568147013782,32650,28100,-4550,1383652,111770.0,영원무역보통주
14538,111770,2016-10-14,0.0506666666666666,37500,35600,-1900,322725,111770.0,영원무역보통주
14539,111770,2016-09-22,0.0585774058577405,35850,37950,2100,484181,111770.0,영원무역보통주
14540,111770,2016-09-05,0.0445765230312035,33650,35150,1500,223639,111770.0,영원무역보통주
14541,111770,2016-08-22,0.060478199718706,35550,33400,-2150,571535,111770.0,영원무역보통주
14542,111770,2016-08-09,0.0495314591700133,37350,39200,1850,311360,111770.0,영원무역보통주
14543,111770,2016-08-02,0.043115438108484,35950,37500,1550,313784,111770.0,영원무역보통주
14544,112610,2021-06-01,0.0500658761528326,75900,79700,3800,753942,112610.0,씨에스윈드보통주
14545,112610,2021-05-25,0.0714285714285714,70000,75000,5000,737267,112610.0,씨에스윈드보통주
14546,112610,2021-05-13,0.0402777777777777,72000,69100,-2900,476834,112610.0,씨에스윈드보통주
14547,112610,2021-05-11,0.0401069518716577,74800,71800,-3000,542896,112610.0,씨에스윈드보통주
14548,112610,2021-05-06,0.0639204545454545,70400,74900,4500,865694,112610.0,씨에스윈드보통주
14549,112610,2021-05-03,0.0662337662337662,77000,71900,-5100,614733,112610.0,씨에스윈드보통주
14550,112610,2021-04-30,0.0504774897680764,73300,77000,3700,627250,112610.0,씨에스윈드보통주
14551,112610,2021-04-28,0.0514138817480719,77800,73800,-4000,853737,112610.0,씨에스윈드보통주
14552,112610,2021-04-27,0.0465686274509803,81600,77800,-3800,985287,112610.0,씨에스윈드보통주
14553,112610,2021-04-16,0.053349875930521,80600,84900,4300,1176190,112610.0,씨에스윈드보통주
14554,112610,2021-04-09,0.0417193426042983,79100,82400,3300,1341612,112610.0,씨에스윈드보통주
14555,112610,2021-04-08,0.047682119205298,75500,79100,3600,1134930,112610.0,씨에스윈드보통주
14556,112610,2021-03-26,0.0476858345021037,71300,74700,3400,956513,112610.0,씨에스윈드보통주
14557,112610,2021-03-24,0.0531914893617021,65800,69300,3500,743186,112610.0,씨에스윈드보통주
14558,112610,2021-03-12,0.1007751937984496,64500,71000,6500,1900314,112610.0,씨에스윈드보통주
14559,112610,2021-03-10,0.0572831423895253,61100,64600,3500,2328499,112610.0,씨에스윈드보통주
14560,112610,2021-03-09,0.0426621160409556,58600,61100,2500,2165447,112610.0,씨에스윈드보통주
14561,112610,2021-03-08,0.0942812982998454,64700,58600,-6100,1797469,112610.0,씨에스윈드보통주
14562,112610,2021-03-04,0.0539772727272727,70400,66600,-3800,552757,112610.0,씨에스윈드보통주
14563,112610,2021-02-25,0.0414285714285714,70000,72900,2900,415519,112610.0,씨에스윈드보통주
14564,112610,2021-02-24,0.0476190476190476,73500,70000,-3500,419634,112610.0,씨에스윈드보통주
14565,112610,2021-02-23,0.0454545454545454,77000,73500,-3500,680172,112610.0,씨에스윈드보통주
14566,112610,2021-02-22,0.0609756097560975,82000,77000,-5000,749154,112610.0,씨에스윈드보통주
14567,112610,2021-02-01,0.075,160000,172000,12000,239608,112610.0,씨에스윈드보통주
14568,112610,2021-01-29,0.0504451038575667,168500,160000,-8500,307406,112610.0,씨에스윈드보통주
14569,112610,2021-01-20,0.0463768115942029,172500,180500,8000,559117,112610.0,씨에스윈드보통주
14570,112610,2021-01-19,0.0849056603773584,159000,172500,13500,333102,112610.0,씨에스윈드보통주
14571,112610,2020-12-30,0.0535714285714285,168000,177000,9000,323826,112610.0,씨에스윈드보통주
14572,112610,2020-12-22,0.0601719197707736,174500,155000,-19500,561087,112610.0,씨에스윈드보통주
14573,112610,2020-12-17,0.0597014925373134,167500,177500,10000,492802,112610.0,씨에스윈드보통주
14574,112610,2020-12-16,0.0983606557377049,152500,167500,15000,492773,112610.0,씨에스윈드보통주
14575,112610,2020-12-09,0.1129032258064516,124000,138000,14000,1170385,112610.0,씨에스윈드보통주
14576,112610,2020-11-18,0.0759493670886076,118500,127500,9000,686100,112610.0,씨에스윈드보통주
14577,112610,2020-11-11,0.0648854961832061,131000,122500,-8500,548285,112610.0,씨에스윈드보통주
14578,112610,2020-11-09,0.1548672566371681,113000,130500,17500,1067142,112610.0,씨에스윈드보통주
14579,112610,2020-11-06,0.0610328638497652,106500,113000,6500,834012,112610.0,씨에스윈드보통주
14580,112610,2020-11-05,0.0790273556231003,98700,106500,7800,993812,112610.0,씨에스윈드보통주
14581,112610,2020-11-04,0.0986301369863013,109500,98700,-10800,1726951,112610.0,씨에스윈드보통주
14582,112610,2020-11-02,0.0682046138415245,99700,106500,6800,319396,112610.0,씨에스윈드보통주
14583,112610,2020-10-30,0.0549763033175355,105500,99700,-5800,220953,112610.0,씨에스윈드보통주
14584,112610,2020-10-28,0.0799584631360332,96300,104000,7700,424320,112610.0,씨에스윈드보통주
14585,112610,2020-10-26,0.0719211822660098,101500,94200,-7300,365825,112610.0,씨에스윈드보통주
14586,112610,2020-10-20,0.0544904137235116,99100,104500,5400,408417,112610.0,씨에스윈드보통주
14587,112610,2020-10-19,0.0425120772946859,103500,99100,-4400,298149,112610.0,씨에스윈드보통주
14588,112610,2020-10-16,0.0460829493087557,108500,103500,-5000,381871,112610.0,씨에스윈드보통주
14589,112610,2020-10-13,0.0580912863070539,120500,113500,-7000,405525,112610.0,씨에스윈드보통주
14590,112610,2020-10-06,0.0700934579439252,107000,114500,7500,457751,112610.0,씨에스윈드보통주
14591,112610,2020-10-05,0.0797174571140262,99100,107000,7900,707469,112610.0,씨에스윈드보통주
14592,112610,2020-09-28,0.0881104033970276,94200,102500,8300,293477,112610.0,씨에스윈드보통주
14593,112610,2020-09-22,0.085972850678733,110500,101000,-9500,516436,112610.0,씨에스윈드보통주
14594,112610,2020-09-08,0.0705394190871369,120500,112000,-8500,825035,112610.0,씨에스윈드보통주
14595,112610,2020-09-04,0.1285714285714285,105000,118500,13500,1729769,112610.0,씨에스윈드보통주
14596,112610,2020-09-03,0.0769230769230769,97500,105000,7500,539146,112610.0,씨에스윈드보통주
14597,112610,2020-09-01,0.0439024390243902,102500,98000,-4500,357416,112610.0,씨에스윈드보통주
14598,112610,2020-08-31,0.0835095137420718,94600,102500,7900,548152,112610.0,씨에스윈드보통주
14599,112610,2020-08-28,0.0848623853211009,87200,94600,7400,675080,112610.0,씨에스윈드보통주
14600,112610,2020-08-24,0.0602564102564102,78000,82700,4700,422881,112610.0,씨에스윈드보통주
14601,112610,2020-08-14,0.0492379835873388,85300,81100,-4200,365726,112610.0,씨에스윈드보통주
14602,112610,2020-08-12,0.0452322738386308,81800,85500,3700,605360,112610.0,씨에스윈드보통주
14603,112610,2020-08-07,0.0406698564593301,83600,80200,-3400,473483,112610.0,씨에스윈드보통주
14604,112610,2020-08-05,0.0430379746835443,79000,82400,3400,351599,112610.0,씨에스윈드보통주
14605,112610,2020-07-30,0.1587982832618025,69900,81000,11100,1459297,112610.0,씨에스윈드보통주
14606,112610,2020-07-28,0.0510948905109489,68500,72000,3500,474131,112610.0,씨에스윈드보통주
14607,112610,2020-07-24,0.0463096960926193,69100,65900,-3200,467848,112610.0,씨에스윈드보통주
14608,112610,2020-07-21,0.1483253588516746,62700,72000,9300,2247669,112610.0,씨에스윈드보통주
14609,112610,2020-07-20,0.0627118644067796,59000,62700,3700,947742,112610.0,씨에스윈드보통주
14610,112610,2020-07-16,0.0799256505576208,53800,58100,4300,768400,112610.0,씨에스윈드보통주
14611,112610,2020-07-07,0.0957446808510638,47000,51500,4500,1455532,112610.0,씨에스윈드보통주
14612,112610,2020-07-06,0.0561797752808988,44500,47000,2500,497132,112610.0,씨에스윈드보통주
14613,112610,2020-07-03,0.0595238095238095,42000,44500,2500,347933,112610.0,씨에스윈드보통주
14614,112610,2020-06-26,0.0504413619167717,39650,41650,2000,1111487,112610.0,씨에스윈드보통주
14615,112610,2020-06-19,0.0678426051560379,36850,39350,2500,126311,112610.0,씨에스윈드보통주
14616,112610,2020-06-16,0.04,35000,36400,1400,51786,112610.0,씨에스윈드보통주
14617,112610,2020-06-15,0.0944372574385511,38650,35000,-3650,115495,112610.0,씨에스윈드보통주
14618,112610,2020-05-26,0.0453955901426718,38550,40300,1750,261549,112610.0,씨에스윈드보통주
14619,112610,2020-05-25,0.0649171270718232,36200,38550,2350,122169,112610.0,씨에스윈드보통주
14620,112610,2020-05-22,0.0461133069828722,37950,36200,-1750,144884,112610.0,씨에스윈드보통주
14621,112610,2020-05-21,0.0615384615384615,35750,37950,2200,705392,112610.0,씨에스윈드보통주
14622,112610,2020-05-11,0.0467153284671532,34250,35850,1600,67680,112610.0,씨에스윈드보통주
14623,112610,2020-04-27,0.0627118644067796,29500,31350,1850,64533,112610.0,씨에스윈드보통주
14624,112610,2020-04-02,0.0560747663551401,26750,28250,1500,43456,112610.0,씨에스윈드보통주
14625,112610,2020-03-26,0.0857142857142857,24500,26600,2100,99275,112610.0,씨에스윈드보통주
14626,112610,2020-03-25,0.079295154185022,22700,24500,1800,73997,112610.0,씨에스윈드보통주
14627,112610,2020-03-20,0.1649746192893401,19700,22950,3250,101788,112610.0,씨에스윈드보통주
14628,112610,2020-03-19,0.1416122004357298,22950,19700,-3250,359823,112610.0,씨에스윈드보통주
14629,112610,2020-03-18,0.0874751491053678,25150,22950,-2200,73623,112610.0,씨에스윈드보통주
14630,112610,2020-03-17,0.0437262357414448,26300,25150,-1150,108511,112610.0,씨에스윈드보통주
14631,112610,2020-03-16,0.0962199312714776,29100,26300,-2800,71750,112610.0,씨에스윈드보통주
14632,112610,2020-03-12,0.0779014308426073,31450,29000,-2450,104597,112610.0,씨에스윈드보통주
14633,112610,2020-03-11,0.0411585365853658,32800,31450,-1350,71406,112610.0,씨에스윈드보통주
14634,112610,2020-03-09,0.0820995962314939,37150,34100,-3050,72392,112610.0,씨에스윈드보통주
14635,112610,2020-02-24,0.0431937172774869,38200,36550,-1650,49189,112610.0,씨에스윈드보통주
14636,112610,2020-02-05,0.0490716180371352,37700,39550,1850,112510,112610.0,씨에스윈드보통주
14637,112610,2020-01-16,0.0405759162303664,38200,39750,1550,61836,112610.0,씨에스윈드보통주
14638,112610,2019-11-13,0.0462585034013605,36750,38450,1700,123026,112610.0,씨에스윈드보통주
14639,112610,2019-11-12,0.0417209908735332,38350,36750,-1600,163411,112610.0,씨에스윈드보통주
14640,112610,2019-11-08,0.0993006993006993,35750,39300,3550,381084,112610.0,씨에스윈드보통주
14641,112610,2019-11-07,0.0545722713864306,33900,35750,1850,161149,112610.0,씨에스윈드보통주
14642,112610,2019-11-01,0.0520673813169984,32650,34350,1700,97601,112610.0,씨에스윈드보통주
14643,112610,2019-08-26,0.0511182108626198,31300,29700,-1600,44963,112610.0,씨에스윈드보통주
14644,112610,2019-08-07,0.0931098696461825,26850,29350,2500,219432,112610.0,씨에스윈드보통주
14645,112610,2019-08-06,0.105,30000,26850,-3150,284810,112610.0,씨에스윈드보통주
14646,112610,2019-08-05,0.0536277602523659,31700,30000,-1700,102439,112610.0,씨에스윈드보통주
14647,112610,2019-07-26,0.0448807854137447,35650,34050,-1600,99838,112610.0,씨에스윈드보통주
14648,112610,2019-07-17,0.073170731707317,38950,36100,-2850,268914,112610.0,씨에스윈드보통주
14649,112610,2019-07-05,0.0496453900709219,42300,40200,-2100,206812,112610.0,씨에스윈드보통주
14650,112610,2019-06-13,0.0600255427841634,39150,41500,2350,105860,112610.0,씨에스윈드보통주
14651,112610,2019-06-05,0.0428571428571428,38500,40150,1650,127429,112610.0,씨에스윈드보통주
14652,112610,2019-06-04,0.0490463215258855,36700,38500,1800,82519,112610.0,씨에스윈드보통주
14653,112610,2019-06-03,0.0455840455840455,35100,36700,1600,55689,112610.0,씨에스윈드보통주
14654,112610,2019-05-29,0.0493506493506493,38500,36600,-1900,82570,112610.0,씨에스윈드보통주
14655,112610,2019-05-02,0.0656167979002624,38100,40600,2500,162474,112610.0,씨에스윈드보통주
14656,112610,2019-04-19,0.0477386934673366,39800,37900,-1900,156717,112610.0,씨에스윈드보통주
14657,112610,2019-04-17,0.0672703751617076,38650,41250,2600,450965,112610.0,씨에스윈드보통주
14658,112610,2019-04-12,0.0406824146981627,38100,39650,1550,143766,112610.0,씨에스윈드보통주
14659,112610,2019-03-20,0.0658857979502196,34150,36400,2250,317490,112610.0,씨에스윈드보통주
14660,112610,2019-03-19,0.0491551459293394,32550,34150,1600,247006,112610.0,씨에스윈드보통주
14661,112610,2019-03-05,0.0603588907014681,30650,32500,1850,122901,112610.0,씨에스윈드보통주
14662,112610,2018-12-27,0.0443159922928709,25950,27100,1150,71483,112610.0,씨에스윈드보통주
14663,112610,2018-12-03,0.0541012216404886,28650,30200,1550,85511,112610.0,씨에스윈드보통주
14664,112610,2018-11-27,0.0430622009569378,31350,30000,-1350,142183,112610.0,씨에스윈드보통주
14665,112610,2018-10-31,0.046793760831889,28850,30200,1350,87828,112610.0,씨에스윈드보통주
14666,112610,2018-10-30,0.0452898550724637,27600,28850,1250,82387,112610.0,씨에스윈드보통주
14667,112610,2018-10-29,0.0612244897959183,29400,27600,-1800,91335,112610.0,씨에스윈드보통주
14668,112610,2018-10-24,0.0623003194888178,31300,29350,-1950,44917,112610.0,씨에스윈드보통주
14669,112610,2018-10-11,0.0563165905631659,32850,31000,-1850,145778,112610.0,씨에스윈드보통주
14670,112610,2018-10-08,0.0524781341107871,34300,32500,-1800,58970,112610.0,씨에스윈드보통주
14671,112610,2018-09-21,0.0572289156626506,33200,35100,1900,304317,112610.0,씨에스윈드보통주
14672,112610,2018-09-07,0.053781512605042,29750,31350,1600,192729,112610.0,씨에스윈드보통주
14673,112610,2018-09-06,0.0530973451327433,28250,29750,1500,86900,112610.0,씨에스윈드보통주
14674,112610,2018-08-17,0.051056338028169,28400,29850,1450,212196,112610.0,씨에스윈드보통주
14675,112610,2018-08-16,0.0881226053639846,26100,28400,2300,135345,112610.0,씨에스윈드보통주
14676,112610,2018-08-13,0.0526315789473684,27550,26100,-1450,46639,112610.0,씨에스윈드보통주
14677,112610,2018-07-24,0.0684104627766599,24850,26550,1700,91949,112610.0,씨에스윈드보통주
14678,112610,2018-07-02,0.0641025641025641,27300,25550,-1750,119454,112610.0,씨에스윈드보통주
14679,112610,2018-06-25,0.04930966469428,25350,26600,1250,68639,112610.0,씨에스윈드보통주
14680,112610,2018-06-19,0.084870848708487,27100,24800,-2300,257175,112610.0,씨에스윈드보통주
14681,112610,2018-06-18,0.0491228070175438,28500,27100,-1400,165774,112610.0,씨에스윈드보통주
14682,112610,2018-06-05,0.0516934046345811,28050,26600,-1450,416651,112610.0,씨에스윈드보통주
14683,112610,2018-05-29,0.0874233128834355,32600,29750,-2850,1868423,112610.0,씨에스윈드보통주
14684,112610,2018-05-16,0.064066852367688,35900,33600,-2300,134112,112610.0,씨에스윈드보통주
14685,112610,2018-05-10,0.0803571428571428,33600,36300,2700,216618,112610.0,씨에스윈드보통주
14686,112610,2018-05-08,0.0561797752808988,35600,33600,-2000,99666,112610.0,씨에스윈드보통주
14687,112610,2018-05-02,0.081081081081081,33300,36000,2700,152301,112610.0,씨에스윈드보통주
14688,112610,2018-04-25,0.0466867469879518,33200,31650,-1550,42706,112610.0,씨에스윈드보통주
14689,112610,2018-04-09,0.0425219941348973,34100,32650,-1450,61035,112610.0,씨에스윈드보통주
14690,112610,2018-03-21,0.0449101796407185,33400,31900,-1500,90037,112610.0,씨에스윈드보통주
14691,112610,2018-03-12,0.0641399416909621,34300,36500,2200,74075,112610.0,씨에스윈드보통주
14692,112610,2018-03-05,0.0597439544807965,35150,33050,-2100,61836,112610.0,씨에스윈드보통주
14693,112610,2018-02-21,0.0712468193384223,39300,36500,-2800,149564,112610.0,씨에스윈드보통주
14694,112610,2018-02-19,0.0630136986301369,36500,38800,2300,154491,112610.0,씨에스윈드보통주
14695,112610,2018-02-12,0.0482954545454545,35200,36900,1700,73860,112610.0,씨에스윈드보통주
14696,112610,2018-01-29,0.0537010159651669,34450,36300,1850,172909,112610.0,씨에스윈드보통주
14697,112610,2018-01-23,0.080188679245283,31800,34350,2550,234313,112610.0,씨에스윈드보통주
14698,112610,2018-01-10,0.042087542087542,29700,30950,1250,126887,112610.0,씨에스윈드보통주
14699,112610,2018-01-04,0.051660516605166,27100,28500,1400,164921,112610.0,씨에스윈드보통주
14700,112610,2018-01-02,0.0419847328244274,26200,27300,1100,100639,112610.0,씨에스윈드보통주
14701,112610,2017-12-20,0.049618320610687,26200,24900,-1300,139323,112610.0,씨에스윈드보통주
14702,112610,2017-12-13,0.0777096114519427,24450,26350,1900,215091,112610.0,씨에스윈드보통주
14703,112610,2017-12-07,0.0410677618069815,24350,25350,1000,194717,112610.0,씨에스윈드보통주
14704,112610,2017-12-05,0.0442105263157894,23750,24800,1050,107428,112610.0,씨에스윈드보통주
14705,112610,2017-11-27,0.0511811023622047,25400,24100,-1300,77627,112610.0,씨에스윈드보통주
14706,112610,2017-11-02,0.0433962264150943,26500,25350,-1150,77664,112610.0,씨에스윈드보통주
14707,112610,2017-10-25,0.0554493307839388,26150,27600,1450,223089,112610.0,씨에스윈드보통주
14708,112610,2017-09-21,0.0633663366336633,25250,23650,-1600,55173,112610.0,씨에스윈드보통주
14709,112610,2017-09-12,0.0718562874251497,25050,26850,1800,210663,112610.0,씨에스윈드보통주
14710,112610,2017-09-04,0.0434782608695652,27600,26400,-1200,78833,112610.0,씨에스윈드보통주
14711,112610,2017-08-22,0.0502793296089385,26850,28200,1350,61709,112610.0,씨에스윈드보통주
14712,112610,2017-08-09,0.0546075085324232,29300,27700,-1600,72653,112610.0,씨에스윈드보통주
14713,112610,2017-08-01,0.0802238805970149,26800,28950,2150,139739,112610.0,씨에스윈드보통주
14714,112610,2017-07-28,0.0416666666666666,28800,27600,-1200,67007,112610.0,씨에스윈드보통주
14715,112610,2017-07-20,0.1087719298245614,28500,31600,3100,448927,112610.0,씨에스윈드보통주
14716,112610,2017-07-03,0.0598911070780399,27550,25900,-1650,85270,112610.0,씨에스윈드보통주
14717,112610,2017-06-26,0.0826923076923076,26000,28150,2150,149549,112610.0,씨에스윈드보통주
14718,112610,2017-06-19,0.0537190082644628,24200,25500,1300,121891,112610.0,씨에스윈드보통주
14719,112610,2017-05-23,0.0491452991452991,23400,24550,1150,77385,112610.0,씨에스윈드보통주
14720,112610,2017-05-18,0.0515695067264574,22300,23450,1150,104087,112610.0,씨에스윈드보통주
14721,112610,2017-05-10,0.0471464019851116,20150,21100,950,55404,112610.0,씨에스윈드보통주
14722,112610,2017-03-16,0.0414201183431952,16900,17600,700,85077,112610.0,씨에스윈드보통주
14723,112610,2016-11-09,0.1823770491803278,24400,19950,-4450,412256,112610.0,씨에스윈드보통주
14724,112610,2016-11-07,0.067391304347826,23000,24550,1550,182293,112610.0,씨에스윈드보통주
14725,112610,2016-11-02,0.0691056910569105,24600,22900,-1700,100912,112610.0,씨에스윈드보통주
14726,112610,2016-10-31,0.0425531914893617,25850,24750,-1100,105669,112610.0,씨에스윈드보통주
14727,112610,2016-10-24,0.0513347022587269,24350,25600,1250,112132,112610.0,씨에스윈드보통주
14728,112610,2016-08-26,0.0622641509433962,26500,24850,-1650,197627,112610.0,씨에스윈드보통주
14729,112610,2016-08-10,0.0462962962962962,27000,25750,-1250,203110,112610.0,씨에스윈드보통주
14730,112610,2016-08-08,0.0458015267175572,26200,27400,1200,258048,112610.0,씨에스윈드보통주
14731,112610,2016-08-02,0.0481927710843373,24900,26100,1200,369093,112610.0,씨에스윈드보통주
14732,120110,2021-06-01,0.0401284109149277,62300,64800,2500,502601,120110.0,코오롱인더스트리보통주
14733,120110,2021-05-13,0.0403877221324717,61900,59400,-2500,396598,120110.0,코오롱인더스트리보통주
14734,120110,2021-04-13,0.0402476780185758,64600,62000,-2600,640241,120110.0,코오롱인더스트리보통주
14735,120110,2021-04-05,0.0554621848739495,59500,62800,3300,555009,120110.0,코오롱인더스트리보통주
14736,120110,2021-03-29,0.0510366826156299,62700,59500,-3200,548456,120110.0,코오롱인더스트리보통주
14737,120110,2021-03-24,0.0571923743500866,57700,61000,3300,776145,120110.0,코오롱인더스트리보통주
14738,120110,2021-03-11,0.0874751491053678,50300,54700,4400,584066,120110.0,코오롱인더스트리보통주
14739,120110,2021-03-09,0.0511882998171846,54700,51900,-2800,541542,120110.0,코오롱인더스트리보통주
14740,120110,2021-02-25,0.0611835506519558,49850,52900,3050,541197,120110.0,코오롱인더스트리보통주
14741,120110,2021-02-18,0.0669014084507042,56800,53000,-3800,783818,120110.0,코오롱인더스트리보통주
14742,120110,2021-02-03,0.0855397148676171,49100,53300,4200,3141662,120110.0,코오롱인더스트리보통주
14743,120110,2021-02-02,0.1704410011918951,41950,49100,7150,6136833,120110.0,코오롱인더스트리보통주
14744,120110,2021-01-25,0.0630841121495327,42800,45500,2700,506857,120110.0,코오롱인더스트리보통주
14745,120110,2021-01-08,0.0402843601895734,42200,43900,1700,763948,120110.0,코오롱인더스트리보통주
14746,120110,2020-11-19,0.06640625,38400,40950,2550,918366,120110.0,코오롱인더스트리보통주
14747,120110,2020-11-09,0.0461329715061058,36850,38550,1700,213757,120110.0,코오롱인더스트리보통주
14748,120110,2020-10-16,0.0463215258855585,36700,38400,1700,276691,120110.0,코오롱인더스트리보통주
14749,120110,2020-09-28,0.0507042253521126,35500,37300,1800,211838,120110.0,코오롱인더스트리보통주
14750,120110,2020-09-24,0.0625832223701731,37550,35200,-2350,335056,120110.0,코오롱인더스트리보통주
14751,120110,2020-09-22,0.0665859564164648,41300,38550,-2750,537944,120110.0,코오롱인더스트리보통주
14752,120110,2020-09-16,0.05578231292517,36750,38800,2050,1031642,120110.0,코오롱인더스트리보통주
14753,120110,2020-09-14,0.0535211267605633,35500,37400,1900,704162,120110.0,코오롱인더스트리보통주
14754,120110,2020-09-07,0.0920060331825037,33150,36200,3050,962688,120110.0,코오롱인더스트리보통주
14755,120110,2020-09-01,0.04375,32000,33400,1400,230516,120110.0,코오롱인더스트리보통주
14756,120110,2020-08-20,0.0508221225710014,33450,31750,-1700,236031,120110.0,코오롱인더스트리보통주
14757,120110,2020-08-18,0.0539772727272727,35200,33300,-1900,361296,120110.0,코오롱인더스트리보통주
14758,120110,2020-08-10,0.0442857142857142,35000,36550,1550,469910,120110.0,코오롱인더스트리보통주
14759,120110,2020-07-14,0.0451527224435591,37650,35950,-1700,444733,120110.0,코오롱인더스트리보통주
14760,120110,2020-07-13,0.097667638483965,34300,37650,3350,755494,120110.0,코오롱인더스트리보통주
14761,120110,2020-07-06,0.086021505376344,32550,35350,2800,672479,120110.0,코오롱인더스트리보통주
14762,120110,2020-06-16,0.0605564648117839,30550,32400,1850,213714,120110.0,코오롱인더스트리보통주
14763,120110,2020-06-15,0.0839580209895052,33350,30550,-2800,325153,120110.0,코오롱인더스트리보통주
14764,120110,2020-06-12,0.0525568181818181,35200,33350,-1850,315375,120110.0,코오롱인더스트리보통주
14765,120110,2020-05-27,0.0477657935285053,32450,34000,1550,561958,120110.0,코오롱인더스트리보통주
14766,120110,2020-05-26,0.048465266558966,30950,32450,1500,338051,120110.0,코오롱인더스트리보통주
14767,120110,2020-04-14,0.101010101010101,34650,31150,-3500,3263859,120110.0,코오롱인더스트리보통주
14768,120110,2020-04-13,0.1627516778523489,29800,34650,4850,7029112,120110.0,코오롱인더스트리보통주
14769,120110,2020-04-01,0.0616666666666666,30000,28150,-1850,755017,120110.0,코오롱인더스트리보통주
14770,120110,2020-03-31,0.0676156583629893,28100,30000,1900,385771,120110.0,코오롱인더스트리보통주
14771,120110,2020-03-30,0.1217564870259481,25050,28100,3050,330261,120110.0,코오롱인더스트리보통주
14772,120110,2020-03-25,0.0831509846827133,22850,24750,1900,243015,120110.0,코오롱인더스트리보통주
14773,120110,2020-03-24,0.0829383886255924,21100,22850,1750,152115,120110.0,코오롱인더스트리보통주
14774,120110,2020-03-23,0.1002132196162046,23450,21100,-2350,188886,120110.0,코오롱인더스트리보통주
14775,120110,2020-03-20,0.1193317422434367,20950,23450,2500,265602,120110.0,코오롱인더스트리보통주
14776,120110,2020-03-19,0.1215932914046121,23850,20950,-2900,332133,120110.0,코오롱인더스트리보통주
14777,120110,2020-03-18,0.0791505791505791,25900,23850,-2050,187526,120110.0,코오롱인더스트리보통주
14778,120110,2020-03-13,0.1039182282793867,29350,26300,-3050,396165,120110.0,코오롱인더스트리보통주
14779,120110,2020-03-12,0.0501618122977346,30900,29350,-1550,249836,120110.0,코오롱인더스트리보통주
14780,120110,2020-02-28,0.0456490727532097,35050,33450,-1600,194762,120110.0,코오롱인더스트리보통주
14781,120110,2020-02-24,0.0510752688172043,37200,35300,-1900,231790,120110.0,코오롱인더스트리보통주
14782,120110,2020-02-21,0.0498084291187739,39150,37200,-1950,303606,120110.0,코오롱인더스트리보통주
14783,120110,2020-02-19,0.0643274853801169,42750,40000,-2750,406194,120110.0,코오롱인더스트리보통주
14784,120110,2020-01-28,0.0465367965367965,46200,44050,-2150,117097,120110.0,코오롱인더스트리보통주
14785,120110,2020-01-08,0.0625651720542231,47950,44950,-3000,202518,120110.0,코오롱인더스트리보통주
14786,120110,2019-11-06,0.0604453870625662,47150,50000,2850,464070,120110.0,코오롱인더스트리보통주
14787,120110,2019-10-14,0.0420673076923076,41600,43350,1750,153005,120110.0,코오롱인더스트리보통주
14788,120110,2019-08-05,0.0425531914893617,39950,38250,-1700,177663,120110.0,코오롱인더스트리보통주
14789,120110,2019-07-19,0.048780487804878,41000,43000,2000,221769,120110.0,코오롱인더스트리보통주
14790,120110,2019-07-09,0.0582959641255605,44600,42000,-2600,210292,120110.0,코오롱인더스트리보통주
14791,120110,2019-05-30,0.0417193426042983,39550,41200,1650,198875,120110.0,코오롱인더스트리보통주
14792,120110,2019-05-29,0.0515587529976019,41700,39550,-2150,346212,120110.0,코오롱인더스트리보통주
14793,120110,2019-05-28,0.0511945392491467,43950,41700,-2250,450484,120110.0,코오롱인더스트리보통주
14794,120110,2019-05-14,0.0520361990950226,44200,46500,2300,211802,120110.0,코오롱인더스트리보통주
14795,120110,2019-03-05,0.0404411764705882,54400,52200,-2200,377481,120110.0,코오롱인더스트리보통주
14796,120110,2019-02-19,0.1011419249592169,61300,55100,-6200,1244391,120110.0,코오롱인더스트리보통주
14797,120110,2019-01-07,0.0545454545454545,55000,58000,3000,161578,120110.0,코오롱인더스트리보통주
14798,120110,2018-12-28,0.0552486187845303,54300,57300,3000,223728,120110.0,코오롱인더스트리보통주
14799,120110,2018-12-21,0.0458891013384321,52300,54700,2400,182421,120110.0,코오롱인더스트리보통주
14800,120110,2018-11-02,0.0797665369649805,51400,55500,4100,222788,120110.0,코오롱인더스트리보통주
14801,120110,2018-10-29,0.04642166344294,51700,49300,-2400,244592,120110.0,코오롱인더스트리보통주
14802,120110,2018-10-11,0.0436974789915966,59500,56900,-2600,184614,120110.0,코오롱인더스트리보통주
14803,120110,2018-09-19,0.0692194403534609,67900,63200,-4700,487727,120110.0,코오롱인더스트리보통주
14804,120110,2018-08-09,0.0544,62500,65900,3400,439512,120110.0,코오롱인더스트리보통주
14805,120110,2018-07-03,0.1087289433384379,65300,58200,-7100,1267824,120110.0,코오롱인더스트리보통주
14806,120110,2018-06-15,0.0418918918918918,74000,70900,-3100,235849,120110.0,코오롱인더스트리보통주
14807,120110,2018-06-01,0.0725075528700906,66200,71000,4800,608784,120110.0,코오롱인더스트리보통주
14808,120110,2018-05-14,0.0605187319884726,69400,65200,-4200,340683,120110.0,코오롱인더스트리보통주
14809,120110,2018-03-23,0.0411764705882352,68000,65200,-2800,179795,120110.0,코오롱인더스트리보통주
14810,120110,2018-01-11,0.0579196217494089,84600,79700,-4900,983495,120110.0,코오롱인더스트리보통주
14811,120110,2017-12-27,0.0494571773220747,82900,87000,4100,433469,120110.0,코오롱인더스트리보통주
14812,120110,2017-09-21,0.0548302872062663,76600,72400,-4200,533507,120110.0,코오롱인더스트리보통주
14813,120110,2017-09-13,0.1151178918169209,72100,80400,8300,1463220,120110.0,코오롱인더스트리보통주
14814,120110,2017-09-12,0.0587371512481644,68100,72100,4000,378490,120110.0,코오롱인더스트리보통주
14815,120110,2017-08-14,0.0412844036697247,65400,68100,2700,175932,120110.0,코오롱인더스트리보통주
14816,120110,2017-06-19,0.0549927641099855,69100,72900,3800,568662,120110.0,코오롱인더스트리보통주
14817,120110,2017-05-17,0.0481049562682215,68600,65300,-3300,410206,120110.0,코오롱인더스트리보통주
14818,120110,2017-04-06,0.0446304044630404,71700,68500,-3200,513443,120110.0,코오롱인더스트리보통주
14819,120110,2017-01-02,0.0702702702702702,74000,79200,5200,330661,120110.0,코오롱인더스트리보통주
14820,120110,2016-12-08,0.0589928057553956,69500,73600,4100,233431,120110.0,코오롱인더스트리보통주
14821,120110,2016-11-11,0.0510067114093959,74500,70700,-3800,255919,120110.0,코오롱인더스트리보통주
14822,120110,2016-11-07,0.0419580419580419,71500,74500,3000,90632,120110.0,코오롱인더스트리보통주
14823,120110,2016-10-19,0.0434782608695652,75900,79200,3300,471804,120110.0,코오롱인더스트리보통주
14824,120110,2016-09-27,0.0480404551201011,79100,82900,3800,253764,120110.0,코오롱인더스트리보통주
14825,120110,2016-08-29,0.0478971962616822,85600,81500,-4100,193574,120110.0,코오롱인더스트리보통주
14826,122630,2021-03-11,0.0422930446983363,24945,26000,1055,37068944,,
14827,122630,2021-02-26,0.0530552506403219,27330,25880,-1450,48357169,,
14828,122630,2021-02-25,0.071344570756566,25510,27330,1820,39211065,,
14829,122630,2021-02-24,0.0416979714500375,26620,25510,-1110,49977421,,
14830,122630,2021-02-01,0.0491318074191002,25340,26585,1245,53778379,,
14831,122630,2021-01-29,0.0477264186396091,26610,25340,-1270,57505130,,
14832,122630,2021-01-26,0.0533378630881603,29435,27865,-1570,42364091,,
14833,122630,2021-01-25,0.0471362504446816,28110,29435,1325,32979184,,
14834,122630,2021-01-19,0.0538772368674235,25985,27385,1400,50743899,,
14835,122630,2021-01-18,0.04869119531393,27315,25985,-1330,51188340,,
14836,122630,2021-01-15,0.0417470619189615,28505,27315,-1190,60344002,,
14837,122630,2021-01-08,0.0911859889586902,26265,28660,2395,82580037,,
14838,122630,2021-01-07,0.0487123178279097,25045,26265,1220,64213048,,
14839,122630,2021-01-04,0.0541286351093186,23555,24830,1275,47006539,,
14840,122630,2020-12-30,0.0492204899777282,22450,23555,1105,82665235,,
14841,122630,2020-12-09,0.0430215107553776,19990,20850,860,69067841,,
14842,122630,2020-11-23,0.0446911471676629,17565,18350,785,66558284,,
14843,122630,2020-11-16,0.0433491686460807,16840,17570,730,70135877,,
14844,122630,2020-11-05,0.0446666666666666,15000,15670,670,68150084,,
14845,122630,2020-11-03,0.0407303370786516,14240,14820,580,49844786,,
14846,122630,2020-10-30,0.0523076923076923,14625,13860,-765,69968858,,
14847,122630,2020-09-24,0.0446275317542052,14565,13915,-650,93336355,,
14848,122630,2020-09-22,0.0470704410796576,15190,14475,-715,87031205,,
14849,122630,2020-08-20,0.0767195767195767,15120,13960,-1160,88667816,,
14850,122630,2020-08-18,0.0402813299232736,15640,15010,-630,50533337,,
14851,122630,2020-07-28,0.0407239819004524,13260,13800,540,58274268,,
14852,122630,2020-06-25,0.0534441805225653,12630,11955,-675,101259290,,
14853,122630,2020-06-16,0.1185286103542234,11010,12315,1305,108269670,,
14854,122630,2020-06-15,0.1001225991009399,12235,11010,-1225,108611045,,
14855,122630,2020-06-03,0.0713983945923109,11835,12680,845,120807314,,
14856,122630,2020-05-19,0.0506640432857845,10165,10680,515,83759982,,
14857,122630,2020-05-04,0.0583132530120481,10375,9770,-605,109536575,,
14858,122630,2020-04-27,0.0411734431291816,9715,10115,400,100714810,,
14859,122630,2020-04-17,0.0634171907756813,9540,10145,605,151077291,,
14860,122630,2020-04-06,0.0823389021479713,8380,9070,690,175582249,,
14861,122630,2020-04-02,0.0572687224669603,7945,8400,455,237250899,,
14862,122630,2020-04-01,0.0888761467889908,8720,7945,-775,140887045,,
14863,122630,2020-03-27,0.0462107208872458,8115,8490,375,258365393,,
14864,122630,2020-03-25,0.0964797913950456,7670,8410,740,359958109,,
14865,122630,2020-03-24,0.1818181818181818,6490,7670,1180,321288874,,
14866,122630,2020-03-23,0.1170068027210884,7350,6490,-860,254018216,,
14867,122630,2020-03-20,0.1395348837209302,6450,7350,900,317997413,,
14868,122630,2020-03-19,0.1439946914399469,7535,6450,-1085,348129036,,
14869,122630,2020-03-18,0.111962286387743,8485,7535,-950,207660013,,
14870,122630,2020-03-16,0.0770844257996853,9535,8800,-735,139803278,,
14871,122630,2020-03-13,0.0450676014021031,9985,9535,-450,217764791,,
14872,122630,2020-03-12,0.0814167433302667,10870,9985,-885,149276466,,
14873,122630,2020-03-11,0.0605012964563526,11570,10870,-700,85614537,,
14874,122630,2020-03-09,0.07516077170418,12440,11505,-935,81658729,,
14875,122630,2020-03-06,0.0401234567901234,12960,12440,-520,53915669,,
14876,122630,2020-03-04,0.0464256368118323,12170,12735,565,56395689,,
14877,122630,2020-02-28,0.0623028391167192,12680,11890,-790,77195789,,
14878,122630,2020-02-24,0.0726177825008855,14115,13090,-1025,54223745,,
14879,122630,2020-02-06,0.0598653914275593,14115,14960,845,33957205,,
14880,122630,2020-01-28,0.0576036866359447,15190,14315,-875,19627071,,
14881,122630,2019-10-02,0.0433198380566801,12350,11815,-535,18828245,,
14882,122630,2019-08-05,0.043076923076923,11375,10885,-490,32773134,,
14883,122630,2019-07-08,0.0427247077791213,12405,11875,-530,26500612,,
14884,122630,2019-05-09,0.0571428571428571,12950,12210,-740,35934867,,
14885,122630,2019-03-25,0.0403926009815024,13245,12710,-535,15855015,,
14886,122630,2019-01-09,0.041259982253771,11270,11735,465,23324011,,
14887,122630,2018-11-02,0.0725984949092518,11295,12115,820,27541346,,
14888,122630,2018-10-23,0.0476748729972645,12795,12185,-610,23408737,,
14889,122630,2018-10-11,0.0819312362838332,13670,12550,-1120,32570741,,
14890,122630,2018-07-02,0.0431994600067499,14815,14175,-640,17360237,,
14891,122630,2018-05-30,0.04293921983671,16535,15825,-710,40059396,,
14892,122630,2018-03-23,0.0683588116527257,17335,16150,-1185,30572550,,
14893,122630,2018-03-06,0.0401944894651539,15425,16045,620,14334983,,
14894,122630,2018-02-09,0.0507025045815516,16370,15540,-830,30251675,,
14895,122630,2018-02-07,0.0486869282974328,16945,16120,-825,32122967,,
14896,122630,2017-05-08,0.0512731077781653,14335,15070,735,19000858,,
14897,122630,2016-11-09,0.0418799441600744,10745,10295,-450,92379630,,
14898,122630,2016-09-12,0.0502283105022831,10950,10400,-550,25078756,,
14899,128940,2021-05-27,0.0568862275449101,334000,353000,19000,127862,128940.0,한미약품보통주
14900,128940,2021-05-14,0.0532374100719424,347500,329000,-18500,130105,128940.0,한미약품보통주
14901,128940,2021-04-23,0.0590778097982708,347000,367500,20500,243269,128940.0,한미약품보통주
14902,128940,2021-04-15,0.0467836257309941,342000,358000,16000,264673,128940.0,한미약품보통주
14903,128940,2021-04-07,0.0511182108626198,313000,329000,16000,60348,128940.0,한미약품보통주
14904,128940,2021-03-12,0.044189852700491,305500,319000,13500,66747,128940.0,한미약품보통주
14905,128940,2021-03-02,0.0699708454810495,343000,319000,-24000,246189,128940.0,한미약품보통주
14906,128940,2021-02-25,0.0416666666666666,336000,350000,14000,68808,128940.0,한미약품보통주
14907,128940,2021-01-29,0.084826762246117,418500,383000,-35500,245144,128940.0,한미약품보통주
14908,128940,2021-01-27,0.0714285714285714,378000,405000,27000,713054,128940.0,한미약품보통주
14909,128940,2021-01-25,0.0580110497237569,362000,383000,21000,167129,128940.0,한미약품보통주
14910,128940,2021-01-18,0.0416088765603328,360500,345500,-15000,68405,128940.0,한미약품보통주
14911,128940,2021-01-07,0.0423280423280423,378000,394000,16000,246771,128940.0,한미약품보통주
14912,128940,2021-01-06,0.0441988950276243,362000,378000,16000,636828,128940.0,한미약품보통주
14913,128940,2020-12-30,0.0516499282639885,348500,366500,18000,271094,128940.0,한미약품보통주
14914,128940,2020-12-29,0.0742424242424242,330000,348500,18500,169190,128940.0,한미약품보통주
14915,128940,2020-12-22,0.0492264416315049,355500,338000,-17500,103708,128940.0,한미약품보통주
14916,128940,2020-12-08,0.04,375000,360000,-15000,394297,128940.0,한미약품보통주
14917,128940,2020-12-03,0.0442359249329758,373000,356500,-16500,185258,128940.0,한미약품보통주
14918,128940,2020-11-27,0.0819423368740516,329500,356500,27000,444284,128940.0,한미약품보통주
14919,128940,2020-11-19,0.048,312500,327500,15000,272999,128940.0,한미약품보통주
14920,128940,2020-11-18,0.0738831615120274,291000,312500,21500,283849,128940.0,한미약품보통주
14921,128940,2020-11-03,0.0501858736059479,269000,282500,13500,92186,128940.0,한미약품보통주
14922,128940,2020-10-23,0.0461254612546125,271000,283500,12500,68407,128940.0,한미약품보통주
14923,128940,2020-10-16,0.0542056074766355,267500,282000,14500,68431,128940.0,한미약품보통주
14924,128940,2020-10-06,0.0457038391224862,273500,286000,12500,98198,128940.0,한미약품보통주
14925,128940,2020-09-24,0.0507246376811594,276000,262000,-14000,80286,128940.0,한미약품보통주
14926,128940,2020-08-27,0.0410094637223974,317000,304000,-13000,103383,128940.0,한미약품보통주
14927,128940,2020-08-25,0.0442176870748299,294000,307000,13000,139237,128940.0,한미약품보통주
14928,128940,2020-08-18,0.0489396411092985,306500,291500,-15000,176877,128940.0,한미약품보통주
14929,128940,2020-08-10,0.082036775106082,353500,324500,-29000,667247,128940.0,한미약품보통주
14930,128940,2020-08-05,0.2990990990990991,277500,360500,83000,514265,128940.0,한미약품보통주
14931,128940,2020-07-29,0.0738137082601054,284500,263500,-21000,236540,128940.0,한미약품보통주
14932,128940,2020-07-28,0.1518218623481781,247000,284500,37500,1627889,128940.0,한미약품보통주
14933,128940,2020-07-16,0.0568421052631578,237500,251000,13500,141164,128940.0,한미약품보통주
14934,128940,2020-06-16,0.041015625,256000,266500,10500,115445,128940.0,한미약품보통주
14935,128940,2020-06-05,0.0567951318458417,246500,260500,14000,197246,128940.0,한미약품보통주
14936,128940,2020-05-14,0.0949820788530465,279000,252500,-26500,354250,128940.0,한미약품보통주
14937,128940,2020-05-08,0.0656370656370656,259000,276000,17000,154534,128940.0,한미약품보통주
14938,128940,2020-04-01,0.0611854684512428,261500,245500,-16000,61523,128940.0,한미약품보통주
14939,128940,2020-03-31,0.0544354838709677,248000,261500,13500,75733,128940.0,한미약품보통주
14940,128940,2020-03-25,0.0501089324618736,229500,241000,11500,65397,128940.0,한미약품보통주
14941,128940,2020-03-24,0.0649651972157772,215500,229500,14000,62513,128940.0,한미약품보통주
14942,128940,2020-03-23,0.0506607929515418,227000,215500,-11500,51487,128940.0,한미약품보통주
14943,128940,2020-03-20,0.0412844036697247,218000,227000,9000,73900,128940.0,한미약품보통주
14944,128940,2020-03-19,0.0743099787685774,235500,218000,-17500,82505,128940.0,한미약품보통주
14945,128940,2020-03-13,0.0732177263969171,259500,240500,-19000,97335,128940.0,한미약품보통주
14946,128940,2020-03-12,0.0406654343807763,270500,259500,-11000,81336,128940.0,한미약품보통주
14947,128940,2020-03-05,0.047970479704797,271000,284000,13000,68356,128940.0,한미약품보통주
14948,128940,2020-02-24,0.0543478260869565,276000,261000,-15000,64895,128940.0,한미약품보통주
14949,128940,2019-12-27,0.0424143556280587,306500,288000,-18500,166626,128940.0,한미약품보통주
14950,128940,2019-12-10,0.06875,320000,298000,-22000,229698,128940.0,한미약품보통주
14951,128940,2019-11-29,0.0405405405405405,333000,319500,-13500,39604,128940.0,한미약품보통주
14952,128940,2019-11-21,0.0417910447761194,335000,321000,-14000,42498,128940.0,한미약품보통주
14953,128940,2019-10-25,0.0401234567901234,324000,337000,13000,144113,128940.0,한미약품보통주
14954,128940,2019-10-23,0.0676567656765676,303000,323500,20500,129967,128940.0,한미약품보통주
14955,128940,2019-10-07,0.0446428571428571,280000,292500,12500,49897,128940.0,한미약품보통주
14956,128940,2019-10-01,0.0452898550724637,276000,288500,12500,34034,128940.0,한미약품보통주
14957,128940,2019-09-17,0.048695652173913,287500,301500,14000,103774,128940.0,한미약품보통주
14958,128940,2019-08-21,0.0462633451957295,281000,294000,13000,53267,128940.0,한미약품보통주
14959,128940,2019-08-09,0.0764925373134328,268000,288500,20500,81006,128940.0,한미약품보통주
14960,128940,2019-08-05,0.071917808219178,292000,271000,-21000,68481,128940.0,한미약품보통주
14961,128940,2019-07-04,0.2726176115802171,414500,301500,-113000,791120,128940.0,한미약품보통주
14962,128940,2019-02-19,0.0463362068965517,464000,485500,21500,99775,128940.0,한미약품보통주
14963,128940,2019-02-11,0.0400890868596882,449000,467000,18000,68570,128940.0,한미약품보통주
14964,128940,2018-12-20,0.0641025641025641,468000,438000,-30000,151511,128940.0,한미약품보통주
14965,128940,2018-12-04,0.0419426048565121,453000,472000,19000,73115,128940.0,한미약품보통주
14966,128940,2018-11-05,0.0565110565110565,407000,430000,23000,120592,128940.0,한미약품보통주
14967,128940,2018-10-23,0.0547320410490307,438500,414500,-24000,53604,128940.0,한미약품보통주
14968,128940,2018-10-01,0.061,500000,469500,-30500,117081,128940.0,한미약품보통주
14969,128940,2018-08-27,0.0422993492407809,461000,480500,19500,105889,128940.0,한미약품보통주
14970,128940,2018-08-13,0.074398249452954,457000,423000,-34000,115953,128940.0,한미약품보통주
14971,128940,2018-08-06,0.048667439165701,431500,452500,21000,71682,128940.0,한미약품보통주
14972,128940,2018-07-25,0.0522727272727272,440000,417000,-23000,59146,128940.0,한미약품보통주
14973,128940,2018-07-04,0.084870848708487,406500,441000,34500,91373,128940.0,한미약품보통주
14974,128940,2018-06-22,0.0496277915632754,403000,423000,20000,46523,128940.0,한미약품보통주
14975,128940,2018-06-19,0.0686845168800931,429500,400000,-29500,108716,128940.0,한미약품보통주
14976,128940,2018-05-23,0.045,500000,477500,-22500,67045,128940.0,한미약품보통주
14977,128940,2018-05-09,0.0598194130925507,443000,469500,26500,80894,128940.0,한미약품보통주
14978,128940,2018-04-26,0.0406147091108671,455500,474000,18500,71969,128940.0,한미약품보통주
14979,128940,2018-04-23,0.0700507614213198,492500,458000,-34500,145202,128940.0,한미약품보통주
14980,128940,2018-04-10,0.083984375,512000,555000,43000,182538,128940.0,한미약품보통주
14981,128940,2018-03-12,0.0647181628392484,479000,510000,31000,115466,128940.0,한미약품보통주
14982,128940,2018-03-06,0.0515916575192096,455500,479000,23500,92983,128940.0,한미약품보통주
14983,128940,2018-02-28,0.0551020408163265,490000,463000,-27000,142214,128940.0,한미약품보통주
14984,128940,2018-02-19,0.0850277264325323,541000,495000,-46000,527313,128940.0,한미약품보통주
14985,128940,2018-02-06,0.0633397312859884,521000,554000,33000,216132,128940.0,한미약품보통주
14986,128940,2018-02-05,0.0746003552397868,563000,521000,-42000,132115,128940.0,한미약품보통주
14987,128940,2018-02-01,0.0469011725293132,597000,569000,-28000,137676,128940.0,한미약품보통주
14988,128940,2018-01-23,0.05,560000,588000,28000,67710,128940.0,한미약품보통주
14989,128940,2018-01-12,0.0598290598290598,585000,620000,35000,202299,128940.0,한미약품보통주
14990,128940,2017-12-11,0.0672897196261682,535000,571000,36000,79741,128940.0,한미약품보통주
14991,128940,2017-12-07,0.0431654676258992,556000,532000,-24000,81751,128940.0,한미약품보통주
14992,128940,2017-11-30,0.0436974789915966,595000,569000,-26000,99594,128940.0,한미약품보통주
14993,128940,2017-11-22,0.0410958904109589,584000,560000,-24000,114796,128940.0,한미약품보통주
14994,128940,2017-11-15,0.0949720670391061,537000,588000,51000,359915,128940.0,한미약품보통주
14995,128940,2017-11-13,0.0474308300395256,506000,530000,24000,125614,128940.0,한미약품보통주
14996,128940,2017-11-03,0.0474226804123711,485000,508000,23000,156915,128940.0,한미약품보통주
14997,128940,2017-11-01,0.0765911542610571,463500,499000,35500,251688,128940.0,한미약품보통주
14998,128940,2017-10-30,0.0464396284829721,484500,462000,-22500,132032,128940.0,한미약품보통주
14999,128940,2017-10-25,0.0413385826771653,508000,487000,-21000,145831,128940.0,한미약품보통주
15000,128940,2017-10-19,0.0729166666666666,480000,515000,35000,327206,128940.0,한미약품보통주
15001,128940,2017-10-12,0.0485961123110151,463000,485500,22500,159936,128940.0,한미약품보통주
15002,128940,2017-10-10,0.0484048404840484,454500,476500,22000,161969,128940.0,한미약품보통주
15003,128940,2017-09-29,0.0545243619489559,431000,454500,23500,201366,128940.0,한미약품보통주
15004,128940,2017-09-19,0.06288532675709,405500,431000,25500,238657,128940.0,한미약품보통주
15005,128940,2017-08-28,0.0728744939271255,370500,397500,27000,260032,128940.0,한미약품보통주
15006,128940,2017-08-18,0.0577200577200577,346500,366500,20000,124945,128940.0,한미약품보통주
15007,128940,2017-08-03,0.0407303370786516,356000,341500,-14500,149934,128940.0,한미약품보통주
15008,128940,2017-06-28,0.0543881334981458,404500,382500,-22000,197053,128940.0,한미약품보통주
15009,128940,2017-06-16,0.0565371024734982,424500,400500,-24000,222827,128940.0,한미약품보통주
15010,128940,2017-06-09,0.05470737913486,393000,414500,21500,324268,128940.0,한미약품보통주
15011,128940,2017-05-31,0.0408719346049046,367000,382000,15000,339295,128940.0,한미약품보통주
15012,128940,2017-05-23,0.0420757363253856,356500,371500,15000,236966,128940.0,한미약품보통주
15013,128940,2017-05-11,0.0779036827195467,353000,380500,27500,356748,128940.0,한미약품보통주
15014,128940,2017-05-08,0.1026856240126382,316500,349000,32500,483332,128940.0,한미약품보통주
15015,128940,2017-02-01,0.0416666666666666,288000,300000,12000,119011,128940.0,한미약품보통주
15016,128940,2017-01-13,0.0415224913494809,289000,301000,12000,174934,128940.0,한미약품보통주
15017,128940,2017-01-02,0.0687397708674304,305500,284500,-21000,298485,128940.0,한미약품보통주
15018,128940,2016-12-29,0.1041055718475073,341000,305500,-35500,432668,128940.0,한미약품보통주
15019,128940,2016-12-07,0.1076040172166427,348500,311000,-37500,860669,128940.0,한미약품보통주
15020,128940,2016-12-01,0.0434192672998643,368500,352500,-16000,85892,128940.0,한미약품보통주
15021,128940,2016-11-23,0.0445682451253481,359000,343000,-16000,180790,128940.0,한미약품보통주
15022,128940,2016-11-18,0.0456919060052219,383000,365500,-17500,131789,128940.0,한미약품보통주
15023,128940,2016-11-10,0.1215083798882681,358000,401500,43500,344974,128940.0,한미약품보통주
15024,128940,2016-11-09,0.0440587449933244,374500,358000,-16500,227646,128940.0,한미약품보통주
15025,128940,2016-11-03,0.0524737631184407,333500,351000,17500,165848,128940.0,한미약품보통주
15026,128940,2016-11-02,0.0444126074498567,349000,333500,-15500,168212,128940.0,한미약품보통주
15027,128940,2016-10-28,0.0867970660146699,409000,373500,-35500,233299,128940.0,한미약품보통주
15028,128940,2016-10-07,0.0610432852386237,450500,423000,-27500,485284,128940.0,한미약품보통주
15029,128940,2016-10-04,0.0728346456692913,508000,471000,-37000,1163160,128940.0,한미약품보통주
15030,128940,2016-09-30,0.1806451612903225,620000,508000,-112000,1800563,128940.0,한미약품보통주
15031,128940,2016-09-20,0.0518783542039356,559000,588000,29000,116311,128940.0,한미약품보통주
15032,128940,2016-08-23,0.0427350427350427,585000,610000,25000,83960,128940.0,한미약품보통주
15033,138040,2021-05-25,0.0567567567567567,18500,19550,1050,520139,138040.0,메리츠금융지주회사보통주
15034,138040,2021-05-24,0.0451977401129943,17700,18500,800,712704,138040.0,메리츠금융지주회사보통주
15035,138040,2021-05-17,0.1556122448979592,19600,16550,-3050,2800391,138040.0,메리츠금융지주회사보통주
15036,138040,2021-05-14,0.0415647921760391,20450,19600,-850,418958,138040.0,메리츠금융지주회사보통주
15037,138040,2021-05-06,0.0435967302452316,18350,19150,800,234799,138040.0,메리츠금융지주회사보통주
15038,138040,2021-04-30,0.0437317784256559,17150,17900,750,239706,138040.0,메리츠금융지주회사보통주
15039,138040,2021-04-02,0.0513595166163142,16550,15700,-850,378649,138040.0,메리츠금융지주회사보통주
15040,138040,2021-03-31,0.0552147239263803,16300,17200,900,400848,138040.0,메리츠금융지주회사보통주
15041,138040,2021-03-30,0.0516129032258064,15500,16300,800,188292,138040.0,메리츠금융지주회사보통주
15042,138040,2021-03-08,0.048,12500,13100,600,415192,138040.0,메리츠금융지주회사보통주
15043,138040,2021-02-22,0.0442477876106194,11300,11800,500,424870,138040.0,메리츠금융지주회사보통주
15044,138040,2020-12-29,0.0523809523809523,10500,9950,-550,377199,138040.0,메리츠금융지주회사보통주
15045,138040,2020-11-16,0.0445544554455445,10100,10550,450,245860,138040.0,메리츠금융지주회사보통주
15046,138040,2020-10-22,0.0458422174840085,9380,9810,430,223342,138040.0,메리츠금융지주회사보통주
15047,138040,2020-08-04,0.0455075845974329,8570,8960,390,193522,138040.0,메리츠금융지주회사보통주
15048,138040,2020-06-15,0.0483091787439613,10350,9850,-500,65693,138040.0,메리츠금융지주회사보통주
15049,138040,2020-06-09,0.0414746543778801,10850,10400,-450,123312,138040.0,메리츠금융지주회사보통주
15050,138040,2020-05-22,0.0430622009569378,10450,10000,-450,96882,138040.0,메리츠금융지주회사보통주
15051,138040,2020-03-31,0.1123110151187904,9260,10300,1040,161620,138040.0,메리츠금융지주회사보통주
15052,138040,2020-03-30,0.064367816091954,8700,9260,560,102520,138040.0,메리츠금융지주회사보통주
15053,138040,2020-03-26,0.0475,8000,8380,380,142950,138040.0,메리츠금융지주회사보통주
15054,138040,2020-03-25,0.1527377521613832,6940,8000,1060,145528,138040.0,메리츠금융지주회사보통주
15055,138040,2020-03-24,0.0515151515151515,6600,6940,340,106915,138040.0,메리츠금융지주회사보통주
15056,138040,2020-03-20,0.09,6000,6540,540,173142,138040.0,메리츠금융지주회사보통주
15057,138040,2020-03-19,0.1869918699186991,7380,6000,-1380,281279,138040.0,메리츠금융지주회사보통주
15058,138040,2020-03-18,0.0809464508094645,8030,7380,-650,149203,138040.0,메리츠금융지주회사보통주
15059,138040,2020-03-17,0.08646188850967,8790,8030,-760,106832,138040.0,메리츠금융지주회사보통주
15060,138040,2020-03-13,0.1121212121212121,9900,8790,-1110,408661,138040.0,메리츠금융지주회사보통주
15061,138040,2020-01-31,0.0439024390243902,10250,10700,450,159554,138040.0,메리츠금융지주회사보통주
15062,138040,2019-12-11,0.043859649122807,11400,11900,500,212475,138040.0,메리츠금융지주회사보통주
15063,138040,2019-12-06,0.0791666666666666,12000,11050,-950,639046,138040.0,메리츠금융지주회사보통주
15064,138040,2019-09-27,0.049618320610687,13100,12450,-650,143964,138040.0,메리츠금융지주회사보통주
15065,138040,2019-08-07,0.0441176470588235,13600,13000,-600,83778,138040.0,메리츠금융지주회사보통주
15066,138040,2019-07-03,0.0410958904109589,14600,14000,-600,80444,138040.0,메리츠금융지주회사보통주
15067,138040,2019-05-29,0.0463576158940397,15100,14400,-700,167850,138040.0,메리츠금융지주회사보통주
15068,138040,2019-05-28,0.0633802816901408,14200,15100,900,183556,138040.0,메리츠금융지주회사보통주
15069,138040,2019-04-25,0.0434782608695652,13800,13200,-600,49968,138040.0,메리츠금융지주회사보통주
15070,138040,2018-11-30,0.0537190082644628,12100,11450,-650,120648,138040.0,메리츠금융지주회사보통주
15071,138040,2018-10-11,0.0408163265306122,12250,11750,-500,101220,138040.0,메리츠금융지주회사보통주
15072,138040,2017-12-15,0.04375,16000,15300,-700,115695,138040.0,메리츠금융지주회사보통주
15073,138040,2017-10-11,0.0486322188449848,16450,15650,-800,81004,138040.0,메리츠금융지주회사보통주
15074,138040,2017-09-19,0.0465116279069767,15050,15750,700,65041,138040.0,메리츠금융지주회사보통주
15075,138040,2017-08-31,0.0668789808917197,15700,16750,1050,129721,138040.0,메리츠금융지주회사보통주
15076,138040,2017-05-04,0.05078125,12800,13450,650,165069,138040.0,메리츠금융지주회사보통주
15077,138930,2021-05-06,0.0575635876840696,7470,7900,430,4275860,138930.0,BNK금융지주보통주
15078,138930,2021-04-30,0.0478142076502732,7320,7670,350,5125163,138930.0,BNK금융지주보통주
15079,138930,2021-03-08,0.0527156549520766,6260,6590,330,4057949,138930.0,BNK금융지주보통주
15080,138930,2021-03-03,0.0639730639730639,5940,6320,380,5323786,138930.0,BNK금융지주보통주
15081,138930,2020-12-29,0.0628099173553719,6050,5670,-380,3592648,138930.0,BNK금융지주보통주
15082,138930,2020-12-02,0.0437062937062937,5720,5970,250,4963645,138930.0,BNK금융지주보통주
15083,138930,2020-08-20,0.0485074626865671,5360,5100,-260,1589009,138930.0,BNK금융지주보통주
15084,138930,2020-06-16,0.0509803921568627,5100,5360,260,1731490,138930.0,BNK금융지주보통주
15085,138930,2020-06-11,0.0448028673835125,5580,5330,-250,2290961,138930.0,BNK금융지주보통주
15086,138930,2020-06-03,0.0509090909090909,5500,5780,280,3619388,138930.0,BNK금융지주보통주
15087,138930,2020-06-02,0.0638297872340425,5170,5500,330,2743947,138930.0,BNK금융지주보통주
15088,138930,2020-05-19,0.0782997762863534,4470,4820,350,2265836,138930.0,BNK금융지주보통주
15089,138930,2020-05-04,0.0405940594059405,5050,4845,-205,2286802,138930.0,BNK금융지주보통주
15090,138930,2020-04-27,0.0517799352750809,4635,4875,240,2139177,138930.0,BNK금융지주보통주
15091,138930,2020-04-06,0.0538990825688073,4360,4595,235,1079789,138930.0,BNK금융지주보통주
15092,138930,2020-03-25,0.0900783289817232,3830,4175,345,2744519,138930.0,BNK금융지주보통주
15093,138930,2020-03-24,0.0493150684931506,3650,3830,180,2078158,138930.0,BNK금융지주보통주
15094,138930,2020-03-23,0.0806045340050377,3970,3650,-320,1516667,138930.0,BNK금융지주보통주
15095,138930,2020-03-18,0.0873108265424912,4295,3920,-375,2653320,138930.0,BNK금융지주보통주
15096,138930,2020-03-17,0.0632497273718647,4585,4295,-290,2217662,138930.0,BNK금융지주보통주
15097,138930,2020-03-16,0.0437956204379562,4795,4585,-210,1734833,138930.0,BNK금융지주보통주
15098,138930,2020-03-13,0.0579567779960707,5090,4795,-295,2318097,138930.0,BNK금융지주보통주
15099,138930,2020-03-12,0.0660550458715596,5450,5090,-360,2728553,138930.0,BNK금융지주보통주
15100,138930,2020-03-09,0.0602409638554216,5810,5460,-350,1348899,138930.0,BNK금융지주보통주
15101,138930,2020-02-24,0.0460829493087557,6510,6210,-300,896940,138930.0,BNK금융지주보통주
15102,138930,2020-01-28,0.0455801104972375,7240,6910,-330,1024385,138930.0,BNK금융지주보통주
15103,138930,2019-12-05,0.0468085106382978,7050,7380,330,2045984,138930.0,BNK금융지주보통주
15104,138930,2019-03-15,0.0560344827586206,6960,7350,390,3249912,138930.0,BNK금융지주보통주
15105,138930,2019-01-02,0.0450204638472032,7330,7000,-330,1474391,138930.0,BNK금융지주보통주
15106,138930,2018-11-30,0.0400500625782227,7990,7670,-320,1903328,138930.0,BNK금융지주보통주
15107,138930,2018-10-11,0.0475638051044083,8620,8210,-410,1286711,138930.0,BNK금융지주보통주
15108,138930,2018-06-21,0.0429769392033543,9540,9130,-410,1460431,138930.0,BNK금융지주보통주
15109,138930,2018-03-23,0.0401785714285714,11200,10750,-450,1027678,138930.0,BNK금융지주보통주
15110,138930,2018-02-06,0.0422535211267605,10650,10200,-450,1754997,138930.0,BNK금융지주보통주
15111,138930,2017-11-02,0.0515151515151515,9900,9390,-510,3689676,138930.0,BNK금융지주보통주
15112,138930,2017-07-31,0.0414746543778801,10850,11300,450,1281791,138930.0,BNK금융지주보통주
15113,138930,2016-11-11,0.0470974808324205,9130,9560,430,2837049,138930.0,BNK금융지주보통주
15114,139130,2021-05-06,0.06,8500,9010,510,1879656,139130.0,DGB금융지주보통주
15115,139130,2021-04-30,0.0435806831566548,8490,8860,370,3227547,139130.0,DGB금융지주보통주
15116,139130,2021-03-23,0.047457627118644,8850,8430,-420,1797224,139130.0,DGB금융지주보통주
15117,139130,2021-03-19,0.065398335315101,8410,8960,550,5363846,139130.0,DGB금융지주보통주
15118,139130,2021-03-15,0.0559085133418043,7870,8310,440,2077296,139130.0,DGB금융지주보통주
15119,139130,2021-03-08,0.0465425531914893,7520,7870,350,2349717,139130.0,DGB금융지주보통주
15120,139130,2021-03-04,0.0412087912087912,7280,7580,300,2319457,139130.0,DGB금융지주보통주
15121,139130,2021-02-05,0.0409711684370258,6590,6860,270,1102918,139130.0,DGB금융지주보통주
15122,139130,2021-01-29,0.0406626506024096,6640,6370,-270,737750,139130.0,DGB금융지주보통주
15123,139130,2021-01-07,0.0588235294117647,6800,7200,400,1870252,139130.0,DGB금융지주보통주
15124,139130,2020-12-29,0.0498614958448753,7220,6860,-360,1101081,139130.0,DGB금융지주보통주
15125,139130,2020-12-11,0.0523415977961432,7260,7640,380,1651862,139130.0,DGB금융지주보통주
15126,139130,2020-11-11,0.0437235543018335,7090,7400,310,1775511,139130.0,DGB금융지주보통주
15127,139130,2020-11-03,0.042042042042042,6660,6940,280,1613055,139130.0,DGB금융지주보통주
15128,139130,2020-11-02,0.0776699029126213,6180,6660,480,1372816,139130.0,DGB금융지주보통주
15129,139130,2020-10-30,0.0477657935285053,6490,6180,-310,1679379,139130.0,DGB금융지주보통주
15130,139130,2020-10-27,0.0449927431059506,6890,6580,-310,1972748,139130.0,DGB금융지주보통주
15131,139130,2020-10-22,0.0438871473354232,6380,6660,280,2906165,139130.0,DGB금융지주보통주
15132,139130,2020-10-08,0.0407079646017699,5650,5880,230,1797206,139130.0,DGB금융지주보통주
15133,139130,2020-08-18,0.0412926391382405,5570,5340,-230,995976,139130.0,DGB금융지주보통주
15134,139130,2020-08-11,0.0462962962962962,5400,5650,250,2270811,139130.0,DGB금융지주보통주
15135,139130,2020-06-16,0.0604288499025341,5130,5440,310,1180305,139130.0,DGB금융지주보통주
15136,139130,2020-06-03,0.0463458110516934,5610,5870,260,2429411,139130.0,DGB금융지주보통주
15137,139130,2020-05-19,0.0595111583421891,4705,4985,280,1409967,139130.0,DGB금융지주보통주
15138,139130,2020-04-28,0.0467479674796747,4920,5150,230,2610130,139130.0,DGB금융지주보통주
15139,139130,2020-04-27,0.0468085106382978,4700,4920,220,1695570,139130.0,DGB금융지주보통주
15140,139130,2020-04-10,0.0652883569096844,4595,4895,300,2007990,139130.0,DGB금융지주보통주
15141,139130,2020-04-01,0.0413943355119825,4590,4400,-190,1491399,139130.0,DGB금융지주보통주
15142,139130,2020-03-31,0.0625,4320,4590,270,1295413,139130.0,DGB금융지주보통주
15143,139130,2020-03-27,0.0532837670384138,4035,4250,215,1968366,139130.0,DGB금융지주보통주
15144,139130,2020-03-25,0.1147994467496542,3615,4030,415,2073464,139130.0,DGB금융지주보통주
15145,139130,2020-03-24,0.0570175438596491,3420,3615,195,1110315,139130.0,DGB금융지주보통주
15146,139130,2020-03-23,0.0806451612903225,3720,3420,-300,1175158,139130.0,DGB금융지주보통주
15147,139130,2020-03-20,0.0689655172413793,3480,3720,240,2186265,139130.0,DGB금융지주보통주
15148,139130,2020-03-19,0.0925684485006518,3835,3480,-355,2047585,139130.0,DGB금융지주보통주
15149,139130,2020-03-18,0.0483870967741935,4030,3835,-195,2119167,139130.0,DGB금융지주보통주
15150,139130,2020-03-17,0.0799086757990867,4380,4030,-350,2464448,139130.0,DGB금융지주보통주
15151,139130,2020-03-12,0.067193675889328,5060,4720,-340,2857946,139130.0,DGB금융지주보통주
15152,139130,2020-03-09,0.0433962264150943,5300,5070,-230,1418969,139130.0,DGB금융지주보통주
15153,139130,2020-02-28,0.041025641025641,5850,5610,-240,1256864,139130.0,DGB금융지주보통주
15154,139130,2020-02-24,0.0450885668276972,6210,5930,-280,1177269,139130.0,DGB금융지주보통주
15155,139130,2019-12-27,0.0415549597855227,7460,7150,-310,1135851,139130.0,DGB금융지주보통주
15156,139130,2018-08-01,0.0577540106951871,9350,9890,540,1905821,139130.0,DGB금융지주보통주
15157,139130,2018-03-14,0.0403225806451612,12400,11900,-500,732955,139130.0,DGB금융지주보통주
15158,139130,2018-02-19,0.0474137931034482,11600,12150,550,483411,139130.0,DGB금융지주보통주
15159,139130,2018-02-06,0.0418250950570342,13150,12600,-550,1728882,139130.0,DGB금융지주보통주
15160,139130,2018-02-05,0.047808764940239,12550,13150,600,2275021,139130.0,DGB금융지주보통주
15161,139130,2017-11-09,0.0458715596330275,9810,9360,-450,1994853,139130.0,DGB금융지주보통주
15162,139130,2017-09-05,0.0688073394495412,10900,10150,-750,1211131,139130.0,DGB금융지주보통주
15163,139130,2017-06-21,0.0418410041841004,11950,11450,-500,1159669,139130.0,DGB금융지주보통주
15164,139130,2017-03-20,0.0425531914893617,11750,11250,-500,647001,139130.0,DGB금융지주보통주
15165,139130,2017-02-01,0.0486322188449848,9870,10350,480,980260,139130.0,DGB금융지주보통주
15166,139480,2021-03-03,0.0850439882697947,170500,185000,14500,757744,139480.0,이마트보통주
15167,139480,2021-02-16,0.0617977528089887,178000,189000,11000,779943,139480.0,이마트보통주
15168,139480,2021-01-26,0.0490463215258855,183500,174500,-9000,644663,139480.0,이마트보통주
15169,139480,2021-01-25,0.0545977011494252,174000,183500,9500,438042,139480.0,이마트보통주
15170,139480,2021-01-12,0.0547550432276657,173500,183000,9500,1152248,139480.0,이마트보통주
15171,139480,2021-01-08,0.0623145400593471,168500,179000,10500,1152187,139480.0,이마트보통주
15172,139480,2021-01-07,0.0870967741935483,155000,168500,13500,1081746,139480.0,이마트보통주
15173,139480,2021-01-05,0.0429042904290429,151500,158000,6500,491848,139480.0,이마트보통주
15174,139480,2020-11-11,0.0764119601328903,150500,162000,11500,842419,139480.0,이마트보통주
15175,139480,2020-09-10,0.0543478260869565,138000,145500,7500,1288453,139480.0,이마트보통주
15176,139480,2020-09-07,0.0433070866141732,127000,132500,5500,552803,139480.0,이마트보통주
15177,139480,2020-09-01,0.05,120000,126000,6000,495842,139480.0,이마트보통주
15178,139480,2020-08-20,0.0517928286852589,125500,119000,-6500,431942,139480.0,이마트보통주
15179,139480,2020-08-18,0.053639846743295,130500,123500,-7000,522691,139480.0,이마트보통주
15180,139480,2020-08-14,0.0653061224489796,122500,130500,8000,763902,139480.0,이마트보통주
15181,139480,2020-08-10,0.056768558951965,114500,121000,6500,562619,139480.0,이마트보통주
15182,139480,2020-07-29,0.0405405405405405,111000,115500,4500,307984,139480.0,이마트보통주
15183,139480,2020-07-21,0.0442477876106194,113000,118000,5000,426375,139480.0,이마트보통주
15184,139480,2020-07-13,0.0412844036697247,109000,113500,4500,378812,139480.0,이마트보통주
15185,139480,2020-06-16,0.0416666666666666,108000,112500,4500,235594,139480.0,이마트보통주
15186,139480,2020-06-15,0.0442477876106194,113000,108000,-5000,296418,139480.0,이마트보통주
15187,139480,2020-04-27,0.1013824884792626,108500,119500,11000,675818,139480.0,이마트보통주
15188,139480,2020-04-06,0.070754716981132,106000,113500,7500,336357,139480.0,이마트보통주
15189,139480,2020-04-02,0.0439024390243902,102500,107000,4500,173345,139480.0,이마트보통주
15190,139480,2020-03-24,0.0572012257405515,97900,103500,5600,207709,139480.0,이마트보통주
15191,139480,2020-03-23,0.0676190476190476,105000,97900,-7100,211971,139480.0,이마트보통주
15192,139480,2020-03-18,0.0506912442396313,108500,103000,-5500,233030,139480.0,이마트보통주
15193,139480,2020-03-13,0.0585585585585585,111000,104500,-6500,407709,139480.0,이마트보통주
15194,139480,2020-03-03,0.0420560747663551,107000,111500,4500,358858,139480.0,이마트보통주
15195,139480,2020-02-25,0.0422960725075528,99300,103500,4200,287811,139480.0,이마트보통주
15196,139480,2020-02-06,0.0410958904109589,109500,114000,4500,156863,139480.0,이마트보통주
15197,139480,2019-11-28,0.048582995951417,123500,129500,6000,268323,139480.0,이마트보통주
15198,139480,2019-11-20,0.0416666666666666,132000,126500,-5500,261555,139480.0,이마트보통주
15199,139480,2019-11-14,0.05078125,128000,134500,6500,416170,139480.0,이마트보통주
15200,139480,2019-11-06,0.0729613733905579,116500,125000,8500,491170,139480.0,이마트보통주
15201,139480,2019-11-04,0.0616740088105726,113500,120500,7000,330153,139480.0,이마트보통주
15202,139480,2019-10-16,0.0652173913043478,115000,122500,7500,449999,139480.0,이마트보통주
15203,139480,2019-08-19,0.0424528301886792,106000,110500,4500,195369,139480.0,이마트보통주
15204,139480,2019-08-16,0.045045045045045,111000,106000,-5000,278776,139480.0,이마트보통주
15205,139480,2019-08-13,0.0663507109004739,105500,112500,7000,750186,139480.0,이마트보통주
15206,139480,2019-07-18,0.040590405904059,135500,130000,-5500,183786,139480.0,이마트보통주
15207,139480,2019-05-16,0.0548387096774193,155000,146500,-8500,388331,139480.0,이마트보통주
15208,139480,2019-04-08,0.0524781341107871,171500,180500,9000,335009,139480.0,이마트보통주
15209,139480,2019-02-01,0.0625,192000,180000,-12000,473212,139480.0,이마트보통주
15210,139480,2019-01-04,0.0402144772117962,186500,194000,7500,138010,139480.0,이마트보통주
15211,139480,2018-12-10,0.0467532467532467,192500,183500,-9000,167871,139480.0,이마트보통주
15212,139480,2018-11-12,0.0469135802469135,202500,193000,-9500,154063,139480.0,이마트보통주
15213,139480,2018-10-31,0.0514138817480719,194500,204500,10000,190614,139480.0,이마트보통주
15214,139480,2018-10-25,0.0405727923627685,209500,201000,-8500,93987,139480.0,이마트보통주
15215,139480,2018-10-05,0.0452380952380952,210000,219500,9500,200989,139480.0,이마트보통주
15216,139480,2018-09-28,0.0532994923857868,197000,207500,10500,313911,139480.0,이마트보통주
15217,139480,2018-08-28,0.0497630331753554,211000,221500,10500,206599,139480.0,이마트보통주
15218,139480,2018-07-12,0.0702127659574468,235000,218500,-16500,339363,139480.0,이마트보통주
15219,139480,2018-07-11,0.0408163265306122,245000,235000,-10000,108479,139480.0,이마트보통주
15220,139480,2018-05-18,0.0462427745664739,259500,271500,12000,140670,139480.0,이마트보통주
15221,139480,2018-05-10,0.0505836575875486,257000,270000,13000,147645,139480.0,이마트보통주
15222,139480,2018-03-12,0.060655737704918,305000,286500,-18500,186601,139480.0,이마트보통주
15223,139480,2018-03-05,0.0432692307692307,312000,298500,-13500,108244,139480.0,이마트보통주
15224,139480,2018-02-23,0.042016806722689,297500,310000,12500,111962,139480.0,이마트보통주
15225,139480,2018-02-19,0.0454545454545454,286000,299000,13000,116346,139480.0,이마트보통주
15226,139480,2018-01-26,0.150390625,256000,294500,38500,515536,139480.0,이마트보통주
15227,139480,2018-01-08,0.0482625482625482,259000,271500,12500,81519,139480.0,이마트보통주
15228,139480,2017-12-15,0.0444444444444444,270000,282000,12000,133110,139480.0,이마트보통주
15229,139480,2017-12-13,0.0479846449136276,260500,273000,12500,97798,139480.0,이마트보통주
15230,139480,2017-11-24,0.0628803245436105,246500,262000,15500,115686,139480.0,이마트보통주
15231,139480,2017-11-07,0.0519187358916478,221500,233000,11500,125750,139480.0,이마트보통주
15232,139480,2017-10-10,0.0431654676258992,208500,217500,9000,180355,139480.0,이마트보통주
15233,139480,2017-08-21,0.043103448275862,232000,222000,-10000,150418,139480.0,이마트보통주
15234,139480,2017-06-27,0.0408163265306122,220500,229500,9000,162241,139480.0,이마트보통주
15235,139480,2017-05-08,0.0570175438596491,228000,241000,13000,77713,139480.0,이마트보통주
15236,139480,2017-04-12,0.0443458980044345,225500,235500,10000,142652,139480.0,이마트보통주
15237,139480,2017-04-07,0.0512820512820512,214500,225500,11000,215810,139480.0,이마트보통주
15238,139480,2017-03-24,0.04,200000,208000,8000,104742,139480.0,이마트보통주
15239,139480,2017-02-23,0.0411622276029055,206500,215000,8500,132289,139480.0,이마트보통주
15240,139480,2017-01-26,0.05,190000,199500,9500,244775,139480.0,이마트보통주
15241,139480,2017-01-05,0.0418994413407821,179000,186500,7500,90211,139480.0,이마트보통주
15242,139480,2016-11-08,0.0716510903426791,160500,172000,11500,377204,139480.0,이마트보통주
15243,161390,2021-05-06,0.0502092050209205,47800,50200,2400,358302,161390.0,한국타이어앤테크놀로지보통주
15244,161390,2021-04-28,0.0485981308411214,53500,50900,-2600,261440,161390.0,한국타이어앤테크놀로지보통주
15245,161390,2021-04-23,0.0519877675840978,49050,51600,2550,304626,161390.0,한국타이어앤테크놀로지보통주
15246,161390,2021-03-30,0.0557377049180327,45750,48300,2550,670200,161390.0,한국타이어앤테크놀로지보통주
15247,161390,2021-03-04,0.0457256461232604,50300,48000,-2300,377888,161390.0,한국타이어앤테크놀로지보통주
15248,161390,2021-03-03,0.0490093847758081,47950,50300,2350,419759,161390.0,한국타이어앤테크놀로지보통주
15249,161390,2021-02-26,0.062007874015748,50800,47650,-3150,701905,161390.0,한국타이어앤테크놀로지보통주
15250,161390,2021-02-25,0.05175983436853,48300,50800,2500,346426,161390.0,한국타이어앤테크놀로지보통주
15251,161390,2021-02-24,0.0547945205479452,51100,48300,-2800,541729,161390.0,한국타이어앤테크놀로지보통주
15252,161390,2021-02-19,0.0438328236493374,49050,51200,2150,476622,161390.0,한국타이어앤테크놀로지보통주
15253,161390,2021-02-08,0.1087680355160932,45050,49950,4900,1592149,161390.0,한국타이어앤테크놀로지보통주
15254,161390,2021-02-01,0.0680437424058323,41150,43950,2800,336259,161390.0,한국타이어앤테크놀로지보통주
15255,161390,2021-01-29,0.0605022831050228,43800,41150,-2650,539122,161390.0,한국타이어앤테크놀로지보통주
15256,161390,2021-01-28,0.0590762620837808,46550,43800,-2750,418934,161390.0,한국타이어앤테크놀로지보통주
15257,161390,2021-01-27,0.0591581342434584,43950,46550,2600,521883,161390.0,한국타이어앤테크놀로지보통주
15258,161390,2021-01-21,0.0639810426540284,42200,44900,2700,801204,161390.0,한국타이어앤테크놀로지보통주
15259,161390,2021-01-04,0.0507614213197969,39400,37400,-2000,1309364,161390.0,한국타이어앤테크놀로지보통주
15260,161390,2020-12-15,0.049136786188579,37650,39500,1850,576734,161390.0,한국타이어앤테크놀로지보통주
15261,161390,2020-12-14,0.0480404551201011,39550,37650,-1900,346810,161390.0,한국타이어앤테크놀로지보통주
15262,161390,2020-12-09,0.0734312416555407,37450,40200,2750,843254,161390.0,한국타이어앤테크놀로지보통주
15263,161390,2020-12-03,0.0537482319660537,35350,37250,1900,651094,161390.0,한국타이어앤테크놀로지보통주
15264,161390,2020-12-01,0.0504587155963302,32700,34350,1650,304787,161390.0,한국타이어앤테크놀로지보통주
15265,161390,2020-11-30,0.0494186046511627,34400,32700,-1700,849581,161390.0,한국타이어앤테크놀로지보통주
15266,161390,2020-11-19,0.0574018126888217,33100,35000,1900,1259043,161390.0,한국타이어앤테크놀로지보통주
15267,161390,2020-11-03,0.047040971168437,32950,31400,-1550,994258,161390.0,한국타이어앤테크놀로지보통주
15268,161390,2020-11-02,0.0410742496050552,31650,32950,1300,331176,161390.0,한국타이어앤테크놀로지보통주
15269,161390,2020-10-30,0.0409090909090909,33000,31650,-1350,440339,161390.0,한국타이어앤테크놀로지보통주
15270,161390,2020-09-22,0.0524822695035461,35250,33400,-1850,743130,161390.0,한국타이어앤테크놀로지보통주
15271,161390,2020-09-14,0.0775444264943457,30950,33350,2400,1202176,161390.0,한국타이어앤테크놀로지보통주
15272,161390,2020-08-26,0.0412044374009508,31550,30250,-1300,1245957,161390.0,한국타이어앤테크놀로지보통주
15273,161390,2020-08-25,0.097391304347826,28750,31550,2800,4053153,161390.0,한국타이어앤테크놀로지보통주
15274,161390,2020-08-20,0.0539215686274509,30600,28950,-1650,523223,161390.0,한국타이어앤테크놀로지보통주
15275,161390,2020-08-19,0.0906389301634472,33650,30600,-3050,861264,161390.0,한국타이어앤테크놀로지보통주
15276,161390,2020-08-13,0.04251968503937,31750,33100,1350,711305,161390.0,한국타이어앤테크놀로지보통주
15277,161390,2020-08-12,0.0461285008237232,30350,31750,1400,919613,161390.0,한국타이어앤테크놀로지보통주
15278,161390,2020-08-05,0.0548446069469835,27350,28850,1500,2584513,161390.0,한국타이어앤테크놀로지보통주
15279,161390,2020-08-04,0.0810276679841897,25300,27350,2050,1372907,161390.0,한국타이어앤테크놀로지보통주
15280,161390,2020-07-31,0.0663082437275985,27900,26050,-1850,1919269,161390.0,한국타이어앤테크놀로지보통주
15281,161390,2020-07-30,0.087719298245614,25650,27900,2250,3301642,161390.0,한국타이어앤테크놀로지보통주
15282,161390,2020-07-10,0.0419847328244274,26200,25100,-1100,385925,161390.0,한국타이어앤테크놀로지보통주
15283,161390,2020-07-06,0.1164658634538152,24900,27800,2900,1386027,161390.0,한국타이어앤테크놀로지보통주
15284,161390,2020-07-02,0.0454545454545454,24200,25300,1100,498348,161390.0,한국타이어앤테크놀로지보통주
15285,161390,2020-06-30,0.0422832980972515,23650,24650,1000,2741159,161390.0,한국타이어앤테크놀로지보통주
15286,161390,2020-06-25,0.0434782608695652,25300,24200,-1100,324768,161390.0,한국타이어앤테크놀로지보통주
15287,161390,2020-06-17,0.0593047034764826,24450,25900,1450,761681,161390.0,한국타이어앤테크놀로지보통주
15288,161390,2020-06-16,0.0866666666666666,22500,24450,1950,324514,161390.0,한국타이어앤테크놀로지보통주
15289,161390,2020-06-15,0.0486257928118393,23650,22500,-1150,412333,161390.0,한국타이어앤테크놀로지보통주
15290,161390,2020-06-12,0.054,25000,23650,-1350,433550,161390.0,한국타이어앤테크놀로지보통주
15291,161390,2020-06-03,0.0427698574338085,24550,25600,1050,643672,161390.0,한국타이어앤테크놀로지보통주
15292,161390,2020-06-01,0.044776119402985,23450,24500,1050,453634,161390.0,한국타이어앤테크놀로지보통주
15293,161390,2020-05-28,0.0523138832997987,24850,23550,-1300,463659,161390.0,한국타이어앤테크놀로지보통주
15294,161390,2020-05-26,0.0516129032258064,23250,24450,1200,721607,161390.0,한국타이어앤테크놀로지보통주
15295,161390,2020-05-19,0.0628019323671497,20700,22000,1300,989124,161390.0,한국타이어앤테크놀로지보통주
15296,161390,2020-05-11,0.0424107142857142,22400,21450,-950,461971,161390.0,한국타이어앤테크놀로지보통주
15297,161390,2020-05-08,0.0821256038647343,20700,22400,1700,1640497,161390.0,한국타이어앤테크놀로지보통주
15298,161390,2020-04-16,0.0439814814814814,21600,20650,-950,733615,161390.0,한국타이어앤테크놀로지보통주
15299,161390,2020-04-13,0.0488888888888888,22500,21400,-1100,426719,161390.0,한국타이어앤테크놀로지보통주
15300,161390,2020-04-06,0.0483460559796437,19650,20600,950,600041,161390.0,한국타이어앤테크놀로지보통주
15301,161390,2020-04-02,0.0426666666666666,18750,19550,800,551818,161390.0,한국타이어앤테크놀로지보통주
15302,161390,2020-03-31,0.0602739726027397,18250,19350,1100,702431,161390.0,한국타이어앤테크놀로지보통주
15303,161390,2020-03-27,0.0485714285714285,17500,18350,850,1333233,161390.0,한국타이어앤테크놀로지보통주
15304,161390,2020-03-26,0.054054054054054,18500,17500,-1000,1431919,161390.0,한국타이어앤테크놀로지보통주
15305,161390,2020-03-25,0.0850439882697947,17050,18500,1450,657643,161390.0,한국타이어앤테크놀로지보통주
15306,161390,2020-03-24,0.0929487179487179,15600,17050,1450,453113,161390.0,한국타이어앤테크놀로지보통주
15307,161390,2020-03-23,0.0714285714285714,16800,15600,-1200,760492,161390.0,한국타이어앤테크놀로지보통주
15308,161390,2020-03-19,0.1223404255319148,18800,16500,-2300,701053,161390.0,한국타이어앤테크놀로지보통주
15309,161390,2020-03-18,0.0669975186104218,20150,18800,-1350,558474,161390.0,한국타이어앤테크놀로지보통주
15310,161390,2020-03-13,0.058165548098434,22350,21050,-1300,1146113,161390.0,한국타이어앤테크놀로지보통주
15311,161390,2020-03-12,0.0589473684210526,23750,22350,-1400,750172,161390.0,한국타이어앤테크놀로지보통주
15312,161390,2020-03-10,0.0466531440162271,24650,23500,-1150,712545,161390.0,한국타이어앤테크놀로지보통주
15313,161390,2020-02-14,0.0481099656357388,29100,27700,-1400,957658,161390.0,한국타이어앤테크놀로지보통주
15314,161390,2020-01-28,0.0551948051948051,30800,29100,-1700,312082,161390.0,한국타이어앤테크놀로지보통주
15315,161390,2019-11-12,0.0425219941348973,34100,35550,1450,343838,161390.0,한국타이어앤테크놀로지보통주
15316,161390,2019-11-05,0.0880121396054628,32950,35850,2900,1050396,161390.0,한국타이어앤테크놀로지보통주
15317,161390,2019-11-04,0.0410742496050552,31650,32950,1300,244761,161390.0,한국타이어앤테크놀로지보통주
15318,161390,2019-10-02,0.0422960725075528,33100,31700,-1400,558535,161390.0,한국타이어앤테크놀로지보통주
15319,161390,2019-09-24,0.0538336052202283,30650,32300,1650,455512,161390.0,한국타이어앤테크놀로지보통주
15320,161390,2019-09-11,0.0511945392491467,29300,30800,1500,671332,161390.0,한국타이어앤테크놀로지보통주
15321,161390,2019-05-07,0.041405269761606,39850,38200,-1650,453891,161390.0,한국타이어앤테크놀로지보통주
15322,161390,2019-03-25,0.0412121212121212,41250,39550,-1700,330406,161390.0,한국타이어앤테크놀로지보통주
15323,161390,2019-02-13,0.0524390243902439,41000,43150,2150,373713,161390.0,한국타이어앤테크놀로지보통주
15324,161390,2019-01-30,0.0481927710843373,41500,43500,2000,394323,161390.0,한국타이어앤테크놀로지보통주
15325,161390,2019-01-17,0.0441558441558441,38500,40200,1700,542448,161390.0,한국타이어앤테크놀로지보통주
15326,161390,2019-01-08,0.0654088050314465,39750,37150,-2600,761130,161390.0,한국타이어앤테크놀로지보통주
15327,161390,2018-11-01,0.0519323671497584,41400,39250,-2150,494259,161390.0,한국타이어앤테크놀로지보통주
15328,161390,2018-10-30,0.0718358038768529,43850,40700,-3150,710501,161390.0,한국타이어앤테크놀로지보통주
15329,161390,2018-10-11,0.042016806722689,47600,45600,-2000,438856,161390.0,한국타이어앤테크놀로지보통주
15330,161390,2018-09-19,0.0513368983957219,46750,49150,2400,821937,161390.0,한국타이어앤테크놀로지보통주
15331,161390,2018-06-27,0.0434298440979955,44900,42950,-1950,235908,161390.0,한국타이어앤테크놀로지보통주
15332,161390,2018-05-30,0.0562913907284768,45300,42750,-2550,718190,161390.0,한국타이어앤테크놀로지보통주
15333,161390,2018-04-30,0.0443505807814149,47350,49450,2100,656450,161390.0,한국타이어앤테크놀로지보통주
15334,161390,2018-04-19,0.043222003929273,50900,48700,-2200,521052,161390.0,한국타이어앤테크놀로지보통주
15335,161390,2018-02-23,0.0426287744227353,56300,58700,2400,459323,161390.0,한국타이어앤테크놀로지보통주
15336,161390,2018-02-21,0.0555555555555555,54000,57000,3000,517278,161390.0,한국타이어앤테크놀로지보통주
15337,161390,2018-02-12,0.0498220640569395,56200,53400,-2800,515319,161390.0,한국타이어앤테크놀로지보통주
15338,161390,2018-02-09,0.0504672897196261,53500,56200,2700,665702,161390.0,한국타이어앤테크놀로지보통주
15339,161390,2017-07-31,0.0587349397590361,66400,62500,-3900,421604,161390.0,한국타이어앤테크놀로지보통주
15340,161390,2017-06-22,0.0423197492163009,63800,66500,2700,294241,161390.0,한국타이어앤테크놀로지보통주
15341,161390,2017-04-20,0.0426287744227353,56300,58700,2400,357766,161390.0,한국타이어앤테크놀로지보통주
15342,161390,2017-04-12,0.0657894736842105,53200,56700,3500,485763,161390.0,한국타이어앤테크놀로지보통주
15343,161390,2017-02-14,0.0505226480836236,57400,60300,2900,740072,161390.0,한국타이어앤테크놀로지보통주
15344,161390,2017-02-06,0.0492359932088285,58900,56000,-2900,692538,161390.0,한국타이어앤테크놀로지보통주
15345,161390,2017-02-01,0.0459363957597173,56600,59200,2600,612101,161390.0,한국타이어앤테크놀로지보통주
15346,161390,2017-01-10,0.0638655462184873,59500,63300,3800,394010,161390.0,한국타이어앤테크놀로지보통주
15347,161390,2016-12-08,0.0518518518518518,54000,56800,2800,306282,161390.0,한국타이어앤테크놀로지보통주
15348,161390,2016-10-13,0.0460526315789473,60800,58000,-2800,397333,161390.0,한국타이어앤테크놀로지보통주
15349,161390,2016-09-29,0.045886075949367,63200,60300,-2900,305883,161390.0,한국타이어앤테크놀로지보통주
15350,161390,2016-09-07,0.0422535211267605,56800,59200,2400,368563,161390.0,한국타이어앤테크놀로지보통주
15351,161390,2016-08-17,0.0679611650485436,51500,55000,3500,784077,161390.0,한국타이어앤테크놀로지보통주
15352,161890,2021-04-21,0.0415973377703826,60100,57600,-2500,459975,161890.0,한국콜마보통주
15353,161890,2021-02-18,0.0973282442748091,52400,57500,5100,2044354,161890.0,한국콜마보통주
15354,161890,2021-01-18,0.0523364485981308,53500,50700,-2800,429214,161890.0,한국콜마보통주
15355,161890,2020-12-29,0.0426638917793964,48050,50100,2050,549834,161890.0,한국콜마보통주
15356,161890,2020-12-21,0.05119825708061,45900,48250,2350,659099,161890.0,한국콜마보통주
15357,161890,2020-10-12,0.052518756698821,46650,49100,2450,533412,161890.0,한국콜마보통주
15358,161890,2020-08-20,0.0544554455445544,50500,47750,-2750,380469,161890.0,한국콜마보통주
15359,161890,2020-08-18,0.0650095602294455,52300,48900,-3400,440332,161890.0,한국콜마보통주
15360,161890,2020-08-12,0.0417495029821073,50300,52400,2100,556064,161890.0,한국콜마보통주
15361,161890,2020-08-07,0.0495780590717299,47400,49750,2350,1001615,161890.0,한국콜마보통주
15362,161890,2020-07-30,0.0416210295728368,45650,47550,1900,696707,161890.0,한국콜마보통주
15363,161890,2020-06-30,0.0703517587939698,39800,42600,2800,2113544,161890.0,한국콜마보통주
15364,161890,2020-06-15,0.0672645739910313,44600,41600,-3000,353345,161890.0,한국콜마보통주
15365,161890,2020-06-11,0.040880503144654,47700,45750,-1950,448731,161890.0,한국콜마보통주
15366,161890,2020-06-04,0.0510783200908059,44050,46300,2250,980949,161890.0,한국콜마보통주
15367,161890,2020-03-25,0.0446153846153846,32500,33950,1450,405393,161890.0,한국콜마보통주
15368,161890,2020-03-23,0.057057057057057,33300,31400,-1900,205022,161890.0,한국콜마보통주
15369,161890,2020-03-20,0.0438871473354232,31900,33300,1400,301244,161890.0,한국콜마보통주
15370,161890,2020-03-19,0.0699708454810495,34300,31900,-2400,411375,161890.0,한국콜마보통주
15371,161890,2020-03-13,0.0641711229946524,37400,35000,-2400,488863,161890.0,한국콜마보통주
15372,161890,2020-03-12,0.070807453416149,40250,37400,-2850,374788,161890.0,한국콜마보통주
15373,161890,2020-02-24,0.0885529157667386,46300,42200,-4100,626426,161890.0,한국콜마보통주
15374,161890,2020-01-28,0.0941295546558704,49400,44750,-4650,505457,161890.0,한국콜마보통주
15375,161890,2020-01-13,0.0860655737704918,48800,53000,4200,1243114,161890.0,한국콜마보통주
15376,161890,2020-01-07,0.0548245614035087,45600,48100,2500,393563,161890.0,한국콜마보통주
15377,161890,2020-01-06,0.04,47500,45600,-1900,267095,161890.0,한국콜마보통주
15378,161890,2019-11-25,0.0644418872266973,43450,46250,2800,237637,161890.0,한국콜마보통주
15379,161890,2019-10-30,0.0443951165371809,45050,47050,2000,429739,161890.0,한국콜마보통주
15380,161890,2019-10-04,0.0553549939831528,41550,39250,-2300,505181,161890.0,한국콜마보통주
15381,161890,2019-08-14,0.0634408602150537,46500,43550,-2950,1061414,161890.0,한국콜마보통주
15382,161890,2019-08-09,0.048804780876494,50200,47750,-2450,627663,161890.0,한국콜마보통주
15383,161890,2019-08-08,0.0425752855659397,48150,50200,2050,211229,161890.0,한국콜마보통주
15384,161890,2019-08-05,0.0494296577946768,52600,50000,-2600,164166,161890.0,한국콜마보통주
15385,161890,2019-05-15,0.0615615615615615,66600,70700,4100,227315,161890.0,한국콜마보통주
15386,161890,2019-04-02,0.0421836228287841,80600,77200,-3400,244133,161890.0,한국콜마보통주
15387,161890,2019-03-26,0.0434782608695652,78200,81600,3400,105541,161890.0,한국콜마보통주
15388,161890,2019-03-18,0.0497448979591836,78400,82300,3900,213643,161890.0,한국콜마보통주
15389,161890,2019-02-15,0.0564738292011019,72600,76700,4100,486326,161890.0,한국콜마보통주
15390,161890,2019-02-14,0.1033434650455927,65800,72600,6800,768881,161890.0,한국콜마보통주
15391,161890,2019-01-23,0.0526315789473684,64600,68000,3400,245307,161890.0,한국콜마보통주
15392,161890,2019-01-17,0.0489614243323442,67400,64100,-3300,183861,161890.0,한국콜마보통주
15393,161890,2018-12-27,0.0466165413533834,66500,69600,3100,157920,161890.0,한국콜마보통주
15394,161890,2018-11-26,0.0612244897959183,63700,67600,3900,166910,161890.0,한국콜마보통주
15395,161890,2018-11-15,0.1101083032490974,55400,61500,6100,343442,161890.0,한국콜마보통주
15396,161890,2018-11-07,0.042016806722689,59500,57000,-2500,223429,161890.0,한국콜마보통주
15397,161890,2018-11-02,0.0561403508771929,57000,60200,3200,100383,161890.0,한국콜마보통주
15398,161890,2018-11-01,0.051660516605166,54200,57000,2800,125885,161890.0,한국콜마보통주
15399,161890,2018-10-29,0.0789915966386554,59500,54800,-4700,196495,161890.0,한국콜마보통주
15400,161890,2018-10-26,0.0525477707006369,62800,59500,-3300,148251,161890.0,한국콜마보통주
15401,161890,2018-10-11,0.0492040520984081,69100,65700,-3400,111406,161890.0,한국콜마보통주
15402,161890,2018-10-04,0.0404172099087353,76700,73600,-3100,133932,161890.0,한국콜마보통주
15403,161890,2018-10-01,0.0561497326203208,74800,79000,4200,253466,161890.0,한국콜마보통주
15404,161890,2018-08-01,0.0615835777126099,68200,72400,4200,266465,161890.0,한국콜마보통주
15405,161890,2018-07-05,0.0457920792079207,80800,77100,-3700,193880,161890.0,한국콜마보통주
15406,161890,2018-06-27,0.0885072655217965,75700,82400,6700,591719,161890.0,한국콜마보통주
15407,161890,2018-06-19,0.0476190476190476,75600,72000,-3600,125732,161890.0,한국콜마보통주
15408,161890,2018-04-02,0.057618437900128,78100,82600,4500,488921,161890.0,한국콜마보통주
15409,161890,2018-03-09,0.0608020698576972,77300,82000,4700,330851,161890.0,한국콜마보통주
15410,161890,2018-02-22,0.0483675937122128,82700,78700,-4000,438318,161890.0,한국콜마보통주
15411,161890,2018-02-21,0.065721649484536,77600,82700,5100,1401457,161890.0,한국콜마보통주
15412,161890,2018-02-14,0.0908018867924528,84800,77100,-7700,591026,161890.0,한국콜마보통주
15413,161890,2018-01-10,0.0442260442260442,81400,85000,3600,157122,161890.0,한국콜마보통주
15414,161890,2017-12-12,0.055813953488372,86000,81200,-4800,197748,161890.0,한국콜마보통주
15415,161890,2017-11-29,0.0476190476190476,81900,85800,3900,509702,161890.0,한국콜마보통주
15416,161890,2017-11-15,0.0650887573964497,84500,79000,-5500,531702,161890.0,한국콜마보통주
15417,161890,2017-10-13,0.0463576158940397,75500,79000,3500,394677,161890.0,한국콜마보통주
15418,161890,2017-09-26,0.0405405405405405,66600,69300,2700,203062,161890.0,한국콜마보통주
15419,161890,2017-09-25,0.0499286733238231,70100,66600,-3500,191182,161890.0,한국콜마보통주
15420,161890,2017-09-21,0.0998463901689708,65100,71600,6500,697298,161890.0,한국콜마보통주
15421,161890,2017-08-16,0.0513888888888888,72000,68300,-3700,646913,161890.0,한국콜마보통주
15422,161890,2017-07-26,0.0466760961810466,70700,74000,3300,429388,161890.0,한국콜마보통주
15423,161890,2017-06-13,0.0409937888198757,80500,77200,-3300,296692,161890.0,한국콜마보통주
15424,161890,2017-05-12,0.0466666666666666,90000,85800,-4200,601355,161890.0,한국콜마보통주
15425,161890,2017-05-04,0.0460772104607721,80300,84000,3700,201678,161890.0,한국콜마보통주
15426,161890,2017-04-17,0.0412371134020618,77600,80800,3200,264548,161890.0,한국콜마보통주
15427,161890,2017-04-13,0.0673076923076923,72800,77700,4900,305541,161890.0,한국콜마보통주
15428,161890,2017-03-24,0.0680851063829787,70500,75300,4800,320302,161890.0,한국콜마보통주
15429,161890,2017-03-03,0.0560875512995896,73100,69000,-4100,281739,161890.0,한국콜마보통주
15430,161890,2017-03-02,0.0469361147327249,76700,73100,-3600,165038,161890.0,한국콜마보통주
15431,161890,2017-02-24,0.0512129380053908,74200,78000,3800,379678,161890.0,한국콜마보통주
15432,161890,2017-02-15,0.0447154471544715,73800,77100,3300,462573,161890.0,한국콜마보통주
15433,161890,2017-02-14,0.0603448275862069,69600,73800,4200,580238,161890.0,한국콜마보통주
15434,161890,2017-02-13,0.0529500756429652,66100,69600,3500,321734,161890.0,한국콜마보통주
15435,161890,2017-02-10,0.0508744038155802,62900,66100,3200,187131,161890.0,한국콜마보통주
15436,161890,2017-01-31,0.0436746987951807,66400,69300,2900,120434,161890.0,한국콜마보통주
15437,161890,2017-01-09,0.0495207667731629,62600,59500,-3100,228717,161890.0,한국콜마보통주
15438,161890,2017-01-02,0.0623100303951367,65800,61700,-4100,219026,161890.0,한국콜마보통주
15439,161890,2016-12-23,0.0427480916030534,65500,68300,2800,159345,161890.0,한국콜마보통주
15440,161890,2016-12-09,0.0535714285714285,67200,70800,3600,324489,161890.0,한국콜마보통주
15441,161890,2016-12-05,0.0467741935483871,62000,64900,2900,211690,161890.0,한국콜마보통주
15442,161890,2016-12-02,0.0402476780185758,64600,62000,-2600,222664,161890.0,한국콜마보통주
15443,161890,2016-12-01,0.0415430267062314,67400,64600,-2800,139791,161890.0,한국콜마보통주
15444,161890,2016-11-29,0.0458015267175572,65500,68500,3000,249566,161890.0,한국콜마보통주
15445,161890,2016-11-21,0.0511363636363636,70400,66800,-3600,256185,161890.0,한국콜마보통주
15446,161890,2016-11-15,0.0418300653594771,76500,73300,-3200,179842,161890.0,한국콜마보통주
15447,161890,2016-11-02,0.0451219512195121,82000,78300,-3700,173290,161890.0,한국콜마보통주
15448,161890,2016-10-31,0.0400471142520612,84900,81500,-3400,92774,161890.0,한국콜마보통주
15449,161890,2016-10-26,0.04875,80000,83900,3900,155716,161890.0,한국콜마보통주
15450,161890,2016-10-25,0.0825688073394495,87200,80000,-7200,272496,161890.0,한국콜마보통주
15451,161890,2016-08-23,0.0522727272727272,88000,92600,4600,96791,161890.0,한국콜마보통주
15452,161890,2016-08-08,0.041049030786773,87700,91300,3600,254777,161890.0,한국콜마보통주
15453,175330,2021-05-21,0.0406607369758576,7870,7550,-320,878565,175330.0,JB금융지주보통주
15454,175330,2021-04-27,0.0413589364844904,6770,7050,280,1182728,175330.0,JB금융지주보통주
15455,175330,2021-01-29,0.0407407407407407,5400,5180,-220,502828,175330.0,JB금융지주보통주
15456,175330,2020-12-29,0.0441426146010186,5890,5630,-260,625995,175330.0,JB금융지주보통주
15457,175330,2020-12-17,0.0528,6250,5920,-330,707647,175330.0,JB금융지주보통주
15458,175330,2020-11-11,0.053763440860215,5580,5880,300,1271307,175330.0,JB금융지주보통주
15459,175330,2020-11-02,0.0431372549019607,5100,5320,220,751655,175330.0,JB금융지주보통주
15460,175330,2020-06-15,0.0612648221343873,5060,4750,-310,446666,175330.0,JB금융지주보통주
15461,175330,2020-05-19,0.0627099664053751,4465,4745,280,661645,175330.0,JB금융지주보통주
15462,175330,2020-04-27,0.0549828178694158,4365,4605,240,776746,175330.0,JB금융지주보통주
15463,175330,2020-03-26,0.048284625158831,3935,4125,190,854056,175330.0,JB금융지주보통주
15464,175330,2020-03-25,0.0870165745856353,3620,3935,315,625522,175330.0,JB금융지주보통주
15465,175330,2020-03-24,0.0402298850574712,3480,3620,140,521168,175330.0,JB금융지주보통주
15466,175330,2020-03-23,0.0890052356020942,3820,3480,-340,627780,175330.0,JB금융지주보통주
15467,175330,2020-03-20,0.1318518518518518,3375,3820,445,1052187,175330.0,JB금융지주보통주
15468,175330,2020-03-19,0.0975935828877005,3740,3375,-365,1322175,175330.0,JB금융지주보통주
15469,175330,2020-03-17,0.06318347509113,4115,3855,-260,867784,175330.0,JB금융지주보통주
15470,175330,2020-03-13,0.0591581342434584,4395,4135,-260,1187241,175330.0,JB금융지주보통주
15471,175330,2020-03-09,0.0475206611570247,4840,4610,-230,763653,175330.0,JB금융지주보통주
15472,175330,2018-10-11,0.0462328767123287,5840,5570,-270,447059,175330.0,JB금융지주보통주
15473,175330,2018-07-13,0.0689045936395759,5660,6050,390,960454,175330.0,JB금융지주보통주
15474,175330,2018-02-07,0.0459940652818991,6740,6430,-310,599624,175330.0,JB금융지주보통주
15475,175330,2017-07-31,0.0452488687782805,6630,6930,300,1408344,175330.0,JB금융지주보통주
15476,175330,2016-11-02,0.0472972972972973,5920,5640,-280,628772,175330.0,JB금융지주보통주
15477,180640,2021-06-02,0.0685975609756097,65600,70100,4500,617560,180640.0,한진칼보통주
15478,180640,2021-05-28,0.0408759124087591,68500,65700,-2800,338953,180640.0,한진칼보통주
15479,180640,2021-05-25,0.0596546310832025,63700,67500,3800,601420,180640.0,한진칼보통주
15480,180640,2021-05-17,0.1018363939899833,59900,66000,6100,1429921,180640.0,한진칼보통주
15481,180640,2021-05-11,0.0558558558558558,55500,58600,3100,662805,180640.0,한진칼보통주
15482,180640,2021-05-10,0.0818713450292397,51300,55500,4200,312127,180640.0,한진칼보통주
15483,180640,2021-05-03,0.0882882882882882,55500,50600,-4900,326196,180640.0,한진칼보통주
15484,180640,2021-04-08,0.0427184466019417,51500,53700,2200,160283,180640.0,한진칼보통주
15485,180640,2021-04-06,0.0434782608695652,52900,50600,-2300,323239,180640.0,한진칼보통주
15486,180640,2021-04-05,0.078397212543554,57400,52900,-4500,415129,180640.0,한진칼보통주
15487,180640,2020-12-15,0.0443740095087163,63100,60300,-2800,385189,180640.0,한진칼보통주
15488,180640,2020-12-14,0.0410334346504559,65800,63100,-2700,352796,180640.0,한진칼보통주
15489,180640,2020-12-02,0.0659340659340659,72800,68000,-4800,1069964,180640.0,한진칼보통주
15490,180640,2020-11-17,0.0888077858880778,82200,74900,-7300,1730811,180640.0,한진칼보통주
15491,180640,2020-11-16,0.0565552699228791,77800,82200,4400,11647662,180640.0,한진칼보통주
15492,180640,2020-11-13,0.0825471698113207,84800,77800,-7000,1341803,180640.0,한진칼보통주
15493,180640,2020-11-09,0.0535714285714285,84000,88500,4500,363151,180640.0,한진칼보통주
15494,180640,2020-11-02,0.0575635876840696,74700,79000,4300,288218,180640.0,한진칼보통주
15495,180640,2020-10-12,0.0426997245179063,72600,75700,3100,251717,180640.0,한진칼보통주
15496,180640,2020-10-08,0.0629575402635432,68300,72600,4300,339718,180640.0,한진칼보통주
15497,180640,2020-09-24,0.0516039051603905,71700,68000,-3700,198486,180640.0,한진칼보통주
15498,180640,2020-09-22,0.0433639947437582,76100,72800,-3300,141939,180640.0,한진칼보통주
15499,180640,2020-09-21,0.0499375780274656,80100,76100,-4000,165282,180640.0,한진칼보통주
15500,180640,2020-09-18,0.0402597402597402,77000,80100,3100,713371,180640.0,한진칼보통주
15501,180640,2020-08-31,0.0425824175824175,72800,75900,3100,222908,180640.0,한진칼보통주
15502,180640,2020-08-20,0.0621890547263681,80400,75400,-5000,350660,180640.0,한진칼보통주
15503,180640,2020-07-23,0.0470588235294117,93500,89100,-4400,589245,180640.0,한진칼보통주
15504,180640,2020-07-22,0.0497967479674796,98400,93500,-4900,690224,180640.0,한진칼보통주
15505,180640,2020-07-21,0.047923322683706,93900,98400,4500,770077,180640.0,한진칼보통주
15506,180640,2020-07-13,0.0518763796909492,90600,95300,4700,987500,180640.0,한진칼보통주
15507,180640,2020-07-08,0.050351288056206,85400,89700,4300,928496,180640.0,한진칼보통주
15508,180640,2020-07-01,0.0785536159600997,80200,86500,6300,1175743,180640.0,한진칼보통주
15509,180640,2020-06-16,0.0423031727379553,85100,88700,3600,568194,180640.0,한진칼보통주
15510,180640,2020-06-15,0.0719738276990185,91700,85100,-6600,817979,180640.0,한진칼보통주
15511,180640,2020-06-12,0.0737373737373737,99000,91700,-7300,1334421,180640.0,한진칼보통주
15512,180640,2020-06-11,0.0565635005336179,93700,99000,5300,4241916,180640.0,한진칼보통주
15513,180640,2020-06-01,0.0556199304750869,86300,91100,4800,1560942,180640.0,한진칼보통주
15514,180640,2020-05-29,0.07502679528403,93300,86300,-7000,2574010,180640.0,한진칼보통주
15515,180640,2020-05-28,0.0459641255605381,89200,93300,4100,2697830,180640.0,한진칼보통주
15516,180640,2020-05-26,0.1421319796954314,78800,90000,11200,8007371,180640.0,한진칼보통주
15517,180640,2020-05-13,0.1289617486338797,91500,79700,-11800,2353631,180640.0,한진칼보통주
15518,180640,2020-05-11,0.0656682027649769,86800,92500,5700,1991449,180640.0,한진칼보통주
15519,180640,2020-05-07,0.0434258142340168,82900,86500,3600,1965513,180640.0,한진칼보통주
15520,180640,2020-05-04,0.0494252873563218,87000,82700,-4300,976706,180640.0,한진칼보통주
15521,180640,2020-04-24,0.0915492957746478,85200,93000,7800,9390503,180640.0,한진칼보통주
15522,180640,2020-04-20,0.2602739726027397,109500,81000,-28500,6522949,180640.0,한진칼보통주
15523,180640,2020-04-17,0.288235294117647,85000,109500,24500,13623107,180640.0,한진칼보통주
15524,180640,2020-04-09,0.0501882057716436,79700,83700,4000,6732369,180640.0,한진칼보통주
15525,180640,2020-04-08,0.0743321718931475,86100,79700,-6400,3804445,180640.0,한진칼보통주
15526,180640,2020-04-07,0.2317596566523605,69900,86100,16200,8186102,180640.0,한진칼보통주
15527,180640,2020-04-03,0.0552486187845303,72400,68400,-4000,1790590,180640.0,한진칼보통주
15528,180640,2020-04-02,0.1061728395061728,81000,72400,-8600,2788795,180640.0,한진칼보통주
15529,180640,2020-04-01,0.0901749663526245,74300,81000,6700,7791191,180640.0,한진칼보통주
15530,180640,2020-03-30,0.2989510489510489,57200,74300,17100,6733285,180640.0,한진칼보통주
15531,180640,2020-03-27,0.2985244040862656,44050,57200,13150,10585018,180640.0,한진칼보통주
15532,180640,2020-03-25,0.0633802816901408,42600,45300,2700,3690263,180640.0,한진칼보통주
15533,180640,2020-03-24,0.2692967409948542,58300,42600,-15700,9170002,180640.0,한진칼보통주
15534,180640,2020-03-23,0.0938086303939962,53300,58300,5000,6514432,180640.0,한진칼보통주
15535,180640,2020-03-20,0.2984165651644336,41050,53300,12250,6293980,180640.0,한진칼보통주
15536,180640,2020-03-18,0.1845124282982791,52300,42650,-9650,2400703,180640.0,한진칼보통주
15537,180640,2020-03-17,0.1090289608177172,58700,52300,-6400,1544437,180640.0,한진칼보통주
15538,180640,2020-03-13,0.0464344941956882,60300,57500,-2800,2724014,180640.0,한진칼보통주
15539,180640,2020-03-11,0.0765625,64000,59100,-4900,1714407,180640.0,한진칼보통주
15540,180640,2020-03-09,0.1032531824611032,70700,63400,-7300,3318153,180640.0,한진칼보통주
15541,180640,2020-03-06,0.1451027811366384,82700,70700,-12000,5952356,180640.0,한진칼보통주
15542,180640,2020-03-04,0.0482673267326732,80800,84700,3900,6419975,180640.0,한진칼보통주
15543,180640,2020-03-03,0.200594353640416,67300,80800,13500,9410961,180640.0,한진칼보통주
15544,180640,2020-02-27,0.0833333333333333,60000,65000,5000,7972161,180640.0,한진칼보통주
15545,180640,2020-02-26,0.1650485436893204,51500,60000,8500,7891424,180640.0,한진칼보통주
15546,180640,2020-02-13,0.1034482758620689,43500,48000,4500,6799473,180640.0,한진칼보통주
15547,180640,2020-02-12,0.0984848484848484,39600,43500,3900,2936011,180640.0,한진칼보통주
15548,180640,2020-01-09,0.0503778337531486,39700,41700,2000,1285296,180640.0,한진칼보통주
15549,180640,2019-12-26,0.0979020979020979,42900,38700,-4200,4859653,180640.0,한진칼보통주
15550,180640,2019-12-24,0.0714285714285714,46200,42900,-3300,12581857,180640.0,한진칼보통주
15551,180640,2019-12-23,0.2,38500,46200,7700,9527785,180640.0,한진칼보통주
15552,180640,2019-12-04,0.0403225806451612,37200,38700,1500,612087,180640.0,한진칼보통주
15553,180640,2019-11-28,0.0774962742175856,33550,36150,2600,1027608,180640.0,한진칼보통주
15554,180640,2019-11-06,0.0513219284603421,32150,33800,1650,726332,180640.0,한진칼보통주
15555,180640,2019-11-04,0.0734557595993322,29950,32150,2200,962980,180640.0,한진칼보통주
15556,180640,2019-10-30,0.0451505016722408,29900,31250,1350,509950,180640.0,한진칼보통주
15557,180640,2019-10-01,0.0461254612546125,27100,28350,1250,363575,180640.0,한진칼보통주
15558,180640,2019-07-29,0.0524412296564195,27650,26200,-1450,1026875,180640.0,한진칼보통주
15559,180640,2019-07-08,0.0678807947019867,30200,28150,-2050,1259237,180640.0,한진칼보통주
15560,180640,2019-06-24,0.0932944606413994,34300,31100,-3200,5112886,180640.0,한진칼보통주
15561,180640,2019-06-21,0.1509900990099009,40400,34300,-6100,6543734,180640.0,한진칼보통주
15562,180640,2019-06-18,0.0471204188481675,38200,40000,1800,1564694,180640.0,한진칼보통주
15563,180640,2019-06-14,0.0482076637824474,40450,38500,-1950,1745062,180640.0,한진칼보통주
15564,180640,2019-06-05,0.0544135429262394,41350,43600,2250,2757098,180640.0,한진칼보통주
15565,180640,2019-05-27,0.0980603448275862,46400,41850,-4550,2341330,180640.0,한진칼보통주
15566,180640,2019-05-24,0.0485875706214689,44250,46400,2150,3340078,180640.0,한진칼보통주
15567,180640,2019-05-14,0.1256830601092896,36600,41200,4600,6388022,180640.0,한진칼보통주
15568,180640,2019-04-23,0.0720606826801517,39550,36700,-2850,3126733,180640.0,한진칼보통주
15569,180640,2019-04-22,0.0407894736842105,38000,39550,1550,4970394,180640.0,한진칼보통주
15570,180640,2019-04-17,0.0649038461538461,41600,38900,-2700,6390672,180640.0,한진칼보통주
15571,180640,2019-04-16,0.0491428571428571,43750,41600,-2150,11375406,180640.0,한진칼보통주
15572,180640,2019-04-12,0.2989690721649484,33950,44100,10150,11917137,180640.0,한진칼보통주
15573,180640,2019-04-10,0.0912106135986733,30150,32900,2750,10341401,180640.0,한진칼보통주
15574,180640,2019-04-08,0.2063492063492063,25200,30400,5200,11006226,180640.0,한진칼보통주
15575,180640,2019-03-22,0.048582995951417,24700,25900,1200,1269655,180640.0,한진칼보통주
15576,180640,2019-03-21,0.0608365019011406,26300,24700,-1600,1727513,180640.0,한진칼보통주
15577,180640,2019-03-04,0.0941176470588235,25500,27900,2400,1423353,180640.0,한진칼보통주
15578,180640,2019-02-18,0.0427509293680297,26900,25750,-1150,1025801,180640.0,한진칼보통주
15579,180640,2019-01-25,0.0408858603066439,29350,28150,-1200,1165609,180640.0,한진칼보통주
15580,180640,2019-01-18,0.0415973377703826,30050,31300,1250,766574,180640.0,한진칼보통주
15581,180640,2018-12-28,0.0628930817610062,31800,29800,-2000,3090364,180640.0,한진칼보통주
15582,180640,2018-12-20,0.064039408866995,30450,32400,1950,2988804,180640.0,한진칼보통주
15583,180640,2018-12-13,0.0544217687074829,29400,31000,1600,1577394,180640.0,한진칼보통주
15584,180640,2018-11-29,0.0709570957095709,30300,32450,2150,1990534,180640.0,한진칼보통주
15585,180640,2018-11-27,0.0649122807017543,28500,30350,1850,1754834,180640.0,한진칼보통주
15586,180640,2018-11-21,0.0449826989619377,28900,30200,1300,2752397,180640.0,한진칼보통주
15587,180640,2018-11-20,0.090566037735849,26500,28900,2400,3591398,180640.0,한진칼보통주
15588,180640,2018-11-19,0.0669014084507042,28400,26500,-1900,7806047,180640.0,한진칼보통주
15589,180640,2018-11-16,0.1474747474747474,24750,28400,3650,7877754,180640.0,한진칼보통주
15590,180640,2018-11-14,0.1258278145695364,22650,25500,2850,4415619,180640.0,한진칼보통주
15591,180640,2018-11-02,0.0923076923076923,19500,21300,1800,974505,180640.0,한진칼보통주
15592,180640,2018-10-17,0.0421052631578947,19000,19800,800,393973,180640.0,한진칼보통주
15593,180640,2018-10-10,0.0421545667447306,21350,20450,-900,618415,180640.0,한진칼보통주
15594,180640,2018-09-13,0.0551378446115288,19950,21050,1100,1227328,180640.0,한진칼보통주
15595,180640,2018-09-11,0.0604395604395604,18200,19300,1100,967770,180640.0,한진칼보통주
15596,180640,2018-09-07,0.0571428571428571,17500,18500,1000,504923,180640.0,한진칼보통주
15597,180640,2018-08-17,0.0558823529411764,17000,17950,950,1206195,180640.0,한진칼보통주
15598,180640,2018-07-31,0.0605187319884726,17350,18400,1050,777308,180640.0,한진칼보통주
15599,180640,2018-07-26,0.0446428571428571,16800,17550,750,532994,180640.0,한진칼보통주
15600,180640,2018-07-13,0.0495626822157434,17150,18000,850,566293,180640.0,한진칼보통주
15601,180640,2018-07-10,0.0414201183431952,16900,17600,700,806366,180640.0,한진칼보통주
15602,180640,2018-07-02,0.0502958579881656,16900,16050,-850,730434,180640.0,한진칼보통주
15603,180640,2018-06-27,0.0533707865168539,17800,16850,-950,1172825,180640.0,한진칼보통주
15604,180640,2018-06-21,0.0807291666666666,19200,17650,-1550,1182835,180640.0,한진칼보통주
15605,180640,2018-06-15,0.0554272517321016,21650,20450,-1200,705316,180640.0,한진칼보통주
15606,180640,2018-06-07,0.0580357142857142,22400,21100,-1300,984247,180640.0,한진칼보통주
15607,180640,2018-05-31,0.0691244239631336,21700,23200,1500,553363,180640.0,한진칼보통주
15608,180640,2018-05-23,0.0522727272727272,22000,20850,-1150,632228,180640.0,한진칼보통주
15609,180640,2018-05-15,0.0466101694915254,23600,22500,-1100,384604,180640.0,한진칼보통주
15610,180640,2018-05-11,0.0406320541760722,22150,23050,900,524941,180640.0,한진칼보통주
15611,180640,2018-05-09,0.0502092050209205,23900,22700,-1200,1084996,180640.0,한진칼보통주
15612,180640,2018-04-24,0.0428571428571428,24500,25550,1050,2193096,180640.0,한진칼보통주
15613,180640,2018-04-23,0.0675381263616557,22950,24500,1550,1220977,180640.0,한진칼보통주
15614,180640,2018-04-12,0.0642398286937901,23350,21850,-1500,864161,180640.0,한진칼보통주
15615,180640,2018-04-03,0.0581395348837209,21500,22750,1250,1651660,180640.0,한진칼보통주
15616,180640,2018-03-30,0.0609137055837563,19700,20900,1200,509412,180640.0,한진칼보통주
15617,180640,2018-03-23,0.0488997555012225,20450,19450,-1000,354581,180640.0,한진칼보통주
15618,180640,2018-01-24,0.0563725490196078,20400,21550,1150,872364,180640.0,한진칼보통주
15619,180640,2018-01-02,0.0491803278688524,18300,19200,900,579561,180640.0,한진칼보통주
15620,180640,2017-12-13,0.0512820512820512,17550,18450,900,532645,180640.0,한진칼보통주
15621,180640,2017-12-08,0.0449735449735449,18900,18050,-850,1113741,180640.0,한진칼보통주
15622,180640,2017-11-17,0.0481283422459893,18700,19600,900,2100124,180640.0,한진칼보통주
15623,180640,2017-11-15,0.0545454545454545,19250,18200,-1050,1228014,180640.0,한진칼보통주
15624,180640,2017-11-10,0.0403022670025188,19850,19050,-800,1621229,180640.0,한진칼보통주
15625,180640,2017-11-02,0.058411214953271,21400,20150,-1250,1135296,180640.0,한진칼보통주
15626,180640,2017-10-26,0.0574162679425837,20900,22100,1200,823989,180640.0,한진칼보통주
15627,180640,2017-10-19,0.0547263681592039,20100,21200,1100,649808,180640.0,한진칼보통주
15628,180640,2017-10-18,0.0551181102362204,19050,20100,1050,743354,180640.0,한진칼보통주
15629,180640,2017-09-21,0.0441501103752759,22650,21650,-1000,568478,180640.0,한진칼보통주
15630,180640,2017-09-11,0.0714285714285714,21000,22500,1500,578931,180640.0,한진칼보통주
15631,180640,2017-08-08,0.0630081300813008,24600,26150,1550,1132138,180640.0,한진칼보통주
15632,180640,2017-08-03,0.0480961923847695,24950,23750,-1200,502416,180640.0,한진칼보통주
15633,180640,2017-08-02,0.0572033898305084,23600,24950,1350,517542,180640.0,한진칼보통주
15634,180640,2017-07-26,0.040983606557377,24400,23400,-1000,662504,180640.0,한진칼보통주
15635,180640,2017-07-14,0.0444444444444444,24750,23650,-1100,778904,180640.0,한진칼보통주
15636,180640,2017-07-03,0.0452830188679245,26500,25300,-1200,892358,180640.0,한진칼보통주
15637,180640,2017-06-02,0.0580645161290322,23250,24600,1350,987983,180640.0,한진칼보통주
15638,180640,2017-05-25,0.042316258351893,22450,23400,950,600477,180640.0,한진칼보통주
15639,180640,2017-05-04,0.0413625304136253,20550,21400,850,676670,180640.0,한진칼보통주
15640,180640,2017-04-25,0.0461538461538461,19500,20400,900,767307,180640.0,한진칼보통주
15641,180640,2017-03-31,0.0453333333333333,18750,19600,850,859583,180640.0,한진칼보통주
15642,180640,2017-03-21,0.0421348314606741,17800,18550,750,1174532,180640.0,한진칼보통주
15643,180640,2017-03-17,0.0626865671641791,16750,17800,1050,1342105,180640.0,한진칼보통주
15644,180640,2017-03-03,0.0483383685800604,16550,15750,-800,964844,180640.0,한진칼보통주
15645,180640,2017-01-25,0.0420711974110032,15450,14800,-650,606791,180640.0,한진칼보통주
15646,180640,2017-01-02,0.0423452768729641,15350,14700,-650,645361,180640.0,한진칼보통주
15647,180640,2016-12-05,0.043859649122807,17100,16350,-750,433246,180640.0,한진칼보통주
15648,180640,2016-12-01,0.0533707865168539,17800,16850,-950,843988,180640.0,한진칼보통주
15649,180640,2016-11-15,0.0807453416149068,16100,17400,1300,1481575,180640.0,한진칼보통주
15650,180640,2016-11-11,0.056547619047619,16800,15850,-950,904684,180640.0,한진칼보통주
15651,180640,2016-09-22,0.0552486187845303,18100,19100,1000,903361,180640.0,한진칼보통주
15652,180640,2016-09-09,0.0416666666666666,19200,18400,-800,1300309,180640.0,한진칼보통주
15653,180640,2016-09-01,0.0526315789473684,19000,20000,1000,1715643,180640.0,한진칼보통주
15654,180640,2016-08-30,0.0584958217270195,17950,19000,1050,3073453,180640.0,한진칼보통주
15655,180640,2016-08-24,0.044378698224852,16900,17650,750,824068,180640.0,한진칼보통주
15656,180640,2016-08-23,0.0864864864864864,18500,16900,-1600,1761000,180640.0,한진칼보통주
15657,180640,2016-08-17,0.0947630922693266,20050,18150,-1900,1824502,180640.0,한진칼보통주
15658,180640,2016-08-12,0.0467532467532467,19250,20150,900,1702186,180640.0,한진칼보통주
15659,180640,2016-08-11,0.0635359116022099,18100,19250,1150,2314445,180640.0,한진칼보통주
15660,180640,2016-08-04,0.0416666666666666,18000,17250,-750,491764,180640.0,한진칼보통주
15661,181710,2020-09-04,0.062251655629139,75500,80200,4700,683908,181710.0,NHN보통주
15662,181710,2020-08-20,0.0620155038759689,77400,72600,-4800,265370,181710.0,NHN보통주
15663,181710,2020-08-07,0.0594285714285714,87500,82300,-5200,436108,181710.0,NHN보통주
15664,181710,2020-07-07,0.0419664268585131,83400,86900,3500,216417,181710.0,NHN보통주
15665,181710,2020-06-25,0.0451467268623024,88600,84600,-4000,143789,181710.0,NHN보통주
15666,181710,2020-06-23,0.0541176470588235,85000,89600,4600,330077,181710.0,NHN보통주
15667,181710,2020-06-15,0.0614136732329084,86300,81000,-5300,139999,181710.0,NHN보통주
15668,181710,2020-05-20,0.0492957746478873,85200,89400,4200,287855,181710.0,NHN보통주
15669,181710,2020-05-19,0.0405405405405405,88800,85200,-3600,498364,181710.0,NHN보통주
15670,181710,2020-05-18,0.04,92500,88800,-3700,232136,181710.0,NHN보통주
15671,181710,2020-05-11,0.0626506024096385,83000,88200,5200,355552,181710.0,NHN보통주
15672,181710,2020-04-16,0.0616929698708751,69700,74000,4300,173208,181710.0,NHN보통주
15673,181710,2020-03-31,0.0770440251572327,63600,68500,4900,200132,181710.0,NHN보통주
15674,181710,2020-03-30,0.0460526315789473,60800,63600,2800,104766,181710.0,NHN보통주
15675,181710,2020-03-25,0.0444810543657331,60700,63400,2700,84185,181710.0,NHN보통주
15676,181710,2020-03-24,0.1056466302367941,54900,60700,5800,133344,181710.0,NHN보통주
15677,181710,2020-03-23,0.0819397993311036,59800,54900,-4900,98169,181710.0,NHN보통주
15678,181710,2020-03-20,0.0872727272727272,55000,59800,4800,125559,181710.0,NHN보통주
15679,181710,2020-03-19,0.0802675585284281,59800,55000,-4800,212311,181710.0,NHN보통주
15680,181710,2020-03-18,0.0743034055727554,64600,59800,-4800,100630,181710.0,NHN보통주
15681,181710,2020-03-12,0.056338028169014,71000,67000,-4000,144787,181710.0,NHN보통주
15682,181710,2020-03-11,0.0456989247311828,74400,71000,-3400,97870,181710.0,NHN보통주
15683,181710,2020-03-04,0.0456431535269709,72300,75600,3300,96428,181710.0,NHN보통주
15684,181710,2020-03-02,0.0545193687230989,69700,73500,3800,128605,181710.0,NHN보통주
15685,181710,2020-02-28,0.0491132332878581,73300,69700,-3600,104986,181710.0,NHN보통주
15686,181710,2020-02-04,0.0424966799468791,75300,78500,3200,85336,181710.0,NHN보통주
15687,181710,2020-01-29,0.0446549391069012,73900,77200,3300,134959,181710.0,NHN보통주
15688,181710,2020-01-10,0.0827285921625544,68900,74600,5700,307556,181710.0,NHN보통주
15689,181710,2020-01-09,0.0487062404870624,65700,68900,3200,148280,181710.0,NHN보통주
15690,181710,2019-11-27,0.0570522979397781,63100,66700,3600,187687,181710.0,NHN보통주
15691,181710,2019-08-08,0.0531561461794019,60200,63400,3200,114026,181710.0,NHN보통주
15692,181710,2019-08-05,0.0441176470588235,61200,58500,-2700,136014,181710.0,NHN보통주
15693,181710,2019-07-19,0.0409448818897637,63500,66100,2600,131433,181710.0,NHN보통주
15694,181710,2019-07-08,0.0421768707482993,73500,70400,-3100,158812,181710.0,NHN보통주
15695,181710,2019-07-05,0.05,70000,73500,3500,281666,181710.0,NHN보통주
15696,181710,2019-07-01,0.0646830530401035,77300,72300,-5000,224584,181710.0,NHN보통주
15697,181710,2019-06-27,0.0404040404040404,79200,76000,-3200,157201,181710.0,NHN보통주
15698,181710,2019-06-26,0.0446320868516284,82900,79200,-3700,152135,181710.0,NHN보통주
15699,181710,2019-06-18,0.0529634300126103,79300,83500,4200,185623,181710.0,NHN보통주
15700,181710,2019-06-10,0.0494652406417112,74800,78500,3700,91579,181710.0,NHN보통주
15701,181710,2019-05-02,0.0988095238095238,84000,75700,-8300,410580,181710.0,NHN보통주
15702,181710,2019-04-16,0.0574324324324324,88800,83700,-5100,192340,181710.0,NHN보통주
15703,181710,2019-03-26,0.0410132689987937,82900,86300,3400,155682,181710.0,NHN보통주
15704,181710,2019-03-19,0.0402234636871508,89500,85900,-3600,190585,181710.0,NHN보통주
15705,181710,2019-03-18,0.0406976744186046,86000,89500,3500,164144,181710.0,NHN보통주
15706,181710,2019-03-11,0.0580964153275649,80900,85600,4700,352597,181710.0,NHN보통주
15707,181710,2019-03-04,0.054054054054054,74000,78000,4000,127176,181710.0,NHN보통주
15708,181710,2019-02-14,0.1195652173913043,64400,72100,7700,673236,181710.0,NHN보통주
15709,181710,2019-02-11,0.0502958579881656,67600,64200,-3400,122927,181710.0,NHN보통주
15710,181710,2019-02-01,0.1440677966101695,59000,67500,8500,624458,181710.0,NHN보통주
15711,181710,2019-01-07,0.0545774647887323,56800,59900,3100,110672,181710.0,NHN보통주
15712,181710,2018-11-21,0.0513761467889908,54500,57300,2800,66142,181710.0,NHN보통주
15713,181710,2018-11-12,0.0415400202634245,49350,51400,2050,130321,181710.0,NHN보통주
15714,181710,2018-11-08,0.0471596998928188,46650,48850,2200,52162,181710.0,NHN보통주
15715,181710,2018-10-30,0.0542452830188679,42400,44700,2300,140085,181710.0,NHN보통주
15716,181710,2018-10-29,0.0681318681318681,45500,42400,-3100,127985,181710.0,NHN보통주
15717,181710,2018-10-26,0.054054054054054,48100,45500,-2600,146405,181710.0,NHN보통주
15718,181710,2018-10-11,0.0556521739130434,57500,54300,-3200,162203,181710.0,NHN보통주
15719,181710,2018-08-13,0.0414110429447852,65200,62500,-2700,84062,181710.0,NHN보통주
15720,181710,2018-08-09,0.0682539682539682,63000,67300,4300,145946,181710.0,NHN보통주
15721,181710,2018-06-15,0.0520231213872832,69200,65600,-3600,125908,181710.0,NHN보통주
15722,181710,2018-05-11,0.0666666666666666,60000,64000,4000,476267,181710.0,NHN보통주
15723,181710,2018-03-16,0.0409026798307475,70900,68000,-2900,269443,181710.0,NHN보통주
15724,181710,2018-03-07,0.046480743691899,75300,71800,-3500,174626,181710.0,NHN보통주
15725,181710,2018-01-25,0.0432569974554707,78600,82000,3400,227971,181710.0,NHN보통주
15726,181710,2018-01-16,0.0522696011004126,72700,76500,3800,259758,181710.0,NHN보통주
15727,181710,2018-01-11,0.059347181008902,67400,71400,4000,240956,181710.0,NHN보통주
15728,181710,2017-12-27,0.088235294117647,64600,70300,5700,185816,181710.0,NHN보통주
15729,181710,2017-12-06,0.044378698224852,67600,64600,-3000,121353,181710.0,NHN보통주
15730,181710,2017-11-14,0.0735294117647058,68000,73000,5000,352324,181710.0,NHN보통주
15731,181710,2017-10-12,0.0552325581395348,68800,65000,-3800,252120,181710.0,NHN보통주
15732,181710,2017-09-26,0.0415430267062314,67400,70200,2800,132857,181710.0,NHN보통주
15733,181710,2017-09-20,0.0527027027027027,74000,70100,-3900,191417,181710.0,NHN보통주
15734,181710,2017-08-16,0.0420711974110032,61800,64400,2600,271793,181710.0,NHN보통주
15735,181710,2017-08-11,0.1449864498644986,73800,63100,-10700,599641,181710.0,NHN보통주
15736,181710,2017-08-04,0.0463576158940397,75500,72000,-3500,135731,181710.0,NHN보통주
15737,181710,2017-07-26,0.0490196078431372,81600,77600,-4000,217113,181710.0,NHN보통주
15738,181710,2017-07-07,0.04406364749082,81700,78100,-3600,115640,181710.0,NHN보통주
15739,181710,2017-06-19,0.0565552699228791,77800,82200,4400,349134,181710.0,NHN보통주
15740,181710,2017-05-15,0.0523809523809523,63000,66300,3300,188772,181710.0,NHN보통주
15741,181710,2017-03-21,0.0469565217391304,57500,60200,2700,160221,181710.0,NHN보통주
15742,181710,2017-02-22,0.0585106382978723,56400,59700,3300,208384,181710.0,NHN보통주
15743,181710,2017-02-13,0.04,57500,55200,-2300,249431,181710.0,NHN보통주
15744,181710,2017-01-31,0.0536779324055666,50300,53000,2700,168895,181710.0,NHN보통주
15745,181710,2016-12-28,0.0477178423236514,48200,50500,2300,83323,181710.0,NHN보통주
15746,181710,2016-10-17,0.0483592400690846,57900,55100,-2800,148878,181710.0,NHN보통주
15747,185750,2021-05-03,0.0611510791366906,139000,130500,-8500,198109,185750.0,종근당보통주
15748,185750,2021-04-29,0.0410958904109589,146000,140000,-6000,157437,185750.0,종근당보통주
15749,185750,2021-04-28,0.046594982078853,139500,146000,6500,873035,185750.0,종근당보통주
15750,185750,2021-04-21,0.0606060606060606,148500,139500,-9000,576461,185750.0,종근당보통주
15751,185750,2021-03-25,0.0460992907801418,141000,134500,-6500,373851,185750.0,종근당보통주
15752,185750,2021-03-23,0.0592105263157894,152000,143000,-9000,347257,185750.0,종근당보통주
15753,185750,2021-03-18,0.2025641025641025,195000,155500,-39500,1294834,185750.0,종근당보통주
15754,185750,2021-03-17,0.1641791044776119,167500,195000,27500,2429331,185750.0,종근당보통주
15755,185750,2021-03-16,0.0534591194968553,159000,167500,8500,255463,185750.0,종근당보통주
15756,185750,2021-03-09,0.0697674418604651,172000,160000,-12000,288901,185750.0,종근당보통주
15757,185750,2021-03-08,0.0899470899470899,189000,172000,-17000,451947,185750.0,종근당보통주
15758,185750,2021-03-04,0.0659025787965616,174500,186000,11500,439876,185750.0,종근당보통주
15759,185750,2021-02-24,0.0459770114942528,174000,166000,-8000,178192,185750.0,종근당보통주
15760,185750,2021-02-23,0.0465753424657534,182500,174000,-8500,125897,185750.0,종근당보통주
15761,185750,2021-02-19,0.0412087912087912,182000,189500,7500,154830,185750.0,종근당보통주
15762,185750,2021-02-17,0.0421052631578947,190000,182000,-8000,122123,185750.0,종근당보통주
15763,185750,2021-02-04,0.0428954423592493,186500,178500,-8000,200494,185750.0,종근당보통주
15764,185750,2021-01-29,0.0613810741687979,195500,183500,-12000,273594,185750.0,종근당보통주
15765,185750,2021-01-28,0.0555555555555555,207000,195500,-11500,207543,185750.0,종근당보통주
15766,185750,2021-01-21,0.0401002506265664,199500,207500,8000,242392,185750.0,종근당보통주
15767,185750,2021-01-18,0.0546318289786223,210500,199000,-11500,305616,185750.0,종근당보통주
15768,185750,2021-01-15,0.0787746170678337,228500,210500,-18000,599971,185750.0,종근당보통주
15769,185750,2021-01-14,0.128395061728395,202500,228500,26000,3046540,185750.0,종근당보통주
15770,185750,2021-01-11,0.0433789954337899,219000,209500,-9500,245894,185750.0,종근당보통주
15771,185750,2021-01-08,0.0478260869565217,230000,219000,-11000,274929,185750.0,종근당보통주
15772,185750,2020-12-30,0.046189376443418,216500,226500,10000,1296036,185750.0,종근당보통주
15773,185750,2020-12-29,0.0437788018433179,217000,216500,-500,274469,185750.0,종근당보통주
15774,185750,2020-12-28,0.0482456140350877,228000,217000,-11000,377724,185750.0,종근당보통주
15775,185750,2020-12-23,0.0857142857142857,245000,224000,-21000,785661,185750.0,종근당보통주
15776,185750,2020-12-22,0.0613026819923371,261000,245000,-16000,813404,185750.0,종근당보통주
15777,185750,2020-12-21,0.0718685831622176,243500,261000,17500,3588462,185750.0,종근당보통주
15778,185750,2020-12-18,0.2583979328165374,193500,243500,50000,3603607,185750.0,종근당보통주
15779,185750,2020-12-17,0.0516304347826086,184000,193500,9500,349933,185750.0,종근당보통주
15780,185750,2020-12-14,0.0566572237960339,176500,186500,10000,1107072,185750.0,종근당보통주
15781,185750,2020-12-08,0.0618279569892473,186000,174500,-11500,213715,185750.0,종근당보통주
15782,185750,2020-12-07,0.0478873239436619,177500,186000,8500,812977,185750.0,종근당보통주
15783,185750,2020-12-04,0.0441176470588235,170000,177500,7500,259487,185750.0,종근당보통주
15784,185750,2020-11-30,0.0609756097560975,164000,174000,10000,1525305,185750.0,종근당보통주
15785,185750,2020-11-24,0.0470588235294117,170000,162000,-8000,285271,185750.0,종근당보통주
15786,185750,2020-11-23,0.1029023746701846,189500,170000,-19500,590295,185750.0,종근당보통주
15787,185750,2020-11-20,0.1770186335403726,161000,189500,28500,2970156,185750.0,종근당보통주
15788,185750,2020-11-03,0.0969899665551839,149500,164000,14500,154540,185750.0,종근당보통주
15789,185750,2020-10-30,0.040880503144654,159000,152500,-6500,77891,185750.0,종근당보통주
15790,185750,2020-10-27,0.04375,160000,153000,-7000,67973,185750.0,종근당보통주
15791,185750,2020-10-12,0.043859649122807,171000,178500,7500,117004,185750.0,종근당보통주
15792,185750,2020-09-22,0.0547550432276657,173500,164000,-9500,136884,185750.0,종근당보통주
15793,185750,2020-09-21,0.0467032967032967,182000,173500,-8500,96593,185750.0,종근당보통주
15794,185750,2020-09-01,0.0412371134020618,194000,186000,-8000,559121,185750.0,종근당보통주
15795,185750,2020-08-31,0.0601092896174863,183000,194000,11000,773872,185750.0,종근당보통주
15796,185750,2020-08-26,0.0437017994858611,194500,186000,-8500,198868,185750.0,종근당보통주
15797,185750,2020-08-24,0.052896725440806,198500,188000,-10500,244541,185750.0,종근당보통주
15798,185750,2020-08-21,0.0570071258907363,210500,198500,-12000,399266,185750.0,종근당보통주
15799,185750,2020-08-20,0.0794871794871794,195000,210500,15500,1195147,185750.0,종근당보통주
15800,185750,2020-08-19,0.0985915492957746,177500,195000,17500,359391,185750.0,종근당보통주
15801,185750,2020-08-14,0.0617647058823529,170000,180500,10500,377848,185750.0,종근당보통주
15802,185750,2020-08-12,0.0572207084468664,183500,173000,-10500,251005,185750.0,종근당보통주
15803,185750,2020-08-06,0.0592783505154639,194000,182500,-11500,695560,185750.0,종근당보통주
15804,185750,2020-08-05,0.0777777777777777,180000,194000,14000,4980715,185750.0,종근당보통주
15805,185750,2020-08-04,0.2996389891696751,138500,180000,41500,2165681,185750.0,종근당보통주
15806,185750,2020-07-23,0.0627450980392156,127500,135500,8000,331126,185750.0,종근당보통주
15807,185750,2020-07-16,0.0438247011952191,125500,120000,-5500,79527,185750.0,종근당보통주
15808,185750,2020-07-13,0.0401606425702811,124500,129500,5000,112491,185750.0,종근당보통주
15809,185750,2020-07-10,0.050632911392405,118500,124500,6000,156541,185750.0,종근당보통주
15810,185750,2020-07-06,0.0486725663716814,113000,118500,5500,113029,185750.0,종근당보통주
15811,185750,2020-06-19,0.0674603174603174,126000,117500,-8500,288747,185750.0,종근당보통주
15812,185750,2020-06-18,0.1,140000,126000,-14000,788123,185750.0,종근당보통주
15813,185750,2020-06-17,0.1914893617021276,117500,140000,22500,356296,185750.0,종근당보통주
15814,185750,2020-06-16,0.0779816513761468,109000,117500,8500,263206,185750.0,종근당보통주
15815,185750,2020-06-15,0.0603448275862069,116000,109000,-7000,175754,185750.0,종근당보통주
15816,185750,2020-06-12,0.0403587443946188,111500,116000,4500,163644,185750.0,종근당보통주
15817,185750,2020-06-09,0.107754279959718,99300,110000,10700,355753,185750.0,종근당보통주
15818,185750,2020-04-07,0.0406976744186046,86000,89500,3500,63624,185750.0,종근당보통주
15819,185750,2020-04-06,0.0513447432762836,81800,86000,4200,37869,185750.0,종근당보통주
15820,185750,2020-04-01,0.0435294117647058,85000,81300,-3700,66251,185750.0,종근당보통주
15821,185750,2020-03-31,0.1273209549071618,75400,85000,9600,80861,185750.0,종근당보통주
15822,185750,2020-03-25,0.0579494799405646,67300,71200,3900,77922,185750.0,종근당보통주
15823,185750,2020-03-24,0.097879282218597,61300,67300,6000,63559,185750.0,종근당보통주
15824,185750,2020-03-23,0.0598159509202454,65200,61300,-3900,63929,185750.0,종근당보통주
15825,185750,2020-03-19,0.1098748261474269,71900,64000,-7900,75245,185750.0,종근당보통주
15826,185750,2020-03-16,0.040764331210191,78500,75300,-3200,51450,185750.0,종근당보통주
15827,185750,2020-02-11,0.0408602150537634,93000,96800,3800,38386,185750.0,종근당보통주
15828,185750,2019-12-23,0.0588235294117647,91800,97200,5400,52115,185750.0,종근당보통주
15829,185750,2019-10-31,0.0447598253275109,91600,95700,4100,62667,185750.0,종근당보통주
15830,185750,2019-08-05,0.0578034682080924,86500,81500,-5000,30234,185750.0,종근당보통주
15831,185750,2019-07-19,0.0535714285714285,89600,94400,4800,39809,185750.0,종근당보통주
15832,185750,2019-06-18,0.05,92000,96600,4600,47506,185750.0,종근당보통주
15833,185750,2018-12-05,0.0424528301886792,106000,110500,4500,55101,185750.0,종근당보통주
15834,185750,2018-11-02,0.0437284234752589,86900,90700,3800,34790,185750.0,종근당보통주
15835,185750,2018-10-11,0.0455445544554455,101000,96400,-4600,49385,185750.0,종근당보통주
15836,185750,2018-10-10,0.0471698113207547,106000,101000,-5000,51307,185750.0,종근당보통주
15837,185750,2018-07-31,0.0773195876288659,97000,104500,7500,88326,185750.0,종근당보통주
15838,185750,2018-07-04,0.0456852791878172,98500,103000,4500,38977,185750.0,종근당보통주
15839,185750,2018-05-30,0.0504587155963302,109000,103500,-5500,105400,185750.0,종근당보통주
15840,185750,2018-04-23,0.044,125000,119500,-5500,86423,185750.0,종근당보통주
15841,185750,2018-04-10,0.0454545454545454,132000,138000,6000,111408,185750.0,종근당보통주
15842,185750,2018-03-23,0.0509803921568627,127500,121000,-6500,54019,185750.0,종근당보통주
15843,185750,2018-02-28,0.0512820512820512,136500,129500,-7000,54057,185750.0,종근당보통주
15844,185750,2018-02-06,0.0436363636363636,137500,131500,-6000,101053,185750.0,종근당보통주
15845,185750,2018-01-25,0.0442176870748299,147000,153500,6500,79565,185750.0,종근당보통주
15846,185750,2018-01-05,0.0451127819548872,133000,139000,6000,34748,185750.0,종근당보통주
15847,185750,2018-01-04,0.0431654676258992,139000,133000,-6000,35143,185750.0,종근당보통주
15848,185750,2017-12-22,0.0581395348837209,129000,136500,7500,51259,185750.0,종근당보통주
15849,185750,2017-12-11,0.0441767068273092,124500,130000,5500,31982,185750.0,종근당보통주
15850,185750,2017-12-05,0.0472727272727272,137500,131000,-6500,53091,185750.0,종근당보통주
15851,185750,2017-11-22,0.0795847750865051,144500,133000,-11500,183112,185750.0,종근당보통주
15852,185750,2017-11-20,0.0641509433962264,132500,141000,8500,106737,185750.0,종근당보통주
15853,185750,2017-11-03,0.0488888888888888,112500,118000,5500,94343,185750.0,종근당보통주
15854,185750,2017-06-05,0.0450819672131147,122000,127500,5500,130485,185750.0,종근당보통주
15855,185750,2017-05-08,0.0466101694915254,118000,123500,5500,132204,185750.0,종근당보통주
15856,185750,2017-04-03,0.0497737556561085,110500,116000,5500,158954,185750.0,종근당보통주
15857,185750,2017-03-24,0.0434782608695652,103500,108000,4500,65256,185750.0,종근당보통주
15858,185750,2017-02-17,0.0518867924528301,106000,111500,5500,216724,185750.0,종근당보통주
15859,185750,2017-02-15,0.0492610837438423,101500,106500,5000,91326,185750.0,종근당보통주
15860,185750,2016-12-13,0.090146750524109,95400,104000,8600,161383,185750.0,종근당보통주
15861,185750,2016-11-10,0.1201298701298701,92400,103500,11100,194934,185750.0,종근당보통주
15862,185750,2016-11-02,0.0448851774530271,95800,91500,-4300,69321,185750.0,종근당보통주
15863,185750,2016-10-28,0.0443037974683544,94800,90600,-4200,67684,185750.0,종근당보통주
15864,185750,2016-09-30,0.0648148148148148,108000,101000,-7000,168232,185750.0,종근당보통주
15865,185750,2016-09-23,0.0631895687061183,99700,106000,6300,113325,185750.0,종근당보통주
15866,185750,2016-09-20,0.0748373101952277,92200,99100,6900,129329,185750.0,종근당보통주
15867,192080,2021-04-09,0.0845070422535211,63900,69300,5400,1560141,192080.0,더블유게임즈보통주
15868,192080,2021-03-23,0.1038062283737024,57800,63800,6000,2265892,192080.0,더블유게임즈보통주
15869,192080,2021-03-12,0.0473484848484848,52800,55300,2500,82584,192080.0,더블유게임즈보통주
15870,192080,2021-01-28,0.0451713395638629,64200,61300,-2900,172274,192080.0,더블유게임즈보통주
15871,192080,2020-12-18,0.0403361344537815,59500,61900,2400,402323,192080.0,더블유게임즈보통주
15872,192080,2020-12-03,0.0400696864111498,57400,59700,2300,226240,192080.0,더블유게임즈보통주
15873,192080,2020-11-17,0.0405186385737439,61700,59200,-2500,173892,192080.0,더블유게임즈보통주
15874,192080,2020-11-10,0.0448222565687789,64700,61800,-2900,177144,192080.0,더블유게임즈보통주
15875,192080,2020-11-03,0.048780487804878,61500,64500,3000,94281,192080.0,더블유게임즈보통주
15876,192080,2020-09-24,0.0407358738501971,76100,73000,-3100,184474,192080.0,더블유게임즈보통주
15877,192080,2020-09-22,0.0426065162907268,79800,76400,-3400,204733,192080.0,더블유게임즈보통주
15878,192080,2020-08-20,0.0605263157894736,76000,71400,-4600,219701,192080.0,더블유게임즈보통주
15879,192080,2020-08-04,0.0513833992094861,75900,79800,3900,333695,192080.0,더블유게임즈보통주
15880,192080,2020-07-24,0.0560109289617486,73200,77300,4100,440432,192080.0,더블유게임즈보통주
15881,192080,2020-07-23,0.0406290956749672,76300,73200,-3100,331765,192080.0,더블유게임즈보통주
15882,192080,2020-07-16,0.0480404551201011,79100,75300,-3800,301044,192080.0,더블유게임즈보통주
15883,192080,2020-07-07,0.0489690721649484,77600,81400,3800,466098,192080.0,더블유게임즈보통주
15884,192080,2020-07-06,0.074792243767313,72200,77600,5400,498369,192080.0,더블유게임즈보통주
15885,192080,2020-07-02,0.0533854166666666,76800,72700,-4100,1716872,192080.0,더블유게임즈보통주
15886,192080,2020-06-30,0.0541611624834874,75700,79800,4100,272045,192080.0,더블유게임즈보통주
15887,192080,2020-06-25,0.0452876376988984,81700,78000,-3700,358758,192080.0,더블유게임즈보통주
15888,192080,2020-06-23,0.06266318537859,76600,81400,4800,518805,192080.0,더블유게임즈보통주
15889,192080,2020-06-16,0.0847222222222222,72000,78100,6100,385484,192080.0,더블유게임즈보통주
15890,192080,2020-06-15,0.0412782956058588,75100,72000,-3100,578828,192080.0,더블유게임즈보통주
15891,192080,2020-06-10,0.0436681222707423,68700,71700,3000,477614,192080.0,더블유게임즈보통주
15892,192080,2020-06-08,0.0451010886469673,64300,67200,2900,299482,192080.0,더블유게임즈보통주
15893,192080,2020-06-03,0.0431547619047619,67200,64300,-2900,528635,192080.0,더블유게임즈보통주
15894,192080,2020-05-20,0.0511182108626198,62600,65800,3200,273671,192080.0,더블유게임즈보통주
15895,192080,2020-05-11,0.0449438202247191,62300,65100,2800,319466,192080.0,더블유게임즈보통주
15896,192080,2020-05-07,0.0447504302925989,58100,60700,2600,599973,192080.0,더블유게임즈보통주
15897,192080,2020-04-28,0.0622710622710622,54600,58000,3400,322357,192080.0,더블유게임즈보통주
15898,192080,2020-04-14,0.0808510638297872,47000,50800,3800,369150,192080.0,더블유게임즈보통주
15899,192080,2020-04-13,0.0505050505050505,49500,47000,-2500,285475,192080.0,더블유게임즈보통주
15900,192080,2020-04-10,0.0531914893617021,47000,49500,2500,449453,192080.0,더블유게임즈보통주
15901,192080,2020-04-07,0.0533333333333333,52500,49700,-2800,377769,192080.0,더블유게임즈보통주
15902,192080,2020-04-02,0.0582120582120582,48100,50900,2800,453073,192080.0,더블유게임즈보통주
15903,192080,2020-04-01,0.108294930875576,43400,48100,4700,1177054,192080.0,더블유게임즈보통주
15904,192080,2020-03-25,0.0426908150064683,38650,40300,1650,201128,192080.0,더블유게임즈보통주
15905,192080,2020-03-23,0.0534351145038167,39300,37200,-2100,109928,192080.0,더블유게임즈보통주
15906,192080,2020-03-20,0.0410596026490066,37750,39300,1550,113861,192080.0,더블유게임즈보통주
15907,192080,2020-03-17,0.0426666666666666,37500,39100,1600,154952,192080.0,더블유게임즈보통주
15908,192080,2020-03-16,0.0694789081885856,40300,37500,-2800,283236,192080.0,더블유게임즈보통주
15909,192080,2020-03-13,0.0627906976744186,43000,40300,-2700,315351,192080.0,더블유게임즈보통주
15910,192080,2020-03-12,0.0444444444444444,45000,43000,-2000,229674,192080.0,더블유게임즈보통주
15911,192080,2020-03-06,0.0505747126436781,43500,45700,2200,169789,192080.0,더블유게임즈보통주
15912,192080,2020-02-28,0.0605714285714285,43750,41100,-2650,127907,192080.0,더블유게임즈보통주
15913,192080,2020-02-24,0.0470974808324205,45650,43500,-2150,107431,192080.0,더블유게임즈보통주
15914,192080,2020-02-06,0.0444915254237288,47200,49300,2100,93328,192080.0,더블유게임즈보통주
15915,192080,2020-01-13,0.0448343079922027,51300,53600,2300,112955,192080.0,더블유게임즈보통주
15916,192080,2019-11-01,0.0416666666666666,48000,50000,2000,125760,192080.0,더블유게임즈보통주
15917,192080,2019-09-10,0.0434782608695652,55200,57600,2400,67596,192080.0,더블유게임즈보통주
15918,192080,2019-08-19,0.0417457305502846,52700,54900,2200,52305,192080.0,더블유게임즈보통주
15919,192080,2019-08-08,0.0462107208872458,54100,56600,2500,74899,192080.0,더블유게임즈보통주
15920,192080,2019-08-05,0.0607142857142857,56000,52600,-3400,127390,192080.0,더블유게임즈보통주
15921,192080,2019-06-14,0.0482654600301659,66300,63100,-3200,245248,192080.0,더블유게임즈보통주
15922,192080,2019-04-24,0.1170046801872074,64100,71600,7500,817040,192080.0,더블유게임즈보통주
15923,192080,2019-03-08,0.0420560747663551,64200,61500,-2700,253985,192080.0,더블유게임즈보통주
15924,192080,2019-01-29,0.0485074626865671,53600,56200,2600,191014,192080.0,더블유게임즈보통주
15925,192080,2019-01-02,0.0451505016722408,59800,57100,-2700,87586,192080.0,더블유게임즈보통주
15926,192080,2018-12-19,0.0709219858156028,56400,60400,4000,111495,192080.0,더블유게임즈보통주
15927,192080,2018-12-10,0.0500834724540901,59900,56900,-3000,98652,192080.0,더블유게임즈보통주
15928,192080,2018-11-27,0.0485762144053601,59700,62600,2900,125381,192080.0,더블유게임즈보통주
15929,192080,2018-10-24,0.0468965517241379,72500,69100,-3400,131816,192080.0,더블유게임즈보통주
15930,192080,2018-10-12,0.0577507598784194,65800,69600,3800,107474,192080.0,더블유게임즈보통주
15931,192080,2018-10-11,0.0491329479768786,69200,65800,-3400,127045,192080.0,더블유게임즈보통주
15932,192080,2018-09-18,0.0597243491577335,65300,69200,3900,150537,192080.0,더블유게임즈보통주
15933,192080,2018-08-14,0.0434782608695652,64400,67200,2800,292875,192080.0,더블유게임즈보통주
15934,192080,2018-08-10,0.098471986417657,58900,64700,5800,594641,192080.0,더블유게임즈보통주
15935,192080,2018-08-09,0.0670289855072463,55200,58900,3700,497536,192080.0,더블유게임즈보통주
15936,192080,2018-07-23,0.0561224489795918,58800,55500,-3300,91980,192080.0,더블유게임즈보통주
15937,192080,2018-07-13,0.0497427101200686,58300,61200,2900,212607,192080.0,더블유게임즈보통주
15938,192080,2018-07-12,0.1,53000,58300,5300,164545,192080.0,더블유게임즈보통주
15939,192080,2018-07-02,0.0409683426443202,53700,51500,-2200,47176,192080.0,더블유게임즈보통주
15940,192080,2018-05-09,0.0431778929188255,57900,60400,2500,106274,192080.0,더블유게임즈보통주
15941,192080,2018-05-02,0.04,62500,60000,-2500,193202,192080.0,더블유게임즈보통주
15942,192080,2018-04-17,0.047457627118644,59000,61800,2800,222080,192080.0,더블유게임즈보통주
15943,192080,2018-04-13,0.0936507936507936,63000,57100,-5900,480462,192080.0,더블유게임즈보통주
15944,192080,2018-04-04,0.0661971830985915,71000,66300,-4700,260649,192080.0,더블유게임즈보통주
15945,192080,2018-03-09,0.0482115085536547,64300,67400,3100,254074,192080.0,더블유게임즈보통주
15946,192080,2018-03-06,0.0584415584415584,61600,65200,3600,269978,192080.0,더블유게임즈보통주
15947,192080,2018-02-12,0.0411663807890223,58300,60700,2400,118006,192080.0,더블유게임즈보통주
15948,192080,2018-02-09,0.0426929392446633,60900,58300,-2600,149727,192080.0,더블유게임즈보통주
15949,192080,2017-11-17,0.0494037478705281,58700,55800,-2900,234874,192080.0,더블유게임즈보통주
15950,192080,2017-11-15,0.0417422867513611,55100,57400,2300,390268,192080.0,더블유게임즈보통주
15951,192080,2017-11-13,0.0420650095602294,52300,54500,2200,258980,192080.0,더블유게임즈보통주
15952,192080,2017-11-07,0.0597539543057996,56900,53500,-3400,496831,192080.0,더블유게임즈보통주
15953,192080,2017-11-06,0.0984555984555984,51800,56900,5100,315820,192080.0,더블유게임즈보통주
15954,192080,2017-11-01,0.0623781676413255,51300,54500,3200,254900,192080.0,더블유게임즈보통주
15955,192080,2017-10-10,0.0424778761061946,56500,54100,-2400,78920,192080.0,더블유게임즈보통주
15956,192080,2017-09-27,0.0686274509803921,51000,54500,3500,167385,192080.0,더블유게임즈보통주
15957,192080,2017-09-25,0.0533333333333333,52500,49700,-2800,246222,192080.0,더블유게임즈보통주
15958,192080,2017-09-22,0.0757042253521126,56800,52500,-4300,242165,192080.0,더블유게임즈보통주
15959,192080,2017-09-15,0.07439446366782,57800,62100,4300,318014,192080.0,더블유게임즈보통주
15960,192080,2017-09-13,0.0418181818181818,55000,57300,2300,102597,192080.0,더블유게임즈보통주
15961,192080,2017-08-04,0.077175697865353,60900,56200,-4700,332352,192080.0,더블유게임즈보통주
15962,192080,2017-08-03,0.0484375,64000,60900,-3100,112991,192080.0,더블유게임즈보통주
15963,192080,2017-07-20,0.0482315112540192,62200,65200,3000,290956,192080.0,더블유게임즈보통주
15964,192080,2017-07-10,0.0419254658385093,64400,61700,-2700,143947,192080.0,더블유게임즈보통주
15965,192080,2017-07-05,0.0422535211267605,63900,66600,2700,434803,192080.0,더블유게임즈보통주
15966,192080,2017-06-19,0.0577557755775577,60600,64100,3500,543237,192080.0,더블유게임즈보통주
15967,192080,2017-06-07,0.0531914893617021,56400,59400,3000,955042,192080.0,더블유게임즈보통주
15968,192080,2017-05-08,0.0425894378194207,58700,56200,-2500,376695,192080.0,더블유게임즈보통주
15969,192080,2017-05-04,0.0850277264325323,54100,58700,4600,526689,192080.0,더블유게임즈보통주
15970,192080,2017-04-19,0.0700757575757575,52800,56500,3700,3489377,192080.0,더블유게임즈보통주
15971,192080,2017-04-18,0.2988929889298893,40650,52800,12150,1687686,192080.0,더블유게임즈보통주
15972,192080,2017-02-21,0.0603337612323491,38950,41300,2350,256106,192080.0,더블유게임즈보통주
15973,192080,2016-12-27,0.0634278002699055,37050,39400,2350,232267,192080.0,더블유게임즈보통주
15974,192080,2016-12-21,0.0427236315086782,37450,39050,1600,401304,192080.0,더블유게임즈보통주
15975,192080,2016-11-10,0.0415335463258785,31300,32600,1300,45644,192080.0,더블유게임즈보통주
15976,192080,2016-11-02,0.0959666203059805,35950,32500,-3450,251381,192080.0,더블유게임즈보통주
15977,192080,2016-08-05,0.0430809399477806,38300,39950,1650,232897,192080.0,더블유게임즈보통주
15978,192820,2021-06-02,0.0436507936507936,126000,131500,5500,153089,192820.0,코스맥스보통주
15979,192820,2021-05-26,0.0598290598290598,117000,124000,7000,166586,192820.0,코스맥스보통주
15980,192820,2021-05-03,0.0411522633744856,121500,116500,-5000,158798,192820.0,코스맥스보통주
15981,192820,2021-04-29,0.0538116591928251,111500,117500,6000,330953,192820.0,코스맥스보통주
15982,192820,2021-04-28,0.0590717299578059,118500,111500,-7000,504478,192820.0,코스맥스보통주
15983,192820,2021-04-27,0.1156716417910447,134000,118500,-15500,672458,192820.0,코스맥스보통주
15984,192820,2021-04-20,0.0415094339622641,132500,138000,5500,195752,192820.0,코스맥스보통주
15985,192820,2021-04-16,0.0693877551020408,122500,131000,8500,446529,192820.0,코스맥스보통주
15986,192820,2021-03-12,0.0538116591928251,111500,117500,6000,174233,192820.0,코스맥스보통주
15987,192820,2021-03-08,0.047008547008547,117000,111500,-5500,161533,192820.0,코스맥스보통주
15988,192820,2021-03-03,0.0761904761904762,105000,113000,8000,506847,192820.0,코스맥스보통주
15989,192820,2021-02-24,0.0465116279069767,107500,102500,-5000,133431,192820.0,코스맥스보통주
15990,192820,2021-02-18,0.0610328638497652,106500,113000,6500,514945,192820.0,코스맥스보통주
15991,192820,2021-01-29,0.041860465116279,107500,103000,-4500,203059,192820.0,코스맥스보통주
15992,192820,2021-01-22,0.0886699507389162,101500,110500,9000,711088,192820.0,코스맥스보통주
15993,192820,2021-01-14,0.0405827263267429,96100,100000,3900,246651,192820.0,코스맥스보통주
15994,192820,2020-12-09,0.0435244161358811,94200,98300,4100,226010,192820.0,코스맥스보통주
15995,192820,2020-11-16,0.0945945945945946,111000,100500,-10500,485574,192820.0,코스맥스보통주
15996,192820,2020-11-09,0.0509259259259259,108000,113500,5500,147872,192820.0,코스맥스보통주
15997,192820,2020-11-05,0.0490196078431372,102000,107000,5000,151385,192820.0,코스맥스보통주
15998,192820,2020-11-04,0.0511627906976744,107500,102000,-5500,467549,192820.0,코스맥스보통주
15999,192820,2020-10-30,0.0666666666666666,112500,105000,-7500,124155,192820.0,코스맥스보통주
16000,192820,2020-10-26,0.0502092050209205,119500,113500,-6000,88843,192820.0,코스맥스보통주
16001,192820,2020-10-12,0.0862068965517241,116000,126000,10000,299879,192820.0,코스맥스보통주
16002,192820,2020-09-29,0.0497737556561085,110500,116000,5500,182704,192820.0,코스맥스보통주
16003,192820,2020-09-25,0.0541871921182266,101500,107000,5500,114867,192820.0,코스맥스보통주
16004,192820,2020-09-22,0.0547945205479452,109500,103500,-6000,121943,192820.0,코스맥스보통주
16005,192820,2020-09-21,0.0528846153846153,104000,109500,5500,276614,192820.0,코스맥스보통주
16006,192820,2020-09-01,0.0539215686274509,102000,107500,5500,168564,192820.0,코스맥스보통주
16007,192820,2020-08-20,0.0542986425339366,110500,104500,-6000,284860,192820.0,코스맥스보통주
16008,192820,2020-08-14,0.1386138613861386,101000,115000,14000,993196,192820.0,코스맥스보통주
16009,192820,2020-08-12,0.0559741657696447,92900,98100,5200,319910,192820.0,코스맥스보통주
16010,192820,2020-07-15,0.081081081081081,99900,91800,-8100,377829,192820.0,코스맥스보통주
16011,192820,2020-07-13,0.0460732984293193,95500,99900,4400,123416,192820.0,코스맥스보통주
16012,192820,2020-06-16,0.0510083036773428,84300,88600,4300,80554,192820.0,코스맥스보통주
16013,192820,2020-06-15,0.065410199556541,90200,84300,-5900,112285,192820.0,코스맥스보통주
16014,192820,2020-05-25,0.0435267857142857,89600,93500,3900,186601,192820.0,코스맥스보통주
16015,192820,2020-05-22,0.044776119402985,93800,89600,-4200,185578,192820.0,코스맥스보통주
16016,192820,2020-05-15,0.0417582417582417,91000,94800,3800,416061,192820.0,코스맥스보통주
16017,192820,2020-05-14,0.0950661853188929,83100,91000,7900,386807,192820.0,코스맥스보통주
16018,192820,2020-04-27,0.0481786133960047,85100,89200,4100,158679,192820.0,코스맥스보통주
16019,192820,2020-04-06,0.0468557336621455,81100,84900,3800,187348,192820.0,코스맥스보통주
16020,192820,2020-04-02,0.0490716180371352,75400,79100,3700,122271,192820.0,코스맥스보통주
16021,192820,2020-03-31,0.0637720488466757,73700,78400,4700,224099,192820.0,코스맥스보통주
16022,192820,2020-03-30,0.0409604519774011,70800,73700,2900,143485,192820.0,코스맥스보통주
16023,192820,2020-03-25,0.0852713178294573,64500,70000,5500,264320,192820.0,코스맥스보통주
16024,192820,2020-03-24,0.0626029654036243,60700,64500,3800,172103,192820.0,코스맥스보통주
16025,192820,2020-03-23,0.0844645550527903,66300,60700,-5600,141310,192820.0,코스맥스보통주
16026,192820,2020-03-19,0.0480349344978165,68700,65400,-3300,192323,192820.0,코스맥스보통주
16027,192820,2020-03-17,0.0575757575757575,66000,69800,3800,147778,192820.0,코스맥스보통주
16028,192820,2020-03-12,0.081190798376184,73900,67900,-6000,260402,192820.0,코스맥스보통주
16029,192820,2020-03-11,0.0609911054637865,78700,73900,-4800,180581,192820.0,코스맥스보통주
16030,192820,2020-03-04,0.05,80000,84000,4000,195007,192820.0,코스맥스보통주
16031,192820,2020-03-02,0.0745672436750998,75100,80700,5600,154623,192820.0,코스맥스보통주
16032,192820,2020-02-28,0.043312101910828,78500,75100,-3400,138215,192820.0,코스맥스보통주
16033,192820,2020-02-21,0.0508940852819807,72700,76400,3700,548397,192820.0,코스맥스보통주
16034,192820,2020-01-28,0.0867970660146699,81800,74700,-7100,289476,192820.0,코스맥스보통주
16035,192820,2020-01-23,0.0421545667447306,85400,81800,-3600,171328,192820.0,코스맥스보통주
16036,192820,2020-01-13,0.0532687651331719,82600,87000,4400,418187,192820.0,코스맥스보통주
16037,192820,2020-01-07,0.049618320610687,78600,82500,3900,206729,192820.0,코스맥스보통주
16038,192820,2020-01-02,0.048811013767209,79900,83800,3900,123691,192820.0,코스맥스보통주
16039,192820,2019-11-14,0.0600750938673341,79900,75100,-4800,383880,192820.0,코스맥스보통주
16040,192820,2019-11-06,0.0558252427184466,82400,87000,4600,347174,192820.0,코스맥스보통주
16041,192820,2019-10-31,0.0653333333333333,75000,79900,4900,547181,192820.0,코스맥스보통주
16042,192820,2019-10-30,0.0460251046025104,71700,75000,3300,188835,192820.0,코스맥스보통주
16043,192820,2019-10-04,0.0486486486486486,74000,70400,-3600,211312,192820.0,코스맥스보통주
16044,192820,2019-08-13,0.0416107382550335,74500,71400,-3100,674558,192820.0,코스맥스보통주
16045,192820,2019-08-12,0.1971982758620689,92800,74500,-18300,1104412,192820.0,코스맥스보통주
16046,192820,2019-08-08,0.0661345496009122,87700,93500,5800,122572,192820.0,코스맥스보통주
16047,192820,2019-08-05,0.0610376398779247,98300,92300,-6000,125779,192820.0,코스맥스보통주
16048,192820,2019-07-25,0.0616784630940343,98900,105000,6100,254577,192820.0,코스맥스보통주
16049,192820,2019-05-13,0.05078125,128000,121500,-6500,112261,192820.0,코스맥스보통주
16050,192820,2019-05-09,0.0416666666666666,132000,126500,-5500,65461,192820.0,코스맥스보통주
16051,192820,2019-03-18,0.0542372881355932,147500,155500,8000,110978,192820.0,코스맥스보통주
16052,192820,2019-02-15,0.0881226053639846,130500,142000,11500,301741,192820.0,코스맥스보통주
16053,192820,2018-12-27,0.0491803278688524,122000,128000,6000,71671,192820.0,코스맥스보통주
16054,192820,2018-12-12,0.046875,128000,134000,6000,71479,192820.0,코스맥스보통주
16055,192820,2018-11-29,0.0421052631578947,142500,136500,-6000,108957,192820.0,코스맥스보통주
16056,192820,2018-11-19,0.0428015564202334,128500,134000,5500,105887,192820.0,코스맥스보통주
16057,192820,2018-11-15,0.1515151515151515,115500,133000,17500,262811,192820.0,코스맥스보통주
16058,192820,2018-11-09,0.0553359683794466,126500,119500,-7000,174127,192820.0,코스맥스보통주
16059,192820,2018-11-08,0.0497925311203319,120500,126500,6000,210507,192820.0,코스맥스보통주
16060,192820,2018-10-30,0.0601851851851851,108000,114500,6500,150974,192820.0,코스맥스보통주
16061,192820,2018-10-29,0.0729613733905579,116500,108000,-8500,225948,192820.0,코스맥스보통주
16062,192820,2018-10-26,0.0450819672131147,122000,116500,-5500,178445,192820.0,코스맥스보통주
16063,192820,2018-10-25,0.0505836575875486,128500,122000,-6500,167608,192820.0,코스맥스보통주
16064,192820,2018-10-12,0.0483271375464684,134500,141000,6500,132255,192820.0,코스맥스보통주
16065,192820,2018-10-10,0.0668896321070234,149500,139500,-10000,170244,192820.0,코스맥스보통주
16066,192820,2018-10-04,0.0773993808049535,161500,149000,-12500,216204,192820.0,코스맥스보통주
16067,192820,2018-09-21,0.0419354838709677,155000,148500,-6500,107895,192820.0,코스맥스보통주
16068,192820,2018-08-21,0.0472727272727272,137500,144000,6500,108682,192820.0,코스맥스보통주
16069,192820,2018-08-13,0.0459363957597173,141500,148000,6500,145807,192820.0,코스맥스보통주
16070,192820,2018-08-01,0.0735294117647058,136000,146000,10000,161664,192820.0,코스맥스보통주
16071,192820,2018-07-17,0.043046357615894,151000,144500,-6500,110497,192820.0,코스맥스보통주
16072,192820,2018-07-06,0.071917808219178,146000,156500,10500,66029,192820.0,코스맥스보통주
16073,192820,2018-06-22,0.0504451038575667,168500,160000,-8500,107254,192820.0,코스맥스보통주
16074,192820,2018-06-05,0.0471976401179941,169500,177500,8000,87327,192820.0,코스맥스보통주
16075,192820,2018-05-11,0.0906148867313915,154500,168500,14000,363717,192820.0,코스맥스보통주
16076,192820,2018-05-03,0.0443037974683544,158000,151000,-7000,87965,192820.0,코스맥스보통주
16077,192820,2018-04-13,0.0582191780821917,146000,154500,8500,195350,192820.0,코스맥스보통주
16078,192820,2018-03-26,0.0416666666666666,132000,137500,5500,64596,192820.0,코스맥스보통주
16079,192820,2018-03-12,0.0416666666666666,132000,137500,5500,212114,192820.0,코스맥스보통주
16080,192820,2018-03-09,0.056,125000,132000,7000,186566,192820.0,코스맥스보통주
16081,192820,2018-03-02,0.04296875,128000,122500,-5500,106583,192820.0,코스맥스보통주
16082,192820,2018-02-19,0.0403225806451612,124000,129000,5000,98433,192820.0,코스맥스보통주
16083,192820,2018-02-14,0.0464135021097046,118500,124000,5500,266291,192820.0,코스맥스보통주
16084,192820,2018-02-07,0.0597609561752988,125500,118000,-7500,137429,192820.0,코스맥스보통주
16085,192820,2018-01-10,0.0413223140495867,121000,126000,5000,237304,192820.0,코스맥스보통주
16086,192820,2017-12-12,0.0433070866141732,127000,121500,-5500,130342,192820.0,코스맥스보통주
16087,192820,2017-11-29,0.048780487804878,123000,129000,6000,232017,192820.0,코스맥스보통주
16088,192820,2017-11-15,0.0450819672131147,122000,116500,-5500,514031,192820.0,코스맥스보통주
16089,192820,2017-11-14,0.0615384615384615,130000,122000,-8000,526810,192820.0,코스맥스보통주
16090,192820,2017-10-13,0.073170731707317,123000,132000,9000,441381,192820.0,코스맥스보통주
16091,192820,2017-09-29,0.0627615062761506,119500,127000,7500,358764,192820.0,코스맥스보통주
16092,192820,2017-09-21,0.045045045045045,111000,116000,5000,167591,192820.0,코스맥스보통주
16093,192820,2017-09-14,0.0521327014218009,105500,111000,5500,103589,192820.0,코스맥스보통주
16094,192820,2017-09-08,0.0468085106382978,117500,112000,-5500,108514,192820.0,코스맥스보통주
16095,192820,2017-08-24,0.0600858369098712,116500,123500,7000,203263,192820.0,코스맥스보통주
16096,192820,2017-08-09,0.0669856459330143,104500,111500,7000,146078,192820.0,코스맥스보통주
16097,192820,2017-07-31,0.0504587155963302,109000,103500,-5500,116628,192820.0,코스맥스보통주
16098,192820,2017-07-10,0.0502283105022831,109500,104000,-5500,185555,192820.0,코스맥스보통주
16099,192820,2017-06-29,0.0625,120000,112500,-7500,201340,192820.0,코스맥스보통주
16100,192820,2017-06-23,0.0530973451327433,113000,119000,6000,142208,192820.0,코스맥스보통주
16101,192820,2017-05-12,0.1735015772870662,158500,131000,-27500,1112171,192820.0,코스맥스보통주
16102,192820,2017-05-04,0.0492957746478873,142000,149000,7000,102942,192820.0,코스맥스보통주
16103,192820,2017-04-13,0.0490566037735849,132500,139000,6500,156447,192820.0,코스맥스보통주
16104,192820,2017-03-24,0.0501930501930501,129500,136000,6500,138648,192820.0,코스맥스보통주
16105,192820,2017-03-02,0.0418118466898954,143500,137500,-6000,142028,192820.0,코스맥스보통주
16106,192820,2017-02-27,0.0404040404040404,148500,142500,-6000,105555,192820.0,코스맥스보통주
16107,192820,2017-02-24,0.0683453237410072,139000,148500,9500,185398,192820.0,코스맥스보통주
16108,192820,2017-02-14,0.0769230769230769,130000,140000,10000,263143,192820.0,코스맥스보통주
16109,192820,2017-01-24,0.0431372549019607,127500,133000,5500,105848,192820.0,코스맥스보통주
16110,192820,2017-01-13,0.0478260869565217,115000,120500,5500,109545,192820.0,코스맥스보통주
16111,192820,2017-01-09,0.0526315789473684,123500,117000,-6500,81389,192820.0,코스맥스보통주
16112,192820,2017-01-02,0.0585774058577405,119500,112500,-7000,68230,192820.0,코스맥스보통주
16113,192820,2016-12-27,0.0481927710843373,124500,118500,-6000,92588,192820.0,코스맥스보통주
16114,192820,2016-12-23,0.0466101694915254,118000,123500,5500,74983,192820.0,코스맥스보통주
16115,192820,2016-12-09,0.0900473933649289,105500,115000,9500,195222,192820.0,코스맥스보통주
16116,192820,2016-11-29,0.0816326530612244,98000,106000,8000,197254,192820.0,코스맥스보통주
16117,192820,2016-11-21,0.0572687224669603,113500,107000,-6500,137680,192820.0,코스맥스보통주
16118,192820,2016-11-18,0.0421940928270042,118500,113500,-5000,122660,192820.0,코스맥스보통주
16119,192820,2016-11-10,0.0622406639004149,120500,128000,7500,105151,192820.0,코스맥스보통주
16120,192820,2016-10-31,0.0414937759336099,120500,115500,-5000,88769,192820.0,코스맥스보통주
16121,192820,2016-10-25,0.0849420849420849,129500,118500,-11000,439024,192820.0,코스맥스보통주
16122,192820,2016-10-24,0.1068965517241379,145000,129500,-15500,453092,192820.0,코스맥스보통주
16123,192820,2016-10-04,0.0693069306930693,151500,162000,10500,210010,192820.0,코스맥스보통주
16124,192820,2016-09-01,0.0409556313993174,146500,152500,6000,72734,192820.0,코스맥스보통주
16125,192820,2016-08-23,0.0638297872340425,141000,150000,9000,113024,192820.0,코스맥스보통주
16126,192820,2016-08-08,0.0823970037453183,133500,144500,11000,177941,192820.0,코스맥스보통주
16127,192820,2016-08-05,0.0464285714285714,140000,133500,-6500,218042,192820.0,코스맥스보통주
16128,204320,2021-05-28,0.0655737704918032,61000,65000,4000,1110519,204320.0,만도보통주
16129,204320,2021-05-20,0.0728083209509658,67300,62400,-4900,1824877,204320.0,만도보통주
16130,204320,2021-05-03,0.0705679862306368,58100,62200,4100,1767218,204320.0,만도보통주
16131,204320,2021-03-30,0.044891640866873,64600,67500,2900,778038,204320.0,만도보통주
16132,204320,2021-03-24,0.0470756062767475,70100,66800,-3300,1676814,204320.0,만도보통주
16133,204320,2021-03-18,0.0511695906432748,68400,71900,3500,1733883,204320.0,만도보통주
16134,204320,2021-03-12,0.0848287112561174,61300,66500,5200,1219412,204320.0,만도보통주
16135,204320,2021-02-24,0.0679468242245199,67700,63100,-4600,901970,204320.0,만도보통주
16136,204320,2021-02-08,0.0748299319727891,73500,68000,-5500,1654045,204320.0,만도보통주
16137,204320,2021-02-04,0.0489335006273525,79700,75800,-3900,2862663,204320.0,만도보통주
16138,204320,2021-02-03,0.1131284916201117,71600,79700,8100,3405569,204320.0,만도보통주
16139,204320,2021-01-29,0.0481430536451169,72700,69200,-3500,1165146,204320.0,만도보통주
16140,204320,2021-01-28,0.0434210526315789,76000,72700,-3300,1030492,204320.0,만도보통주
16141,204320,2021-01-21,0.0709504685408299,74700,80000,5300,1934627,204320.0,만도보통주
16142,204320,2021-01-14,0.0429128738621586,76900,73600,-3300,1386396,204320.0,만도보통주
16143,204320,2021-01-08,0.1432791728212703,67700,77400,9700,5970009,204320.0,만도보통주
16144,204320,2021-01-05,0.0637958532695374,62700,66700,4000,1605512,204320.0,만도보통주
16145,204320,2021-01-04,0.0663265306122449,58800,62700,3900,1446315,204320.0,만도보통주
16146,204320,2020-12-23,0.1007462686567164,53600,59000,5400,4708102,204320.0,만도보통주
16147,204320,2020-12-07,0.0586080586080586,54600,57800,3200,1358502,204320.0,만도보통주
16148,204320,2020-12-02,0.0423892100192678,51900,54100,2200,1546161,204320.0,만도보통주
16149,204320,2020-12-01,0.0701030927835051,48500,51900,3400,1167360,204320.0,만도보통주
16150,204320,2020-11-25,0.0616591928251121,44600,47350,2750,1744298,204320.0,만도보통주
16151,204320,2020-11-13,0.0982800982800982,40700,44700,4000,4044615,204320.0,만도보통주
16152,204320,2020-11-12,0.0476190476190476,38850,40700,1850,1030954,204320.0,만도보통주
16153,204320,2020-11-02,0.0532212885154061,35700,37600,1900,2022863,204320.0,만도보통주
16154,204320,2020-10-22,0.0413105413105413,35100,33650,-1450,520742,204320.0,만도보통주
16155,204320,2020-10-20,0.0437317784256559,34300,35800,1500,1101264,204320.0,만도보통주
16156,204320,2020-10-16,0.0486486486486486,37000,35200,-1800,1082762,204320.0,만도보통주
16157,204320,2020-10-05,0.1023842917251051,35650,39300,3650,2218464,204320.0,만도보통주
16158,204320,2020-09-28,0.0512820512820512,33150,34850,1700,951877,204320.0,만도보통주
16159,204320,2020-09-24,0.0829875518672199,36150,33150,-3000,1802525,204320.0,만도보통주
16160,204320,2020-09-23,0.0478260869565217,34500,36150,1650,1814070,204320.0,만도보통주
16161,204320,2020-09-22,0.0700808625336927,37100,34500,-2600,1499754,204320.0,만도보통주
16162,204320,2020-09-17,0.0659670164917541,33350,35550,2200,3154158,204320.0,만도보통주
16163,204320,2020-09-14,0.1003344481605351,29900,32900,3000,1862684,204320.0,만도보통주
16164,204320,2020-08-31,0.0644067796610169,29500,31400,1900,1519774,204320.0,만도보통주
16165,204320,2020-08-20,0.0535117056856187,29900,28300,-1600,710023,204320.0,만도보통주
16166,204320,2020-08-18,0.0850393700787401,31750,29050,-2700,884724,204320.0,만도보통주
16167,204320,2020-08-10,0.0608974358974358,31200,33100,1900,2300018,204320.0,만도보통주
16168,204320,2020-08-06,0.048780487804878,28700,30100,1400,1322563,204320.0,만도보통주
16169,204320,2020-07-30,0.1380753138075313,23900,27200,3300,4743705,204320.0,만도보통주
16170,204320,2020-06-29,0.043103448275862,23200,22200,-1000,475873,204320.0,만도보통주
16171,204320,2020-06-16,0.0603448275862069,23200,24600,1400,560726,204320.0,만도보통주
16172,204320,2020-06-15,0.0901960784313725,25500,23200,-2300,850666,204320.0,만도보통주
16173,204320,2020-06-12,0.0573012939001848,27050,25500,-1550,966801,204320.0,만도보통주
16174,204320,2020-06-03,0.0408163265306122,26950,28050,1100,1129134,204320.0,만도보통주
16175,204320,2020-05-26,0.0479846449136276,26050,27300,1250,841715,204320.0,만도보통주
16176,204320,2020-05-22,0.0469924812030075,26600,25350,-1250,699663,204320.0,만도보통주
16177,204320,2020-05-19,0.1343283582089552,23450,26600,3150,2334798,204320.0,만도보통주
16178,204320,2020-05-12,0.0418326693227091,25100,24050,-1050,553106,204320.0,만도보통주
16179,204320,2020-05-08,0.0762527233115468,22950,24700,1750,816975,204320.0,만도보통주
16180,204320,2020-04-17,0.0411522633744856,24300,25300,1000,609915,204320.0,만도보통주
16181,204320,2020-04-13,0.0525291828793774,25700,24350,-1350,515665,204320.0,만도보통주
16182,204320,2020-04-09,0.0889830508474576,23600,25700,2100,1159857,204320.0,만도보통주
16183,204320,2020-04-06,0.0858468677494199,21550,23400,1850,573131,204320.0,만도보통주
16184,204320,2020-03-25,0.1938202247191011,17800,21250,3450,1077339,204320.0,만도보통주
16185,204320,2020-03-24,0.0501474926253687,16950,17800,850,804501,204320.0,만도보통주
16186,204320,2020-03-23,0.0788043478260869,18400,16950,-1450,491309,204320.0,만도보통주
16187,204320,2020-03-20,0.0605187319884726,17350,18400,1050,836084,204320.0,만도보통주
16188,204320,2020-03-19,0.1389578163771712,20150,17350,-2800,638573,204320.0,만도보통주
16189,204320,2020-03-18,0.0671296296296296,21600,20150,-1450,492058,204320.0,만도보통주
16190,204320,2020-03-16,0.0407239819004524,22100,21200,-900,562763,204320.0,만도보통주
16191,204320,2020-03-13,0.0905349794238683,24300,22100,-2200,1345807,204320.0,만도보통주
16192,204320,2020-03-12,0.0777988614800759,26350,24300,-2050,927134,204320.0,만도보통주
16193,204320,2020-03-09,0.0471204188481675,28650,27300,-1350,414642,204320.0,만도보통주
16194,204320,2020-02-28,0.0584518167456556,31650,29800,-1850,537608,204320.0,만도보통주
16195,204320,2020-02-12,0.0402298850574712,34800,36200,1400,489878,204320.0,만도보통주
16196,204320,2020-02-06,0.0441176470588235,34000,35500,1500,672359,204320.0,만도보통주
16197,204320,2020-01-30,0.0523415977961432,36300,34400,-1900,677811,204320.0,만도보통주
16198,204320,2020-01-28,0.0858974358974359,39000,35650,-3350,1162582,204320.0,만도보통주
16199,204320,2020-01-23,0.0743801652892562,36300,39000,2700,1373755,204320.0,만도보통주
16200,204320,2019-12-11,0.0410764872521246,35300,36750,1450,333119,204320.0,만도보통주
16201,204320,2019-11-19,0.0566801619433198,37050,34950,-2100,776461,204320.0,만도보통주
16202,204320,2019-10-08,0.0412844036697247,32700,34050,1350,387817,204320.0,만도보통주
16203,204320,2019-09-24,0.0718085106382978,37600,34900,-2700,2507097,204320.0,만도보통주
16204,204320,2019-09-20,0.0495750708215297,35300,37050,1750,528557,204320.0,만도보통주
16205,204320,2019-08-28,0.0719874804381846,31950,34250,2300,784508,204320.0,만도보통주
16206,204320,2019-08-08,0.0421686746987951,33200,34600,1400,535852,204320.0,만도보통주
16207,204320,2019-07-29,0.044349070100143,34950,33400,-1550,940687,204320.0,만도보통주
16208,204320,2019-07-26,0.0990566037735849,31800,34950,3150,2676141,204320.0,만도보통주
16209,204320,2019-07-24,0.0418060200668896,29900,31150,1250,896800,204320.0,만도보통주
16210,204320,2019-07-03,0.0572390572390572,29700,28000,-1700,1040925,204320.0,만도보통주
16211,204320,2019-05-09,0.0403726708074534,32200,30900,-1300,461648,204320.0,만도보통주
16212,204320,2019-04-29,0.0796875,32000,34550,2550,671093,204320.0,만도보통주
16213,204320,2019-04-26,0.0764790764790764,34650,32000,-2650,1451248,204320.0,만도보통주
16214,204320,2019-04-17,0.0645624103299856,34850,37100,2250,815180,204320.0,만도보통주
16215,204320,2019-04-11,0.0414814814814814,33750,35150,1400,1175361,204320.0,만도보통주
16216,204320,2019-03-25,0.0447019867549668,30200,28850,-1350,525142,204320.0,만도보통주
16217,204320,2019-03-07,0.0423600605143721,33050,31650,-1400,567841,204320.0,만도보통주
16218,204320,2019-02-28,0.0437317784256559,34300,32800,-1500,509205,204320.0,만도보통주
16219,204320,2019-02-25,0.0445151033386327,31450,32850,1400,604353,204320.0,만도보통주
16220,204320,2019-02-12,0.040650406504065,30750,32000,1250,964386,204320.0,만도보통주
16221,204320,2019-02-01,0.0618556701030927,33950,31850,-2100,1820409,204320.0,만도보통주
16222,204320,2019-01-18,0.0629032258064516,31000,32950,1950,929475,204320.0,만도보통주
16223,204320,2019-01-15,0.0569514237855946,29850,31550,1700,930104,204320.0,만도보통주
16224,204320,2019-01-09,0.0842490842490842,27300,29600,2300,1300472,204320.0,만도보통주
16225,204320,2019-01-08,0.0838926174496644,29800,27300,-2500,1139022,204320.0,만도보통주
16226,204320,2018-12-26,0.0509031198686371,30450,28900,-1550,392398,204320.0,만도보통주
16227,204320,2018-12-05,0.0413223140495867,30250,29000,-1250,480665,204320.0,만도보통주
16228,204320,2018-12-03,0.0402684563758389,29800,31000,1200,349705,204320.0,만도보통주
16229,204320,2018-11-27,0.0813308687615526,27050,29250,2200,849052,204320.0,만도보통주
16230,204320,2018-11-22,0.0779896013864818,28850,26600,-2250,780605,204320.0,만도보통주
16231,204320,2018-11-20,0.0662251655629139,30200,28200,-2000,720993,204320.0,만도보통주
16232,204320,2018-11-12,0.0444810543657331,30350,29000,-1350,399448,204320.0,만도보통주
16233,204320,2018-11-01,0.0458265139116202,30550,31950,1400,640763,204320.0,만도보통주
16234,204320,2018-10-30,0.1197822141560798,27550,30850,3300,1438355,204320.0,만도보통주
16235,204320,2018-10-24,0.0670289855072463,27600,29450,1850,493793,204320.0,만도보통주
16236,204320,2018-10-23,0.0691399662731871,29650,27600,-2050,536177,204320.0,만도보통주
16237,204320,2018-10-22,0.0608228980322003,27950,29650,1700,517255,204320.0,만도보통주
16238,204320,2018-10-17,0.0423280423280423,28350,29550,1200,402036,204320.0,만도보통주
16239,204320,2018-10-16,0.0677966101694915,26550,28350,1800,552957,204320.0,만도보통주
16240,204320,2018-10-10,0.060200668896321,29900,28100,-1800,484854,204320.0,만도보통주
16241,204320,2018-10-04,0.0906298003072196,32550,29600,-2950,942866,204320.0,만도보통주
16242,204320,2018-09-11,0.0506155950752394,36550,34700,-1850,902967,204320.0,만도보통주
16243,204320,2018-08-02,0.0413625304136253,41100,39400,-1700,387022,204320.0,만도보통주
16244,204320,2018-07-27,0.0477386934673366,39800,41700,1900,1172103,204320.0,만도보통주
16245,204320,2018-07-24,0.051373954599761,41850,39700,-2150,828162,204320.0,만도보통주
16246,204320,2018-07-09,0.0414507772020725,38600,40200,1600,415988,204320.0,만도보통주
16247,204320,2018-07-06,0.0842696629213483,35600,38600,3000,910533,204320.0,만도보통주
16248,204320,2018-07-05,0.0424597364568082,34150,35600,1450,590534,204320.0,만도보통주
16249,204320,2018-07-04,0.068212824010914,36650,34150,-2500,561257,204320.0,만도보통주
16250,204320,2018-06-15,0.0423841059602649,37750,39350,1600,1228644,204320.0,만도보통주
16251,204320,2018-06-08,0.0549707602339181,42750,40400,-2350,453623,204320.0,만도보통주
16252,204320,2018-06-04,0.0539215686274509,40800,43000,2200,832347,204320.0,만도보통주
16253,204320,2018-06-01,0.0611183355006502,38450,40800,2350,623473,204320.0,만도보통주
16254,204320,2018-05-25,0.0471698113207547,42400,40400,-2000,582775,204320.0,만도보통주
16255,204320,2018-05-23,0.0403489640130861,45850,44000,-1850,364721,204320.0,만도보통주
16256,204320,2018-05-17,0.0555555555555555,44100,46550,2450,402992,204320.0,만도보통주
16257,204320,2018-05-16,0.0562874251497006,41750,44100,2350,462180,204320.0,만도보통주
16258,204320,2018-04-25,0.0682819383259911,227000,211500,-15500,112510,204320.0,만도보통주
16259,204320,2018-04-04,0.0443974630021141,236500,247000,10500,69193,204320.0,만도보통주
16260,204320,2018-04-02,0.0581896551724137,232000,245500,13500,109733,204320.0,만도보통주
16261,204320,2018-03-27,0.0404255319148936,235000,244500,9500,69722,204320.0,만도보통주
16262,204320,2018-03-23,0.0417536534446764,239500,229500,-10000,70409,204320.0,만도보통주
16263,204320,2018-03-22,0.050438596491228,228000,239500,11500,142157,204320.0,만도보통주
16264,204320,2018-03-02,0.0601941747572815,257500,242000,-15500,75052,204320.0,만도보통주
16265,204320,2018-02-07,0.1818181818181818,286000,234000,-52000,657625,204320.0,만도보통주
16266,204320,2018-02-02,0.0415913200723327,276500,288000,11500,119742,204320.0,만도보통주
16267,204320,2018-01-26,0.0614334470989761,293000,275000,-18000,132386,204320.0,만도보통주
16268,204320,2017-12-11,0.0425867507886435,317000,303500,-13500,89422,204320.0,만도보통주
16269,204320,2017-12-05,0.0414110429447852,326000,339500,13500,47738,204320.0,만도보통주
16270,204320,2017-11-09,0.0580431177446102,301500,319000,17500,91969,204320.0,만도보통주
16271,204320,2017-11-08,0.0488958990536277,317000,301500,-15500,148197,204320.0,만도보통주
16272,204320,2017-10-26,0.0748752079866888,300500,323000,22500,90878,204320.0,만도보통주
16273,204320,2017-10-23,0.0504201680672268,297500,312500,15000,107695,204320.0,만도보통주
16274,204320,2017-10-18,0.1184210526315789,266000,297500,31500,144174,204320.0,만도보통주
16275,204320,2017-10-10,0.0589390962671905,254500,269500,15000,142808,204320.0,만도보통주
16276,204320,2017-09-26,0.0645833333333333,240000,255500,15500,87010,204320.0,만도보통주
16277,204320,2017-07-28,0.059880239520958,250500,265500,15000,114958,204320.0,만도보통주
16278,204320,2017-07-17,0.0403397027600849,235500,245000,9500,72907,204320.0,만도보통주
16279,204320,2017-06-12,0.0404858299595141,247000,257000,10000,64935,204320.0,만도보통주
16280,204320,2017-05-10,0.0580645161290322,232500,246000,13500,213595,204320.0,만도보통주
16281,204320,2017-04-28,0.0416666666666666,240000,230000,-10000,84410,204320.0,만도보통주
16282,204320,2017-04-20,0.0497737556561085,221000,232000,11000,117944,204320.0,만도보통주
16283,204320,2017-04-04,0.058027079303675,258500,243500,-15000,122444,204320.0,만도보통주
16284,204320,2017-03-03,0.0486381322957198,257000,244500,-12500,127182,204320.0,만도보통주
16285,204320,2017-02-08,0.0789980732177264,259500,280000,20500,214110,204320.0,만도보통주
16286,204320,2017-02-07,0.0745341614906832,241500,259500,18000,153696,204320.0,만도보통주
16287,204320,2017-01-03,0.0582329317269076,249000,263500,14500,102388,204320.0,만도보통주
16288,204320,2017-01-02,0.0618336886993603,234500,249000,14500,49947,204320.0,만도보통주
16289,204320,2016-12-16,0.04,250000,240000,-10000,53794,204320.0,만도보통주
16290,204320,2016-12-05,0.0422535211267605,248500,238000,-10500,39744,204320.0,만도보통주
16291,204320,2016-11-16,0.046979865771812,223500,234000,10500,79024,204320.0,만도보통주
16292,204320,2016-11-04,0.0421455938697318,261000,250000,-11000,71612,204320.0,만도보통주
16293,204320,2016-10-25,0.0780287474332648,243500,262500,19000,83050,204320.0,만도보통주
16294,204320,2016-10-11,0.0456349206349206,252000,263500,11500,52005,204320.0,만도보통주
16295,204320,2016-10-06,0.0416666666666666,264000,253000,-11000,104497,204320.0,만도보통주
16296,204320,2016-10-04,0.0566801619433198,247000,261000,14000,202205,204320.0,만도보통주
16297,204320,2016-09-30,0.1333333333333333,285000,247000,-38000,216025,204320.0,만도보통주
16298,204320,2016-08-19,0.044280442804428,271000,259000,-12000,72997,204320.0,만도보통주
16299,204320,2016-08-18,0.0627450980392156,255000,271000,16000,155126,204320.0,만도보통주
16300,207940,2021-05-17,0.0780590717299578,948000,874000,-74000,546343,207940.0,삼성바이오로직스보통주
16301,207940,2021-05-14,0.0946882217090069,866000,948000,82000,1010588,207940.0,삼성바이오로직스보통주
16302,207940,2021-05-12,0.047735618115055,817000,856000,39000,785496,207940.0,삼성바이오로직스보통주
16303,207940,2021-03-11,0.0437956204379562,685000,715000,30000,110454,207940.0,삼성바이오로직스보통주
16304,207940,2021-01-29,0.0536992840095465,838000,793000,-45000,276664,207940.0,삼성바이오로직스보통주
16305,207940,2021-01-27,0.0586034912718204,802000,849000,47000,652417,207940.0,삼성바이오로직스보통주
16306,207940,2020-12-29,0.0418250950570342,789000,822000,33000,222705,207940.0,삼성바이오로직스보통주
16307,207940,2020-12-08,0.059090909090909,880000,828000,-52000,400980,207940.0,삼성바이오로직스보통주
16308,207940,2020-12-07,0.0666666666666666,825000,880000,55000,507215,207940.0,삼성바이오로직스보통주
16309,207940,2020-11-18,0.0490956072351421,774000,812000,38000,403958,207940.0,삼성바이오로직스보통주
16310,207940,2020-11-05,0.0654843110504774,733000,781000,48000,447218,207940.0,삼성바이오로직스보통주
16311,207940,2020-11-04,0.0486409155937052,699000,733000,34000,252251,207940.0,삼성바이오로직스보통주
16312,207940,2020-10-29,0.0941915227629513,637000,697000,60000,301106,207940.0,삼성바이오로직스보통주
16313,207940,2020-10-22,0.0436046511627907,688000,658000,-30000,186612,207940.0,삼성바이오로직스보통주
16314,207940,2020-09-24,0.0453900709219858,705000,673000,-32000,186230,207940.0,삼성바이오로직스보통주
16315,207940,2020-08-12,0.0485074626865671,804000,843000,39000,760424,207940.0,삼성바이오로직스보통주
16316,207940,2020-08-11,0.0428015564202334,771000,804000,33000,761446,207940.0,삼성바이오로직스보통주
16317,207940,2020-08-05,0.0707482993197279,735000,787000,52000,521095,207940.0,삼성바이오로직스보통주
16318,207940,2020-07-22,0.0533333333333333,750000,790000,40000,371837,207940.0,삼성바이오로직스보통주
16319,207940,2020-07-02,0.0452127659574468,752000,786000,34000,266716,207940.0,삼성바이오로직스보통주
16320,207940,2020-06-12,0.0776439089692101,747000,805000,58000,789465,207940.0,삼성바이오로직스보통주
16321,207940,2020-06-11,0.0610795454545454,704000,747000,43000,593199,207940.0,삼성바이오로직스보통주
16322,207940,2020-06-10,0.0414201183431952,676000,704000,28000,282781,207940.0,삼성바이오로직스보통주
16323,207940,2020-05-13,0.0405405405405405,592000,616000,24000,510468,207940.0,삼성바이오로직스보통주
16324,207940,2020-05-04,0.0430292598967297,581000,556000,-25000,302753,207940.0,삼성바이오로직스보통주
16325,207940,2020-04-17,0.0481481481481481,540000,566000,26000,776987,207940.0,삼성바이오로직스보통주
16326,207940,2020-04-10,0.1682340647857889,478500,559000,80500,3037570,207940.0,삼성바이오로직스보통주
16327,207940,2020-04-01,0.0612033195020746,482000,452500,-29500,313016,207940.0,삼성바이오로직스보통주
16328,207940,2020-03-31,0.0711111111111111,450000,482000,32000,665621,207940.0,삼성바이오로직스보통주
16329,207940,2020-03-24,0.091743119266055,436000,476000,40000,509039,207940.0,삼성바이오로직스보통주
16330,207940,2020-03-20,0.174863387978142,366000,430000,64000,586738,207940.0,삼성바이오로직스보통주
16331,207940,2020-03-19,0.0861423220973782,400500,366000,-34500,470624,207940.0,삼성바이오로직스보통주
16332,207940,2020-03-18,0.0407185628742515,417500,400500,-17000,276886,207940.0,삼성바이오로직스보통주
16333,207940,2020-03-16,0.0580503833515881,456500,430000,-26500,218369,207940.0,삼성바이오로직스보통주
16334,207940,2020-03-13,0.0548654244306418,483000,456500,-26500,477093,207940.0,삼성바이오로직스보통주
16335,207940,2020-02-24,0.0524152106885919,486500,461000,-25500,278895,207940.0,삼성바이오로직스보통주
16336,207940,2020-02-06,0.0591836734693877,490000,519000,29000,298254,207940.0,삼성바이오로직스보통주
16337,207940,2020-01-23,0.0685840707964601,452000,483000,31000,438529,207940.0,삼성바이오로직스보통주
16338,207940,2019-12-23,0.0655737704918032,396500,422500,26000,385044,207940.0,삼성바이오로직스보통주
16339,207940,2019-10-23,0.0828488372093023,344000,372500,28500,565378,207940.0,삼성바이오로직스보통주
16340,207940,2019-10-01,0.0504065040650406,307500,323000,15500,105042,207940.0,삼성바이오로직스보통주
16341,207940,2019-09-23,0.0635155096011816,338500,317000,-21500,284614,207940.0,삼성바이오로직스보통주
16342,207940,2019-09-19,0.0411392405063291,316000,329000,13000,273672,207940.0,삼성바이오로직스보통주
16343,207940,2019-09-17,0.0732538330494037,293500,315000,21500,342854,207940.0,삼성바이오로직스보통주
16344,207940,2019-08-29,0.0488656195462478,286500,272500,-14000,796095,207940.0,삼성바이오로직스보통주
16345,207940,2019-08-26,0.0423280423280423,283500,271500,-12000,92053,207940.0,삼성바이오로직스보통주
16346,207940,2019-08-12,0.072356215213358,269500,289000,19500,240244,207940.0,삼성바이오로직스보통주
16347,207940,2019-08-09,0.0801603206412825,249500,269500,20000,251336,207940.0,삼성바이오로직스보통주
16348,207940,2019-08-05,0.0718132854578097,278500,258500,-20000,246067,207940.0,삼성바이오로직스보통주
16349,207940,2019-07-09,0.0410742496050552,316500,303500,-13000,98425,207940.0,삼성바이오로직스보통주
16350,207940,2019-06-04,0.0465890183028286,300500,314500,14000,147236,207940.0,삼성바이오로직스보통주
16351,207940,2019-05-31,0.0582010582010582,283500,300000,16500,145193,207940.0,삼성바이오로직스보통주
16352,207940,2019-05-14,0.075438596491228,285000,306500,21500,408431,207940.0,삼성바이오로직스보통주
16353,207940,2019-05-13,0.0436241610738255,298000,285000,-13000,180720,207940.0,삼성바이오로직스보통주
16354,207940,2019-05-08,0.0773993808049535,323000,298000,-25000,539282,207940.0,삼성바이오로직스보통주
16355,207940,2019-04-25,0.0649171270718232,362000,338500,-23500,322619,207940.0,삼성바이오로직스보통주
16356,207940,2019-04-02,0.065648854961832,327500,349000,21500,239085,207940.0,삼성바이오로직스보통주
16357,207940,2019-03-15,0.0421348314606741,356000,341000,-15000,342069,207940.0,삼성바이오로직스보통주
16358,207940,2018-12-28,0.0417789757412398,371000,386500,15500,256133,207940.0,삼성바이오로직스보통주
16359,207940,2018-12-20,0.0652173913043478,368000,344000,-24000,368200,207940.0,삼성바이오로직스보통주
16360,207940,2018-12-17,0.0485312899106002,391500,372500,-19000,402873,207940.0,삼성바이오로직스보통주
16361,207940,2018-12-14,0.0451219512195121,410000,391500,-18500,467797,207940.0,삼성바이오로직스보통주
16362,207940,2018-12-11,0.1778774289985052,334500,394000,59500,1393121,207940.0,삼성바이오로직스보통주
16363,207940,2018-11-14,0.0669856459330143,313500,334500,21000,1495609,207940.0,삼성바이오로직스보통주
16364,207940,2018-11-13,0.0980735551663747,285500,313500,28000,1508590,207940.0,삼성바이오로직스보통주
16365,207940,2018-11-12,0.2241847826086956,368000,285500,-82500,1504675,207940.0,삼성바이오로직스보통주
16366,207940,2018-11-09,0.0429128738621586,384500,368000,-16500,295775,207940.0,삼성바이오로직스보통주
16367,207940,2018-10-30,0.0979310344827586,362500,398000,35500,411792,207940.0,삼성바이오로직스보통주
16368,207940,2018-10-26,0.0485933503836317,391000,372000,-19000,300551,207940.0,삼성바이오로직스보통주
16369,207940,2018-10-23,0.0659955257270693,447000,417500,-29500,434396,207940.0,삼성바이오로직스보통주
16370,207940,2018-10-11,0.0430327868852459,488000,467000,-21000,331580,207940.0,삼성바이오로직스보통주
16371,207940,2018-10-10,0.0412573673870334,509000,488000,-21000,234332,207940.0,삼성바이오로직스보통주
16372,207940,2018-10-02,0.0427509293680297,538000,515000,-23000,192678,207940.0,삼성바이오로직스보통주
16373,207940,2018-09-20,0.0414201183431952,507000,528000,21000,490554,207940.0,삼성바이오로직스보통주
16374,207940,2018-09-18,0.0432098765432098,486000,507000,21000,347511,207940.0,삼성바이오로직스보통주
16375,207940,2018-08-17,0.0409090909090909,440000,458000,18000,233685,207940.0,삼성바이오로직스보통주
16376,207940,2018-08-08,0.070754716981132,424000,454000,30000,623311,207940.0,삼성바이오로직스보통주
16377,207940,2018-08-07,0.0653266331658291,398000,424000,26000,472153,207940.0,삼성바이오로직스보통주
16378,207940,2018-07-25,0.0535931790499391,410500,388500,-22000,366589,207940.0,삼성바이오로직스보통주
16379,207940,2018-07-13,0.0629370629370629,429000,402000,-27000,796570,207940.0,삼성바이오로직스보통주
16380,207940,2018-07-09,0.0414634146341463,410000,427000,17000,230626,207940.0,삼성바이오로직스보통주
16381,207940,2018-06-22,0.0542168674698795,415000,437500,22500,345522,207940.0,삼성바이오로직스보통주
16382,207940,2018-06-20,0.1023622047244094,381000,420000,39000,400393,207940.0,삼성바이오로직스보통주
16383,207940,2018-06-19,0.0650306748466257,407500,381000,-26500,240421,207940.0,삼성바이오로직스보통주
16384,207940,2018-06-14,0.0500582072176949,429500,408000,-21500,245236,207940.0,삼성바이오로직스보통주
16385,207940,2018-06-04,0.0719822812846068,451500,419000,-32500,689971,207940.0,삼성바이오로직스보통주
16386,207940,2018-05-24,0.04630788485607,399500,418000,18500,295791,207940.0,삼성바이오로직스보통주
16387,207940,2018-05-16,0.0656370656370656,388500,414000,25500,729170,207940.0,삼성바이오로직스보통주
16388,207940,2018-05-15,0.0542740841248303,368500,388500,20000,426156,207940.0,삼성바이오로직스보통주
16389,207940,2018-05-14,0.0465717981888745,386500,368500,-18000,430529,207940.0,삼성바이오로직스보통주
16390,207940,2018-05-09,0.0742240215924426,370500,398000,27500,1236829,207940.0,삼성바이오로직스보통주
16391,207940,2018-05-04,0.0782051282051282,390000,359500,-30500,1522558,207940.0,삼성바이오로직스보통주
16392,207940,2018-05-02,0.1721311475409836,488000,404000,-84000,2332526,207940.0,삼성바이오로직스보통주
16393,207940,2018-04-26,0.0417972831765935,478500,498500,20000,336856,207940.0,삼성바이오로직스보통주
16394,207940,2018-04-23,0.0652173913043478,506000,473000,-33000,580297,207940.0,삼성바이오로직스보통주
16395,207940,2018-04-19,0.059369202226345,539000,507000,-32000,476884,207940.0,삼성바이오로직스보통주
16396,207940,2018-04-09,0.0828516377649325,519000,562000,43000,543779,207940.0,삼성바이오로직스보통주
16397,207940,2018-03-29,0.0451612903225806,465000,486000,21000,226147,207940.0,삼성바이오로직스보통주
16398,207940,2018-03-28,0.07,500000,465000,-35000,451007,207940.0,삼성바이오로직스보통주
16399,207940,2018-02-22,0.0423529411764705,425000,443000,18000,374488,207940.0,삼성바이오로직스보통주
16400,207940,2018-02-12,0.0536828963795255,400500,422000,21500,247343,207940.0,삼성바이오로직스보통주
16401,207940,2018-01-29,0.0514354066985645,418000,439500,21500,794689,207940.0,삼성바이오로직스보통주
16402,207940,2018-01-23,0.0412903225806451,387500,403500,16000,193047,207940.0,삼성바이오로직스보통주
16403,207940,2018-01-12,0.0478589420654911,397000,416000,19000,732180,207940.0,삼성바이오로직스보통주
16404,207940,2018-01-02,0.0498652291105121,371000,389500,18500,409343,207940.0,삼성바이오로직스보통주
16405,207940,2017-12-27,0.0624092888243831,344500,366000,21500,277024,207940.0,삼성바이오로직스보통주
16406,207940,2017-12-11,0.0637982195845697,337000,358500,21500,311770,207940.0,삼성바이오로직스보통주
16407,207940,2017-12-07,0.0449927431059506,344500,329000,-15500,427710,207940.0,삼성바이오로직스보통주
16408,207940,2017-12-01,0.0613138686131386,342500,363500,21000,298111,207940.0,삼성바이오로직스보통주
16409,207940,2017-11-30,0.0603566529492455,364500,342500,-22000,790554,207940.0,삼성바이오로직스보통주
16410,207940,2017-11-01,0.0572916666666666,384000,406000,22000,387331,207940.0,삼성바이오로직스보통주
16411,207940,2017-10-25,0.0432503276539973,381500,365000,-16500,326323,207940.0,삼성바이오로직스보통주
16412,207940,2017-10-12,0.0863309352517985,347500,377500,30000,499172,207940.0,삼성바이오로직스보통주
16413,207940,2017-09-22,0.0492537313432835,335000,318500,-16500,437563,207940.0,삼성바이오로직스보통주
16414,207940,2017-09-14,0.0693069306930693,303000,324000,21000,487784,207940.0,삼성바이오로직스보통주
16415,207940,2017-09-12,0.0664335664335664,286000,305000,19000,745221,207940.0,삼성바이오로직스보통주
16416,207940,2017-08-22,0.0418943533697632,274500,286000,11500,362272,207940.0,삼성바이오로직스보통주
16417,207940,2017-07-25,0.0512820512820512,273000,287000,14000,606363,207940.0,삼성바이오로직스보통주
16418,207940,2017-06-29,0.0550621669626998,281500,297000,15500,770998,207940.0,삼성바이오로직스보통주
16419,207940,2017-06-26,0.1345381526104417,249000,282500,33500,1506559,207940.0,삼성바이오로직스보통주
16420,207940,2017-06-23,0.0462184873949579,238000,249000,11000,397068,207940.0,삼성바이오로직스보통주
16421,207940,2017-06-13,0.0722100656455142,228500,245000,16500,525605,207940.0,삼성바이오로직스보통주
16422,207940,2017-06-09,0.0467091295116772,235500,224500,-11000,758098,207940.0,삼성바이오로직스보통주
16423,207940,2017-06-07,0.053763440860215,232500,245000,12500,512783,207940.0,삼성바이오로직스보통주
16424,207940,2017-06-01,0.0409090909090909,220000,229000,9000,457129,207940.0,삼성바이오로직스보통주
16425,207940,2017-05-31,0.0401891252955082,211500,220000,8500,628168,207940.0,삼성바이오로직스보통주
16426,207940,2017-05-26,0.0465686274509803,204000,213500,9500,432433,207940.0,삼성바이오로직스보통주
16427,207940,2017-02-08,0.0495626822157434,171500,163000,-8500,374070,207940.0,삼성바이오로직스보통주
16428,207940,2017-02-02,0.0521472392638036,163000,171500,8500,597838,207940.0,삼성바이오로직스보통주
16429,207940,2017-01-11,0.0529801324503311,151000,159000,8000,353023,207940.0,삼성바이오로직스보통주
16430,207940,2016-12-28,0.0446735395189003,145500,152000,6500,316778,207940.0,삼성바이오로직스보통주
16431,207940,2016-12-01,0.0616883116883116,154000,144500,-9500,852285,207940.0,삼성바이오로직스보통주
16432,207940,2016-11-25,0.0418006430868167,155500,162000,6500,702370,207940.0,삼성바이오로직스보통주
16433,207940,2016-11-24,0.0632530120481927,166000,155500,-10500,837894,207940.0,삼성바이오로직스보통주
16434,207940,2016-11-15,0.0541310541310541,175500,166000,-9500,2592949,207940.0,삼성바이오로직스보통주
16435,207940,2016-11-14,0.0866873065015479,161500,175500,14000,2977177,207940.0,삼성바이오로직스보통주
16436,207940,2016-11-11,0.1215277777777777,144000,161500,17500,8140539,207940.0,삼성바이오로직스보통주
16437,207940,2016-11-10,0.0557275541795665,161500,144000,-17500,7179018,207940.0,삼성바이오로직스보통주
16438,207940,2016-11-11,0.1215277777777777,144000,161500,17500,8140539,207940.0,삼성바이오로직스보통주
16439,207940,2016-11-10,0.0557275541795665,161500,144000,-17500,7179018,207940.0,삼성바이오로직스보통주
16440,207940,2016-11-11,0.1215277777777777,144000,161500,17500,8140539,207940.0,삼성바이오로직스보통주
16441,207940,2016-11-10,0.0557275541795665,161500,144000,-17500,7179018,207940.0,삼성바이오로직스보통주
16442,207940,2016-11-11,0.1215277777777777,144000,161500,17500,8140539,207940.0,삼성바이오로직스보통주
16443,207940,2016-11-10,0.0557275541795665,161500,144000,-17500,7179018,207940.0,삼성바이오로직스보통주
16444,207940,2016-11-11,0.1215277777777777,144000,161500,17500,8140539,207940.0,삼성바이오로직스보통주
16445,207940,2016-11-10,0.0557275541795665,161500,144000,-17500,7179018,207940.0,삼성바이오로직스보통주
16446,207940,2016-11-11,0.1215277777777777,144000,161500,17500,8140539,207940.0,삼성바이오로직스보통주
16447,207940,2016-11-10,0.0557275541795665,161500,144000,-17500,7179018,207940.0,삼성바이오로직스보통주
16448,207940,2016-11-11,0.1215277777777777,144000,161500,17500,8140539,207940.0,삼성바이오로직스보통주
16449,214320,2021-05-24,0.0637583892617449,59600,63400,3800,336600,214320.0,이노션보통주
16450,214320,2021-02-09,0.0461285008237232,60700,63500,2800,153703,214320.0,이노션보통주
16451,214320,2021-01-07,0.0529695024077046,62300,65600,3300,193882,214320.0,이노션보통주
16452,214320,2020-10-19,0.0491525423728813,59000,56100,-2900,103962,214320.0,이노션보통주
16453,214320,2020-10-14,0.0632911392405063,55300,58800,3500,254021,214320.0,이노션보통주
16454,214320,2020-09-29,0.0492125984251968,50800,53300,2500,100520,214320.0,이노션보통주
16455,214320,2020-09-04,0.0661764705882353,54400,50800,-3600,285035,214320.0,이노션보통주
16456,214320,2020-08-21,0.0682730923694779,49800,53200,3400,88784,214320.0,이노션보통주
16457,214320,2020-08-20,0.0621468926553672,53100,49800,-3300,125166,214320.0,이노션보통주
16458,214320,2020-08-18,0.0770609318996415,55800,51500,-4300,139933,214320.0,이노션보통주
16459,214320,2020-08-12,0.0714285714285714,51800,55500,3700,283515,214320.0,이노션보통주
16460,214320,2020-08-10,0.0412890231621349,49650,51700,2050,142292,214320.0,이노션보통주
16461,214320,2020-06-16,0.0472610096670247,46550,48750,2200,85155,214320.0,이노션보통주
16462,214320,2020-06-15,0.0836614173228346,50800,46550,-4250,137608,214320.0,이노션보통주
16463,214320,2020-06-12,0.0540037243947858,53700,50800,-2900,110242,214320.0,이노션보통주
16464,214320,2020-05-04,0.0497427101200686,58300,55400,-2900,51652,214320.0,이노션보통주
16465,214320,2020-04-21,0.0581583198707592,61900,58300,-3600,68373,214320.0,이노션보통주
16466,214320,2020-04-17,0.0782608695652174,57500,62000,4500,95792,214320.0,이노션보통주
16467,214320,2020-04-16,0.0454545454545454,55000,57500,2500,48041,214320.0,이노션보통주
16468,214320,2020-04-07,0.0411214953271028,53500,55700,2200,49833,214320.0,이노션보통주
16469,214320,2020-04-06,0.0469667318982387,51100,53500,2400,50665,214320.0,이노션보통주
16470,214320,2020-04-01,0.0437262357414448,52600,50300,-2300,57431,214320.0,이노션보통주
16471,214320,2020-03-26,0.044362292051756,54100,51700,-2400,68260,214320.0,이노션보통주
16472,214320,2020-03-25,0.1572192513368984,46750,54100,7350,129667,214320.0,이노션보통주
16473,214320,2020-03-24,0.0809248554913294,43250,46750,3500,95099,214320.0,이노션보통주
16474,214320,2020-03-23,0.0608034744842562,46050,43250,-2800,82739,214320.0,이노션보통주
16475,214320,2020-03-20,0.0513698630136986,43800,46050,2250,88755,214320.0,이노션보통주
16476,214320,2020-03-19,0.0875,48000,43800,-4200,136203,214320.0,이노션보통주
16477,214320,2020-03-18,0.102803738317757,53500,48000,-5500,107852,214320.0,이노션보통주
16478,214320,2020-03-12,0.0473856209150326,61200,58300,-2900,84079,214320.0,이노션보통주
16479,214320,2019-12-10,0.0434108527131782,64500,67300,2800,52930,214320.0,이노션보통주
16480,214320,2019-11-04,0.0429447852760736,65200,68000,2800,81229,214320.0,이노션보통주
16481,214320,2019-08-01,0.0823353293413173,66800,72300,5500,133139,214320.0,이노션보통주
16482,214320,2019-06-19,0.0587392550143266,69800,73900,4100,83583,214320.0,이노션보통주
16483,214320,2019-05-10,0.0478955007256894,68900,72200,3300,244418,214320.0,이노션보통주
16484,214320,2019-03-22,0.0414937759336099,72300,69300,-3000,76134,214320.0,이노션보통주
16485,214320,2019-02-12,0.0585774058577405,71700,67500,-4200,802741,214320.0,이노션보통주
16486,214320,2019-01-08,0.0436817472698908,64100,66900,2800,51726,214320.0,이노션보통주
16487,214320,2018-12-03,0.059347181008902,67400,63400,-4000,73451,214320.0,이노션보통주
16488,214320,2018-11-26,0.0489864864864864,59200,62100,2900,31326,214320.0,이노션보통주
16489,214320,2018-11-21,0.0562390158172231,56900,60100,3200,87256,214320.0,이노션보통주
16490,214320,2018-11-07,0.0663265306122449,58800,54900,-3900,86796,214320.0,이노션보통주
16491,214320,2018-11-06,0.0481283422459893,56100,58800,2700,39126,214320.0,이노션보통주
16492,214320,2018-10-30,0.081237911025145,51700,55900,4200,56293,214320.0,이노션보통주
16493,214320,2018-10-23,0.0470162748643761,55300,52700,-2600,38815,214320.0,이노션보통주
16494,214320,2018-10-11,0.0697674418604651,55900,52000,-3900,55387,214320.0,이노션보통주
16495,214320,2018-10-08,0.0489038785834738,59300,56400,-2900,64982,214320.0,이노션보통주
16496,214320,2018-08-10,0.0425531914893617,56400,58800,2400,60611,214320.0,이노션보통주
16497,214320,2018-07-03,0.0416666666666666,57600,55200,-2400,38723,214320.0,이노션보통주
16498,214320,2018-06-25,0.0565068493150684,58400,61700,3300,55632,214320.0,이노션보통주
16499,214320,2018-06-19,0.0522979397781299,63100,59800,-3300,117433,214320.0,이노션보통주
16500,214320,2018-06-15,0.0720588235294117,68000,63100,-4900,78098,214320.0,이노션보통주
16501,214320,2018-05-09,0.0470957613814756,63700,66700,3000,29194,214320.0,이노션보통주
16502,214320,2018-03-02,0.0589147286821705,64500,60700,-3800,55225,214320.0,이노션보통주
16503,214320,2018-02-05,0.0453879941434846,68300,65200,-3100,49988,214320.0,이노션보통주
16504,214320,2018-01-03,0.0516304347826086,73600,69800,-3800,86023,214320.0,이노션보통주
16505,214320,2017-12-27,0.0495436766623207,76700,72900,-3800,38479,214320.0,이노션보통주
16506,214320,2017-10-18,0.0421511627906976,68800,71700,2900,56002,214320.0,이노션보통주
16507,214320,2017-09-25,0.0404624277456647,69200,66400,-2800,51978,214320.0,이노션보통주
16508,214320,2017-09-11,0.0417867435158501,69400,66500,-2900,129241,214320.0,이노션보통주
16509,214320,2017-03-28,0.0470219435736677,63800,60800,-3000,113338,214320.0,이노션보통주
16510,214320,2017-03-21,0.061056105610561,60600,64300,3700,144383,214320.0,이노션보통주
16511,214320,2017-03-17,0.0477815699658703,58600,61400,2800,68006,214320.0,이노션보통주
16512,214320,2017-01-31,0.0507364975450081,61100,58000,-3100,72015,214320.0,이노션보통주
16513,214320,2017-01-18,0.0587219343696027,57900,61300,3400,94604,214320.0,이노션보통주
16514,214320,2016-11-16,0.0561056105610561,60600,64000,3400,85629,214320.0,이노션보통주
16515,214320,2016-11-11,0.0435458786936236,64300,61500,-2800,53999,214320.0,이노션보통주
16516,214320,2016-11-07,0.0537790697674418,68800,65100,-3700,60814,214320.0,이노션보통주
16517,241560,2021-06-03,0.0401459854014598,54800,52600,-2200,572505,241560.0,두산밥캣보통주
16518,241560,2021-06-02,0.0703125,51200,54800,3600,1097343,241560.0,두산밥캣보통주
16519,241560,2021-05-18,0.0416666666666666,48000,50000,2000,290408,241560.0,두산밥캣보통주
16520,241560,2021-05-06,0.106060606060606,46200,51100,4900,1599371,241560.0,두산밥캣보통주
16521,241560,2021-04-27,0.0490928495197438,46850,49150,2300,673960,241560.0,두산밥캣보통주
16522,241560,2021-04-26,0.0575620767494356,44300,46850,2550,358220,241560.0,두산밥캣보통주
16523,241560,2021-03-31,0.0433705080545229,40350,42100,1750,629895,241560.0,두산밥캣보통주
16524,241560,2021-03-30,0.0415676959619952,42100,40350,-1750,1174241,241560.0,두산밥캣보통주
16525,241560,2021-03-29,0.0644753476611883,39550,42100,2550,1169886,241560.0,두산밥캣보통주
16526,241560,2021-03-26,0.0689189189189189,37000,39550,2550,801902,241560.0,두산밥캣보통주
16527,241560,2021-02-26,0.0623188405797101,34500,32350,-2150,613639,241560.0,두산밥캣보통주
16528,241560,2021-02-24,0.0472103004291845,34950,33300,-1650,344879,241560.0,두산밥캣보통주
16529,241560,2021-02-09,0.0637636080870917,32150,34200,2050,2053077,241560.0,두산밥캣보통주
16530,241560,2021-02-03,0.0444444444444444,31500,32900,1400,396771,241560.0,두산밥캣보통주
16531,241560,2021-01-29,0.0632716049382716,32400,30350,-2050,408877,241560.0,두산밥캣보통주
16532,241560,2021-01-28,0.0442477876106194,33900,32400,-1500,404774,241560.0,두산밥캣보통주
16533,241560,2021-01-07,0.0704918032786885,30500,32650,2150,1956745,241560.0,두산밥캣보통주
16534,241560,2020-11-10,0.0623973727422003,30450,32350,1900,928826,241560.0,두산밥캣보통주
16535,241560,2020-11-04,0.046031746031746,31500,30050,-1450,864774,241560.0,두산밥캣보통주
16536,241560,2020-11-02,0.0901213171577123,28850,31450,2600,954289,241560.0,두산밥캣보통주
16537,241560,2020-10-27,0.0566343042071197,30900,29150,-1750,845881,241560.0,두산밥캣보통주
16538,241560,2020-10-21,0.0681431005110732,29350,31350,2000,1673174,241560.0,두산밥캣보통주
16539,241560,2020-10-19,0.0859232175502742,27350,29700,2350,1637795,241560.0,두산밥캣보통주
16540,241560,2020-10-05,0.0501858736059479,26900,28250,1350,455091,241560.0,두산밥캣보통주
16541,241560,2020-09-24,0.0547445255474452,27400,25900,-1500,727008,241560.0,두산밥캣보통주
16542,241560,2020-09-07,0.0594795539033457,26900,28500,1600,2332252,241560.0,두산밥캣보통주
16543,241560,2020-08-18,0.0737564322469982,29150,27000,-2150,581899,241560.0,두산밥캣보통주
16544,241560,2020-08-12,0.0461811722912966,28150,29450,1300,822247,241560.0,두산밥캣보통주
16545,241560,2020-07-21,0.078125,25600,27600,2000,4416478,241560.0,두산밥캣보통주
16546,241560,2020-06-30,0.0415841584158415,25250,26300,1050,488509,241560.0,두산밥캣보통주
16547,241560,2020-06-25,0.0622710622710622,27300,25600,-1700,756942,241560.0,두산밥캣보통주
16548,241560,2020-06-18,0.0502599653379549,28850,27400,-1450,1011728,241560.0,두산밥캣보통주
16549,241560,2020-06-16,0.1805273833671399,24650,29100,4450,6663269,241560.0,두산밥캣보통주
16550,241560,2020-06-15,0.0802238805970149,26800,24650,-2150,817600,241560.0,두산밥캣보통주
16551,241560,2020-06-12,0.0645724258289703,28650,26800,-1850,886740,241560.0,두산밥캣보통주
16552,241560,2020-06-09,0.0580847723704866,31850,30000,-1850,1561116,241560.0,두산밥캣보통주
16553,241560,2020-06-08,0.177449168207024,27050,31850,4800,6247437,241560.0,두산밥캣보통주
16554,241560,2020-06-03,0.0633663366336633,25250,26850,1600,2476409,241560.0,두산밥캣보통주
16555,241560,2020-05-22,0.0552147239263803,24450,23100,-1350,523787,241560.0,두산밥캣보통주
16556,241560,2020-05-19,0.0650759219088937,23050,24550,1500,980151,241560.0,두산밥캣보통주
16557,241560,2020-05-06,0.0460526315789473,22800,23850,1050,434022,241560.0,두산밥캣보통주
16558,241560,2020-04-24,0.0641821946169772,24150,22600,-1550,686023,241560.0,두산밥캣보통주
16559,241560,2020-04-20,0.1091314031180401,22450,24900,2450,2632247,241560.0,두산밥캣보통주
16560,241560,2020-04-10,0.0710900473933649,21100,22600,1500,3419128,241560.0,두산밥캣보통주
16561,241560,2020-04-06,0.0515970515970515,20350,21400,1050,662927,241560.0,두산밥캣보통주
16562,241560,2020-04-02,0.0547619047619047,21000,19850,-1150,1573164,241560.0,두산밥캣보통주
16563,241560,2020-04-01,0.1699164345403899,17950,21000,3050,1481838,241560.0,두산밥캣보통주
16564,241560,2020-03-31,0.0436046511627907,17200,17950,750,490408,241560.0,두산밥캣보통주
16565,241560,2020-03-30,0.0523415977961432,18150,17200,-950,514919,241560.0,두산밥캣보통주
16566,241560,2020-03-27,0.0461095100864553,17350,18150,800,421583,241560.0,두산밥캣보통주
16567,241560,2020-03-25,0.1003236245954692,15450,17000,1550,444939,241560.0,두산밥캣보통주
16568,241560,2020-03-24,0.0804195804195804,14300,15450,1150,264171,241560.0,두산밥캣보통주
16569,241560,2020-03-20,0.072992700729927,13700,14700,1000,566771,241560.0,두산밥캣보통주
16570,241560,2020-03-19,0.2011661807580174,17150,13700,-3450,527847,241560.0,두산밥캣보통주
16571,241560,2020-03-18,0.1403508771929824,19950,17150,-2800,413009,241560.0,두산밥캣보통주
16572,241560,2020-03-17,0.0720930232558139,21500,19950,-1550,320999,241560.0,두산밥캣보통주
16573,241560,2020-03-13,0.1316872427983539,24300,21100,-3200,599321,241560.0,두산밥캣보통주
16574,241560,2020-03-12,0.0414201183431952,25350,24300,-1050,316449,241560.0,두산밥캣보통주
16575,241560,2020-03-11,0.0558659217877094,26850,25350,-1500,320509,241560.0,두산밥캣보통주
16576,241560,2020-02-24,0.0409252669039145,28100,26950,-1150,259355,241560.0,두산밥캣보통주
16577,241560,2019-12-20,0.0426470588235294,34000,35450,1450,179380,241560.0,두산밥캣보통주
16578,241560,2019-09-30,0.0442477876106194,33900,35400,1500,150175,241560.0,두산밥캣보통주
16579,241560,2019-08-09,0.0468521229868228,34150,35750,1600,187141,241560.0,두산밥캣보통주
16580,241560,2019-08-06,0.0524822695035461,35250,33400,-1850,268381,241560.0,두산밥캣보통주
16581,241560,2019-05-02,0.0532081377151799,31950,33650,1700,518629,241560.0,두산밥캣보통주
16582,241560,2019-02-13,0.0752532561505065,34550,31950,-2600,584110,241560.0,두산밥캣보통주
16583,241560,2019-01-09,0.0411392405063291,31600,32900,1300,249939,241560.0,두산밥캣보통주
16584,241560,2018-11-30,0.0733427362482369,35450,32850,-2600,5744519,241560.0,두산밥캣보통주
16585,241560,2018-09-27,0.040207522697795,38550,40100,1550,374354,241560.0,두산밥캣보통주
16586,241560,2018-08-31,0.0579494799405646,33650,35600,1950,1625917,241560.0,두산밥캣보통주
16587,241560,2018-06-14,0.04860088365243,33950,32300,-1650,1291817,241560.0,두산밥캣보통주
16588,241560,2018-02-08,0.0491329479768786,34600,36300,1700,317016,241560.0,두산밥캣보통주
16589,241560,2017-12-05,0.0483641536273115,35150,36850,1700,623531,241560.0,두산밥캣보통주
16590,241560,2017-08-31,0.0553250345781466,36150,38150,2000,456786,241560.0,두산밥캣보통주
16591,241560,2017-08-24,0.0417227456258411,37150,35600,-1550,408954,241560.0,두산밥캣보통주
16592,241560,2017-05-18,0.0489690721649484,38800,36900,-1900,974183,241560.0,두산밥캣보통주
16593,241560,2017-03-17,0.0414507772020725,38600,40200,1600,743734,241560.0,두산밥캣보통주
16594,241560,2017-02-09,0.044,37500,35850,-1650,614183,241560.0,두산밥캣보통주
16595,241560,2017-01-26,0.0792507204610951,34700,37450,2750,1125650,241560.0,두산밥캣보통주
16596,241560,2016-12-05,0.0419161676646706,33400,34800,1400,827683,241560.0,두산밥캣보통주
16597,241560,2016-11-30,0.0401721664275466,34850,33450,-1400,1004454,241560.0,두산밥캣보통주
16598,241560,2016-11-23,0.0420054200542005,36900,35350,-1550,2028435,241560.0,두산밥캣보통주
16599,241560,2016-11-22,0.0695652173913043,34500,36900,2400,4432520,241560.0,두산밥캣보통주
16600,241560,2016-11-23,0.0420054200542005,36900,35350,-1550,2028435,241560.0,두산밥캣보통주
16601,241560,2016-11-22,0.0695652173913043,34500,36900,2400,4432520,241560.0,두산밥캣보통주
16602,241560,2016-11-23,0.0420054200542005,36900,35350,-1550,2028435,241560.0,두산밥캣보통주
16603,241560,2016-11-22,0.0695652173913043,34500,36900,2400,4432520,241560.0,두산밥캣보통주
16604,241560,2016-11-23,0.0420054200542005,36900,35350,-1550,2028435,241560.0,두산밥캣보통주
16605,241560,2016-11-22,0.0695652173913043,34500,36900,2400,4432520,241560.0,두산밥캣보통주
16606,241560,2016-11-23,0.0420054200542005,36900,35350,-1550,2028435,241560.0,두산밥캣보통주
16607,241560,2016-11-22,0.0695652173913043,34500,36900,2400,4432520,241560.0,두산밥캣보통주
16608,241560,2016-11-23,0.0420054200542005,36900,35350,-1550,2028435,241560.0,두산밥캣보통주
16609,241560,2016-11-22,0.0695652173913043,34500,36900,2400,4432520,241560.0,두산밥캣보통주
16610,241560,2016-11-23,0.0420054200542005,36900,35350,-1550,2028435,241560.0,두산밥캣보통주
16611,241560,2016-11-22,0.0695652173913043,34500,36900,2400,4432520,241560.0,두산밥캣보통주
16612,241560,2016-11-23,0.0420054200542005,36900,35350,-1550,2028435,241560.0,두산밥캣보통주
16613,241560,2016-11-22,0.0695652173913043,34500,36900,2400,4432520,241560.0,두산밥캣보통주
16614,248070,2021-04-28,0.0476190476190476,26250,25000,-1250,1181074,248070.0,솔루엠보통주
16615,248070,2021-04-16,0.0407766990291262,25750,26800,1050,1995750,248070.0,솔루엠보통주
16616,248070,2021-04-08,0.0490797546012269,24450,25650,1200,1212862,248070.0,솔루엠보통주
16617,248070,2021-03-31,0.0594795539033457,26900,25300,-1600,2376189,248070.0,솔루엠보통주
16618,248070,2021-03-24,0.1358574610244989,22450,25500,3050,6219517,248070.0,솔루엠보통주
16619,248070,2021-03-03,0.0632054176072234,22150,23550,1400,1013646,248070.0,솔루엠보통주
16620,248070,2021-02-26,0.0617021276595744,23500,22050,-1450,1148307,248070.0,솔루엠보통주
16621,248070,2021-02-23,0.0439121756487025,25050,23950,-1100,1243470,248070.0,솔루엠보통주
16622,248070,2021-02-17,0.0924657534246575,29200,26500,-2700,3834364,248070.0,솔루엠보통주
16623,248070,2021-02-16,0.0503597122302158,27800,29200,1400,8039412,248070.0,솔루엠보통주
16624,248070,2021-02-09,0.04642166344294,25850,27050,1200,11146486,248070.0,솔루엠보통주
16625,248070,2021-02-08,0.0402414486921529,24850,25850,1000,6428840,248070.0,솔루엠보통주
16626,248070,2021-02-05,0.0460652591170825,26050,24850,-1200,6899845,248070.0,솔루엠보통주
16627,248070,2021-02-04,0.0843585237258348,28450,26050,-2400,3681410,248070.0,솔루엠보통주
16628,248070,2021-02-02,0.1951710261569416,24850,29150,4300,19866445,248070.0,솔루엠보통주
16629,248070,2021-02-05,0.0460652591170825,26050,24850,-1200,6899845,248070.0,솔루엠보통주
16630,248070,2021-02-04,0.0843585237258348,28450,26050,-2400,3681410,248070.0,솔루엠보통주
16631,248070,2021-02-02,0.1951710261569416,24850,29150,4300,19866445,248070.0,솔루엠보통주
16632,248070,2021-02-05,0.0460652591170825,26050,24850,-1200,6899845,248070.0,솔루엠보통주
16633,248070,2021-02-04,0.0843585237258348,28450,26050,-2400,3681410,248070.0,솔루엠보통주
16634,248070,2021-02-02,0.1951710261569416,24850,29150,4300,19866445,248070.0,솔루엠보통주
16635,248070,2021-02-05,0.0460652591170825,26050,24850,-1200,6899845,248070.0,솔루엠보통주
16636,248070,2021-02-04,0.0843585237258348,28450,26050,-2400,3681410,248070.0,솔루엠보통주
16637,248070,2021-02-02,0.1951710261569416,24850,29150,4300,19866445,248070.0,솔루엠보통주
16638,248070,2021-02-05,0.0460652591170825,26050,24850,-1200,6899845,248070.0,솔루엠보통주
16639,248070,2021-02-04,0.0843585237258348,28450,26050,-2400,3681410,248070.0,솔루엠보통주
16640,248070,2021-02-02,0.1951710261569416,24850,29150,4300,19866445,248070.0,솔루엠보통주
16641,248070,2021-02-05,0.0460652591170825,26050,24850,-1200,6899845,248070.0,솔루엠보통주
16642,248070,2021-02-04,0.0843585237258348,28450,26050,-2400,3681410,248070.0,솔루엠보통주
16643,248070,2021-02-02,0.1951710261569416,24850,29150,4300,19866445,248070.0,솔루엠보통주
16644,248070,2021-02-05,0.0460652591170825,26050,24850,-1200,6899845,248070.0,솔루엠보통주
16645,248070,2021-02-04,0.0843585237258348,28450,26050,-2400,3681410,248070.0,솔루엠보통주
16646,248070,2021-02-02,0.1951710261569416,24850,29150,4300,19866445,248070.0,솔루엠보통주
16647,248070,2021-02-05,0.0460652591170825,26050,24850,-1200,6899845,248070.0,솔루엠보통주
16648,248070,2021-02-04,0.0843585237258348,28450,26050,-2400,3681410,248070.0,솔루엠보통주
16649,248070,2021-02-02,0.1951710261569416,24850,29150,4300,19866445,248070.0,솔루엠보통주
16650,248070,2021-02-05,0.0460652591170825,26050,24850,-1200,6899845,248070.0,솔루엠보통주
16651,248070,2021-02-04,0.0843585237258348,28450,26050,-2400,3681410,248070.0,솔루엠보통주
16652,248070,2021-02-02,0.1951710261569416,24850,29150,4300,19866445,248070.0,솔루엠보통주
16653,248070,2021-02-05,0.0460652591170825,26050,24850,-1200,6899845,248070.0,솔루엠보통주
16654,248070,2021-02-04,0.0843585237258348,28450,26050,-2400,3681410,248070.0,솔루엠보통주
16655,248070,2021-02-02,0.1951710261569416,24850,29150,4300,19866445,248070.0,솔루엠보통주
16656,248070,2021-02-05,0.0460652591170825,26050,24850,-1200,6899845,248070.0,솔루엠보통주
16657,248070,2021-02-04,0.0843585237258348,28450,26050,-2400,3681410,248070.0,솔루엠보통주
16658,248070,2021-02-02,0.1951710261569416,24850,29150,4300,19866445,248070.0,솔루엠보통주
16659,248070,2021-02-05,0.0460652591170825,26050,24850,-1200,6899845,248070.0,솔루엠보통주
16660,248070,2021-02-04,0.0843585237258348,28450,26050,-2400,3681410,248070.0,솔루엠보통주
16661,248070,2021-02-02,0.1951710261569416,24850,29150,4300,19866445,248070.0,솔루엠보통주
16662,248070,2021-02-05,0.0460652591170825,26050,24850,-1200,6899845,248070.0,솔루엠보통주
16663,248070,2021-02-04,0.0843585237258348,28450,26050,-2400,3681410,248070.0,솔루엠보통주
16664,248070,2021-02-02,0.1951710261569416,24850,29150,4300,19866445,248070.0,솔루엠보통주
16665,248070,2021-02-05,0.0460652591170825,26050,24850,-1200,6899845,248070.0,솔루엠보통주
16666,248070,2021-02-04,0.0843585237258348,28450,26050,-2400,3681410,248070.0,솔루엠보통주
16667,248070,2021-02-02,0.1951710261569416,24850,29150,4300,19866445,248070.0,솔루엠보통주
16668,248070,2021-02-05,0.0460652591170825,26050,24850,-1200,6899845,248070.0,솔루엠보통주
16669,248070,2021-02-04,0.0843585237258348,28450,26050,-2400,3681410,248070.0,솔루엠보통주
16670,248070,2021-02-02,0.1951710261569416,24850,29150,4300,19866445,248070.0,솔루엠보통주
16671,248070,2021-02-05,0.0460652591170825,26050,24850,-1200,6899845,248070.0,솔루엠보통주
16672,248070,2021-02-04,0.0843585237258348,28450,26050,-2400,3681410,248070.0,솔루엠보통주
16673,248070,2021-02-02,0.1951710261569416,24850,29150,4300,19866445,248070.0,솔루엠보통주
16674,248070,2021-02-05,0.0460652591170825,26050,24850,-1200,6899845,248070.0,솔루엠보통주
16675,248070,2021-02-04,0.0843585237258348,28450,26050,-2400,3681410,248070.0,솔루엠보통주
16676,248070,2021-02-02,0.1951710261569416,24850,29150,4300,19866445,248070.0,솔루엠보통주
16677,248070,2021-02-05,0.0460652591170825,26050,24850,-1200,6899845,248070.0,솔루엠보통주
16678,248070,2021-02-04,0.0843585237258348,28450,26050,-2400,3681410,248070.0,솔루엠보통주
16679,248070,2021-02-02,0.1951710261569416,24850,29150,4300,19866445,248070.0,솔루엠보통주
16680,248070,2021-02-05,0.0460652591170825,26050,24850,-1200,6899845,248070.0,솔루엠보통주
16681,248070,2021-02-04,0.0843585237258348,28450,26050,-2400,3681410,248070.0,솔루엠보통주
16682,248070,2021-02-02,0.1951710261569416,24850,29150,4300,19866445,248070.0,솔루엠보통주
16683,248070,2021-02-05,0.0460652591170825,26050,24850,-1200,6899845,248070.0,솔루엠보통주
16684,248070,2021-02-04,0.0843585237258348,28450,26050,-2400,3681410,248070.0,솔루엠보통주
16685,248070,2021-02-02,0.1951710261569416,24850,29150,4300,19866445,248070.0,솔루엠보통주
16686,248070,2021-02-05,0.0460652591170825,26050,24850,-1200,6899845,248070.0,솔루엠보통주
16687,248070,2021-02-04,0.0843585237258348,28450,26050,-2400,3681410,248070.0,솔루엠보통주
16688,248070,2021-02-02,0.1951710261569416,24850,29150,4300,19866445,248070.0,솔루엠보통주
16689,248070,2021-02-05,0.0460652591170825,26050,24850,-1200,6899845,248070.0,솔루엠보통주
16690,248070,2021-02-04,0.0843585237258348,28450,26050,-2400,3681410,248070.0,솔루엠보통주
16691,248070,2021-02-02,0.1951710261569416,24850,29150,4300,19866445,248070.0,솔루엠보통주
16692,248070,2021-02-05,0.0460652591170825,26050,24850,-1200,6899845,248070.0,솔루엠보통주
16693,248070,2021-02-04,0.0843585237258348,28450,26050,-2400,3681410,248070.0,솔루엠보통주
16694,248070,2021-02-02,0.1951710261569416,24850,29150,4300,19866445,248070.0,솔루엠보통주
16695,248070,2021-02-05,0.0460652591170825,26050,24850,-1200,6899845,248070.0,솔루엠보통주
16696,248070,2021-02-04,0.0843585237258348,28450,26050,-2400,3681410,248070.0,솔루엠보통주
16697,248070,2021-02-02,0.1951710261569416,24850,29150,4300,19866445,248070.0,솔루엠보통주
16698,248070,2021-02-05,0.0460652591170825,26050,24850,-1200,6899845,248070.0,솔루엠보통주
16699,248070,2021-02-04,0.0843585237258348,28450,26050,-2400,3681410,248070.0,솔루엠보통주
16700,248070,2021-02-02,0.1951710261569416,24850,29150,4300,19866445,248070.0,솔루엠보통주
16701,248070,2021-02-05,0.0460652591170825,26050,24850,-1200,6899845,248070.0,솔루엠보통주
16702,248070,2021-02-04,0.0843585237258348,28450,26050,-2400,3681410,248070.0,솔루엠보통주
16703,248070,2021-02-02,0.1951710261569416,24850,29150,4300,19866445,248070.0,솔루엠보통주
16704,248070,2021-02-05,0.0460652591170825,26050,24850,-1200,6899845,248070.0,솔루엠보통주
16705,248070,2021-02-04,0.0843585237258348,28450,26050,-2400,3681410,248070.0,솔루엠보통주
16706,248070,2021-02-02,0.1951710261569416,24850,29150,4300,19866445,248070.0,솔루엠보통주
16707,248070,2021-02-05,0.0460652591170825,26050,24850,-1200,6899845,248070.0,솔루엠보통주
16708,248070,2021-02-04,0.0843585237258348,28450,26050,-2400,3681410,248070.0,솔루엠보통주
16709,248070,2021-02-02,0.1951710261569416,24850,29150,4300,19866445,248070.0,솔루엠보통주
16710,248070,2021-02-05,0.0460652591170825,26050,24850,-1200,6899845,248070.0,솔루엠보통주
16711,248070,2021-02-04,0.0843585237258348,28450,26050,-2400,3681410,248070.0,솔루엠보통주
16712,248070,2021-02-02,0.1951710261569416,24850,29150,4300,19866445,248070.0,솔루엠보통주
16713,248070,2021-02-05,0.0460652591170825,26050,24850,-1200,6899845,248070.0,솔루엠보통주
16714,248070,2021-02-04,0.0843585237258348,28450,26050,-2400,3681410,248070.0,솔루엠보통주
16715,248070,2021-02-02,0.1951710261569416,24850,29150,4300,19866445,248070.0,솔루엠보통주
16716,248070,2021-02-05,0.0460652591170825,26050,24850,-1200,6899845,248070.0,솔루엠보통주
16717,248070,2021-02-04,0.0843585237258348,28450,26050,-2400,3681410,248070.0,솔루엠보통주
16718,248070,2021-02-02,0.1951710261569416,24850,29150,4300,19866445,248070.0,솔루엠보통주
16719,248070,2021-02-05,0.0460652591170825,26050,24850,-1200,6899845,248070.0,솔루엠보통주
16720,248070,2021-02-04,0.0843585237258348,28450,26050,-2400,3681410,248070.0,솔루엠보통주
16721,248070,2021-02-02,0.1951710261569416,24850,29150,4300,19866445,248070.0,솔루엠보통주
16722,248070,2021-02-05,0.0460652591170825,26050,24850,-1200,6899845,248070.0,솔루엠보통주
16723,248070,2021-02-04,0.0843585237258348,28450,26050,-2400,3681410,248070.0,솔루엠보통주
16724,248070,2021-02-02,0.1951710261569416,24850,29150,4300,19866445,248070.0,솔루엠보통주
16725,248070,2021-02-05,0.0460652591170825,26050,24850,-1200,6899845,248070.0,솔루엠보통주
16726,248070,2021-02-04,0.0843585237258348,28450,26050,-2400,3681410,248070.0,솔루엠보통주
16727,248070,2021-02-02,0.1951710261569416,24850,29150,4300,19866445,248070.0,솔루엠보통주
16728,248070,2021-02-05,0.0460652591170825,26050,24850,-1200,6899845,248070.0,솔루엠보통주
16729,248070,2021-02-04,0.0843585237258348,28450,26050,-2400,3681410,248070.0,솔루엠보통주
16730,248070,2021-02-02,0.1951710261569416,24850,29150,4300,19866445,248070.0,솔루엠보통주
16731,248070,2021-02-05,0.0460652591170825,26050,24850,-1200,6899845,248070.0,솔루엠보통주
16732,248070,2021-02-04,0.0843585237258348,28450,26050,-2400,3681410,248070.0,솔루엠보통주
16733,248070,2021-02-02,0.1951710261569416,24850,29150,4300,19866445,248070.0,솔루엠보통주
16734,248070,2021-02-05,0.0460652591170825,26050,24850,-1200,6899845,248070.0,솔루엠보통주
16735,248070,2021-02-04,0.0843585237258348,28450,26050,-2400,3681410,248070.0,솔루엠보통주
16736,248070,2021-02-02,0.1951710261569416,24850,29150,4300,19866445,248070.0,솔루엠보통주
16737,248070,2021-02-05,0.0460652591170825,26050,24850,-1200,6899845,248070.0,솔루엠보통주
16738,248070,2021-02-04,0.0843585237258348,28450,26050,-2400,3681410,248070.0,솔루엠보통주
16739,248070,2021-02-02,0.1951710261569416,24850,29150,4300,19866445,248070.0,솔루엠보통주
16740,248070,2021-02-05,0.0460652591170825,26050,24850,-1200,6899845,248070.0,솔루엠보통주
16741,248070,2021-02-04,0.0843585237258348,28450,26050,-2400,3681410,248070.0,솔루엠보통주
16742,248070,2021-02-02,0.1951710261569416,24850,29150,4300,19866445,248070.0,솔루엠보통주
16743,248070,2021-02-05,0.0460652591170825,26050,24850,-1200,6899845,248070.0,솔루엠보통주
16744,248070,2021-02-04,0.0843585237258348,28450,26050,-2400,3681410,248070.0,솔루엠보통주
16745,248070,2021-02-02,0.1951710261569416,24850,29150,4300,19866445,248070.0,솔루엠보통주
16746,248070,2021-02-05,0.0460652591170825,26050,24850,-1200,6899845,248070.0,솔루엠보통주
16747,248070,2021-02-04,0.0843585237258348,28450,26050,-2400,3681410,248070.0,솔루엠보통주
16748,248070,2021-02-02,0.1951710261569416,24850,29150,4300,19866445,248070.0,솔루엠보통주
16749,248070,2021-02-05,0.0460652591170825,26050,24850,-1200,6899845,248070.0,솔루엠보통주
16750,248070,2021-02-04,0.0843585237258348,28450,26050,-2400,3681410,248070.0,솔루엠보통주
16751,248070,2021-02-02,0.1951710261569416,24850,29150,4300,19866445,248070.0,솔루엠보통주
16752,248070,2021-02-05,0.0460652591170825,26050,24850,-1200,6899845,248070.0,솔루엠보통주
16753,248070,2021-02-04,0.0843585237258348,28450,26050,-2400,3681410,248070.0,솔루엠보통주
16754,248070,2021-02-02,0.1951710261569416,24850,29150,4300,19866445,248070.0,솔루엠보통주
16755,248070,2021-02-05,0.0460652591170825,26050,24850,-1200,6899845,248070.0,솔루엠보통주
16756,248070,2021-02-04,0.0843585237258348,28450,26050,-2400,3681410,248070.0,솔루엠보통주
16757,248070,2021-02-02,0.1951710261569416,24850,29150,4300,19866445,248070.0,솔루엠보통주
16758,248070,2021-02-05,0.0460652591170825,26050,24850,-1200,6899845,248070.0,솔루엠보통주
16759,248070,2021-02-04,0.0843585237258348,28450,26050,-2400,3681410,248070.0,솔루엠보통주
16760,248070,2021-02-02,0.1951710261569416,24850,29150,4300,19866445,248070.0,솔루엠보통주
16761,248070,2021-02-05,0.0460652591170825,26050,24850,-1200,6899845,248070.0,솔루엠보통주
16762,248070,2021-02-04,0.0843585237258348,28450,26050,-2400,3681410,248070.0,솔루엠보통주
16763,248070,2021-02-02,0.1951710261569416,24850,29150,4300,19866445,248070.0,솔루엠보통주
16764,248070,2021-02-05,0.0460652591170825,26050,24850,-1200,6899845,248070.0,솔루엠보통주
16765,248070,2021-02-04,0.0843585237258348,28450,26050,-2400,3681410,248070.0,솔루엠보통주
16766,248070,2021-02-02,0.1951710261569416,24850,29150,4300,19866445,248070.0,솔루엠보통주
16767,248070,2021-02-05,0.0460652591170825,26050,24850,-1200,6899845,248070.0,솔루엠보통주
16768,248070,2021-02-04,0.0843585237258348,28450,26050,-2400,3681410,248070.0,솔루엠보통주
16769,248070,2021-02-02,0.1951710261569416,24850,29150,4300,19866445,248070.0,솔루엠보통주
16770,248070,2021-02-05,0.0460652591170825,26050,24850,-1200,6899845,248070.0,솔루엠보통주
16771,248070,2021-02-04,0.0843585237258348,28450,26050,-2400,3681410,248070.0,솔루엠보통주
16772,248070,2021-02-02,0.1951710261569416,24850,29150,4300,19866445,248070.0,솔루엠보통주
16773,248070,2021-02-05,0.0460652591170825,26050,24850,-1200,6899845,248070.0,솔루엠보통주
16774,248070,2021-02-04,0.0843585237258348,28450,26050,-2400,3681410,248070.0,솔루엠보통주
16775,248070,2021-02-02,0.1951710261569416,24850,29150,4300,19866445,248070.0,솔루엠보통주
16776,248070,2021-02-05,0.0460652591170825,26050,24850,-1200,6899845,248070.0,솔루엠보통주
16777,248070,2021-02-04,0.0843585237258348,28450,26050,-2400,3681410,248070.0,솔루엠보통주
16778,248070,2021-02-02,0.1951710261569416,24850,29150,4300,19866445,248070.0,솔루엠보통주
16779,248070,2021-02-05,0.0460652591170825,26050,24850,-1200,6899845,248070.0,솔루엠보통주
16780,248070,2021-02-04,0.0843585237258348,28450,26050,-2400,3681410,248070.0,솔루엠보통주
16781,248070,2021-02-02,0.1951710261569416,24850,29150,4300,19866445,248070.0,솔루엠보통주
16782,248070,2021-02-05,0.0460652591170825,26050,24850,-1200,6899845,248070.0,솔루엠보통주
16783,248070,2021-02-04,0.0843585237258348,28450,26050,-2400,3681410,248070.0,솔루엠보통주
16784,248070,2021-02-02,0.1951710261569416,24850,29150,4300,19866445,248070.0,솔루엠보통주
16785,248070,2021-02-05,0.0460652591170825,26050,24850,-1200,6899845,248070.0,솔루엠보통주
16786,248070,2021-02-04,0.0843585237258348,28450,26050,-2400,3681410,248070.0,솔루엠보통주
16787,248070,2021-02-02,0.1951710261569416,24850,29150,4300,19866445,248070.0,솔루엠보통주
16788,248070,2021-02-05,0.0460652591170825,26050,24850,-1200,6899845,248070.0,솔루엠보통주
16789,248070,2021-02-04,0.0843585237258348,28450,26050,-2400,3681410,248070.0,솔루엠보통주
16790,248070,2021-02-02,0.1951710261569416,24850,29150,4300,19866445,248070.0,솔루엠보통주
16791,248070,2021-02-05,0.0460652591170825,26050,24850,-1200,6899845,248070.0,솔루엠보통주
16792,248070,2021-02-04,0.0843585237258348,28450,26050,-2400,3681410,248070.0,솔루엠보통주
16793,248070,2021-02-02,0.1951710261569416,24850,29150,4300,19866445,248070.0,솔루엠보통주
16794,248070,2021-02-05,0.0460652591170825,26050,24850,-1200,6899845,248070.0,솔루엠보통주
16795,248070,2021-02-04,0.0843585237258348,28450,26050,-2400,3681410,248070.0,솔루엠보통주
16796,248070,2021-02-02,0.1951710261569416,24850,29150,4300,19866445,248070.0,솔루엠보통주
16797,248070,2021-02-05,0.0460652591170825,26050,24850,-1200,6899845,248070.0,솔루엠보통주
16798,248070,2021-02-04,0.0843585237258348,28450,26050,-2400,3681410,248070.0,솔루엠보통주
16799,248070,2021-02-02,0.1951710261569416,24850,29150,4300,19866445,248070.0,솔루엠보통주
16800,248070,2021-02-05,0.0460652591170825,26050,24850,-1200,6899845,248070.0,솔루엠보통주
16801,248070,2021-02-04,0.0843585237258348,28450,26050,-2400,3681410,248070.0,솔루엠보통주
16802,248070,2021-02-02,0.1951710261569416,24850,29150,4300,19866445,248070.0,솔루엠보통주
16803,248070,2021-02-05,0.0460652591170825,26050,24850,-1200,6899845,248070.0,솔루엠보통주
16804,248070,2021-02-04,0.0843585237258348,28450,26050,-2400,3681410,248070.0,솔루엠보통주
16805,248070,2021-02-02,0.1951710261569416,24850,29150,4300,19866445,248070.0,솔루엠보통주
16806,248070,2021-02-05,0.0460652591170825,26050,24850,-1200,6899845,248070.0,솔루엠보통주
16807,248070,2021-02-04,0.0843585237258348,28450,26050,-2400,3681410,248070.0,솔루엠보통주
16808,248070,2021-02-02,0.1951710261569416,24850,29150,4300,19866445,248070.0,솔루엠보통주
16809,248070,2021-02-05,0.0460652591170825,26050,24850,-1200,6899845,248070.0,솔루엠보통주
16810,248070,2021-02-04,0.0843585237258348,28450,26050,-2400,3681410,248070.0,솔루엠보통주
16811,248070,2021-02-02,0.1951710261569416,24850,29150,4300,19866445,248070.0,솔루엠보통주
16812,248070,2021-02-05,0.0460652591170825,26050,24850,-1200,6899845,248070.0,솔루엠보통주
16813,248070,2021-02-04,0.0843585237258348,28450,26050,-2400,3681410,248070.0,솔루엠보통주
16814,248070,2021-02-02,0.1951710261569416,24850,29150,4300,19866445,248070.0,솔루엠보통주
16815,248070,2021-02-05,0.0460652591170825,26050,24850,-1200,6899845,248070.0,솔루엠보통주
16816,248070,2021-02-04,0.0843585237258348,28450,26050,-2400,3681410,248070.0,솔루엠보통주
16817,248070,2021-02-02,0.1951710261569416,24850,29150,4300,19866445,248070.0,솔루엠보통주
16818,248070,2021-02-05,0.0460652591170825,26050,24850,-1200,6899845,248070.0,솔루엠보통주
16819,248070,2021-02-04,0.0843585237258348,28450,26050,-2400,3681410,248070.0,솔루엠보통주
16820,248070,2021-02-02,0.1951710261569416,24850,29150,4300,19866445,248070.0,솔루엠보통주
16821,248070,2021-02-05,0.0460652591170825,26050,24850,-1200,6899845,248070.0,솔루엠보통주
16822,248070,2021-02-04,0.0843585237258348,28450,26050,-2400,3681410,248070.0,솔루엠보통주
16823,248070,2021-02-02,0.1951710261569416,24850,29150,4300,19866445,248070.0,솔루엠보통주
16824,248070,2021-02-05,0.0460652591170825,26050,24850,-1200,6899845,248070.0,솔루엠보통주
16825,248070,2021-02-04,0.0843585237258348,28450,26050,-2400,3681410,248070.0,솔루엠보통주
16826,248070,2021-02-02,0.1951710261569416,24850,29150,4300,19866445,248070.0,솔루엠보통주
16827,248070,2021-02-05,0.0460652591170825,26050,24850,-1200,6899845,248070.0,솔루엠보통주
16828,248070,2021-02-04,0.0843585237258348,28450,26050,-2400,3681410,248070.0,솔루엠보통주
16829,248070,2021-02-02,0.1951710261569416,24850,29150,4300,19866445,248070.0,솔루엠보통주
16830,248070,2021-02-05,0.0460652591170825,26050,24850,-1200,6899845,248070.0,솔루엠보통주
16831,248070,2021-02-04,0.0843585237258348,28450,26050,-2400,3681410,248070.0,솔루엠보통주
16832,248070,2021-02-02,0.1951710261569416,24850,29150,4300,19866445,248070.0,솔루엠보통주
16833,248070,2021-02-05,0.0460652591170825,26050,24850,-1200,6899845,248070.0,솔루엠보통주
16834,248070,2021-02-04,0.0843585237258348,28450,26050,-2400,3681410,248070.0,솔루엠보통주
16835,248070,2021-02-02,0.1951710261569416,24850,29150,4300,19866445,248070.0,솔루엠보통주
16836,248070,2021-02-05,0.0460652591170825,26050,24850,-1200,6899845,248070.0,솔루엠보통주
16837,248070,2021-02-04,0.0843585237258348,28450,26050,-2400,3681410,248070.0,솔루엠보통주
16838,248070,2021-02-02,0.1951710261569416,24850,29150,4300,19866445,248070.0,솔루엠보통주
16839,248070,2021-02-05,0.0460652591170825,26050,24850,-1200,6899845,248070.0,솔루엠보통주
16840,248070,2021-02-04,0.0843585237258348,28450,26050,-2400,3681410,248070.0,솔루엠보통주
16841,248070,2021-02-02,0.1951710261569416,24850,29150,4300,19866445,248070.0,솔루엠보통주
16842,248070,2021-02-05,0.0460652591170825,26050,24850,-1200,6899845,248070.0,솔루엠보통주
16843,248070,2021-02-04,0.0843585237258348,28450,26050,-2400,3681410,248070.0,솔루엠보통주
16844,248070,2021-02-02,0.1951710261569416,24850,29150,4300,19866445,248070.0,솔루엠보통주
16845,248070,2021-02-05,0.0460652591170825,26050,24850,-1200,6899845,248070.0,솔루엠보통주
16846,248070,2021-02-04,0.0843585237258348,28450,26050,-2400,3681410,248070.0,솔루엠보통주
16847,248070,2021-02-02,0.1951710261569416,24850,29150,4300,19866445,248070.0,솔루엠보통주
16848,248070,2021-02-05,0.0460652591170825,26050,24850,-1200,6899845,248070.0,솔루엠보통주
16849,248070,2021-02-04,0.0843585237258348,28450,26050,-2400,3681410,248070.0,솔루엠보통주
16850,248070,2021-02-02,0.1951710261569416,24850,29150,4300,19866445,248070.0,솔루엠보통주
16851,248070,2021-02-05,0.0460652591170825,26050,24850,-1200,6899845,248070.0,솔루엠보통주
16852,248070,2021-02-04,0.0843585237258348,28450,26050,-2400,3681410,248070.0,솔루엠보통주
16853,248070,2021-02-02,0.1951710261569416,24850,29150,4300,19866445,248070.0,솔루엠보통주
16854,248070,2021-02-05,0.0460652591170825,26050,24850,-1200,6899845,248070.0,솔루엠보통주
16855,248070,2021-02-04,0.0843585237258348,28450,26050,-2400,3681410,248070.0,솔루엠보통주
16856,248070,2021-02-02,0.1951710261569416,24850,29150,4300,19866445,248070.0,솔루엠보통주
16857,248070,2021-02-05,0.0460652591170825,26050,24850,-1200,6899845,248070.0,솔루엠보통주
16858,248070,2021-02-04,0.0843585237258348,28450,26050,-2400,3681410,248070.0,솔루엠보통주
16859,248070,2021-02-02,0.1951710261569416,24850,29150,4300,19866445,248070.0,솔루엠보통주
16860,248070,2021-02-05,0.0460652591170825,26050,24850,-1200,6899845,248070.0,솔루엠보통주
16861,248070,2021-02-04,0.0843585237258348,28450,26050,-2400,3681410,248070.0,솔루엠보통주
16862,248070,2021-02-02,0.1951710261569416,24850,29150,4300,19866445,248070.0,솔루엠보통주
16863,248070,2021-02-05,0.0460652591170825,26050,24850,-1200,6899845,248070.0,솔루엠보통주
16864,248070,2021-02-04,0.0843585237258348,28450,26050,-2400,3681410,248070.0,솔루엠보통주
16865,248070,2021-02-02,0.1951710261569416,24850,29150,4300,19866445,248070.0,솔루엠보통주
16866,248070,2021-02-05,0.0460652591170825,26050,24850,-1200,6899845,248070.0,솔루엠보통주
16867,248070,2021-02-04,0.0843585237258348,28450,26050,-2400,3681410,248070.0,솔루엠보통주
16868,248070,2021-02-02,0.1951710261569416,24850,29150,4300,19866445,248070.0,솔루엠보통주
16869,248070,2021-02-05,0.0460652591170825,26050,24850,-1200,6899845,248070.0,솔루엠보통주
16870,248070,2021-02-04,0.0843585237258348,28450,26050,-2400,3681410,248070.0,솔루엠보통주
16871,248070,2021-02-02,0.1951710261569416,24850,29150,4300,19866445,248070.0,솔루엠보통주
16872,248070,2021-02-05,0.0460652591170825,26050,24850,-1200,6899845,248070.0,솔루엠보통주
16873,248070,2021-02-04,0.0843585237258348,28450,26050,-2400,3681410,248070.0,솔루엠보통주
16874,248070,2021-02-02,0.1951710261569416,24850,29150,4300,19866445,248070.0,솔루엠보통주
16875,248070,2021-02-05,0.0460652591170825,26050,24850,-1200,6899845,248070.0,솔루엠보통주
16876,248070,2021-02-04,0.0843585237258348,28450,26050,-2400,3681410,248070.0,솔루엠보통주
16877,248070,2021-02-02,0.1951710261569416,24850,29150,4300,19866445,248070.0,솔루엠보통주
16878,248070,2021-02-05,0.0460652591170825,26050,24850,-1200,6899845,248070.0,솔루엠보통주
16879,248070,2021-02-04,0.0843585237258348,28450,26050,-2400,3681410,248070.0,솔루엠보통주
16880,248070,2021-02-02,0.1951710261569416,24850,29150,4300,19866445,248070.0,솔루엠보통주
16881,248070,2021-02-05,0.0460652591170825,26050,24850,-1200,6899845,248070.0,솔루엠보통주
16882,248070,2021-02-04,0.0843585237258348,28450,26050,-2400,3681410,248070.0,솔루엠보통주
16883,248070,2021-02-02,0.1951710261569416,24850,29150,4300,19866445,248070.0,솔루엠보통주
16884,248070,2021-02-05,0.0460652591170825,26050,24850,-1200,6899845,248070.0,솔루엠보통주
16885,248070,2021-02-04,0.0843585237258348,28450,26050,-2400,3681410,248070.0,솔루엠보통주
16886,248070,2021-02-02,0.1951710261569416,24850,29150,4300,19866445,248070.0,솔루엠보통주
16887,248070,2021-02-05,0.0460652591170825,26050,24850,-1200,6899845,248070.0,솔루엠보통주
16888,248070,2021-02-04,0.0843585237258348,28450,26050,-2400,3681410,248070.0,솔루엠보통주
16889,248070,2021-02-02,0.1951710261569416,24850,29150,4300,19866445,248070.0,솔루엠보통주
16890,248070,2021-02-05,0.0460652591170825,26050,24850,-1200,6899845,248070.0,솔루엠보통주
16891,248070,2021-02-04,0.0843585237258348,28450,26050,-2400,3681410,248070.0,솔루엠보통주
16892,248070,2021-02-02,0.1951710261569416,24850,29150,4300,19866445,248070.0,솔루엠보통주
16893,248070,2021-02-05,0.0460652591170825,26050,24850,-1200,6899845,248070.0,솔루엠보통주
16894,248070,2021-02-04,0.0843585237258348,28450,26050,-2400,3681410,248070.0,솔루엠보통주
16895,248070,2021-02-02,0.1951710261569416,24850,29150,4300,19866445,248070.0,솔루엠보통주
16896,248070,2021-02-05,0.0460652591170825,26050,24850,-1200,6899845,248070.0,솔루엠보통주
16897,248070,2021-02-04,0.0843585237258348,28450,26050,-2400,3681410,248070.0,솔루엠보통주
16898,248070,2021-02-02,0.1951710261569416,24850,29150,4300,19866445,248070.0,솔루엠보통주
16899,248070,2021-02-05,0.0460652591170825,26050,24850,-1200,6899845,248070.0,솔루엠보통주
16900,248070,2021-02-04,0.0843585237258348,28450,26050,-2400,3681410,248070.0,솔루엠보통주
16901,248070,2021-02-02,0.1951710261569416,24850,29150,4300,19866445,248070.0,솔루엠보통주
16902,248070,2021-02-05,0.0460652591170825,26050,24850,-1200,6899845,248070.0,솔루엠보통주
16903,248070,2021-02-04,0.0843585237258348,28450,26050,-2400,3681410,248070.0,솔루엠보통주
16904,248070,2021-02-02,0.1951710261569416,24850,29150,4300,19866445,248070.0,솔루엠보통주
16905,248070,2021-02-05,0.0460652591170825,26050,24850,-1200,6899845,248070.0,솔루엠보통주
16906,248070,2021-02-04,0.0843585237258348,28450,26050,-2400,3681410,248070.0,솔루엠보통주
16907,248070,2021-02-02,0.1951710261569416,24850,29150,4300,19866445,248070.0,솔루엠보통주
16908,248070,2021-02-05,0.0460652591170825,26050,24850,-1200,6899845,248070.0,솔루엠보통주
16909,248070,2021-02-04,0.0843585237258348,28450,26050,-2400,3681410,248070.0,솔루엠보통주
16910,248070,2021-02-02,0.1951710261569416,24850,29150,4300,19866445,248070.0,솔루엠보통주
16911,248070,2021-02-05,0.0460652591170825,26050,24850,-1200,6899845,248070.0,솔루엠보통주
16912,248070,2021-02-04,0.0843585237258348,28450,26050,-2400,3681410,248070.0,솔루엠보통주
16913,248070,2021-02-02,0.1951710261569416,24850,29150,4300,19866445,248070.0,솔루엠보통주
16914,248070,2021-02-05,0.0460652591170825,26050,24850,-1200,6899845,248070.0,솔루엠보통주
16915,248070,2021-02-04,0.0843585237258348,28450,26050,-2400,3681410,248070.0,솔루엠보통주
16916,248070,2021-02-02,0.1951710261569416,24850,29150,4300,19866445,248070.0,솔루엠보통주
16917,248070,2021-02-05,0.0460652591170825,26050,24850,-1200,6899845,248070.0,솔루엠보통주
16918,248070,2021-02-04,0.0843585237258348,28450,26050,-2400,3681410,248070.0,솔루엠보통주
16919,248070,2021-02-02,0.1951710261569416,24850,29150,4300,19866445,248070.0,솔루엠보통주
16920,248070,2021-02-05,0.0460652591170825,26050,24850,-1200,6899845,248070.0,솔루엠보통주
16921,248070,2021-02-04,0.0843585237258348,28450,26050,-2400,3681410,248070.0,솔루엠보통주
16922,248070,2021-02-02,0.1951710261569416,24850,29150,4300,19866445,248070.0,솔루엠보통주
16923,248070,2021-02-05,0.0460652591170825,26050,24850,-1200,6899845,248070.0,솔루엠보통주
16924,248070,2021-02-04,0.0843585237258348,28450,26050,-2400,3681410,248070.0,솔루엠보통주
16925,248070,2021-02-02,0.1951710261569416,24850,29150,4300,19866445,248070.0,솔루엠보통주
16926,248070,2021-02-05,0.0460652591170825,26050,24850,-1200,6899845,248070.0,솔루엠보통주
16927,248070,2021-02-04,0.0843585237258348,28450,26050,-2400,3681410,248070.0,솔루엠보통주
16928,248070,2021-02-02,0.1951710261569416,24850,29150,4300,19866445,248070.0,솔루엠보통주
16929,248070,2021-02-05,0.0460652591170825,26050,24850,-1200,6899845,248070.0,솔루엠보통주
16930,248070,2021-02-04,0.0843585237258348,28450,26050,-2400,3681410,248070.0,솔루엠보통주
16931,248070,2021-02-02,0.1951710261569416,24850,29150,4300,19866445,248070.0,솔루엠보통주
16932,248070,2021-02-05,0.0460652591170825,26050,24850,-1200,6899845,248070.0,솔루엠보통주
16933,248070,2021-02-04,0.0843585237258348,28450,26050,-2400,3681410,248070.0,솔루엠보통주
16934,248070,2021-02-02,0.1951710261569416,24850,29150,4300,19866445,248070.0,솔루엠보통주
16935,248070,2021-02-05,0.0460652591170825,26050,24850,-1200,6899845,248070.0,솔루엠보통주
16936,248070,2021-02-04,0.0843585237258348,28450,26050,-2400,3681410,248070.0,솔루엠보통주
16937,248070,2021-02-02,0.1951710261569416,24850,29150,4300,19866445,248070.0,솔루엠보통주
16938,248070,2021-02-05,0.0460652591170825,26050,24850,-1200,6899845,248070.0,솔루엠보통주
16939,248070,2021-02-04,0.0843585237258348,28450,26050,-2400,3681410,248070.0,솔루엠보통주
16940,248070,2021-02-02,0.1951710261569416,24850,29150,4300,19866445,248070.0,솔루엠보통주
16941,248070,2021-02-05,0.0460652591170825,26050,24850,-1200,6899845,248070.0,솔루엠보통주
16942,248070,2021-02-04,0.0843585237258348,28450,26050,-2400,3681410,248070.0,솔루엠보통주
16943,248070,2021-02-02,0.1951710261569416,24850,29150,4300,19866445,248070.0,솔루엠보통주
16944,248070,2021-02-05,0.0460652591170825,26050,24850,-1200,6899845,248070.0,솔루엠보통주
16945,248070,2021-02-04,0.0843585237258348,28450,26050,-2400,3681410,248070.0,솔루엠보통주
16946,248070,2021-02-02,0.1951710261569416,24850,29150,4300,19866445,248070.0,솔루엠보통주
16947,248070,2021-02-05,0.0460652591170825,26050,24850,-1200,6899845,248070.0,솔루엠보통주
16948,248070,2021-02-04,0.0843585237258348,28450,26050,-2400,3681410,248070.0,솔루엠보통주
16949,248070,2021-02-02,0.1951710261569416,24850,29150,4300,19866445,248070.0,솔루엠보통주
16950,248070,2021-02-05,0.0460652591170825,26050,24850,-1200,6899845,248070.0,솔루엠보통주
16951,248070,2021-02-04,0.0843585237258348,28450,26050,-2400,3681410,248070.0,솔루엠보통주
16952,248070,2021-02-02,0.1951710261569416,24850,29150,4300,19866445,248070.0,솔루엠보통주
16953,248070,2021-02-05,0.0460652591170825,26050,24850,-1200,6899845,248070.0,솔루엠보통주
16954,248070,2021-02-04,0.0843585237258348,28450,26050,-2400,3681410,248070.0,솔루엠보통주
16955,248070,2021-02-02,0.1951710261569416,24850,29150,4300,19866445,248070.0,솔루엠보통주
16956,248070,2021-02-05,0.0460652591170825,26050,24850,-1200,6899845,248070.0,솔루엠보통주
16957,248070,2021-02-04,0.0843585237258348,28450,26050,-2400,3681410,248070.0,솔루엠보통주
16958,251270,2021-04-12,0.0646387832699619,131500,140000,8500,941931,251270.0,넷마블보통주
16959,251270,2021-02-26,0.05,130000,123500,-6500,396171,251270.0,넷마블보통주
16960,251270,2021-02-25,0.0526315789473684,123500,130000,6500,363011,251270.0,넷마블보통주
16961,251270,2021-02-04,0.0515463917525773,145500,138000,-7500,820392,251270.0,넷마블보통주
16962,251270,2021-02-01,0.0608365019011406,131500,139500,8000,1056831,251270.0,넷마블보통주
16963,251270,2021-01-22,0.0495867768595041,121000,127000,6000,888658,251270.0,넷마블보통주
16964,251270,2021-01-11,0.0522388059701492,134000,127000,-7000,1242320,251270.0,넷마블보통주
16965,251270,2020-12-30,0.0436507936507936,126000,131500,5500,584685,251270.0,넷마블보통주
16966,251270,2020-10-30,0.0526315789473684,123500,117000,-6500,442160,251270.0,넷마블보통주
16967,251270,2020-10-26,0.0433070866141732,127000,121500,-5500,448855,251270.0,넷마블보통주
16968,251270,2020-10-22,0.0413533834586466,133000,127500,-5500,563312,251270.0,넷마블보통주
16969,251270,2020-10-15,0.0986842105263157,152000,137000,-15000,1995819,251270.0,넷마블보통주
16970,251270,2020-09-24,0.0401146131805157,174500,167500,-7000,905067,251270.0,넷마블보통주
16971,251270,2020-09-03,0.1242774566473988,173000,194500,21500,4764031,251270.0,넷마블보통주
16972,251270,2020-09-02,0.0646153846153846,162500,173000,10500,1202889,251270.0,넷마블보통주
16973,251270,2020-08-31,0.0918032786885245,152500,166500,14000,1798138,251270.0,넷마블보통주
16974,251270,2020-08-07,0.0785714285714285,140000,151000,11000,1548323,251270.0,넷마블보통주
16975,251270,2020-07-15,0.0629629629629629,135000,126500,-8500,911921,251270.0,넷마블보통주
16976,251270,2020-07-13,0.0470588235294117,127500,133500,6000,739238,251270.0,넷마블보통주
16977,251270,2020-07-07,0.055793991416309,116500,123000,6500,1525070,251270.0,넷마블보통주
16978,251270,2020-07-06,0.0938967136150234,106500,116500,10000,2030908,251270.0,넷마블보통주
16979,251270,2020-07-02,0.0916580844490216,97100,106000,8900,1403159,251270.0,넷마블보통주
16980,251270,2020-06-30,0.055672268907563,95200,100500,5300,724776,251270.0,넷마블보통주
16981,251270,2020-06-23,0.0617154811715481,95600,101500,5900,1064185,251270.0,넷마블보통주
16982,251270,2020-06-16,0.0464362850971922,92600,96900,4300,309927,251270.0,넷마블보통주
16983,251270,2020-05-14,0.0894230769230769,104000,94700,-9300,1205146,251270.0,넷마블보통주
16984,251270,2020-05-12,0.055,100000,105500,5500,1060894,251270.0,넷마블보통주
16985,251270,2020-05-06,0.04,92500,96200,3700,325862,251270.0,넷마블보통주
16986,251270,2020-03-18,0.048780487804878,94300,89700,-4600,346239,251270.0,넷마블보통주
16987,251270,2020-03-13,0.0551724137931034,87000,91800,4800,892080,251270.0,넷마블보통주
16988,251270,2020-03-09,0.0443243243243243,92500,88400,-4100,377974,251270.0,넷마블보통주
16989,251270,2020-03-04,0.0715909090909091,88000,94300,6300,453992,251270.0,넷마블보통주
16990,251270,2020-02-14,0.0460385438972162,93400,97700,4300,540815,251270.0,넷마블보통주
16991,251270,2020-02-06,0.0419426048565121,90600,94400,3800,255725,251270.0,넷마블보통주
16992,251270,2020-01-28,0.0466804979253112,96400,91900,-4500,242539,251270.0,넷마블보통주
16993,251270,2020-01-13,0.0758082497212932,89700,96500,6800,571447,251270.0,넷마블보통주
16994,251270,2019-11-13,0.0420711974110032,92700,88800,-3900,403124,251270.0,넷마블보통주
16995,251270,2019-10-08,0.0447598253275109,91600,95700,4100,264671,251270.0,넷마블보통주
16996,251270,2019-10-07,0.0480549199084668,87400,91600,4200,466800,251270.0,넷마블보통주
16997,251270,2019-10-04,0.0541125541125541,92400,87400,-5000,385123,251270.0,넷마블보통주
16998,251270,2019-10-02,0.0434782608695652,96600,92400,-4200,249884,251270.0,넷마블보통주
16999,251270,2019-08-20,0.0505617977528089,89000,93500,4500,321647,251270.0,넷마블보통주
17000,251270,2019-08-14,0.0721040189125295,84600,90700,6100,460427,251270.0,넷마블보통주
17001,251270,2019-08-13,0.0620842572062084,90200,84600,-5600,737962,251270.0,넷마블보통주
17002,251270,2019-07-10,0.0446700507614213,98500,94100,-4400,664558,251270.0,넷마블보통주
17003,251270,2019-07-09,0.0523504273504273,93600,98500,4900,1049234,251270.0,넷마블보통주
17004,251270,2019-07-01,0.1106194690265486,113000,100500,-12500,1322257,251270.0,넷마블보통주
17005,251270,2019-06-28,0.0775510204081632,122500,113000,-9500,778528,251270.0,넷마블보통주
17006,251270,2019-06-25,0.054054054054054,129500,122500,-7000,507583,251270.0,넷마블보통주
17007,251270,2019-06-14,0.0411522633744856,121500,126500,5000,597483,251270.0,넷마블보통주
17008,251270,2019-06-07,0.0403225806451612,124000,119000,-5000,385292,251270.0,넷마블보통주
17009,251270,2019-06-03,0.0480349344978165,114500,120000,5500,321145,251270.0,넷마블보통주
17010,251270,2019-05-15,0.040650406504065,123000,118000,-5000,467372,251270.0,넷마블보통주
17011,251270,2019-05-14,0.0465116279069767,129000,123000,-6000,379799,251270.0,넷마블보통주
17012,251270,2019-05-10,0.0607287449392712,123500,131000,7500,377194,251270.0,넷마블보통주
17013,251270,2019-04-23,0.0441176470588235,136000,130000,-6000,268321,251270.0,넷마블보통주
17014,251270,2019-04-10,0.040650406504065,123000,128000,5000,287938,251270.0,넷마블보통주
17015,251270,2019-04-03,0.0414937759336099,120500,125500,5000,312809,251270.0,넷마블보통주
17016,251270,2019-03-26,0.0521739130434782,115000,121000,6000,296414,251270.0,넷마블보통주
17017,251270,2019-02-15,0.0403225806451612,124000,119000,-5000,221949,251270.0,넷마블보통주
17018,251270,2019-02-13,0.0466101694915254,118000,123500,5500,447866,251270.0,넷마블보통주
17019,251270,2019-02-08,0.0867579908675799,109500,119000,9500,1354003,251270.0,넷마블보통주
17020,251270,2019-01-04,0.0432692307692307,104000,108500,4500,218348,251270.0,넷마블보통주
17021,251270,2019-01-02,0.0493273542600896,111500,106000,-5500,271562,251270.0,넷마블보통주
17022,251270,2018-12-27,0.0454545454545454,110000,115000,5000,250236,251270.0,넷마블보통주
17023,251270,2018-12-21,0.0504587155963302,109000,114500,5500,510705,251270.0,넷마블보통주
17024,251270,2018-12-10,0.0622222222222222,112500,105500,-7000,779248,251270.0,넷마블보통주
17025,251270,2018-12-06,0.1195219123505976,125500,110500,-15000,1579206,251270.0,넷마블보통주
17026,251270,2018-11-02,0.0502283105022831,109500,115000,5500,301230,251270.0,넷마블보통주
17027,251270,2018-10-31,0.0516431924882629,106500,112000,5500,550466,251270.0,넷마블보통주
17028,251270,2018-10-30,0.1601307189542483,91800,106500,14700,1159588,251270.0,넷마블보통주
17029,251270,2018-10-29,0.082,100000,91800,-8200,799904,251270.0,넷마블보통주
17030,251270,2018-10-26,0.0783410138248847,108500,100000,-8500,437001,251270.0,넷마블보통주
17031,251270,2018-10-15,0.0578512396694214,121000,114000,-7000,455347,251270.0,넷마블보통주
17032,251270,2018-10-08,0.0425531914893617,117500,122500,5000,465353,251270.0,넷마블보통주
17033,251270,2018-09-20,0.0491071428571428,112000,117500,5500,664074,251270.0,넷마블보통주
17034,251270,2018-08-21,0.0555555555555555,117000,123500,6500,398822,251270.0,넷마블보통주
17035,251270,2018-08-16,0.0607287449392712,123500,116000,-7500,1068017,251270.0,넷마블보통주
17036,251270,2018-08-09,0.1126760563380281,142000,126000,-16000,1245103,251270.0,넷마블보통주
17037,251270,2018-07-16,0.0566037735849056,159000,150000,-9000,486751,251270.0,넷마블보통주
17038,251270,2018-07-13,0.045045045045045,166500,159000,-7500,292058,251270.0,넷마블보통주
17039,251270,2018-05-29,0.0429042904290429,151500,158000,6500,831698,251270.0,넷마블보통주
17040,251270,2018-05-04,0.0489510489510489,143000,136000,-7000,337502,251270.0,넷마블보통주
17041,251270,2018-04-27,0.0757575757575757,132000,142000,10000,1015443,251270.0,넷마블보통주
17042,251270,2018-04-04,0.0786163522012578,159000,146500,-12500,612059,251270.0,넷마블보통주
17043,251270,2018-03-30,0.0408163265306122,147000,153000,6000,725123,251270.0,넷마블보통주
17044,251270,2018-03-09,0.0448275862068965,145000,151500,6500,459122,251270.0,넷마블보통주
17045,251270,2018-03-05,0.0466666666666666,150000,143000,-7000,270337,251270.0,넷마블보통주
17046,251270,2018-02-28,0.0544871794871794,156000,147500,-8500,899146,251270.0,넷마블보통주
17047,251270,2018-02-23,0.0429042904290429,151500,158000,6500,262177,251270.0,넷마블보통주
17048,251270,2018-02-12,0.0477941176470588,136000,142500,6500,274326,251270.0,넷마블보통주
17049,251270,2018-02-07,0.0816993464052287,153000,140500,-12500,1037686,251270.0,넷마블보통주
17050,251270,2018-02-06,0.0496894409937888,161000,153000,-8000,459578,251270.0,넷마블보통주
17051,251270,2018-02-05,0.0501474926253687,169500,161000,-8500,257288,251270.0,넷마블보통주
17052,251270,2018-01-26,0.0604229607250755,165500,175500,10000,635249,251270.0,넷마블보통주
17053,251270,2018-01-04,0.0524861878453038,181000,171500,-9500,617781,251270.0,넷마블보통주
17054,251270,2017-12-15,0.0426065162907268,199500,191000,-8500,621734,251270.0,넷마블보통주
17055,251270,2017-12-01,0.0828402366863905,169000,183000,14000,617111,251270.0,넷마블보통주
17056,251270,2017-11-30,0.0558659217877094,179000,169000,-10000,511746,251270.0,넷마블보통주
17057,251270,2017-11-28,0.043010752688172,186000,178000,-8000,476893,251270.0,넷마블보통주
17058,251270,2017-11-21,0.0408719346049046,183500,191000,7500,501789,251270.0,넷마블보통주
17059,251270,2017-11-06,0.0657142857142857,175000,186500,11500,759611,251270.0,넷마블보통주
17060,251270,2017-10-18,0.0412979351032448,169500,176500,7000,729789,251270.0,넷마블보통주
17061,251270,2017-10-17,0.0527950310559006,161000,169500,8500,775357,251270.0,넷마블보통주
17062,251270,2017-10-13,0.087248322147651,149000,162000,13000,905002,251270.0,넷마블보통주
17063,251270,2017-09-08,0.0474683544303797,158000,150500,-7500,369958,251270.0,넷마블보통주
17064,251270,2017-09-06,0.0431893687707641,150500,157000,6500,408286,251270.0,넷마블보통주
17065,251270,2017-08-30,0.0481099656357388,145500,152500,7000,389665,251270.0,넷마블보통주
17066,251270,2017-08-24,0.0836236933797909,143500,155500,12000,1363312,251270.0,넷마블보통주
17067,251270,2017-08-16,0.0419847328244274,131000,136500,5500,335214,251270.0,넷마블보통주
17068,251270,2017-08-04,0.0439560439560439,136500,130500,-6000,505939,251270.0,넷마블보통주
17069,251270,2017-07-07,0.0472972972972973,148000,155000,7000,452333,251270.0,넷마블보통주
17070,251270,2017-06-29,0.0402684563758389,149000,155000,6000,305111,251270.0,넷마블보통주
17071,251270,2017-06-12,0.0503355704697986,149000,141500,-7500,1361725,251270.0,넷마블보통주
17072,251270,2017-06-08,0.043613707165109,160500,153500,-7000,1255870,251270.0,넷마블보통주
17073,251270,2017-06-02,0.0462046204620462,151500,158500,7000,1005171,251270.0,넷마블보통주
17074,251270,2017-05-17,0.0769230769230769,156000,144000,-12000,2006418,251270.0,넷마블보통주
17075,251270,2017-05-17,0.0769230769230769,156000,144000,-12000,2006418,251270.0,넷마블보통주
17076,251270,2017-05-17,0.0769230769230769,156000,144000,-12000,2006418,251270.0,넷마블보통주
17077,251270,2017-05-17,0.0769230769230769,156000,144000,-12000,2006418,251270.0,넷마블보통주
17078,251270,2017-05-17,0.0769230769230769,156000,144000,-12000,2006418,251270.0,넷마블보통주
17079,251270,2017-05-17,0.0769230769230769,156000,144000,-12000,2006418,251270.0,넷마블보통주
17080,251270,2017-05-17,0.0769230769230769,156000,144000,-12000,2006418,251270.0,넷마블보통주
17081,251270,2017-05-17,0.0769230769230769,156000,144000,-12000,2006418,251270.0,넷마블보통주
17082,251270,2017-05-17,0.0769230769230769,156000,144000,-12000,2006418,251270.0,넷마블보통주
17083,251270,2017-05-17,0.0769230769230769,156000,144000,-12000,2006418,251270.0,넷마블보통주
17084,251270,2017-05-17,0.0769230769230769,156000,144000,-12000,2006418,251270.0,넷마블보통주
17085,251270,2017-05-17,0.0769230769230769,156000,144000,-12000,2006418,251270.0,넷마블보통주
17086,251270,2017-05-17,0.0769230769230769,156000,144000,-12000,2006418,251270.0,넷마블보통주
17087,251270,2017-05-17,0.0769230769230769,156000,144000,-12000,2006418,251270.0,넷마블보통주
17088,251270,2017-05-17,0.0769230769230769,156000,144000,-12000,2006418,251270.0,넷마블보통주
17089,251270,2017-05-17,0.0769230769230769,156000,144000,-12000,2006418,251270.0,넷마블보통주
17090,251270,2017-05-17,0.0769230769230769,156000,144000,-12000,2006418,251270.0,넷마블보통주
17091,251270,2017-05-17,0.0769230769230769,156000,144000,-12000,2006418,251270.0,넷마블보통주
17092,251270,2017-05-17,0.0769230769230769,156000,144000,-12000,2006418,251270.0,넷마블보통주
17093,251270,2017-05-17,0.0769230769230769,156000,144000,-12000,2006418,251270.0,넷마블보통주
17094,252670,2021-03-11,0.0445434298440979,2245,2145,-100,413670475,,
17095,252670,2021-02-26,0.0558252427184466,2060,2175,115,537602541,,
17096,252670,2021-02-25,0.0762331838565022,2230,2060,-170,526447366,,
17097,252670,2021-02-24,0.0469483568075117,2130,2230,100,736655197,,
17098,252670,2021-02-01,0.0527472527472527,2275,2155,-120,631911974,,
17099,252670,2021-01-29,0.0508083140877598,2165,2275,110,837063842,,
17100,252670,2021-01-26,0.0561224489795918,1960,2070,110,357656003,,
17101,252670,2021-01-25,0.0462287104622871,2055,1960,-95,336512000,,
17102,252670,2021-01-19,0.0558035714285714,2240,2115,-125,484379038,,
17103,252670,2021-01-18,0.0491803278688524,2135,2240,105,552680045,,
17104,252670,2021-01-15,0.0440097799511002,2045,2135,90,544112094,,
17105,252670,2021-01-08,0.0913140311804008,2245,2040,-205,464832002,,
17106,252670,2021-01-07,0.048728813559322,2360,2245,-115,300683421,,
17107,252670,2021-01-04,0.0517928286852589,2510,2380,-130,178030291,,
17108,252670,2020-12-30,0.0492424242424242,2640,2510,-130,276345359,,
17109,252670,2020-12-24,0.0418118466898954,2870,2750,-120,252984898,,
17110,252670,2020-12-09,0.0417362270450751,2995,2870,-125,218925446,,
17111,252670,2020-11-23,0.0465793304221251,3435,3275,-160,188096897,,
17112,252670,2020-11-16,0.0458970792767733,3595,3430,-165,200373612,,
17113,252670,2020-11-05,0.044280442804428,4065,3885,-180,240749482,,
17114,252670,2020-11-03,0.0407925407925407,4290,4115,-175,199801946,,
17115,252670,2020-10-30,0.0525059665871121,4190,4410,220,214675759,,
17116,252670,2020-09-24,0.0459905660377358,4240,4435,195,333011749,,
17117,252670,2020-09-22,0.0477941176470588,4080,4275,195,252446700,,
17118,252670,2020-08-20,0.076463560334528,4185,4505,320,329691686,,
17119,252670,2020-08-18,0.042027194066749,4045,4215,170,204873013,,
17120,252670,2020-07-28,0.0405405405405405,4810,4615,-195,194286530,,
17121,252670,2020-06-25,0.0525803310613437,5135,5405,270,242660764,,
17122,252670,2020-06-16,0.1174496644295302,5960,5260,-700,316290914,,
17123,252670,2020-06-15,0.0996309963099631,5420,5960,540,337746671,,
17124,252670,2020-06-11,0.0406342913776015,5045,5250,205,229822004,,
17125,252670,2020-06-03,0.0705467372134038,5670,5270,-400,230048100,,
17126,252670,2020-05-19,0.051012753188297,6665,6325,-340,131947471,,
17127,252670,2020-05-04,0.0600760456273764,6575,6970,395,180130954,,
17128,252670,2020-04-27,0.0432317505315379,7055,6750,-305,156679490,,
17129,252670,2020-04-17,0.0623268698060941,7220,6770,-450,257739187,,
17130,252670,2020-04-06,0.0804321728691476,8330,7660,-670,246362127,,
17131,252670,2020-04-02,0.0571913929784824,8830,8325,-505,384091052,,
17132,252670,2020-04-01,0.0914709517923362,8090,8830,740,269351753,,
17133,252670,2020-03-27,0.046937607326846,8735,8325,-410,422788093,,
17134,252670,2020-03-25,0.1219512195121951,9635,8460,-1175,375960417,,
17135,252670,2020-03-24,0.1764957264957265,11700,9635,-2065,266756217,,
17136,252670,2020-03-23,0.1111111111111111,10530,11700,1170,269458606,,
17137,252670,2020-03-20,0.1484027496967246,12365,10530,-1835,353530116,,
17138,252670,2020-03-19,0.1328447091158955,10915,12365,1450,493263934,,
17139,252670,2020-03-18,0.1206365503080082,9740,10915,1175,275017474,,
17140,252670,2020-03-16,0.0816091954022988,8700,9410,710,204351634,,
17141,252670,2020-03-13,0.0431654676258992,8340,8700,360,229000640,,
17142,252670,2020-03-12,0.0761290322580645,7750,8340,590,232154519,,
17143,252670,2020-03-11,0.0609171800136892,7305,7750,445,130760459,,
17144,252670,2020-03-09,0.0871794871794871,6825,7420,595,91256710,,
17145,252670,2020-03-04,0.0456165359942979,7015,6695,-320,88807232,,
17146,252670,2020-02-28,0.0642540620384047,6770,7205,435,101702582,,
17147,252670,2020-02-24,0.073469387755102,6125,6575,450,94418563,,
17148,252670,2020-02-06,0.0614886731391585,6180,5800,-380,61550484,,
17149,252670,2020-01-28,0.0614718614718614,5775,6130,355,36279514,,
17150,252670,2019-10-02,0.0418668496911461,7285,7590,305,30207511,,
17151,252670,2019-08-05,0.041147132169576,8020,8350,330,37915615,,
17152,252670,2019-07-08,0.0427118644067796,7375,7690,315,28401004,,
17153,252670,2019-05-09,0.0588235294117647,7140,7560,420,44997236,,
17154,252670,2019-04-29,0.040197461212976,7090,6805,-285,20186379,,
17155,252670,2019-01-09,0.0430879712746858,8355,7995,-360,21883656,,
17156,252670,2018-11-02,0.0746619635508524,8505,7870,-635,28527832,,
17157,252670,2018-10-23,0.048472775564409,7530,7895,365,18747738,,
17158,252670,2018-10-11,0.0835087719298245,7125,7720,595,22110467,,
17159,252670,2018-07-02,0.0449775112443778,6670,6970,300,20050900,,
17160,252670,2018-05-30,0.0439834024896265,6025,6290,265,16550381,,
17161,252670,2018-03-23,0.0697674418604651,5805,6210,405,22002991,,
17162,252670,2018-03-06,0.0427154843630816,6555,6275,-280,18004328,,
17163,252670,2018-02-09,0.0515297906602254,6210,6530,320,21883951,,
17164,252670,2018-02-07,0.0515378221113881,6015,6325,310,21369792,,
17165,252670,2018-02-02,0.0401459854014598,5480,5700,220,13692530,,
17166,252670,2017-05-08,0.05,7400,7030,-370,10544276,,
17167,252670,2016-11-10,0.0411089866156787,10460,10030,-430,17215972,,
17168,252670,2016-11-09,0.0433915211970074,10025,10460,435,36018301,,
17169,267250,2021-06-01,0.0638297872340425,70500,75000,4500,615920,267250.0,현대중공업지주보통주
17170,267250,2021-05-06,0.097841726618705,69500,76300,6800,877025,267250.0,현대중공업지주보통주
17171,267250,2021-04-26,0.0851788756388415,58700,63700,5000,1146567,267250.0,현대중공업지주보통주
17172,267250,2021-03-26,0.07380073800738,271000,291000,20000,189015,267250.0,현대중공업지주보통주
17173,267250,2021-02-23,0.072936660268714,260500,279500,19000,174483,267250.0,현대중공업지주보통주
17174,267250,2020-12-29,0.0879120879120879,318500,290500,-28000,211631,267250.0,현대중공업지주보통주
17175,267250,2020-12-11,0.0608228980322003,279500,296500,17000,129829,267250.0,현대중공업지주보통주
17176,267250,2020-11-24,0.0431519699812382,266500,278000,11500,111471,267250.0,현대중공업지주보통주
17177,267250,2020-11-10,0.0665236051502145,233000,248500,15500,184771,267250.0,현대중공업지주보통주
17178,267250,2020-11-09,0.0495495495495495,222000,233000,11000,100959,267250.0,현대중공업지주보통주
17179,267250,2020-09-24,0.0401891252955082,211500,203000,-8500,64132,267250.0,현대중공업지주보통주
17180,267250,2020-09-11,0.0492170022371364,223500,234500,11000,143819,267250.0,현대중공업지주보통주
17181,267250,2020-08-20,0.0578842315369261,250500,236000,-14500,54402,267250.0,현대중공업지주보통주
17182,267250,2020-08-18,0.049618320610687,262000,249000,-13000,64495,267250.0,현대중공업지주보통주
17183,267250,2020-08-12,0.0465587044534413,247000,258500,11500,99252,267250.0,현대중공업지주보통주
17184,267250,2020-08-11,0.0646551724137931,232000,247000,15000,125277,267250.0,현대중공업지주보통주
17185,267250,2020-06-16,0.0585858585858585,247500,262000,14500,48173,267250.0,현대중공업지주보통주
17186,267250,2020-06-15,0.0764925373134328,268000,247500,-20500,69515,267250.0,현대중공업지주보통주
17187,267250,2020-06-12,0.056338028169014,284000,268000,-16000,59806,267250.0,현대중공업지주보통주
17188,267250,2020-05-06,0.0531914893617021,235000,247500,12500,76150,267250.0,현대중공업지주보통주
17189,267250,2020-04-29,0.0519480519480519,231000,243000,12000,94372,267250.0,현대중공업지주보통주
17190,267250,2020-04-06,0.0825471698113207,212000,229500,17500,85548,267250.0,현대중공업지주보통주
17191,267250,2020-04-02,0.0668380462724935,194500,207500,13000,67324,267250.0,현대중공업지주보통주
17192,267250,2020-03-25,0.150997150997151,175500,202000,26500,94644,267250.0,현대중공업지주보통주
17193,267250,2020-03-24,0.0934579439252336,160500,175500,15000,82377,267250.0,현대중공업지주보통주
17194,267250,2020-03-23,0.1229508196721311,183000,160500,-22500,75290,267250.0,현대중공업지주보통주
17195,267250,2020-03-20,0.0487106017191977,174500,183000,8500,118677,267250.0,현대중공업지주보통주
17196,267250,2020-03-19,0.1403940886699507,203000,174500,-28500,133794,267250.0,현대중공업지주보통주
17197,267250,2020-03-18,0.0536130536130536,214500,203000,-11500,75783,267250.0,현대중공업지주보통주
17198,267250,2020-03-13,0.0652173913043478,230000,215000,-15000,160753,267250.0,현대중공업지주보통주
17199,267250,2020-03-12,0.065040650406504,246000,230000,-16000,96272,267250.0,현대중공업지주보통주
17200,267250,2020-03-09,0.0564971751412429,265500,250500,-15000,66760,267250.0,현대중공업지주보통주
17201,267250,2020-03-06,0.0517857142857142,280000,265500,-14500,99221,267250.0,현대중공업지주보통주
17202,267250,2020-02-24,0.0516014234875444,281000,266500,-14500,49783,267250.0,현대중공업지주보통주
17203,267250,2020-02-21,0.0458404074702886,294500,281000,-13500,60200,267250.0,현대중공업지주보통주
17204,267250,2020-02-06,0.1584905660377358,265000,307000,42000,172533,267250.0,현대중공업지주보통주
17205,267250,2020-01-28,0.0478547854785478,303000,288500,-14500,53520,267250.0,현대중공업지주보통주
17206,267250,2019-12-27,0.0472222222222222,360000,343000,-17000,67719,267250.0,현대중공업지주보통주
17207,267250,2019-08-19,0.0434056761268781,299500,312500,13000,27872,267250.0,현대중공업지주보통주
17208,267250,2019-07-25,0.043026706231454,337000,322500,-14500,52695,267250.0,현대중공업지주보통주
17209,267250,2019-07-04,0.046583850931677,322000,337000,15000,42022,267250.0,현대중공업지주보통주
17210,267250,2019-01-31,0.0439414114513981,375500,359000,-16500,224522,267250.0,현대중공업지주보통주
17211,267250,2018-11-06,0.043010752688172,372000,388000,16000,39876,267250.0,현대중공업지주보통주
17212,267250,2018-11-02,0.062049062049062,346500,368000,21500,44295,267250.0,현대중공업지주보통주
17213,267250,2018-10-26,0.0470914127423822,361000,344000,-17000,38872,267250.0,현대중공업지주보통주
17214,267250,2018-10-11,0.050632911392405,395000,375000,-20000,54965,267250.0,현대중공업지주보통주
17215,267250,2018-10-08,0.0460048426150121,413000,394000,-19000,44915,267250.0,현대중공업지주보통주
17216,267250,2018-08-03,0.0602941176470588,340000,360500,20500,100101,267250.0,현대중공업지주보통주
17217,267250,2018-08-01,0.0402384500745156,335500,349000,13500,48443,267250.0,현대중공업지주보통주
17218,267250,2018-07-26,0.0516499282639885,348500,330500,-18000,138093,267250.0,현대중공업지주보통주
17219,267250,2018-07-02,0.041018387553041,353500,339000,-14500,51785,267250.0,현대중공업지주보통주
17220,267250,2018-06-19,0.043360433604336,369000,353000,-16000,61749,267250.0,현대중공업지주보통주
17221,267250,2018-06-14,0.0518806744487678,385500,365500,-20000,170418,267250.0,현대중공업지주보통주
17222,267250,2018-05-30,0.0428211586901763,397000,380000,-17000,74150,267250.0,현대중공업지주보통주
17223,267250,2018-05-10,0.0599755201958384,408500,433000,24500,74068,267250.0,현대중공업지주보통주
17224,267250,2018-04-26,0.0459627329192546,402500,421000,18500,43114,267250.0,현대중공업지주보통주
17225,267250,2018-03-13,0.0436730123180291,446500,427000,-19500,68734,267250.0,현대중공업지주보통주
17226,267250,2018-03-06,0.0557532621589561,421500,445000,23500,57857,267250.0,현대중공업지주보통주
17227,267250,2018-02-13,0.0764705882352941,425000,392500,-32500,224453,267250.0,현대중공업지주보통주
17228,267250,2018-02-09,0.053274139844617,450500,426500,-24000,87509,267250.0,현대중공업지주보통주
17229,267250,2018-01-29,0.0449678800856531,467000,488000,21000,110533,267250.0,현대중공업지주보통주
17230,267250,2018-01-23,0.0439814814814814,432000,451000,19000,73811,267250.0,현대중공업지주보통주
17231,267250,2018-01-04,0.0419664268585131,417000,434500,17500,217691,267250.0,현대중공업지주보통주
17232,267250,2018-01-02,0.0879265091863517,381000,414500,33500,145399,267250.0,현대중공업지주보통주
17233,267250,2017-12-28,0.0568654646324549,360500,381000,20500,84750,267250.0,현대중공업지주보통주
17234,267250,2017-12-06,0.0481927710843373,415000,395000,-20000,86022,267250.0,현대중공업지주보통주
17235,267250,2017-11-15,0.0454545454545454,396000,378000,-18000,124684,267250.0,현대중공업지주보통주
17236,267250,2017-10-16,0.0420454545454545,440000,458500,18500,102533,267250.0,현대중공업지주보통주
17237,267250,2017-09-12,0.0429447852760736,407500,425000,17500,66607,267250.0,현대중공업지주보통주
17238,267250,2017-08-07,0.0524691358024691,486000,460500,-25500,146894,267250.0,현대중공업지주보통주
17239,267250,2017-08-01,0.0522133938706015,440500,463500,23000,301709,267250.0,현대중공업지주보통주
17240,267250,2017-06-22,0.0524296675191815,391000,370500,-20500,1359752,267250.0,현대중공업지주보통주
17241,267250,2017-06-14,0.0845070422535211,390500,423500,33000,209336,267250.0,현대중공업지주보통주
17242,267250,2017-06-13,0.0521844660194174,412000,390500,-21500,169733,267250.0,현대중공업지주보통주
17243,267250,2017-06-08,0.0473815461346633,401000,420000,19000,93344,267250.0,현대중공업지주보통주
17244,267250,2017-05-24,0.0453400503778337,397000,415000,18000,203838,267250.0,현대중공업지주보통주
17245,267250,2017-05-23,0.0600801068090787,374500,397000,22500,156818,267250.0,현대중공업지주보통주
17246,267250,2017-05-19,0.0414285714285714,350000,364500,14500,156722,267250.0,현대중공업지주보통주
17247,267250,2017-05-15,0.0500658761528326,379500,360500,-19000,159155,267250.0,현대중공업지주보통주
17248,267250,2017-05-10,0.0551282051282051,390000,390000,0,756348,267250.0,현대중공업지주보통주
17249,267250,2017-05-10,0.0551282051282051,390000,390000,0,756348,267250.0,현대중공업지주보통주
17250,267250,2017-05-10,0.0551282051282051,390000,390000,0,756348,267250.0,현대중공업지주보통주
17251,267250,2017-05-10,0.0551282051282051,390000,390000,0,756348,267250.0,현대중공업지주보통주
17252,267250,2017-05-10,0.0551282051282051,390000,390000,0,756348,267250.0,현대중공업지주보통주
17253,267250,2017-05-10,0.0551282051282051,390000,390000,0,756348,267250.0,현대중공업지주보통주
17254,267250,2017-05-10,0.0551282051282051,390000,390000,0,756348,267250.0,현대중공업지주보통주
17255,267250,2017-05-10,0.0551282051282051,390000,390000,0,756348,267250.0,현대중공업지주보통주
17256,267250,2017-05-10,0.0551282051282051,390000,390000,0,756348,267250.0,현대중공업지주보통주
17257,267250,2017-05-10,0.0551282051282051,390000,390000,0,756348,267250.0,현대중공업지주보통주
17258,267250,2017-05-10,0.0551282051282051,390000,390000,0,756348,267250.0,현대중공업지주보통주
17259,267250,2017-05-10,0.0551282051282051,390000,390000,0,756348,267250.0,현대중공업지주보통주
17260,267250,2017-05-10,0.0551282051282051,390000,390000,0,756348,267250.0,현대중공업지주보통주
17261,267250,2017-05-10,0.0551282051282051,390000,390000,0,756348,267250.0,현대중공업지주보통주
17262,267250,2017-05-10,0.0551282051282051,390000,390000,0,756348,267250.0,현대중공업지주보통주
17263,267250,2017-05-10,0.0551282051282051,390000,390000,0,756348,267250.0,현대중공업지주보통주
17264,267250,2017-05-10,0.0551282051282051,390000,390000,0,756348,267250.0,현대중공업지주보통주
17265,267250,2017-05-10,0.0551282051282051,390000,390000,0,756348,267250.0,현대중공업지주보통주
17266,271560,2021-02-26,0.0446096654275092,134500,128500,-6000,164445,271560.0,오리온보통주
17267,271560,2021-02-25,0.0549019607843137,127500,134500,7000,120821,271560.0,오리온보통주
17268,271560,2021-02-24,0.0449438202247191,133500,127500,-6000,163842,271560.0,오리온보통주
17269,271560,2021-02-17,0.0570342205323193,131500,139000,7500,425574,271560.0,오리온보통주
17270,271560,2021-02-16,0.0647773279352226,123500,131500,8000,259119,271560.0,오리온보통주
17271,271560,2020-12-14,0.0476190476190476,126000,132000,6000,269766,271560.0,오리온보통주
17272,271560,2020-11-18,0.087719298245614,114000,124000,10000,448569,271560.0,오리온보통주
17273,271560,2020-11-04,0.0442477876106194,113000,118000,5000,181830,271560.0,오리온보통주
17274,271560,2020-10-30,0.0646551724137931,116000,108500,-7500,217014,271560.0,오리온보통주
17275,271560,2020-09-24,0.044776119402985,134000,128000,-6000,87342,271560.0,오리온보통주
17276,271560,2020-09-22,0.0616438356164383,146000,137000,-9000,115557,271560.0,오리온보통주
17277,271560,2020-09-17,0.05,140000,147000,7000,212246,271560.0,오리온보통주
17278,271560,2020-08-18,0.0443037974683544,158000,151000,-7000,149539,271560.0,오리온보통주
17279,271560,2020-08-13,0.0535117056856187,149500,157500,8000,180264,271560.0,오리온보통주
17280,271560,2020-07-15,0.0559440559440559,143000,135000,-8000,295805,271560.0,오리온보통주
17281,271560,2020-07-06,0.0464285714285714,140000,146500,6500,114712,271560.0,오리온보통주
17282,271560,2020-06-17,0.05,130000,136500,6500,242122,271560.0,오리온보통주
17283,271560,2020-06-15,0.069090909090909,137500,128000,-9500,193045,271560.0,오리온보통주
17284,271560,2020-05-26,0.0462633451957295,140500,134000,-6500,151862,271560.0,오리온보통주
17285,271560,2020-05-25,0.060377358490566,132500,140500,8000,185784,271560.0,오리온보통주
17286,271560,2020-05-18,0.075,140000,129500,-10500,363838,271560.0,오리온보통주
17287,271560,2020-05-15,0.048689138576779,133500,140000,6500,202683,271560.0,오리온보통주
17288,271560,2020-04-23,0.050632911392405,118500,124500,6000,246839,271560.0,오리온보통주
17289,271560,2020-04-22,0.0533333333333333,112500,118500,6000,176746,271560.0,오리온보통주
17290,271560,2020-04-14,0.0482456140350877,114000,119500,5500,278329,271560.0,오리온보통주
17291,271560,2020-04-09,0.0416666666666666,120000,115000,-5000,236313,271560.0,오리온보통주
17292,271560,2020-04-02,0.0409090909090909,110000,114500,4500,106172,271560.0,오리온보통주
17293,271560,2020-04-01,0.0434782608695652,115000,110000,-5000,126300,271560.0,오리온보통주
17294,271560,2020-03-31,0.055045871559633,109000,115000,6000,192613,271560.0,오리온보통주
17295,271560,2020-03-25,0.0842754367934224,97300,105500,8200,200822,271560.0,오리온보통주
17296,271560,2020-03-23,0.0715686274509803,102000,94700,-7300,135945,271560.0,오리온보통주
17297,271560,2020-03-17,0.044776119402985,100500,105000,4500,195308,271560.0,오리온보통주
17298,271560,2020-03-16,0.043613707165109,96300,100500,4200,191633,271560.0,오리온보통주
17299,271560,2020-03-10,0.0433884297520661,96800,101000,4200,115635,271560.0,오리온보통주
17300,271560,2020-02-25,0.0423116615067079,96900,101000,4100,126265,271560.0,오리온보통주
17301,271560,2020-02-24,0.0637681159420289,103500,96900,-6600,122362,271560.0,오리온보통주
17302,271560,2020-02-20,0.0509259259259259,108000,102500,-5500,161730,271560.0,오리온보통주
17303,271560,2020-02-06,0.0631067961165048,103000,109500,6500,212644,271560.0,오리온보통주
17304,271560,2020-01-28,0.0552995391705069,108500,102500,-6000,161312,271560.0,오리온보통주
17305,271560,2020-01-13,0.0473933649289099,105500,110500,5000,126239,271560.0,오리온보통주
17306,271560,2019-12-03,0.0439024390243902,102500,107000,4500,103137,271560.0,오리온보통주
17307,271560,2019-11-26,0.0420560747663551,107000,102500,-4500,186544,271560.0,오리온보통주
17308,271560,2019-11-01,0.0660377358490566,106000,113000,7000,374004,271560.0,오리온보통주
17309,271560,2019-05-17,0.0496054114994363,88700,84300,-4400,435301,271560.0,오리온보통주
17310,271560,2019-05-16,0.070230607966457,95400,88700,-6700,386236,271560.0,오리온보통주
17311,271560,2019-05-09,0.0568627450980392,102000,96200,-5800,172178,271560.0,오리온보통주
17312,271560,2019-05-08,0.0515463917525773,97000,102000,5000,424227,271560.0,오리온보통주
17313,271560,2019-04-12,0.0526829268292682,102500,97100,-5400,499014,271560.0,오리온보통주
17314,271560,2019-02-14,0.0403587443946188,111500,116000,4500,165955,271560.0,오리온보통주
17315,271560,2019-01-24,0.0418410041841004,119500,114500,-5000,282625,271560.0,오리온보통주
17316,271560,2019-01-10,0.0483870967741935,124000,118000,-6000,143620,271560.0,오리온보통주
17317,271560,2019-01-03,0.063063063063063,111000,118000,7000,154677,271560.0,오리온보통주
17318,271560,2019-01-02,0.075,120000,111000,-9000,172930,271560.0,오리온보통주
17319,271560,2018-12-28,0.0526315789473684,114000,120000,6000,108932,271560.0,오리온보통주
17320,271560,2018-12-12,0.0526315789473684,114000,120000,6000,191761,271560.0,오리온보통주
17321,271560,2018-11-26,0.0401785714285714,112000,116500,4500,251697,271560.0,오리온보통주
17322,271560,2018-11-21,0.0728155339805825,103000,110500,7500,336391,271560.0,오리온보통주
17323,271560,2018-11-09,0.0466321243523316,96500,92000,-4500,156026,271560.0,오리온보통주
17324,271560,2018-11-07,0.0914221218961625,88600,96700,8100,716517,271560.0,오리온보통주
17325,271560,2018-10-23,0.045045045045045,111000,106000,-5000,100671,271560.0,오리온보통주
17326,271560,2018-10-12,0.0692148760330578,96800,103500,6700,134038,271560.0,오리온보통주
17327,271560,2018-10-02,0.0420560747663551,107000,102500,-4500,121451,271560.0,오리온보통주
17328,271560,2018-09-12,0.0890052356020942,95500,104000,8500,314585,271560.0,오리온보통주
17329,271560,2018-09-07,0.0555023923444976,104500,98700,-5800,455755,271560.0,오리온보통주
17330,271560,2018-08-21,0.0428571428571428,105000,109500,4500,156163,271560.0,오리온보통주
17331,271560,2018-08-16,0.1059322033898305,118000,105500,-12500,506283,271560.0,오리온보통주
17332,271560,2018-07-24,0.0456273764258555,131500,137500,6000,127614,271560.0,오리온보통주
17333,271560,2018-07-20,0.044280442804428,135500,129500,-6000,157052,271560.0,오리온보통주
17334,271560,2018-07-17,0.048780487804878,143500,136500,-7000,144827,271560.0,오리온보통주
17335,271560,2018-06-26,0.0451612903225806,155000,148000,-7000,196362,271560.0,오리온보통주
17336,271560,2018-06-04,0.0743494423791821,134500,144500,10000,134899,271560.0,오리온보통주
17337,271560,2018-05-17,0.0415094339622641,132500,127000,-5500,166805,271560.0,오리온보통주
17338,271560,2018-05-16,0.06,125000,132500,7500,208081,271560.0,오리온보통주
17339,271560,2018-05-15,0.0601503759398496,133000,125000,-8000,154392,271560.0,오리온보통주
17340,271560,2018-05-09,0.052,125000,131500,6500,111853,271560.0,오리온보통주
17341,271560,2018-05-03,0.0470588235294117,127500,121500,-6000,59074,271560.0,오리온보통주
17342,271560,2018-04-26,0.048,125000,119000,-6000,105844,271560.0,오리온보통주
17343,271560,2018-04-19,0.0581395348837209,129000,121500,-7500,76753,271560.0,오리온보통주
17344,271560,2018-04-04,0.055350553505535,135500,128000,-7500,155672,271560.0,오리온보통주
17345,271560,2018-03-15,0.073394495412844,109000,117000,8000,99174,271560.0,오리온보통주
17346,271560,2018-03-09,0.0535714285714285,112000,118000,6000,79537,271560.0,오리온보통주
17347,271560,2018-03-08,0.0516431924882629,106500,112000,5500,113625,271560.0,오리온보통주
17348,271560,2018-02-28,0.04,112500,108000,-4500,94441,271560.0,오리온보통주
17349,271560,2018-02-21,0.0610328638497652,106500,113000,6500,146949,271560.0,오리온보통주
17350,271560,2018-02-14,0.05,110000,104500,-5500,373256,271560.0,오리온보통주
17351,271560,2018-02-12,0.0606060606060606,115500,108500,-7000,134903,271560.0,오리온보통주
17352,271560,2018-02-09,0.0414937759336099,120500,115500,-5000,140674,271560.0,오리온보통주
17353,271560,2017-12-26,0.0440528634361233,113500,108500,-5000,112219,271560.0,오리온보통주
17354,271560,2017-12-21,0.043103448275862,116000,111000,-5000,66789,271560.0,오리온보통주
17355,271560,2017-12-01,0.0480349344978165,114500,120000,5500,154816,271560.0,오리온보통주
17356,271560,2017-11-30,0.084,125000,114500,-10500,218274,271560.0,오리온보통주
17357,271560,2017-11-28,0.0762711864406779,118000,127000,9000,188897,271560.0,오리온보통주
17358,271560,2017-11-27,0.0442477876106194,113000,118000,5000,153777,271560.0,오리온보통주
17359,271560,2017-11-24,0.0543933054393305,119500,113000,-6500,123943,271560.0,오리온보통주
17360,271560,2017-11-03,0.0509259259259259,108000,113500,5500,120532,271560.0,오리온보통주
17361,271560,2017-10-30,0.0497512437810945,100500,105500,5000,146117,271560.0,오리온보통주
17362,271560,2017-10-26,0.062367864693446,94600,100500,5900,241723,271560.0,오리온보통주
17363,271560,2017-10-11,0.0421052631578947,95000,91000,-4000,161332,271560.0,오리온보통주
17364,271560,2017-09-11,0.0504009163802978,87300,91700,4400,98648,271560.0,오리온보통주
17365,271560,2017-08-16,0.0659955257270693,89400,95300,5900,239188,271560.0,오리온보통주
17366,271560,2017-07-20,0.0484633569739952,84600,80500,-4100,183151,271560.0,오리온보통주
17367,271560,2017-07-11,0.059090909090909,88000,82800,-5200,422303,271560.0,오리온보통주
17368,271560,2017-07-10,0.0692588092345079,82300,88000,5700,840451,271560.0,오리온보통주
17369,271560,2017-07-07,0.0596273291925465,80500,82300,1800,1619864,271560.0,오리온보통주
17370,271560,2017-07-20,0.0484633569739952,84600,80500,-4100,183151,271560.0,오리온보통주
17371,271560,2017-07-11,0.059090909090909,88000,82800,-5200,422303,271560.0,오리온보통주
17372,271560,2017-07-10,0.0692588092345079,82300,88000,5700,840451,271560.0,오리온보통주
17373,271560,2017-07-07,0.0596273291925465,80500,82300,1800,1619864,271560.0,오리온보통주
17374,271560,2017-07-20,0.0484633569739952,84600,80500,-4100,183151,271560.0,오리온보통주
17375,271560,2017-07-11,0.059090909090909,88000,82800,-5200,422303,271560.0,오리온보통주
17376,271560,2017-07-10,0.0692588092345079,82300,88000,5700,840451,271560.0,오리온보통주
17377,271560,2017-07-07,0.0596273291925465,80500,82300,1800,1619864,271560.0,오리온보통주
17378,271560,2017-07-20,0.0484633569739952,84600,80500,-4100,183151,271560.0,오리온보통주
17379,271560,2017-07-11,0.059090909090909,88000,82800,-5200,422303,271560.0,오리온보통주
17380,271560,2017-07-10,0.0692588092345079,82300,88000,5700,840451,271560.0,오리온보통주
17381,271560,2017-07-07,0.0596273291925465,80500,82300,1800,1619864,271560.0,오리온보통주
17382,271560,2017-07-20,0.0484633569739952,84600,80500,-4100,183151,271560.0,오리온보통주
17383,271560,2017-07-11,0.059090909090909,88000,82800,-5200,422303,271560.0,오리온보통주
17384,271560,2017-07-10,0.0692588092345079,82300,88000,5700,840451,271560.0,오리온보통주
17385,271560,2017-07-07,0.0596273291925465,80500,82300,1800,1619864,271560.0,오리온보통주
17386,271560,2017-07-20,0.0484633569739952,84600,80500,-4100,183151,271560.0,오리온보통주
17387,271560,2017-07-11,0.059090909090909,88000,82800,-5200,422303,271560.0,오리온보통주
17388,271560,2017-07-10,0.0692588092345079,82300,88000,5700,840451,271560.0,오리온보통주
17389,271560,2017-07-07,0.0596273291925465,80500,82300,1800,1619864,271560.0,오리온보통주
17390,271560,2017-07-20,0.0484633569739952,84600,80500,-4100,183151,271560.0,오리온보통주
17391,271560,2017-07-11,0.059090909090909,88000,82800,-5200,422303,271560.0,오리온보통주
17392,271560,2017-07-10,0.0692588092345079,82300,88000,5700,840451,271560.0,오리온보통주
17393,271560,2017-07-07,0.0596273291925465,80500,82300,1800,1619864,271560.0,오리온보통주
17394,271560,2017-07-20,0.0484633569739952,84600,80500,-4100,183151,271560.0,오리온보통주
17395,271560,2017-07-11,0.059090909090909,88000,82800,-5200,422303,271560.0,오리온보통주
17396,271560,2017-07-10,0.0692588092345079,82300,88000,5700,840451,271560.0,오리온보통주
17397,271560,2017-07-07,0.0596273291925465,80500,82300,1800,1619864,271560.0,오리온보통주
17398,271560,2017-07-20,0.0484633569739952,84600,80500,-4100,183151,271560.0,오리온보통주
17399,271560,2017-07-11,0.059090909090909,88000,82800,-5200,422303,271560.0,오리온보통주
17400,271560,2017-07-10,0.0692588092345079,82300,88000,5700,840451,271560.0,오리온보통주
17401,271560,2017-07-07,0.0596273291925465,80500,82300,1800,1619864,271560.0,오리온보통주
17402,271560,2017-07-20,0.0484633569739952,84600,80500,-4100,183151,271560.0,오리온보통주
17403,271560,2017-07-11,0.059090909090909,88000,82800,-5200,422303,271560.0,오리온보통주
17404,271560,2017-07-10,0.0692588092345079,82300,88000,5700,840451,271560.0,오리온보통주
17405,271560,2017-07-07,0.0596273291925465,80500,82300,1800,1619864,271560.0,오리온보통주
17406,271560,2017-07-20,0.0484633569739952,84600,80500,-4100,183151,271560.0,오리온보통주
17407,271560,2017-07-11,0.059090909090909,88000,82800,-5200,422303,271560.0,오리온보통주
17408,271560,2017-07-10,0.0692588092345079,82300,88000,5700,840451,271560.0,오리온보통주
17409,271560,2017-07-07,0.0596273291925465,80500,82300,1800,1619864,271560.0,오리온보통주
17410,271560,2017-07-20,0.0484633569739952,84600,80500,-4100,183151,271560.0,오리온보통주
17411,271560,2017-07-11,0.059090909090909,88000,82800,-5200,422303,271560.0,오리온보통주
17412,271560,2017-07-10,0.0692588092345079,82300,88000,5700,840451,271560.0,오리온보통주
17413,271560,2017-07-07,0.0596273291925465,80500,82300,1800,1619864,271560.0,오리온보통주
17414,271560,2017-07-20,0.0484633569739952,84600,80500,-4100,183151,271560.0,오리온보통주
17415,271560,2017-07-11,0.059090909090909,88000,82800,-5200,422303,271560.0,오리온보통주
17416,271560,2017-07-10,0.0692588092345079,82300,88000,5700,840451,271560.0,오리온보통주
17417,271560,2017-07-07,0.0596273291925465,80500,82300,1800,1619864,271560.0,오리온보통주
17418,271560,2017-07-20,0.0484633569739952,84600,80500,-4100,183151,271560.0,오리온보통주
17419,271560,2017-07-11,0.059090909090909,88000,82800,-5200,422303,271560.0,오리온보통주
17420,271560,2017-07-10,0.0692588092345079,82300,88000,5700,840451,271560.0,오리온보통주
17421,271560,2017-07-07,0.0596273291925465,80500,82300,1800,1619864,271560.0,오리온보통주
17422,271560,2017-07-20,0.0484633569739952,84600,80500,-4100,183151,271560.0,오리온보통주
17423,271560,2017-07-11,0.059090909090909,88000,82800,-5200,422303,271560.0,오리온보통주
17424,271560,2017-07-10,0.0692588092345079,82300,88000,5700,840451,271560.0,오리온보통주
17425,271560,2017-07-07,0.0596273291925465,80500,82300,1800,1619864,271560.0,오리온보통주
17426,271560,2017-07-20,0.0484633569739952,84600,80500,-4100,183151,271560.0,오리온보통주
17427,271560,2017-07-11,0.059090909090909,88000,82800,-5200,422303,271560.0,오리온보통주
17428,271560,2017-07-10,0.0692588092345079,82300,88000,5700,840451,271560.0,오리온보통주
17429,271560,2017-07-07,0.0596273291925465,80500,82300,1800,1619864,271560.0,오리온보통주
17430,271560,2017-07-20,0.0484633569739952,84600,80500,-4100,183151,271560.0,오리온보통주
17431,271560,2017-07-11,0.059090909090909,88000,82800,-5200,422303,271560.0,오리온보통주
17432,271560,2017-07-10,0.0692588092345079,82300,88000,5700,840451,271560.0,오리온보통주
17433,271560,2017-07-07,0.0596273291925465,80500,82300,1800,1619864,271560.0,오리온보통주
17434,271560,2017-07-20,0.0484633569739952,84600,80500,-4100,183151,271560.0,오리온보통주
17435,271560,2017-07-11,0.059090909090909,88000,82800,-5200,422303,271560.0,오리온보통주
17436,271560,2017-07-10,0.0692588092345079,82300,88000,5700,840451,271560.0,오리온보통주
17437,271560,2017-07-07,0.0596273291925465,80500,82300,1800,1619864,271560.0,오리온보통주
17438,271560,2017-07-20,0.0484633569739952,84600,80500,-4100,183151,271560.0,오리온보통주
17439,271560,2017-07-11,0.059090909090909,88000,82800,-5200,422303,271560.0,오리온보통주
17440,271560,2017-07-10,0.0692588092345079,82300,88000,5700,840451,271560.0,오리온보통주
17441,271560,2017-07-07,0.0596273291925465,80500,82300,1800,1619864,271560.0,오리온보통주
17442,271560,2017-07-20,0.0484633569739952,84600,80500,-4100,183151,271560.0,오리온보통주
17443,271560,2017-07-11,0.059090909090909,88000,82800,-5200,422303,271560.0,오리온보통주
17444,271560,2017-07-10,0.0692588092345079,82300,88000,5700,840451,271560.0,오리온보통주
17445,271560,2017-07-07,0.0596273291925465,80500,82300,1800,1619864,271560.0,오리온보통주
17446,271560,2017-07-20,0.0484633569739952,84600,80500,-4100,183151,271560.0,오리온보통주
17447,271560,2017-07-11,0.059090909090909,88000,82800,-5200,422303,271560.0,오리온보통주
17448,271560,2017-07-10,0.0692588092345079,82300,88000,5700,840451,271560.0,오리온보통주
17449,271560,2017-07-07,0.0596273291925465,80500,82300,1800,1619864,271560.0,오리온보통주
17450,271560,2017-07-20,0.0484633569739952,84600,80500,-4100,183151,271560.0,오리온보통주
17451,271560,2017-07-11,0.059090909090909,88000,82800,-5200,422303,271560.0,오리온보통주
17452,271560,2017-07-10,0.0692588092345079,82300,88000,5700,840451,271560.0,오리온보통주
17453,271560,2017-07-07,0.0596273291925465,80500,82300,1800,1619864,271560.0,오리온보통주
17454,271560,2017-07-20,0.0484633569739952,84600,80500,-4100,183151,271560.0,오리온보통주
17455,271560,2017-07-11,0.059090909090909,88000,82800,-5200,422303,271560.0,오리온보통주
17456,271560,2017-07-10,0.0692588092345079,82300,88000,5700,840451,271560.0,오리온보통주
17457,271560,2017-07-07,0.0596273291925465,80500,82300,1800,1619864,271560.0,오리온보통주
17458,271560,2017-07-20,0.0484633569739952,84600,80500,-4100,183151,271560.0,오리온보통주
17459,271560,2017-07-11,0.059090909090909,88000,82800,-5200,422303,271560.0,오리온보통주
17460,271560,2017-07-10,0.0692588092345079,82300,88000,5700,840451,271560.0,오리온보통주
17461,272210,2021-06-01,0.0404624277456647,17300,18000,700,1551849,272210.0,한화시스템보통주
17462,272210,2021-05-06,0.0465116279069767,17200,18000,800,1674487,272210.0,한화시스템보통주
17463,272210,2021-04-02,0.0407239819004524,22100,21200,-900,2709339,272210.0,한화시스템보통주
17464,272210,2021-03-31,0.099502487562189,20100,22100,2000,12925310,272210.0,한화시스템보통주
17465,272210,2021-03-30,0.0578947368421052,19000,20100,1100,4325532,272210.0,한화시스템보통주
17466,272210,2021-03-29,0.0594059405940594,20200,19000,-1200,5615548,272210.0,한화시스템보통주
17467,272210,2021-03-26,0.0575916230366492,19100,20200,1100,2040897,272210.0,한화시스템보통주
17468,272210,2021-03-11,0.0444444444444444,18000,18800,800,1222357,272210.0,한화시스템보통주
17469,272210,2021-03-04,0.0475,20000,19050,-950,2295508,272210.0,한화시스템보통주
17470,272210,2021-02-25,0.0887728459530026,19150,20850,1700,4595933,272210.0,한화시스템보통주
17471,272210,2021-02-24,0.0425,20000,19150,-850,2444452,272210.0,한화시스템보통주
17472,272210,2021-02-23,0.0453460620525059,20950,20000,-950,2266506,272210.0,한화시스템보통주
17473,272210,2021-02-19,0.0431818181818181,22000,21050,-950,3606550,272210.0,한화시스템보통주
17474,272210,2021-02-18,0.083743842364532,20300,22000,1700,7361577,272210.0,한화시스템보통주
17475,272210,2021-02-15,0.1229508196721311,18300,20550,2250,7497004,272210.0,한화시스템보통주
17476,272210,2021-02-09,0.0452127659574468,18800,17950,-850,1667295,272210.0,한화시스템보통주
17477,272210,2021-02-04,0.0653950953678474,18350,19550,1200,5391984,272210.0,한화시스템보통주
17478,272210,2021-02-02,0.0612244897959183,17150,18200,1050,2410765,272210.0,한화시스템보통주
17479,272210,2021-02-01,0.0521472392638036,16300,17150,850,1425853,272210.0,한화시스템보통주
17480,272210,2021-01-26,0.0405405405405405,18500,17750,-750,2317765,272210.0,한화시스템보통주
17481,272210,2021-01-22,0.0519480519480519,19250,18250,-1000,3402623,272210.0,한화시스템보통주
17482,272210,2021-01-21,0.0493827160493827,20250,19250,-1000,12776918,272210.0,한화시스템보통주
17483,272210,2021-01-20,0.0657894736842105,19000,20250,1250,2074762,272210.0,한화시스템보통주
17484,272210,2021-01-13,0.0644257703081232,17850,19000,1150,4908973,272210.0,한화시스템보통주
17485,272210,2020-12-28,0.1136363636363636,15400,17150,1750,6335366,272210.0,한화시스템보통주
17486,272210,2020-12-24,0.0657439446366782,14450,15400,950,3417379,272210.0,한화시스템보통주
17487,272210,2020-12-23,0.0462046204620462,15150,14450,-700,1782604,272210.0,한화시스템보통주
17488,272210,2020-12-21,0.0895061728395061,16200,14750,-1450,2915518,272210.0,한화시스템보통주
17489,272210,2020-12-16,0.0608108108108108,14800,15700,900,3937958,272210.0,한화시스템보통주
17490,272210,2020-12-15,0.088235294117647,13600,14800,1200,3987479,272210.0,한화시스템보통주
17491,272210,2020-12-09,0.046875,12800,13400,600,2178771,272210.0,한화시스템보통주
17492,272210,2020-12-08,0.040650406504065,12300,12800,500,1785608,272210.0,한화시스템보통주
17493,272210,2020-11-10,0.0502283105022831,10950,11500,550,1631008,272210.0,한화시스템보통주
17494,272210,2020-09-28,0.0518867924528301,10600,11150,550,633256,272210.0,한화시스템보통주
17495,272210,2020-09-22,0.0553191489361702,11750,11100,-650,1495155,272210.0,한화시스템보통주
17496,272210,2020-09-02,0.1460176991150442,11300,12950,1650,9743134,272210.0,한화시스템보통주
17497,272210,2020-08-31,0.09,10000,10900,900,2294693,272210.0,한화시스템보통주
17498,272210,2020-08-10,0.0772946859903381,10350,11150,800,4867467,272210.0,한화시스템보통주
17499,272210,2020-08-07,0.0747663551401869,9630,10350,720,2494185,272210.0,한화시스템보통주
17500,272210,2020-07-27,0.0608695652173913,9200,9760,560,1537385,272210.0,한화시스템보통주
17501,272210,2020-06-19,0.049049049049049,9990,9500,-490,5470373,272210.0,한화시스템보통주
17502,272210,2020-06-17,0.0932475884244373,9330,10200,870,14239720,272210.0,한화시스템보통주
17503,272210,2020-06-09,0.0781078107810781,9090,9800,710,4759899,272210.0,한화시스템보통주
17504,272210,2020-05-29,0.0512514898688915,8390,8820,430,940440,272210.0,한화시스템보통주
17505,272210,2020-05-04,0.0756880733944954,8720,8060,-660,1145543,272210.0,한화시스템보통주
17506,272210,2020-04-24,0.063030303030303,8250,8770,520,3395201,272210.0,한화시스템보통주
17507,272210,2020-04-20,0.0583657587548638,7710,8160,450,976840,272210.0,한화시스템보통주
17508,272210,2020-04-13,0.0510471204188481,7640,7250,-390,584264,272210.0,한화시스템보통주
17509,272210,2020-04-01,0.0607344632768361,7080,7510,430,1319626,272210.0,한화시스템보통주
17510,272210,2020-03-31,0.0942812982998454,6470,7080,610,1098021,272210.0,한화시스템보통주
17511,272210,2020-03-26,0.0404721753794266,5930,6170,240,1079774,272210.0,한화시스템보통주
17512,272210,2020-03-25,0.158203125,5120,5930,810,1103075,272210.0,한화시스템보통주
17513,272210,2020-03-24,0.0824524312896406,4730,5120,390,696857,272210.0,한화시스템보통주
17514,272210,2020-03-23,0.0815533980582524,5150,4730,-420,657949,272210.0,한화시스템보통주
17515,272210,2020-03-20,0.0629514963880289,4845,5150,305,603912,272210.0,한화시스템보통주
17516,272210,2020-03-19,0.1559233449477352,5740,4845,-895,1186417,272210.0,한화시스템보통주
17517,272210,2020-03-18,0.0636215334420881,6130,5740,-390,757701,272210.0,한화시스템보통주
17518,272210,2020-03-13,0.064516129032258,6820,6380,-440,909665,272210.0,한화시스템보통주
17519,272210,2020-03-12,0.061898211829436,7270,6820,-450,666520,272210.0,한화시스템보통주
17520,272210,2020-03-09,0.0669975186104218,8060,7520,-540,1006446,272210.0,한화시스템보통주
17521,272210,2020-02-24,0.0641430073606729,9510,8900,-610,728264,272210.0,한화시스템보통주
17522,272210,2020-01-09,0.0691244239631336,10850,10100,-750,2749832,272210.0,한화시스템보통주
17523,272210,2020-01-08,0.0689655172413793,10150,10850,700,8360503,272210.0,한화시스템보통주
17524,272210,2019-11-21,0.04,11250,10800,-450,1441331,272210.0,한화시스템보통주
17525,272210,2019-11-20,0.0546218487394958,11900,11250,-650,1859794,272210.0,한화시스템보통주
17526,272210,2019-11-15,0.0472103004291845,11650,12200,550,5304317,272210.0,한화시스템보통주
17527,272210,2019-11-14,0.0495495495495495,11100,11650,550,3649312,272210.0,한화시스템보통주
17528,272210,2019-11-13,0.0444444444444444,11250,11100,-150,15462185,272210.0,한화시스템보통주
17529,272210,2019-11-20,0.0546218487394958,11900,11250,-650,1859794,272210.0,한화시스템보통주
17530,272210,2019-11-15,0.0472103004291845,11650,12200,550,5304317,272210.0,한화시스템보통주
17531,272210,2019-11-14,0.0495495495495495,11100,11650,550,3649312,272210.0,한화시스템보통주
17532,272210,2019-11-13,0.0444444444444444,11250,11100,-150,15462185,272210.0,한화시스템보통주
17533,272210,2019-11-20,0.0546218487394958,11900,11250,-650,1859794,272210.0,한화시스템보통주
17534,272210,2019-11-15,0.0472103004291845,11650,12200,550,5304317,272210.0,한화시스템보통주
17535,272210,2019-11-14,0.0495495495495495,11100,11650,550,3649312,272210.0,한화시스템보통주
17536,272210,2019-11-13,0.0444444444444444,11250,11100,-150,15462185,272210.0,한화시스템보통주
17537,272210,2019-11-20,0.0546218487394958,11900,11250,-650,1859794,272210.0,한화시스템보통주
17538,272210,2019-11-15,0.0472103004291845,11650,12200,550,5304317,272210.0,한화시스템보통주
17539,272210,2019-11-14,0.0495495495495495,11100,11650,550,3649312,272210.0,한화시스템보통주
17540,272210,2019-11-13,0.0444444444444444,11250,11100,-150,15462185,272210.0,한화시스템보통주
17541,272210,2019-11-20,0.0546218487394958,11900,11250,-650,1859794,272210.0,한화시스템보통주
17542,272210,2019-11-15,0.0472103004291845,11650,12200,550,5304317,272210.0,한화시스템보통주
17543,272210,2019-11-14,0.0495495495495495,11100,11650,550,3649312,272210.0,한화시스템보통주
17544,272210,2019-11-13,0.0444444444444444,11250,11100,-150,15462185,272210.0,한화시스템보통주
17545,272210,2019-11-20,0.0546218487394958,11900,11250,-650,1859794,272210.0,한화시스템보통주
17546,272210,2019-11-15,0.0472103004291845,11650,12200,550,5304317,272210.0,한화시스템보통주
17547,272210,2019-11-14,0.0495495495495495,11100,11650,550,3649312,272210.0,한화시스템보통주
17548,272210,2019-11-13,0.0444444444444444,11250,11100,-150,15462185,272210.0,한화시스템보통주
17549,272210,2019-11-20,0.0546218487394958,11900,11250,-650,1859794,272210.0,한화시스템보통주
17550,272210,2019-11-15,0.0472103004291845,11650,12200,550,5304317,272210.0,한화시스템보통주
17551,272210,2019-11-14,0.0495495495495495,11100,11650,550,3649312,272210.0,한화시스템보통주
17552,272210,2019-11-13,0.0444444444444444,11250,11100,-150,15462185,272210.0,한화시스템보통주
17553,272210,2019-11-20,0.0546218487394958,11900,11250,-650,1859794,272210.0,한화시스템보통주
17554,272210,2019-11-15,0.0472103004291845,11650,12200,550,5304317,272210.0,한화시스템보통주
17555,272210,2019-11-14,0.0495495495495495,11100,11650,550,3649312,272210.0,한화시스템보통주
17556,272210,2019-11-13,0.0444444444444444,11250,11100,-150,15462185,272210.0,한화시스템보통주
17557,272210,2019-11-20,0.0546218487394958,11900,11250,-650,1859794,272210.0,한화시스템보통주
17558,272210,2019-11-15,0.0472103004291845,11650,12200,550,5304317,272210.0,한화시스템보통주
17559,272210,2019-11-14,0.0495495495495495,11100,11650,550,3649312,272210.0,한화시스템보통주
17560,272210,2019-11-13,0.0444444444444444,11250,11100,-150,15462185,272210.0,한화시스템보통주
17561,272210,2019-11-20,0.0546218487394958,11900,11250,-650,1859794,272210.0,한화시스템보통주
17562,272210,2019-11-15,0.0472103004291845,11650,12200,550,5304317,272210.0,한화시스템보통주
17563,272210,2019-11-14,0.0495495495495495,11100,11650,550,3649312,272210.0,한화시스템보통주
17564,272210,2019-11-13,0.0444444444444444,11250,11100,-150,15462185,272210.0,한화시스템보통주
17565,272210,2019-11-20,0.0546218487394958,11900,11250,-650,1859794,272210.0,한화시스템보통주
17566,272210,2019-11-15,0.0472103004291845,11650,12200,550,5304317,272210.0,한화시스템보통주
17567,272210,2019-11-14,0.0495495495495495,11100,11650,550,3649312,272210.0,한화시스템보통주
17568,272210,2019-11-13,0.0444444444444444,11250,11100,-150,15462185,272210.0,한화시스템보통주
17569,272210,2019-11-20,0.0546218487394958,11900,11250,-650,1859794,272210.0,한화시스템보통주
17570,272210,2019-11-15,0.0472103004291845,11650,12200,550,5304317,272210.0,한화시스템보통주
17571,272210,2019-11-14,0.0495495495495495,11100,11650,550,3649312,272210.0,한화시스템보통주
17572,272210,2019-11-13,0.0444444444444444,11250,11100,-150,15462185,272210.0,한화시스템보통주
17573,272210,2019-11-20,0.0546218487394958,11900,11250,-650,1859794,272210.0,한화시스템보통주
17574,272210,2019-11-15,0.0472103004291845,11650,12200,550,5304317,272210.0,한화시스템보통주
17575,272210,2019-11-14,0.0495495495495495,11100,11650,550,3649312,272210.0,한화시스템보통주
17576,272210,2019-11-13,0.0444444444444444,11250,11100,-150,15462185,272210.0,한화시스템보통주
17577,272210,2019-11-20,0.0546218487394958,11900,11250,-650,1859794,272210.0,한화시스템보통주
17578,272210,2019-11-15,0.0472103004291845,11650,12200,550,5304317,272210.0,한화시스템보통주
17579,272210,2019-11-14,0.0495495495495495,11100,11650,550,3649312,272210.0,한화시스템보통주
17580,272210,2019-11-13,0.0444444444444444,11250,11100,-150,15462185,272210.0,한화시스템보통주
17581,272210,2019-11-20,0.0546218487394958,11900,11250,-650,1859794,272210.0,한화시스템보통주
17582,272210,2019-11-15,0.0472103004291845,11650,12200,550,5304317,272210.0,한화시스템보통주
17583,272210,2019-11-14,0.0495495495495495,11100,11650,550,3649312,272210.0,한화시스템보통주
17584,272210,2019-11-13,0.0444444444444444,11250,11100,-150,15462185,272210.0,한화시스템보통주
17585,272210,2019-11-20,0.0546218487394958,11900,11250,-650,1859794,272210.0,한화시스템보통주
17586,272210,2019-11-15,0.0472103004291845,11650,12200,550,5304317,272210.0,한화시스템보통주
17587,272210,2019-11-14,0.0495495495495495,11100,11650,550,3649312,272210.0,한화시스템보통주
17588,272210,2019-11-13,0.0444444444444444,11250,11100,-150,15462185,272210.0,한화시스템보통주
17589,272210,2019-11-20,0.0546218487394958,11900,11250,-650,1859794,272210.0,한화시스템보통주
17590,272210,2019-11-15,0.0472103004291845,11650,12200,550,5304317,272210.0,한화시스템보통주
17591,272210,2019-11-14,0.0495495495495495,11100,11650,550,3649312,272210.0,한화시스템보통주
17592,272210,2019-11-13,0.0444444444444444,11250,11100,-150,15462185,272210.0,한화시스템보통주
17593,272210,2019-11-20,0.0546218487394958,11900,11250,-650,1859794,272210.0,한화시스템보통주
17594,272210,2019-11-15,0.0472103004291845,11650,12200,550,5304317,272210.0,한화시스템보통주
17595,272210,2019-11-14,0.0495495495495495,11100,11650,550,3649312,272210.0,한화시스템보통주
17596,272210,2019-11-13,0.0444444444444444,11250,11100,-150,15462185,272210.0,한화시스템보통주
17597,272210,2019-11-20,0.0546218487394958,11900,11250,-650,1859794,272210.0,한화시스템보통주
17598,272210,2019-11-15,0.0472103004291845,11650,12200,550,5304317,272210.0,한화시스템보통주
17599,272210,2019-11-14,0.0495495495495495,11100,11650,550,3649312,272210.0,한화시스템보통주
17600,272210,2019-11-13,0.0444444444444444,11250,11100,-150,15462185,272210.0,한화시스템보통주
17601,272210,2019-11-20,0.0546218487394958,11900,11250,-650,1859794,272210.0,한화시스템보통주
17602,272210,2019-11-15,0.0472103004291845,11650,12200,550,5304317,272210.0,한화시스템보통주
17603,272210,2019-11-14,0.0495495495495495,11100,11650,550,3649312,272210.0,한화시스템보통주
17604,272210,2019-11-13,0.0444444444444444,11250,11100,-150,15462185,272210.0,한화시스템보통주
17605,272210,2019-11-20,0.0546218487394958,11900,11250,-650,1859794,272210.0,한화시스템보통주
17606,272210,2019-11-15,0.0472103004291845,11650,12200,550,5304317,272210.0,한화시스템보통주
17607,272210,2019-11-14,0.0495495495495495,11100,11650,550,3649312,272210.0,한화시스템보통주
17608,272210,2019-11-13,0.0444444444444444,11250,11100,-150,15462185,272210.0,한화시스템보통주
17609,272210,2019-11-20,0.0546218487394958,11900,11250,-650,1859794,272210.0,한화시스템보통주
17610,272210,2019-11-15,0.0472103004291845,11650,12200,550,5304317,272210.0,한화시스템보통주
17611,272210,2019-11-14,0.0495495495495495,11100,11650,550,3649312,272210.0,한화시스템보통주
17612,272210,2019-11-13,0.0444444444444444,11250,11100,-150,15462185,272210.0,한화시스템보통주
17613,272210,2019-11-20,0.0546218487394958,11900,11250,-650,1859794,272210.0,한화시스템보통주
17614,272210,2019-11-15,0.0472103004291845,11650,12200,550,5304317,272210.0,한화시스템보통주
17615,272210,2019-11-14,0.0495495495495495,11100,11650,550,3649312,272210.0,한화시스템보통주
17616,272210,2019-11-13,0.0444444444444444,11250,11100,-150,15462185,272210.0,한화시스템보통주
17617,272210,2019-11-20,0.0546218487394958,11900,11250,-650,1859794,272210.0,한화시스템보통주
17618,272210,2019-11-15,0.0472103004291845,11650,12200,550,5304317,272210.0,한화시스템보통주
17619,272210,2019-11-14,0.0495495495495495,11100,11650,550,3649312,272210.0,한화시스템보통주
17620,272210,2019-11-13,0.0444444444444444,11250,11100,-150,15462185,272210.0,한화시스템보통주
17621,272210,2019-11-20,0.0546218487394958,11900,11250,-650,1859794,272210.0,한화시스템보통주
17622,272210,2019-11-15,0.0472103004291845,11650,12200,550,5304317,272210.0,한화시스템보통주
17623,272210,2019-11-14,0.0495495495495495,11100,11650,550,3649312,272210.0,한화시스템보통주
17624,272210,2019-11-13,0.0444444444444444,11250,11100,-150,15462185,272210.0,한화시스템보통주
17625,272210,2019-11-20,0.0546218487394958,11900,11250,-650,1859794,272210.0,한화시스템보통주
17626,272210,2019-11-15,0.0472103004291845,11650,12200,550,5304317,272210.0,한화시스템보통주
17627,272210,2019-11-14,0.0495495495495495,11100,11650,550,3649312,272210.0,한화시스템보통주
17628,272210,2019-11-13,0.0444444444444444,11250,11100,-150,15462185,272210.0,한화시스템보통주
17629,272210,2019-11-20,0.0546218487394958,11900,11250,-650,1859794,272210.0,한화시스템보통주
17630,272210,2019-11-15,0.0472103004291845,11650,12200,550,5304317,272210.0,한화시스템보통주
17631,272210,2019-11-14,0.0495495495495495,11100,11650,550,3649312,272210.0,한화시스템보통주
17632,272210,2019-11-13,0.0444444444444444,11250,11100,-150,15462185,272210.0,한화시스템보통주
17633,272210,2019-11-20,0.0546218487394958,11900,11250,-650,1859794,272210.0,한화시스템보통주
17634,272210,2019-11-15,0.0472103004291845,11650,12200,550,5304317,272210.0,한화시스템보통주
17635,272210,2019-11-14,0.0495495495495495,11100,11650,550,3649312,272210.0,한화시스템보통주
17636,272210,2019-11-13,0.0444444444444444,11250,11100,-150,15462185,272210.0,한화시스템보통주
17637,272210,2019-11-20,0.0546218487394958,11900,11250,-650,1859794,272210.0,한화시스템보통주
17638,272210,2019-11-15,0.0472103004291845,11650,12200,550,5304317,272210.0,한화시스템보통주
17639,272210,2019-11-14,0.0495495495495495,11100,11650,550,3649312,272210.0,한화시스템보통주
17640,272210,2019-11-13,0.0444444444444444,11250,11100,-150,15462185,272210.0,한화시스템보통주
17641,272210,2019-11-20,0.0546218487394958,11900,11250,-650,1859794,272210.0,한화시스템보통주
17642,272210,2019-11-15,0.0472103004291845,11650,12200,550,5304317,272210.0,한화시스템보통주
17643,272210,2019-11-14,0.0495495495495495,11100,11650,550,3649312,272210.0,한화시스템보통주
17644,272210,2019-11-13,0.0444444444444444,11250,11100,-150,15462185,272210.0,한화시스템보통주
17645,272210,2019-11-20,0.0546218487394958,11900,11250,-650,1859794,272210.0,한화시스템보통주
17646,272210,2019-11-15,0.0472103004291845,11650,12200,550,5304317,272210.0,한화시스템보통주
17647,272210,2019-11-14,0.0495495495495495,11100,11650,550,3649312,272210.0,한화시스템보통주
17648,272210,2019-11-13,0.0444444444444444,11250,11100,-150,15462185,272210.0,한화시스템보통주
17649,272210,2019-11-20,0.0546218487394958,11900,11250,-650,1859794,272210.0,한화시스템보통주
17650,272210,2019-11-15,0.0472103004291845,11650,12200,550,5304317,272210.0,한화시스템보통주
17651,272210,2019-11-14,0.0495495495495495,11100,11650,550,3649312,272210.0,한화시스템보통주
17652,272210,2019-11-13,0.0444444444444444,11250,11100,-150,15462185,272210.0,한화시스템보통주
17653,272210,2019-11-20,0.0546218487394958,11900,11250,-650,1859794,272210.0,한화시스템보통주
17654,272210,2019-11-15,0.0472103004291845,11650,12200,550,5304317,272210.0,한화시스템보통주
17655,272210,2019-11-14,0.0495495495495495,11100,11650,550,3649312,272210.0,한화시스템보통주
17656,272210,2019-11-13,0.0444444444444444,11250,11100,-150,15462185,272210.0,한화시스템보통주
17657,272210,2019-11-20,0.0546218487394958,11900,11250,-650,1859794,272210.0,한화시스템보통주
17658,272210,2019-11-15,0.0472103004291845,11650,12200,550,5304317,272210.0,한화시스템보통주
17659,272210,2019-11-14,0.0495495495495495,11100,11650,550,3649312,272210.0,한화시스템보통주
17660,272210,2019-11-13,0.0444444444444444,11250,11100,-150,15462185,272210.0,한화시스템보통주
17661,272210,2019-11-20,0.0546218487394958,11900,11250,-650,1859794,272210.0,한화시스템보통주
17662,272210,2019-11-15,0.0472103004291845,11650,12200,550,5304317,272210.0,한화시스템보통주
17663,272210,2019-11-14,0.0495495495495495,11100,11650,550,3649312,272210.0,한화시스템보통주
17664,272210,2019-11-13,0.0444444444444444,11250,11100,-150,15462185,272210.0,한화시스템보통주
17665,272210,2019-11-20,0.0546218487394958,11900,11250,-650,1859794,272210.0,한화시스템보통주
17666,272210,2019-11-15,0.0472103004291845,11650,12200,550,5304317,272210.0,한화시스템보통주
17667,272210,2019-11-14,0.0495495495495495,11100,11650,550,3649312,272210.0,한화시스템보통주
17668,272210,2019-11-13,0.0444444444444444,11250,11100,-150,15462185,272210.0,한화시스템보통주
17669,272210,2019-11-20,0.0546218487394958,11900,11250,-650,1859794,272210.0,한화시스템보통주
17670,272210,2019-11-15,0.0472103004291845,11650,12200,550,5304317,272210.0,한화시스템보통주
17671,272210,2019-11-14,0.0495495495495495,11100,11650,550,3649312,272210.0,한화시스템보통주
17672,272210,2019-11-13,0.0444444444444444,11250,11100,-150,15462185,272210.0,한화시스템보통주
17673,272210,2019-11-20,0.0546218487394958,11900,11250,-650,1859794,272210.0,한화시스템보통주
17674,272210,2019-11-15,0.0472103004291845,11650,12200,550,5304317,272210.0,한화시스템보통주
17675,272210,2019-11-14,0.0495495495495495,11100,11650,550,3649312,272210.0,한화시스템보통주
17676,272210,2019-11-13,0.0444444444444444,11250,11100,-150,15462185,272210.0,한화시스템보통주
17677,272210,2019-11-20,0.0546218487394958,11900,11250,-650,1859794,272210.0,한화시스템보통주
17678,272210,2019-11-15,0.0472103004291845,11650,12200,550,5304317,272210.0,한화시스템보통주
17679,272210,2019-11-14,0.0495495495495495,11100,11650,550,3649312,272210.0,한화시스템보통주
17680,272210,2019-11-13,0.0444444444444444,11250,11100,-150,15462185,272210.0,한화시스템보통주
17681,272210,2019-11-20,0.0546218487394958,11900,11250,-650,1859794,272210.0,한화시스템보통주
17682,272210,2019-11-15,0.0472103004291845,11650,12200,550,5304317,272210.0,한화시스템보통주
17683,272210,2019-11-14,0.0495495495495495,11100,11650,550,3649312,272210.0,한화시스템보통주
17684,272210,2019-11-13,0.0444444444444444,11250,11100,-150,15462185,272210.0,한화시스템보통주
17685,272210,2019-11-20,0.0546218487394958,11900,11250,-650,1859794,272210.0,한화시스템보통주
17686,272210,2019-11-15,0.0472103004291845,11650,12200,550,5304317,272210.0,한화시스템보통주
17687,272210,2019-11-14,0.0495495495495495,11100,11650,550,3649312,272210.0,한화시스템보통주
17688,272210,2019-11-13,0.0444444444444444,11250,11100,-150,15462185,272210.0,한화시스템보통주
17689,272210,2019-11-20,0.0546218487394958,11900,11250,-650,1859794,272210.0,한화시스템보통주
17690,272210,2019-11-15,0.0472103004291845,11650,12200,550,5304317,272210.0,한화시스템보통주
17691,272210,2019-11-14,0.0495495495495495,11100,11650,550,3649312,272210.0,한화시스템보통주
17692,272210,2019-11-13,0.0444444444444444,11250,11100,-150,15462185,272210.0,한화시스템보통주
17693,272210,2019-11-20,0.0546218487394958,11900,11250,-650,1859794,272210.0,한화시스템보통주
17694,272210,2019-11-15,0.0472103004291845,11650,12200,550,5304317,272210.0,한화시스템보통주
17695,272210,2019-11-14,0.0495495495495495,11100,11650,550,3649312,272210.0,한화시스템보통주
17696,272210,2019-11-13,0.0444444444444444,11250,11100,-150,15462185,272210.0,한화시스템보통주
17697,272210,2019-11-20,0.0546218487394958,11900,11250,-650,1859794,272210.0,한화시스템보통주
17698,272210,2019-11-15,0.0472103004291845,11650,12200,550,5304317,272210.0,한화시스템보통주
17699,272210,2019-11-14,0.0495495495495495,11100,11650,550,3649312,272210.0,한화시스템보통주
17700,272210,2019-11-13,0.0444444444444444,11250,11100,-150,15462185,272210.0,한화시스템보통주
17701,272210,2019-11-20,0.0546218487394958,11900,11250,-650,1859794,272210.0,한화시스템보통주
17702,272210,2019-11-15,0.0472103004291845,11650,12200,550,5304317,272210.0,한화시스템보통주
17703,272210,2019-11-14,0.0495495495495495,11100,11650,550,3649312,272210.0,한화시스템보통주
17704,272210,2019-11-13,0.0444444444444444,11250,11100,-150,15462185,272210.0,한화시스템보통주
17705,272210,2019-11-20,0.0546218487394958,11900,11250,-650,1859794,272210.0,한화시스템보통주
17706,272210,2019-11-15,0.0472103004291845,11650,12200,550,5304317,272210.0,한화시스템보통주
17707,272210,2019-11-14,0.0495495495495495,11100,11650,550,3649312,272210.0,한화시스템보통주
17708,272210,2019-11-13,0.0444444444444444,11250,11100,-150,15462185,272210.0,한화시스템보통주
17709,272210,2019-11-20,0.0546218487394958,11900,11250,-650,1859794,272210.0,한화시스템보통주
17710,272210,2019-11-15,0.0472103004291845,11650,12200,550,5304317,272210.0,한화시스템보통주
17711,272210,2019-11-14,0.0495495495495495,11100,11650,550,3649312,272210.0,한화시스템보통주
17712,272210,2019-11-13,0.0444444444444444,11250,11100,-150,15462185,272210.0,한화시스템보통주
17713,272210,2019-11-20,0.0546218487394958,11900,11250,-650,1859794,272210.0,한화시스템보통주
17714,272210,2019-11-15,0.0472103004291845,11650,12200,550,5304317,272210.0,한화시스템보통주
17715,272210,2019-11-14,0.0495495495495495,11100,11650,550,3649312,272210.0,한화시스템보통주
17716,272210,2019-11-13,0.0444444444444444,11250,11100,-150,15462185,272210.0,한화시스템보통주
17717,272210,2019-11-20,0.0546218487394958,11900,11250,-650,1859794,272210.0,한화시스템보통주
17718,272210,2019-11-15,0.0472103004291845,11650,12200,550,5304317,272210.0,한화시스템보통주
17719,272210,2019-11-14,0.0495495495495495,11100,11650,550,3649312,272210.0,한화시스템보통주
17720,272210,2019-11-13,0.0444444444444444,11250,11100,-150,15462185,272210.0,한화시스템보통주
17721,272210,2019-11-20,0.0546218487394958,11900,11250,-650,1859794,272210.0,한화시스템보통주
17722,272210,2019-11-15,0.0472103004291845,11650,12200,550,5304317,272210.0,한화시스템보통주
17723,272210,2019-11-14,0.0495495495495495,11100,11650,550,3649312,272210.0,한화시스템보통주
17724,272210,2019-11-13,0.0444444444444444,11250,11100,-150,15462185,272210.0,한화시스템보통주
17725,272210,2019-11-20,0.0546218487394958,11900,11250,-650,1859794,272210.0,한화시스템보통주
17726,272210,2019-11-15,0.0472103004291845,11650,12200,550,5304317,272210.0,한화시스템보통주
17727,272210,2019-11-14,0.0495495495495495,11100,11650,550,3649312,272210.0,한화시스템보통주
17728,272210,2019-11-13,0.0444444444444444,11250,11100,-150,15462185,272210.0,한화시스템보통주
17729,272210,2019-11-20,0.0546218487394958,11900,11250,-650,1859794,272210.0,한화시스템보통주
17730,272210,2019-11-15,0.0472103004291845,11650,12200,550,5304317,272210.0,한화시스템보통주
17731,272210,2019-11-14,0.0495495495495495,11100,11650,550,3649312,272210.0,한화시스템보통주
17732,272210,2019-11-13,0.0444444444444444,11250,11100,-150,15462185,272210.0,한화시스템보통주
17733,272210,2019-11-20,0.0546218487394958,11900,11250,-650,1859794,272210.0,한화시스템보통주
17734,272210,2019-11-15,0.0472103004291845,11650,12200,550,5304317,272210.0,한화시스템보통주
17735,272210,2019-11-14,0.0495495495495495,11100,11650,550,3649312,272210.0,한화시스템보통주
17736,272210,2019-11-13,0.0444444444444444,11250,11100,-150,15462185,272210.0,한화시스템보통주
17737,272210,2019-11-20,0.0546218487394958,11900,11250,-650,1859794,272210.0,한화시스템보통주
17738,272210,2019-11-15,0.0472103004291845,11650,12200,550,5304317,272210.0,한화시스템보통주
17739,272210,2019-11-14,0.0495495495495495,11100,11650,550,3649312,272210.0,한화시스템보통주
17740,272210,2019-11-13,0.0444444444444444,11250,11100,-150,15462185,272210.0,한화시스템보통주
17741,272210,2019-11-20,0.0546218487394958,11900,11250,-650,1859794,272210.0,한화시스템보통주
17742,272210,2019-11-15,0.0472103004291845,11650,12200,550,5304317,272210.0,한화시스템보통주
17743,272210,2019-11-14,0.0495495495495495,11100,11650,550,3649312,272210.0,한화시스템보통주
17744,272210,2019-11-13,0.0444444444444444,11250,11100,-150,15462185,272210.0,한화시스템보통주
17745,272210,2019-11-20,0.0546218487394958,11900,11250,-650,1859794,272210.0,한화시스템보통주
17746,272210,2019-11-15,0.0472103004291845,11650,12200,550,5304317,272210.0,한화시스템보통주
17747,272210,2019-11-14,0.0495495495495495,11100,11650,550,3649312,272210.0,한화시스템보통주
17748,272210,2019-11-13,0.0444444444444444,11250,11100,-150,15462185,272210.0,한화시스템보통주
17749,272210,2019-11-20,0.0546218487394958,11900,11250,-650,1859794,272210.0,한화시스템보통주
17750,272210,2019-11-15,0.0472103004291845,11650,12200,550,5304317,272210.0,한화시스템보통주
17751,272210,2019-11-14,0.0495495495495495,11100,11650,550,3649312,272210.0,한화시스템보통주
17752,272210,2019-11-13,0.0444444444444444,11250,11100,-150,15462185,272210.0,한화시스템보통주
17753,272210,2019-11-20,0.0546218487394958,11900,11250,-650,1859794,272210.0,한화시스템보통주
17754,272210,2019-11-15,0.0472103004291845,11650,12200,550,5304317,272210.0,한화시스템보통주
17755,272210,2019-11-14,0.0495495495495495,11100,11650,550,3649312,272210.0,한화시스템보통주
17756,272210,2019-11-13,0.0444444444444444,11250,11100,-150,15462185,272210.0,한화시스템보통주
17757,272210,2019-11-20,0.0546218487394958,11900,11250,-650,1859794,272210.0,한화시스템보통주
17758,272210,2019-11-15,0.0472103004291845,11650,12200,550,5304317,272210.0,한화시스템보통주
17759,272210,2019-11-14,0.0495495495495495,11100,11650,550,3649312,272210.0,한화시스템보통주
17760,272210,2019-11-13,0.0444444444444444,11250,11100,-150,15462185,272210.0,한화시스템보통주
17761,272210,2019-11-20,0.0546218487394958,11900,11250,-650,1859794,272210.0,한화시스템보통주
17762,272210,2019-11-15,0.0472103004291845,11650,12200,550,5304317,272210.0,한화시스템보통주
17763,272210,2019-11-14,0.0495495495495495,11100,11650,550,3649312,272210.0,한화시스템보통주
17764,272210,2019-11-13,0.0444444444444444,11250,11100,-150,15462185,272210.0,한화시스템보통주
17765,272210,2019-11-20,0.0546218487394958,11900,11250,-650,1859794,272210.0,한화시스템보통주
17766,272210,2019-11-15,0.0472103004291845,11650,12200,550,5304317,272210.0,한화시스템보통주
17767,272210,2019-11-14,0.0495495495495495,11100,11650,550,3649312,272210.0,한화시스템보통주
17768,272210,2019-11-13,0.0444444444444444,11250,11100,-150,15462185,272210.0,한화시스템보통주
17769,272210,2019-11-20,0.0546218487394958,11900,11250,-650,1859794,272210.0,한화시스템보통주
17770,272210,2019-11-15,0.0472103004291845,11650,12200,550,5304317,272210.0,한화시스템보통주
17771,272210,2019-11-14,0.0495495495495495,11100,11650,550,3649312,272210.0,한화시스템보통주
17772,272210,2019-11-13,0.0444444444444444,11250,11100,-150,15462185,272210.0,한화시스템보통주
17773,272210,2019-11-20,0.0546218487394958,11900,11250,-650,1859794,272210.0,한화시스템보통주
17774,272210,2019-11-15,0.0472103004291845,11650,12200,550,5304317,272210.0,한화시스템보통주
17775,272210,2019-11-14,0.0495495495495495,11100,11650,550,3649312,272210.0,한화시스템보통주
17776,272210,2019-11-13,0.0444444444444444,11250,11100,-150,15462185,272210.0,한화시스템보통주
17777,272210,2019-11-20,0.0546218487394958,11900,11250,-650,1859794,272210.0,한화시스템보통주
17778,272210,2019-11-15,0.0472103004291845,11650,12200,550,5304317,272210.0,한화시스템보통주
17779,272210,2019-11-14,0.0495495495495495,11100,11650,550,3649312,272210.0,한화시스템보통주
17780,272210,2019-11-13,0.0444444444444444,11250,11100,-150,15462185,272210.0,한화시스템보통주
17781,272210,2019-11-20,0.0546218487394958,11900,11250,-650,1859794,272210.0,한화시스템보통주
17782,272210,2019-11-15,0.0472103004291845,11650,12200,550,5304317,272210.0,한화시스템보통주
17783,272210,2019-11-14,0.0495495495495495,11100,11650,550,3649312,272210.0,한화시스템보통주
17784,272210,2019-11-13,0.0444444444444444,11250,11100,-150,15462185,272210.0,한화시스템보통주
17785,272210,2019-11-20,0.0546218487394958,11900,11250,-650,1859794,272210.0,한화시스템보통주
17786,272210,2019-11-15,0.0472103004291845,11650,12200,550,5304317,272210.0,한화시스템보통주
17787,272210,2019-11-14,0.0495495495495495,11100,11650,550,3649312,272210.0,한화시스템보통주
17788,272210,2019-11-13,0.0444444444444444,11250,11100,-150,15462185,272210.0,한화시스템보통주
17789,272210,2019-11-20,0.0546218487394958,11900,11250,-650,1859794,272210.0,한화시스템보통주
17790,272210,2019-11-15,0.0472103004291845,11650,12200,550,5304317,272210.0,한화시스템보통주
17791,272210,2019-11-14,0.0495495495495495,11100,11650,550,3649312,272210.0,한화시스템보통주
17792,272210,2019-11-13,0.0444444444444444,11250,11100,-150,15462185,272210.0,한화시스템보통주
17793,272210,2019-11-20,0.0546218487394958,11900,11250,-650,1859794,272210.0,한화시스템보통주
17794,272210,2019-11-15,0.0472103004291845,11650,12200,550,5304317,272210.0,한화시스템보통주
17795,272210,2019-11-14,0.0495495495495495,11100,11650,550,3649312,272210.0,한화시스템보통주
17796,272210,2019-11-13,0.0444444444444444,11250,11100,-150,15462185,272210.0,한화시스템보통주
17797,272210,2019-11-20,0.0546218487394958,11900,11250,-650,1859794,272210.0,한화시스템보통주
17798,272210,2019-11-15,0.0472103004291845,11650,12200,550,5304317,272210.0,한화시스템보통주
17799,272210,2019-11-14,0.0495495495495495,11100,11650,550,3649312,272210.0,한화시스템보통주
17800,272210,2019-11-13,0.0444444444444444,11250,11100,-150,15462185,272210.0,한화시스템보통주
17801,272210,2019-11-20,0.0546218487394958,11900,11250,-650,1859794,272210.0,한화시스템보통주
17802,272210,2019-11-15,0.0472103004291845,11650,12200,550,5304317,272210.0,한화시스템보통주
17803,272210,2019-11-14,0.0495495495495495,11100,11650,550,3649312,272210.0,한화시스템보통주
17804,272210,2019-11-13,0.0444444444444444,11250,11100,-150,15462185,272210.0,한화시스템보통주
17805,272210,2019-11-20,0.0546218487394958,11900,11250,-650,1859794,272210.0,한화시스템보통주
17806,272210,2019-11-15,0.0472103004291845,11650,12200,550,5304317,272210.0,한화시스템보통주
17807,272210,2019-11-14,0.0495495495495495,11100,11650,550,3649312,272210.0,한화시스템보통주
17808,272210,2019-11-13,0.0444444444444444,11250,11100,-150,15462185,272210.0,한화시스템보통주
17809,272210,2019-11-20,0.0546218487394958,11900,11250,-650,1859794,272210.0,한화시스템보통주
17810,272210,2019-11-15,0.0472103004291845,11650,12200,550,5304317,272210.0,한화시스템보통주
17811,272210,2019-11-14,0.0495495495495495,11100,11650,550,3649312,272210.0,한화시스템보통주
17812,272210,2019-11-13,0.0444444444444444,11250,11100,-150,15462185,272210.0,한화시스템보통주
17813,272210,2019-11-20,0.0546218487394958,11900,11250,-650,1859794,272210.0,한화시스템보통주
17814,272210,2019-11-15,0.0472103004291845,11650,12200,550,5304317,272210.0,한화시스템보통주
17815,272210,2019-11-14,0.0495495495495495,11100,11650,550,3649312,272210.0,한화시스템보통주
17816,272210,2019-11-13,0.0444444444444444,11250,11100,-150,15462185,272210.0,한화시스템보통주
17817,272210,2019-11-20,0.0546218487394958,11900,11250,-650,1859794,272210.0,한화시스템보통주
17818,272210,2019-11-15,0.0472103004291845,11650,12200,550,5304317,272210.0,한화시스템보통주
17819,272210,2019-11-14,0.0495495495495495,11100,11650,550,3649312,272210.0,한화시스템보통주
17820,272210,2019-11-13,0.0444444444444444,11250,11100,-150,15462185,272210.0,한화시스템보통주
17821,272210,2019-11-20,0.0546218487394958,11900,11250,-650,1859794,272210.0,한화시스템보통주
17822,272210,2019-11-15,0.0472103004291845,11650,12200,550,5304317,272210.0,한화시스템보통주
17823,272210,2019-11-14,0.0495495495495495,11100,11650,550,3649312,272210.0,한화시스템보통주
17824,272210,2019-11-13,0.0444444444444444,11250,11100,-150,15462185,272210.0,한화시스템보통주
17825,272210,2019-11-20,0.0546218487394958,11900,11250,-650,1859794,272210.0,한화시스템보통주
17826,272210,2019-11-15,0.0472103004291845,11650,12200,550,5304317,272210.0,한화시스템보통주
17827,272210,2019-11-14,0.0495495495495495,11100,11650,550,3649312,272210.0,한화시스템보통주
17828,272210,2019-11-13,0.0444444444444444,11250,11100,-150,15462185,272210.0,한화시스템보통주
17829,272210,2019-11-20,0.0546218487394958,11900,11250,-650,1859794,272210.0,한화시스템보통주
17830,272210,2019-11-15,0.0472103004291845,11650,12200,550,5304317,272210.0,한화시스템보통주
17831,272210,2019-11-14,0.0495495495495495,11100,11650,550,3649312,272210.0,한화시스템보통주
17832,272210,2019-11-13,0.0444444444444444,11250,11100,-150,15462185,272210.0,한화시스템보통주
17833,272210,2019-11-20,0.0546218487394958,11900,11250,-650,1859794,272210.0,한화시스템보통주
17834,272210,2019-11-15,0.0472103004291845,11650,12200,550,5304317,272210.0,한화시스템보통주
17835,272210,2019-11-14,0.0495495495495495,11100,11650,550,3649312,272210.0,한화시스템보통주
17836,272210,2019-11-13,0.0444444444444444,11250,11100,-150,15462185,272210.0,한화시스템보통주
17837,272210,2019-11-20,0.0546218487394958,11900,11250,-650,1859794,272210.0,한화시스템보통주
17838,272210,2019-11-15,0.0472103004291845,11650,12200,550,5304317,272210.0,한화시스템보통주
17839,272210,2019-11-14,0.0495495495495495,11100,11650,550,3649312,272210.0,한화시스템보통주
17840,272210,2019-11-13,0.0444444444444444,11250,11100,-150,15462185,272210.0,한화시스템보통주
17841,272210,2019-11-20,0.0546218487394958,11900,11250,-650,1859794,272210.0,한화시스템보통주
17842,272210,2019-11-15,0.0472103004291845,11650,12200,550,5304317,272210.0,한화시스템보통주
17843,272210,2019-11-14,0.0495495495495495,11100,11650,550,3649312,272210.0,한화시스템보통주
17844,272210,2019-11-13,0.0444444444444444,11250,11100,-150,15462185,272210.0,한화시스템보통주
17845,272210,2019-11-20,0.0546218487394958,11900,11250,-650,1859794,272210.0,한화시스템보통주
17846,272210,2019-11-15,0.0472103004291845,11650,12200,550,5304317,272210.0,한화시스템보통주
17847,272210,2019-11-14,0.0495495495495495,11100,11650,550,3649312,272210.0,한화시스템보통주
17848,278530,2021-01-08,0.0458955223880597,13400,14015,615,661826,,
17849,278530,2020-06-16,0.0541642399534071,8585,9050,465,461987,,
17850,278530,2020-06-15,0.0466407551360355,9005,8585,-420,451938,,
17851,278530,2020-04-01,0.0448548812664907,7580,7240,-340,430499,,
17852,278530,2020-03-25,0.0567778566359119,7045,7445,400,3021485,,
17853,278530,2020-03-24,0.0855161787365177,6490,7045,555,1349958,,
17854,278530,2020-03-23,0.0511695906432748,6840,6490,-350,306679,,
17855,278530,2020-03-20,0.0746268656716417,6365,6840,475,626680,,
17856,278530,2020-03-19,0.0755265068990559,6885,6365,-520,2282123,,
17857,278530,2020-03-18,0.050999310820124,7255,6885,-370,1002904,,
17858,278530,2020-03-09,0.0421652421652421,8775,8405,-370,527736,,
17859,278530,2018-10-11,0.0400903444381705,8855,8500,-355,880361,,
17860,278540,2021-01-08,0.0509483079211602,13445,14130,685,604784,,
17861,278540,2020-06-16,0.0482277745496804,8605,9020,415,24274,,
17862,278540,2020-06-15,0.0438888888888888,9000,8605,-395,11822,,
17863,278540,2020-04-01,0.0464355788096795,7645,7290,-355,309158,,
17864,278540,2020-03-25,0.0559490084985835,7060,7455,395,337547,,
17865,278540,2020-03-24,0.0844854070660522,6510,7060,550,323388,,
17866,278540,2020-03-23,0.0544662309368191,6885,6510,-375,328221,,
17867,278540,2020-03-20,0.0741029641185647,6410,6885,475,656502,,
17868,278540,2020-03-19,0.0763688760806916,6940,6410,-530,1046125,,
17869,278540,2020-03-18,0.0512645249487354,7315,6940,-375,1037569,,
17870,278540,2020-03-09,0.0447338618346545,8830,8435,-395,1053757,,
17871,278540,2020-02-24,0.0404255319148936,9400,9020,-380,1662335,,
17872,278540,2018-10-11,0.0440755580995993,8735,8350,-385,724495,,
17873,282330,2021-05-10,0.0662650602409638,166000,177000,11000,122935,282330.0,BGF리테일보통주
17874,282330,2021-03-03,0.0660377358490566,159000,169500,10500,59126,282330.0,BGF리테일보통주
17875,282330,2021-02-24,0.042042042042042,166500,159500,-7000,45652,282330.0,BGF리테일보통주
17876,282330,2021-02-17,0.0458452722063037,174500,166500,-8000,43092,282330.0,BGF리테일보통주
17877,282330,2021-02-15,0.0410557184750733,170500,177500,7000,182653,282330.0,BGF리테일보통주
17878,282330,2021-01-28,0.0443037974683544,158000,165000,7000,91596,282330.0,BGF리테일보통주
17879,282330,2021-01-21,0.0612244897959183,147000,156000,9000,143118,282330.0,BGF리테일보통주
17880,282330,2021-01-15,0.0429042904290429,151500,145000,-6500,75654,282330.0,BGF리테일보통주
17881,282330,2021-01-13,0.0498220640569395,140500,147500,7000,135734,282330.0,BGF리테일보통주
17882,282330,2020-11-11,0.0681818181818181,132000,141000,9000,132622,282330.0,BGF리테일보통주
17883,282330,2020-10-19,0.0491803278688524,122000,128000,6000,123078,282330.0,BGF리테일보통주
17884,282330,2020-08-31,0.0493827160493827,121500,127500,6000,101675,282330.0,BGF리테일보통주
17885,282330,2020-07-10,0.044280442804428,135500,129500,-6000,54173,282330.0,BGF리테일보통주
17886,282330,2020-06-15,0.048780487804878,143500,136500,-7000,48751,282330.0,BGF리테일보통주
17887,282330,2020-06-12,0.040133779264214,149500,143500,-6000,53698,282330.0,BGF리테일보통주
17888,282330,2020-05-29,0.0739549839228295,155500,167000,11500,74107,282330.0,BGF리테일보통주
17889,282330,2020-05-08,0.0623052959501557,160500,150500,-10000,162984,282330.0,BGF리테일보통주
17890,282330,2020-04-27,0.0673400673400673,148500,158500,10000,137872,282330.0,BGF리테일보통주
17891,282330,2020-04-14,0.0539568345323741,139000,146500,7500,33157,282330.0,BGF리테일보통주
17892,282330,2020-04-13,0.0608108108108108,148000,139000,-9000,32134,282330.0,BGF리테일보통주
17893,282330,2020-04-06,0.1111111111111111,130500,145000,14500,45854,282330.0,BGF리테일보통주
17894,282330,2020-03-31,0.0909090909090909,121000,132000,11000,96353,282330.0,BGF리테일보통주
17895,282330,2020-03-24,0.0517241379310344,116000,122000,6000,59289,282330.0,BGF리테일보통주
17896,282330,2020-03-23,0.0452674897119341,121500,116000,-5500,37483,282330.0,BGF리테일보통주
17897,282330,2020-03-20,0.1146788990825688,109000,121500,12500,45758,282330.0,BGF리테일보통주
17898,282330,2020-03-19,0.0916666666666666,120000,109000,-11000,55754,282330.0,BGF리테일보통주
17899,282330,2020-03-18,0.0697674418604651,129000,120000,-9000,48304,282330.0,BGF리테일보통주
17900,282330,2020-03-13,0.0422535211267605,142000,136000,-6000,57520,282330.0,BGF리테일보통주
17901,282330,2020-03-12,0.0501672240802675,149500,142000,-7500,49431,282330.0,BGF리테일보통주
17902,282330,2019-11-04,0.0417827298050139,179500,187000,7500,35995,282330.0,BGF리테일보통주
17903,282330,2019-08-09,0.0444964871194379,213500,204000,-9500,26166,282330.0,BGF리테일보통주
17904,282330,2019-08-01,0.0537897310513447,204500,215500,11000,39856,282330.0,BGF리테일보통주
17905,282330,2019-07-22,0.0408653846153846,208000,199500,-8500,21991,282330.0,BGF리테일보통주
17906,282330,2019-06-27,0.0644329896907216,194000,206500,12500,39225,282330.0,BGF리테일보통주
17907,282330,2019-06-14,0.0465116279069767,193500,202500,9000,41135,282330.0,BGF리테일보통주
17908,282330,2019-06-10,0.04,187500,195000,7500,31441,282330.0,BGF리테일보통주
17909,282330,2019-05-29,0.0498753117206982,200500,190500,-10000,27869,282330.0,BGF리테일보통주
17910,282330,2019-02-25,0.048076923076923,208000,218000,10000,24912,282330.0,BGF리테일보통주
17911,282330,2019-02-20,0.0538461538461538,195000,205500,10500,37485,282330.0,BGF리테일보통주
17912,282330,2019-02-13,0.0539083557951482,185500,195500,10000,67670,282330.0,BGF리테일보통주
17913,282330,2019-01-10,0.0933014354066985,209000,189500,-19500,69556,282330.0,BGF리테일보통주
17914,282330,2018-12-19,0.0445544554455445,202000,211000,9000,28040,282330.0,BGF리테일보통주
17915,282330,2018-11-26,0.0491803278688524,183000,192000,9000,26642,282330.0,BGF리테일보통주
17916,282330,2018-11-22,0.0412087912087912,182000,189500,7500,29132,282330.0,BGF리테일보통주
17917,282330,2018-11-19,0.0471976401179941,169500,177500,8000,17531,282330.0,BGF리테일보통주
17918,282330,2018-10-31,0.0426136363636363,176000,168500,-7500,87537,282330.0,BGF리테일보통주
17919,282330,2018-10-26,0.0485175202156334,185500,176500,-9000,26371,282330.0,BGF리테일보통주
17920,282330,2018-10-25,0.0559796437659033,196500,185500,-11000,27397,282330.0,BGF리테일보통주
17921,282330,2018-10-10,0.044776119402985,201000,210000,9000,41465,282330.0,BGF리테일보통주
17922,282330,2018-10-01,0.0510948905109489,205500,195000,-10500,27749,282330.0,BGF리테일보통주
17923,282330,2018-09-27,0.0572139303482587,201000,212500,11500,50760,282330.0,BGF리테일보통주
17924,282330,2018-09-10,0.0523415977961432,181500,191000,9500,52077,282330.0,BGF리테일보통주
17925,282330,2018-09-07,0.0521739130434782,172500,181500,9000,26900,282330.0,BGF리테일보통주
17926,282330,2018-08-28,0.081081081081081,166500,180000,13500,58210,282330.0,BGF리테일보통주
17927,282330,2018-08-27,0.0471698113207547,159000,166500,7500,26875,282330.0,BGF리테일보통주
17928,282330,2018-07-24,0.0465116279069767,150500,157500,7000,60120,282330.0,BGF리테일보통주
17929,282330,2018-07-20,0.0597484276729559,159000,149500,-9500,119967,282330.0,BGF리테일보통주
17930,282330,2018-07-18,0.0411764705882352,170000,163000,-7000,74839,282330.0,BGF리테일보통주
17931,282330,2018-07-16,0.0779944289693593,179500,165500,-14000,223889,282330.0,BGF리테일보통주
17932,282330,2018-07-03,0.0453333333333333,187500,179000,-8500,38610,282330.0,BGF리테일보통주
17933,282330,2018-06-28,0.0450928381962864,188500,197000,8500,57752,282330.0,BGF리테일보통주
17934,282330,2018-06-27,0.0431472081218274,197000,188500,-8500,36398,282330.0,BGF리테일보통주
17935,282330,2018-06-20,0.062200956937799,209000,196000,-13000,57442,282330.0,BGF리테일보통주
17936,282330,2018-06-18,0.0441558441558441,192500,201000,8500,44563,282330.0,BGF리테일보통주
17937,282330,2018-06-12,0.0409207161125319,195500,203500,8000,39578,282330.0,BGF리테일보통주
17938,282330,2018-06-07,0.0602739726027397,182500,193500,11000,53852,282330.0,BGF리테일보통주
17939,282330,2018-05-24,0.0446927374301676,179000,187000,8000,35877,282330.0,BGF리테일보통주
17940,282330,2018-05-02,0.0811518324607329,191000,206500,15500,121961,282330.0,BGF리테일보통주
17941,282330,2018-04-30,0.0670391061452514,179000,191000,12000,95325,282330.0,BGF리테일보통주
17942,282330,2018-04-23,0.0536723163841807,177000,186500,9500,49545,282330.0,BGF리테일보통주
17943,282330,2018-04-10,0.0455764075067024,186500,178000,-8500,39175,282330.0,BGF리테일보통주
17944,282330,2018-04-09,0.0687679083094555,174500,186500,12000,42051,282330.0,BGF리테일보통주
17945,282330,2018-04-03,0.0560471976401179,169500,179000,9500,106031,282330.0,BGF리테일보통주
17946,282330,2018-03-30,0.1081967213114754,152500,169000,16500,64701,282330.0,BGF리테일보통주
17947,282330,2018-02-22,0.0481283422459893,187000,178000,-9000,56556,282330.0,BGF리테일보통주
17948,282330,2018-02-14,0.0603015075376884,199000,187000,-12000,143124,282330.0,BGF리테일보통주
17949,282330,2018-02-13,0.0546318289786223,210500,199000,-11500,41843,282330.0,BGF리테일보통주
17950,282330,2018-01-30,0.0418502202643171,227000,217500,-9500,32415,282330.0,BGF리테일보통주
17951,282330,2017-12-19,0.0462184873949579,238000,227000,-11000,37388,282330.0,BGF리테일보통주
17952,282330,2017-12-12,0.0543259557344064,248500,235000,-13500,286513,282330.0,BGF리테일보통주
17953,282330,2017-12-11,0.2809278350515464,194000,248500,54500,684631,282330.0,BGF리테일보통주
17954,282330,2017-12-08,0.1869747899159664,238000,194000,-44000,68343,282330.0,BGF리테일보통주
17955,282330,2017-12-12,0.0543259557344064,248500,235000,-13500,286513,282330.0,BGF리테일보통주
17956,282330,2017-12-11,0.2809278350515464,194000,248500,54500,684631,282330.0,BGF리테일보통주
17957,282330,2017-12-08,0.1869747899159664,238000,194000,-44000,68343,282330.0,BGF리테일보통주
17958,282330,2017-12-12,0.0543259557344064,248500,235000,-13500,286513,282330.0,BGF리테일보통주
17959,282330,2017-12-11,0.2809278350515464,194000,248500,54500,684631,282330.0,BGF리테일보통주
17960,282330,2017-12-08,0.1869747899159664,238000,194000,-44000,68343,282330.0,BGF리테일보통주
17961,282330,2017-12-12,0.0543259557344064,248500,235000,-13500,286513,282330.0,BGF리테일보통주
17962,282330,2017-12-11,0.2809278350515464,194000,248500,54500,684631,282330.0,BGF리테일보통주
17963,282330,2017-12-08,0.1869747899159664,238000,194000,-44000,68343,282330.0,BGF리테일보통주
17964,282330,2017-12-12,0.0543259557344064,248500,235000,-13500,286513,282330.0,BGF리테일보통주
17965,282330,2017-12-11,0.2809278350515464,194000,248500,54500,684631,282330.0,BGF리테일보통주
17966,282330,2017-12-08,0.1869747899159664,238000,194000,-44000,68343,282330.0,BGF리테일보통주
17967,282330,2017-12-12,0.0543259557344064,248500,235000,-13500,286513,282330.0,BGF리테일보통주
17968,282330,2017-12-11,0.2809278350515464,194000,248500,54500,684631,282330.0,BGF리테일보통주
17969,282330,2017-12-08,0.1869747899159664,238000,194000,-44000,68343,282330.0,BGF리테일보통주
17970,282330,2017-12-12,0.0543259557344064,248500,235000,-13500,286513,282330.0,BGF리테일보통주
17971,282330,2017-12-11,0.2809278350515464,194000,248500,54500,684631,282330.0,BGF리테일보통주
17972,282330,2017-12-08,0.1869747899159664,238000,194000,-44000,68343,282330.0,BGF리테일보통주
17973,282330,2017-12-12,0.0543259557344064,248500,235000,-13500,286513,282330.0,BGF리테일보통주
17974,282330,2017-12-11,0.2809278350515464,194000,248500,54500,684631,282330.0,BGF리테일보통주
17975,282330,2017-12-08,0.1869747899159664,238000,194000,-44000,68343,282330.0,BGF리테일보통주
17976,282330,2017-12-12,0.0543259557344064,248500,235000,-13500,286513,282330.0,BGF리테일보통주
17977,282330,2017-12-11,0.2809278350515464,194000,248500,54500,684631,282330.0,BGF리테일보통주
17978,282330,2017-12-08,0.1869747899159664,238000,194000,-44000,68343,282330.0,BGF리테일보통주
17979,282330,2017-12-12,0.0543259557344064,248500,235000,-13500,286513,282330.0,BGF리테일보통주
17980,282330,2017-12-11,0.2809278350515464,194000,248500,54500,684631,282330.0,BGF리테일보통주
17981,282330,2017-12-08,0.1869747899159664,238000,194000,-44000,68343,282330.0,BGF리테일보통주
17982,282330,2017-12-12,0.0543259557344064,248500,235000,-13500,286513,282330.0,BGF리테일보통주
17983,282330,2017-12-11,0.2809278350515464,194000,248500,54500,684631,282330.0,BGF리테일보통주
17984,282330,2017-12-08,0.1869747899159664,238000,194000,-44000,68343,282330.0,BGF리테일보통주
17985,282330,2017-12-12,0.0543259557344064,248500,235000,-13500,286513,282330.0,BGF리테일보통주
17986,282330,2017-12-11,0.2809278350515464,194000,248500,54500,684631,282330.0,BGF리테일보통주
17987,282330,2017-12-08,0.1869747899159664,238000,194000,-44000,68343,282330.0,BGF리테일보통주
17988,282330,2017-12-12,0.0543259557344064,248500,235000,-13500,286513,282330.0,BGF리테일보통주
17989,282330,2017-12-11,0.2809278350515464,194000,248500,54500,684631,282330.0,BGF리테일보통주
17990,282330,2017-12-08,0.1869747899159664,238000,194000,-44000,68343,282330.0,BGF리테일보통주
17991,282330,2017-12-12,0.0543259557344064,248500,235000,-13500,286513,282330.0,BGF리테일보통주
17992,282330,2017-12-11,0.2809278350515464,194000,248500,54500,684631,282330.0,BGF리테일보통주
17993,282330,2017-12-08,0.1869747899159664,238000,194000,-44000,68343,282330.0,BGF리테일보통주
17994,282330,2017-12-12,0.0543259557344064,248500,235000,-13500,286513,282330.0,BGF리테일보통주
17995,282330,2017-12-11,0.2809278350515464,194000,248500,54500,684631,282330.0,BGF리테일보통주
17996,282330,2017-12-08,0.1869747899159664,238000,194000,-44000,68343,282330.0,BGF리테일보통주
17997,282330,2017-12-12,0.0543259557344064,248500,235000,-13500,286513,282330.0,BGF리테일보통주
17998,282330,2017-12-11,0.2809278350515464,194000,248500,54500,684631,282330.0,BGF리테일보통주
17999,282330,2017-12-08,0.1869747899159664,238000,194000,-44000,68343,282330.0,BGF리테일보통주
18000,282330,2017-12-12,0.0543259557344064,248500,235000,-13500,286513,282330.0,BGF리테일보통주
18001,282330,2017-12-11,0.2809278350515464,194000,248500,54500,684631,282330.0,BGF리테일보통주
18002,282330,2017-12-08,0.1869747899159664,238000,194000,-44000,68343,282330.0,BGF리테일보통주
18003,282330,2017-12-12,0.0543259557344064,248500,235000,-13500,286513,282330.0,BGF리테일보통주
18004,282330,2017-12-11,0.2809278350515464,194000,248500,54500,684631,282330.0,BGF리테일보통주
18005,282330,2017-12-08,0.1869747899159664,238000,194000,-44000,68343,282330.0,BGF리테일보통주
18006,282330,2017-12-12,0.0543259557344064,248500,235000,-13500,286513,282330.0,BGF리테일보통주
18007,282330,2017-12-11,0.2809278350515464,194000,248500,54500,684631,282330.0,BGF리테일보통주
18008,282330,2017-12-08,0.1869747899159664,238000,194000,-44000,68343,282330.0,BGF리테일보통주
18009,282330,2017-12-12,0.0543259557344064,248500,235000,-13500,286513,282330.0,BGF리테일보통주
18010,282330,2017-12-11,0.2809278350515464,194000,248500,54500,684631,282330.0,BGF리테일보통주
18011,282330,2017-12-08,0.1869747899159664,238000,194000,-44000,68343,282330.0,BGF리테일보통주
18012,282330,2017-12-12,0.0543259557344064,248500,235000,-13500,286513,282330.0,BGF리테일보통주
18013,282330,2017-12-11,0.2809278350515464,194000,248500,54500,684631,282330.0,BGF리테일보통주
18014,282330,2017-12-08,0.1869747899159664,238000,194000,-44000,68343,282330.0,BGF리테일보통주
18015,282330,2017-12-12,0.0543259557344064,248500,235000,-13500,286513,282330.0,BGF리테일보통주
18016,282330,2017-12-11,0.2809278350515464,194000,248500,54500,684631,282330.0,BGF리테일보통주
18017,282330,2017-12-08,0.1869747899159664,238000,194000,-44000,68343,282330.0,BGF리테일보통주
18018,282330,2017-12-12,0.0543259557344064,248500,235000,-13500,286513,282330.0,BGF리테일보통주
18019,282330,2017-12-11,0.2809278350515464,194000,248500,54500,684631,282330.0,BGF리테일보통주
18020,282330,2017-12-08,0.1869747899159664,238000,194000,-44000,68343,282330.0,BGF리테일보통주
18021,282330,2017-12-12,0.0543259557344064,248500,235000,-13500,286513,282330.0,BGF리테일보통주
18022,282330,2017-12-11,0.2809278350515464,194000,248500,54500,684631,282330.0,BGF리테일보통주
18023,282330,2017-12-08,0.1869747899159664,238000,194000,-44000,68343,282330.0,BGF리테일보통주
18024,282330,2017-12-12,0.0543259557344064,248500,235000,-13500,286513,282330.0,BGF리테일보통주
18025,282330,2017-12-11,0.2809278350515464,194000,248500,54500,684631,282330.0,BGF리테일보통주
18026,282330,2017-12-08,0.1869747899159664,238000,194000,-44000,68343,282330.0,BGF리테일보통주
18027,282330,2017-12-12,0.0543259557344064,248500,235000,-13500,286513,282330.0,BGF리테일보통주
18028,282330,2017-12-11,0.2809278350515464,194000,248500,54500,684631,282330.0,BGF리테일보통주
18029,282330,2017-12-08,0.1869747899159664,238000,194000,-44000,68343,282330.0,BGF리테일보통주
18030,282330,2017-12-12,0.0543259557344064,248500,235000,-13500,286513,282330.0,BGF리테일보통주
18031,282330,2017-12-11,0.2809278350515464,194000,248500,54500,684631,282330.0,BGF리테일보통주
18032,282330,2017-12-08,0.1869747899159664,238000,194000,-44000,68343,282330.0,BGF리테일보통주
18033,282330,2017-12-12,0.0543259557344064,248500,235000,-13500,286513,282330.0,BGF리테일보통주
18034,282330,2017-12-11,0.2809278350515464,194000,248500,54500,684631,282330.0,BGF리테일보통주
18035,282330,2017-12-08,0.1869747899159664,238000,194000,-44000,68343,282330.0,BGF리테일보통주
18036,282330,2017-12-12,0.0543259557344064,248500,235000,-13500,286513,282330.0,BGF리테일보통주
18037,282330,2017-12-11,0.2809278350515464,194000,248500,54500,684631,282330.0,BGF리테일보통주
18038,282330,2017-12-08,0.1869747899159664,238000,194000,-44000,68343,282330.0,BGF리테일보통주
18039,282330,2017-12-12,0.0543259557344064,248500,235000,-13500,286513,282330.0,BGF리테일보통주
18040,282330,2017-12-11,0.2809278350515464,194000,248500,54500,684631,282330.0,BGF리테일보통주
18041,282330,2017-12-08,0.1869747899159664,238000,194000,-44000,68343,282330.0,BGF리테일보통주
18042,282330,2017-12-12,0.0543259557344064,248500,235000,-13500,286513,282330.0,BGF리테일보통주
18043,282330,2017-12-11,0.2809278350515464,194000,248500,54500,684631,282330.0,BGF리테일보통주
18044,282330,2017-12-08,0.1869747899159664,238000,194000,-44000,68343,282330.0,BGF리테일보통주
18045,282330,2017-12-12,0.0543259557344064,248500,235000,-13500,286513,282330.0,BGF리테일보통주
18046,282330,2017-12-11,0.2809278350515464,194000,248500,54500,684631,282330.0,BGF리테일보통주
18047,282330,2017-12-08,0.1869747899159664,238000,194000,-44000,68343,282330.0,BGF리테일보통주
18048,282330,2017-12-12,0.0543259557344064,248500,235000,-13500,286513,282330.0,BGF리테일보통주
18049,282330,2017-12-11,0.2809278350515464,194000,248500,54500,684631,282330.0,BGF리테일보통주
18050,282330,2017-12-08,0.1869747899159664,238000,194000,-44000,68343,282330.0,BGF리테일보통주
18051,282330,2017-12-12,0.0543259557344064,248500,235000,-13500,286513,282330.0,BGF리테일보통주
18052,282330,2017-12-11,0.2809278350515464,194000,248500,54500,684631,282330.0,BGF리테일보통주
18053,285130,2021-05-28,0.0432098765432098,243000,253500,10500,125704,285130.0,SK케미칼보통주
18054,285130,2021-05-11,0.0457038391224862,273500,261000,-12500,179179,285130.0,SK케미칼보통주
18055,285130,2021-05-10,0.0704500978473581,255500,273500,18000,235802,285130.0,SK케미칼보통주
18056,285130,2021-05-03,0.0431519699812382,266500,255000,-11500,123618,285130.0,SK케미칼보통주
18057,285130,2021-04-29,0.0579964850615114,284500,268000,-16500,208925,285130.0,SK케미칼보통주
18058,285130,2021-04-13,0.0474383301707779,263500,276000,12500,259622,285130.0,SK케미칼보통주
18059,285130,2021-03-29,0.0425925925925925,270000,258500,-11500,200517,285130.0,SK케미칼보통주
18060,285130,2021-03-22,0.0517241379310344,290000,275000,-15000,230856,285130.0,SK케미칼보통주
18061,285130,2021-03-18,0.0534591194968553,318000,301000,-17000,790297,285130.0,SK케미칼보통주
18062,285130,2021-03-17,0.0635451505016722,299000,318000,19000,483452,285130.0,SK케미칼보통주
18063,285130,2021-03-12,0.1076642335766423,274000,303500,29500,732942,285130.0,SK케미칼보통주
18064,285130,2021-03-08,0.0634920634920634,315000,295000,-20000,401971,285130.0,SK케미칼보통주
18065,285130,2021-03-04,0.0907780979827089,347000,315500,-31500,612052,285130.0,SK케미칼보통주
18066,285130,2021-03-03,0.0506155950752394,365500,347000,-18500,357299,285130.0,SK케미칼보통주
18067,285130,2021-02-24,0.0504774897680764,366500,385000,18500,404266,285130.0,SK케미칼보통주
18068,285130,2021-02-05,0.0451467268623024,443000,423000,-20000,434042,285130.0,SK케미칼보통주
18069,285130,2021-02-04,0.0421621621621621,462500,443000,-19500,450130,285130.0,SK케미칼보통주
18070,285130,2021-02-03,0.0619977037887485,435500,462500,27000,728044,285130.0,SK케미칼보통주
18071,285130,2021-02-01,0.0439429928741092,421000,439500,18500,448340,285130.0,SK케미칼보통주
18072,285130,2021-01-27,0.0614334470989761,439500,412500,-27000,655780,285130.0,SK케미칼보통주
18073,285130,2021-01-26,0.0615942028985507,414000,439500,25500,899309,285130.0,SK케미칼보통주
18074,285130,2021-01-21,0.0621039290240811,394500,419000,24500,888682,285130.0,SK케미칼보통주
18075,285130,2021-01-19,0.0425531914893617,376000,392000,16000,417839,285130.0,SK케미칼보통주
18076,285130,2021-01-18,0.0758226037195994,349500,376000,26500,427722,285130.0,SK케미칼보통주
18077,285130,2021-01-11,0.0497382198952879,382000,363000,-19000,384141,285130.0,SK케미칼보통주
18078,285130,2020-12-29,0.0621693121693121,378000,401500,23500,467380,285130.0,SK케미칼보통주
18079,285130,2020-12-22,0.0446650124069478,403000,385000,-18000,266611,285130.0,SK케미칼보통주
18080,285130,2020-12-21,0.044041450777202,386000,403000,17000,392881,285130.0,SK케미칼보통주
18081,285130,2020-11-27,0.0432692307692307,416000,434000,18000,594712,285130.0,SK케미칼보통주
18082,285130,2020-11-24,0.0467706013363029,449000,428000,-21000,754292,285130.0,SK케미칼보통주
18083,285130,2020-11-17,0.06,400000,424000,24000,664607,285130.0,SK케미칼보통주
18084,285130,2020-11-11,0.1118421052631579,456000,405000,-51000,1069027,285130.0,SK케미칼보통주
18085,285130,2020-11-09,0.0990220048899755,409000,449500,40500,1174964,285130.0,SK케미칼보통주
18086,285130,2020-11-06,0.0500641848523748,389500,409000,19500,761451,285130.0,SK케미칼보통주
18087,285130,2020-11-04,0.0666666666666666,367500,392000,24500,1426522,285130.0,SK케미칼보통주
18088,285130,2020-11-03,0.0575539568345323,347500,367500,20000,619658,285130.0,SK케미칼보통주
18089,285130,2020-10-30,0.046831955922865,363000,346000,-17000,471613,285130.0,SK케미칼보통주
18090,285130,2020-10-29,0.0491329479768786,346000,363000,17000,669231,285130.0,SK케미칼보통주
18091,285130,2020-10-26,0.0620031796502384,314500,334000,19500,354130,285130.0,SK케미칼보통주
18092,285130,2020-10-22,0.0498442367601246,321000,305000,-16000,357574,285130.0,SK케미칼보통주
18093,285130,2020-10-20,0.0501474926253687,339000,322000,-17000,425894,285130.0,SK케미칼보통주
18094,285130,2020-10-08,0.1096979332273449,314500,349000,34500,1014851,285130.0,SK케미칼보통주
18095,285130,2020-10-06,0.0518394648829431,299000,314500,15500,486515,285130.0,SK케미칼보통주
18096,285130,2020-09-25,0.0945454545454545,275000,301000,26000,1411032,285130.0,SK케미칼보통주
18097,285130,2020-09-24,0.0968801313628899,304500,275000,-29500,486279,285130.0,SK케미칼보통주
18098,285130,2020-09-21,0.0608308605341246,337000,316500,-20500,462444,285130.0,SK케미칼보통주
18099,285130,2020-09-16,0.0426409903713892,363500,348000,-15500,415796,285130.0,SK케미칼보통주
18100,285130,2020-09-15,0.0505780346820809,346000,363500,17500,580159,285130.0,SK케미칼보통주
18101,285130,2020-09-10,0.0880503144654088,318000,346000,28000,1292176,285130.0,SK케미칼보통주
18102,285130,2020-09-09,0.1417004048582996,370500,318000,-52500,2385330,285130.0,SK케미칼보통주
18103,285130,2020-09-08,0.0596446700507614,394000,370500,-23500,623076,285130.0,SK케미칼보통주
18104,285130,2020-09-01,0.0546378653113087,393500,415000,21500,817082,285130.0,SK케미칼보통주
18105,285130,2020-08-25,0.04125,400000,416500,16500,669755,285130.0,SK케미칼보통주
18106,285130,2020-08-19,0.0870712401055409,379000,412000,33000,803137,285130.0,SK케미칼보통주
18107,285130,2020-08-14,0.1146788990825688,436000,386000,-50000,1935908,285130.0,SK케미칼보통주
18108,285130,2020-08-13,0.09,400000,436000,36000,1138610,285130.0,SK케미칼보통주
18109,285130,2020-08-10,0.1843657817109144,339000,401500,62500,1815181,285130.0,SK케미칼보통주
18110,285130,2020-08-07,0.0610328638497652,319500,339000,19500,734159,285130.0,SK케미칼보통주
18111,285130,2020-08-06,0.0475409836065573,305000,319500,14500,540379,285130.0,SK케미칼보통주
18112,285130,2020-08-04,0.1131725417439703,269500,300000,30500,1078123,285130.0,SK케미칼보통주
18113,285130,2020-07-29,0.082051282051282,292500,268500,-24000,1080186,285130.0,SK케미칼보통주
18114,285130,2020-07-28,0.0564516129032258,310000,292500,-17500,1216222,285130.0,SK케미칼보통주
18115,285130,2020-07-27,0.1051693404634581,280500,310000,29500,4637109,285130.0,SK케미칼보통주
18116,285130,2020-07-24,0.1761006289308176,238500,280500,42000,6873909,285130.0,SK케미칼보통주
18117,285130,2020-07-22,0.299719887955182,178500,232000,53500,1309454,285130.0,SK케미칼보통주
18118,285130,2020-07-20,0.0853658536585365,164000,178000,14000,922880,285130.0,SK케미칼보통주
18119,285130,2020-07-16,0.0733333333333333,150000,161000,11000,975817,285130.0,SK케미칼보통주
18120,285130,2020-07-14,0.1067615658362989,140500,155500,15000,1177114,285130.0,SK케미칼보통주
18121,285130,2020-07-08,0.09765625,128000,140500,12500,1878961,285130.0,SK케미칼보통주
18122,285130,2020-07-06,0.0434782608695652,126500,132000,5500,1137795,285130.0,SK케미칼보통주
18123,285130,2020-07-02,0.0959409594095941,135500,122500,-13000,2187130,285130.0,SK케미칼보통주
18124,285130,2020-07-01,0.0544747081712062,128500,135500,7000,3010097,285130.0,SK케미칼보통주
18125,285130,2020-06-30,0.0446096654275092,134500,128500,-6000,2028840,285130.0,SK케미칼보통주
18126,285130,2020-06-29,0.2117117117117117,111000,134500,23500,5360032,285130.0,SK케미칼보통주
18127,285130,2020-06-25,0.1121951219512195,102500,114000,11500,3681847,285130.0,SK케미칼보통주
18128,285130,2020-06-24,0.0416666666666666,98400,102500,4100,610400,285130.0,SK케미칼보통주
18129,285130,2020-06-09,0.0445387062566277,94300,98500,4200,1086667,285130.0,SK케미칼보통주
18130,285130,2020-05-19,0.0844660194174757,103000,94300,-8700,2199858,285130.0,SK케미칼보통주
18131,285130,2020-05-18,0.0564102564102564,97500,103000,5500,2254397,285130.0,SK케미칼보통주
18132,285130,2020-05-14,0.1791044776119403,80400,94800,14400,3158161,285130.0,SK케미칼보통주
18133,285130,2020-05-11,0.0415094339622641,79500,82800,3300,552022,285130.0,SK케미칼보통주
18134,285130,2020-03-30,0.13671875,76800,87300,10500,2335832,285130.0,SK케미칼보통주
18135,285130,2020-03-27,0.0726256983240223,71600,76800,5200,2278529,285130.0,SK케미칼보통주
18136,285130,2020-03-26,0.1049382716049382,64800,71600,6800,1866931,285130.0,SK케미칼보통주
18137,285130,2020-03-20,0.1075837742504409,56700,62800,6100,424212,285130.0,SK케미칼보통주
18138,285130,2020-03-19,0.1181959564541213,64300,56700,-7600,1574817,285130.0,SK케미칼보통주
18139,285130,2020-03-18,0.0540983606557377,61000,64300,3300,1223796,285130.0,SK케미칼보통주
18140,285130,2020-03-17,0.1233885819521178,54300,61000,6700,550501,285130.0,SK케미칼보통주
18141,285130,2020-03-13,0.0789473684210526,57000,52500,-4500,218260,285130.0,SK케미칼보통주
18142,285130,2020-03-12,0.0484140233722871,59900,57000,-2900,159829,285130.0,SK케미칼보통주
18143,285130,2020-03-09,0.0577557755775577,60600,64100,3500,431940,285130.0,SK케미칼보통주
18144,285130,2020-03-02,0.0434782608695652,57500,60000,2500,116300,285130.0,SK케미칼보통주
18145,285130,2020-02-28,0.043261231281198,60100,57500,-2600,161829,285130.0,SK케미칼보통주
18146,285130,2020-02-24,0.052160953800298,67100,63600,-3500,137040,285130.0,SK케미칼보통주
18147,285130,2020-02-06,0.0464071856287425,66800,69900,3100,446990,285130.0,SK케미칼보통주
18148,285130,2020-02-05,0.1170568561872909,59800,66800,7000,1942745,285130.0,SK케미칼보통주
18149,285130,2020-01-31,0.0445544554455445,60600,57900,-2700,211945,285130.0,SK케미칼보통주
18150,285130,2020-01-10,0.0599078341013824,65100,69000,3900,1292254,285130.0,SK케미칼보통주
18151,285130,2020-01-08,0.0410334346504559,65800,63100,-2700,312351,285130.0,SK케미칼보통주
18152,285130,2020-01-02,0.0421875,64000,66700,2700,450033,285130.0,SK케미칼보통주
18153,285130,2019-12-02,0.0484330484330484,70200,66800,-3400,1883645,285130.0,SK케미칼보통주
18154,285130,2019-11-29,0.0906735751295336,77200,70200,-7000,1593104,285130.0,SK케미칼보통주
18155,285130,2019-11-28,0.0517711171662125,73400,77200,3800,5391611,285130.0,SK케미칼보통주
18156,285130,2019-11-27,0.2991150442477876,56500,73400,16900,1392774,285130.0,SK케미칼보통주
18157,285130,2019-11-25,0.0496323529411764,54400,57100,2700,422223,285130.0,SK케미칼보통주
18158,285130,2019-11-22,0.0441458733205374,52100,54400,2300,975850,285130.0,SK케미칼보통주
18159,285130,2019-11-04,0.0693277310924369,47600,50900,3300,91704,285130.0,SK케미칼보통주
18160,285130,2019-09-16,0.0467899891186071,45950,48100,2150,54625,285130.0,SK케미칼보통주
18161,285130,2019-09-10,0.0505747126436781,43500,45700,2200,40872,285130.0,SK케미칼보통주
18162,285130,2019-07-08,0.0411449016100178,55900,53600,-2300,50199,285130.0,SK케미칼보통주
18163,285130,2019-03-04,0.0488466757123473,73700,77300,3600,79816,285130.0,SK케미칼보통주
18164,285130,2019-02-08,0.059880239520958,66800,70800,4000,143940,285130.0,SK케미칼보통주
18165,285130,2018-12-12,0.0457796852646638,69900,73100,3200,47003,285130.0,SK케미칼보통주
18166,285130,2018-11-21,0.0686813186813186,72800,77800,5000,151742,285130.0,SK케미칼보통주
18167,285130,2018-11-08,0.0835913312693498,64600,70000,5400,138227,285130.0,SK케미칼보통주
18168,285130,2018-11-02,0.0608552631578947,60800,64500,3700,55085,285130.0,SK케미칼보통주
18169,285130,2018-10-29,0.0866141732283464,63500,58000,-5500,135853,285130.0,SK케미칼보통주
18170,285130,2018-10-10,0.056701030927835,77600,73200,-4400,114986,285130.0,SK케미칼보통주
18171,285130,2018-06-19,0.0462365591397849,93000,88700,-4300,91730,285130.0,SK케미칼보통주
18172,285130,2018-06-15,0.0570801317233809,91100,96300,5200,212308,285130.0,SK케미칼보통주
18173,285130,2018-05-29,0.0411280846063454,85100,88600,3500,155374,285130.0,SK케미칼보통주
18174,285130,2018-03-23,0.0497737556561085,110500,105000,-5500,89177,285130.0,SK케미칼보통주
18175,285130,2018-02-19,0.0428571428571428,105000,109500,4500,118500,285130.0,SK케미칼보통주
18176,285130,2018-02-05,0.0596330275229357,109000,102500,-6500,135075,285130.0,SK케미칼보통주
18177,285130,2018-01-17,0.0625,120000,112500,-7500,226037,285130.0,SK케미칼보통주
18178,285130,2018-01-09,0.1485148514851485,101000,116000,15000,782363,285130.0,SK케미칼보통주
18179,285130,2018-01-08,0.0604651162790697,107500,101000,-6500,533640,285130.0,SK케미칼보통주
18180,285130,2018-01-17,0.0625,120000,112500,-7500,226037,285130.0,SK케미칼보통주
18181,285130,2018-01-09,0.1485148514851485,101000,116000,15000,782363,285130.0,SK케미칼보통주
18182,285130,2018-01-08,0.0604651162790697,107500,101000,-6500,533640,285130.0,SK케미칼보통주
18183,285130,2018-01-17,0.0625,120000,112500,-7500,226037,285130.0,SK케미칼보통주
18184,285130,2018-01-09,0.1485148514851485,101000,116000,15000,782363,285130.0,SK케미칼보통주
18185,285130,2018-01-08,0.0604651162790697,107500,101000,-6500,533640,285130.0,SK케미칼보통주
18186,285130,2018-01-17,0.0625,120000,112500,-7500,226037,285130.0,SK케미칼보통주
18187,285130,2018-01-09,0.1485148514851485,101000,116000,15000,782363,285130.0,SK케미칼보통주
18188,285130,2018-01-08,0.0604651162790697,107500,101000,-6500,533640,285130.0,SK케미칼보통주
18189,285130,2018-01-17,0.0625,120000,112500,-7500,226037,285130.0,SK케미칼보통주
18190,285130,2018-01-09,0.1485148514851485,101000,116000,15000,782363,285130.0,SK케미칼보통주
18191,285130,2018-01-08,0.0604651162790697,107500,101000,-6500,533640,285130.0,SK케미칼보통주
18192,285130,2018-01-17,0.0625,120000,112500,-7500,226037,285130.0,SK케미칼보통주
18193,285130,2018-01-09,0.1485148514851485,101000,116000,15000,782363,285130.0,SK케미칼보통주
18194,285130,2018-01-08,0.0604651162790697,107500,101000,-6500,533640,285130.0,SK케미칼보통주
18195,285130,2018-01-17,0.0625,120000,112500,-7500,226037,285130.0,SK케미칼보통주
18196,285130,2018-01-09,0.1485148514851485,101000,116000,15000,782363,285130.0,SK케미칼보통주
18197,285130,2018-01-08,0.0604651162790697,107500,101000,-6500,533640,285130.0,SK케미칼보통주
18198,285130,2018-01-17,0.0625,120000,112500,-7500,226037,285130.0,SK케미칼보통주
18199,285130,2018-01-09,0.1485148514851485,101000,116000,15000,782363,285130.0,SK케미칼보통주
18200,285130,2018-01-08,0.0604651162790697,107500,101000,-6500,533640,285130.0,SK케미칼보통주
18201,285130,2018-01-17,0.0625,120000,112500,-7500,226037,285130.0,SK케미칼보통주
18202,285130,2018-01-09,0.1485148514851485,101000,116000,15000,782363,285130.0,SK케미칼보통주
18203,285130,2018-01-08,0.0604651162790697,107500,101000,-6500,533640,285130.0,SK케미칼보통주
18204,285130,2018-01-17,0.0625,120000,112500,-7500,226037,285130.0,SK케미칼보통주
18205,285130,2018-01-09,0.1485148514851485,101000,116000,15000,782363,285130.0,SK케미칼보통주
18206,285130,2018-01-08,0.0604651162790697,107500,101000,-6500,533640,285130.0,SK케미칼보통주
18207,285130,2018-01-17,0.0625,120000,112500,-7500,226037,285130.0,SK케미칼보통주
18208,285130,2018-01-09,0.1485148514851485,101000,116000,15000,782363,285130.0,SK케미칼보통주
18209,285130,2018-01-08,0.0604651162790697,107500,101000,-6500,533640,285130.0,SK케미칼보통주
18210,285130,2018-01-17,0.0625,120000,112500,-7500,226037,285130.0,SK케미칼보통주
18211,285130,2018-01-09,0.1485148514851485,101000,116000,15000,782363,285130.0,SK케미칼보통주
18212,285130,2018-01-08,0.0604651162790697,107500,101000,-6500,533640,285130.0,SK케미칼보통주
18213,285130,2018-01-17,0.0625,120000,112500,-7500,226037,285130.0,SK케미칼보통주
18214,285130,2018-01-09,0.1485148514851485,101000,116000,15000,782363,285130.0,SK케미칼보통주
18215,285130,2018-01-08,0.0604651162790697,107500,101000,-6500,533640,285130.0,SK케미칼보통주
18216,285130,2018-01-17,0.0625,120000,112500,-7500,226037,285130.0,SK케미칼보통주
18217,285130,2018-01-09,0.1485148514851485,101000,116000,15000,782363,285130.0,SK케미칼보통주
18218,285130,2018-01-08,0.0604651162790697,107500,101000,-6500,533640,285130.0,SK케미칼보통주
18219,285130,2018-01-17,0.0625,120000,112500,-7500,226037,285130.0,SK케미칼보통주
18220,285130,2018-01-09,0.1485148514851485,101000,116000,15000,782363,285130.0,SK케미칼보통주
18221,285130,2018-01-08,0.0604651162790697,107500,101000,-6500,533640,285130.0,SK케미칼보통주
18222,285130,2018-01-17,0.0625,120000,112500,-7500,226037,285130.0,SK케미칼보통주
18223,285130,2018-01-09,0.1485148514851485,101000,116000,15000,782363,285130.0,SK케미칼보통주
18224,285130,2018-01-08,0.0604651162790697,107500,101000,-6500,533640,285130.0,SK케미칼보통주
18225,285130,2018-01-17,0.0625,120000,112500,-7500,226037,285130.0,SK케미칼보통주
18226,285130,2018-01-09,0.1485148514851485,101000,116000,15000,782363,285130.0,SK케미칼보통주
18227,285130,2018-01-08,0.0604651162790697,107500,101000,-6500,533640,285130.0,SK케미칼보통주
18228,285130,2018-01-17,0.0625,120000,112500,-7500,226037,285130.0,SK케미칼보통주
18229,285130,2018-01-09,0.1485148514851485,101000,116000,15000,782363,285130.0,SK케미칼보통주
18230,285130,2018-01-08,0.0604651162790697,107500,101000,-6500,533640,285130.0,SK케미칼보통주
18231,285130,2018-01-17,0.0625,120000,112500,-7500,226037,285130.0,SK케미칼보통주
18232,285130,2018-01-09,0.1485148514851485,101000,116000,15000,782363,285130.0,SK케미칼보통주
18233,285130,2018-01-08,0.0604651162790697,107500,101000,-6500,533640,285130.0,SK케미칼보통주
18234,285130,2018-01-17,0.0625,120000,112500,-7500,226037,285130.0,SK케미칼보통주
18235,285130,2018-01-09,0.1485148514851485,101000,116000,15000,782363,285130.0,SK케미칼보통주
18236,285130,2018-01-08,0.0604651162790697,107500,101000,-6500,533640,285130.0,SK케미칼보통주
18237,285130,2018-01-17,0.0625,120000,112500,-7500,226037,285130.0,SK케미칼보통주
18238,285130,2018-01-09,0.1485148514851485,101000,116000,15000,782363,285130.0,SK케미칼보통주
18239,285130,2018-01-08,0.0604651162790697,107500,101000,-6500,533640,285130.0,SK케미칼보통주
18240,285130,2018-01-17,0.0625,120000,112500,-7500,226037,285130.0,SK케미칼보통주
18241,285130,2018-01-09,0.1485148514851485,101000,116000,15000,782363,285130.0,SK케미칼보통주
18242,285130,2018-01-08,0.0604651162790697,107500,101000,-6500,533640,285130.0,SK케미칼보통주
18243,285130,2018-01-17,0.0625,120000,112500,-7500,226037,285130.0,SK케미칼보통주
18244,285130,2018-01-09,0.1485148514851485,101000,116000,15000,782363,285130.0,SK케미칼보통주
18245,285130,2018-01-08,0.0604651162790697,107500,101000,-6500,533640,285130.0,SK케미칼보통주
18246,285130,2018-01-17,0.0625,120000,112500,-7500,226037,285130.0,SK케미칼보통주
18247,285130,2018-01-09,0.1485148514851485,101000,116000,15000,782363,285130.0,SK케미칼보통주
18248,285130,2018-01-08,0.0604651162790697,107500,101000,-6500,533640,285130.0,SK케미칼보통주
18249,285130,2018-01-17,0.0625,120000,112500,-7500,226037,285130.0,SK케미칼보통주
18250,285130,2018-01-09,0.1485148514851485,101000,116000,15000,782363,285130.0,SK케미칼보통주
18251,285130,2018-01-08,0.0604651162790697,107500,101000,-6500,533640,285130.0,SK케미칼보통주
18252,285130,2018-01-17,0.0625,120000,112500,-7500,226037,285130.0,SK케미칼보통주
18253,285130,2018-01-09,0.1485148514851485,101000,116000,15000,782363,285130.0,SK케미칼보통주
18254,285130,2018-01-08,0.0604651162790697,107500,101000,-6500,533640,285130.0,SK케미칼보통주
18255,285130,2018-01-17,0.0625,120000,112500,-7500,226037,285130.0,SK케미칼보통주
18256,285130,2018-01-09,0.1485148514851485,101000,116000,15000,782363,285130.0,SK케미칼보통주
18257,285130,2018-01-08,0.0604651162790697,107500,101000,-6500,533640,285130.0,SK케미칼보통주
18258,285130,2018-01-17,0.0625,120000,112500,-7500,226037,285130.0,SK케미칼보통주
18259,285130,2018-01-09,0.1485148514851485,101000,116000,15000,782363,285130.0,SK케미칼보통주
18260,285130,2018-01-08,0.0604651162790697,107500,101000,-6500,533640,285130.0,SK케미칼보통주
18261,285130,2018-01-17,0.0625,120000,112500,-7500,226037,285130.0,SK케미칼보통주
18262,285130,2018-01-09,0.1485148514851485,101000,116000,15000,782363,285130.0,SK케미칼보통주
18263,285130,2018-01-08,0.0604651162790697,107500,101000,-6500,533640,285130.0,SK케미칼보통주
18264,285130,2018-01-17,0.0625,120000,112500,-7500,226037,285130.0,SK케미칼보통주
18265,285130,2018-01-09,0.1485148514851485,101000,116000,15000,782363,285130.0,SK케미칼보통주
18266,285130,2018-01-08,0.0604651162790697,107500,101000,-6500,533640,285130.0,SK케미칼보통주
18267,285130,2018-01-17,0.0625,120000,112500,-7500,226037,285130.0,SK케미칼보통주
18268,285130,2018-01-09,0.1485148514851485,101000,116000,15000,782363,285130.0,SK케미칼보통주
18269,285130,2018-01-08,0.0604651162790697,107500,101000,-6500,533640,285130.0,SK케미칼보통주
18270,285130,2018-01-17,0.0625,120000,112500,-7500,226037,285130.0,SK케미칼보통주
18271,285130,2018-01-09,0.1485148514851485,101000,116000,15000,782363,285130.0,SK케미칼보통주
18272,285130,2018-01-08,0.0604651162790697,107500,101000,-6500,533640,285130.0,SK케미칼보통주
18273,285130,2018-01-17,0.0625,120000,112500,-7500,226037,285130.0,SK케미칼보통주
18274,285130,2018-01-09,0.1485148514851485,101000,116000,15000,782363,285130.0,SK케미칼보통주
18275,285130,2018-01-08,0.0604651162790697,107500,101000,-6500,533640,285130.0,SK케미칼보통주
18276,285130,2018-01-17,0.0625,120000,112500,-7500,226037,285130.0,SK케미칼보통주
18277,285130,2018-01-09,0.1485148514851485,101000,116000,15000,782363,285130.0,SK케미칼보통주
18278,285130,2018-01-08,0.0604651162790697,107500,101000,-6500,533640,285130.0,SK케미칼보통주
18279,285130,2018-01-17,0.0625,120000,112500,-7500,226037,285130.0,SK케미칼보통주
18280,285130,2018-01-09,0.1485148514851485,101000,116000,15000,782363,285130.0,SK케미칼보통주
18281,285130,2018-01-08,0.0604651162790697,107500,101000,-6500,533640,285130.0,SK케미칼보통주
18282,285130,2018-01-17,0.0625,120000,112500,-7500,226037,285130.0,SK케미칼보통주
18283,285130,2018-01-09,0.1485148514851485,101000,116000,15000,782363,285130.0,SK케미칼보통주
18284,285130,2018-01-08,0.0604651162790697,107500,101000,-6500,533640,285130.0,SK케미칼보통주
18285,294870,2021-05-27,0.0427807486631016,28050,29250,1200,911567,294870.0,HDC현대산업개발보통주
18286,294870,2021-05-07,0.0481283422459893,28050,29400,1350,1681510,294870.0,HDC현대산업개발보통주
18287,294870,2021-03-15,0.0401459854014598,27400,28500,1100,924491,294870.0,HDC현대산업개발보통주
18288,294870,2021-03-09,0.0524271844660194,25750,27100,1350,721616,294870.0,HDC현대산업개발보통주
18289,294870,2021-02-04,0.0467741935483871,31000,29550,-1450,3014989,294870.0,HDC현대산업개발보통주
18290,294870,2021-02-03,0.0616438356164383,29200,31000,1800,2087987,294870.0,HDC현대산업개발보통주
18291,294870,2021-02-01,0.056672760511883,27350,28900,1550,1041627,294870.0,HDC현대산업개발보통주
18292,294870,2021-01-29,0.0585197934595524,29050,27350,-1700,1430998,294870.0,HDC현대산업개발보통주
18293,294870,2021-01-26,0.0449438202247191,31150,29750,-1400,1265372,294870.0,HDC현대산업개발보통주
18294,294870,2021-01-19,0.0889679715302491,28100,30600,2500,2965987,294870.0,HDC현대산업개발보통주
18295,294870,2021-01-12,0.0407407407407407,27000,28100,1100,2472988,294870.0,HDC현대산업개발보통주
18296,294870,2021-01-05,0.0665399239543726,26300,28050,1750,3748502,294870.0,HDC현대산업개발보통주
18297,294870,2020-12-30,0.0460921843687374,24950,26100,1150,1286693,294870.0,HDC현대산업개발보통주
18298,294870,2020-12-22,0.0508474576271186,26550,25200,-1350,1205277,294870.0,HDC현대산업개발보통주
18299,294870,2020-12-09,0.0626304801670146,23950,25450,1500,3509690,294870.0,HDC현대산업개발보통주
18300,294870,2020-12-07,0.0814479638009049,22100,23900,1800,5426863,294870.0,HDC현대산업개발보통주
18301,294870,2020-12-04,0.0702179176755447,20650,22100,1450,3072959,294870.0,HDC현대산업개발보통주
18302,294870,2020-09-24,0.046189376443418,21650,20650,-1000,802645,294870.0,HDC현대산업개발보통주
18303,294870,2020-09-22,0.0405405405405405,22200,21300,-900,795343,294870.0,HDC현대산업개발보통주
18304,294870,2020-09-21,0.0410367170626349,23150,22200,-950,938719,294870.0,HDC현대산업개발보통주
18305,294870,2020-09-11,0.048728813559322,23600,24750,1150,2123573,294870.0,HDC현대산업개발보통주
18306,294870,2020-09-01,0.1108695652173913,23000,25550,2550,3992617,294870.0,HDC현대산업개발보통주
18307,294870,2020-08-31,0.0526315789473684,21850,23000,1150,1983951,294870.0,HDC현대산업개발보통주
18308,294870,2020-08-28,0.0504807692307692,20800,21850,1050,1245024,294870.0,HDC현대산업개발보통주
18309,294870,2020-08-27,0.0502283105022831,21900,20800,-1100,951466,294870.0,HDC현대산업개발보통주
18310,294870,2020-08-26,0.0579710144927536,20700,21900,1200,1539552,294870.0,HDC현대산업개발보통주
18311,294870,2020-08-18,0.0691244239631336,21700,20200,-1500,1228206,294870.0,HDC현대산업개발보통주
18312,294870,2020-08-10,0.042016806722689,23800,22800,-1000,1354615,294870.0,HDC현대산업개발보통주
18313,294870,2020-08-05,0.0690423162583518,22450,24000,1550,3131193,294870.0,HDC현대산업개발보통주
18314,294870,2020-08-04,0.0441860465116279,21500,22450,950,2642411,294870.0,HDC현대산업개발보통주
18315,294870,2020-07-30,0.0538641686182669,21350,22500,1150,3161481,294870.0,HDC현대산업개발보통주
18316,294870,2020-07-13,0.0426065162907268,19950,20800,850,480449,294870.0,HDC현대산업개발보통주
18317,294870,2020-06-26,0.0408163265306122,22050,21150,-900,1253308,294870.0,HDC현대산업개발보통주
18318,294870,2020-06-24,0.0483091787439613,20700,21700,1000,1533477,294870.0,HDC현대산업개발보통주
18319,294870,2020-06-15,0.0512195121951219,20500,19450,-1050,1164699,294870.0,HDC현대산업개발보통주
18320,294870,2020-06-09,0.0613207547169811,21200,22500,1300,6309331,294870.0,HDC현대산업개발보통주
18321,294870,2020-05-29,0.0567375886524822,21150,19950,-1200,5528278,294870.0,HDC현대산업개발보통주
18322,294870,2020-05-26,0.0429184549356223,23300,22300,-1000,2387049,294870.0,HDC현대산업개발보통주
18323,294870,2020-05-22,0.0601851851851851,21600,22900,1300,2902756,294870.0,HDC현대산업개발보통주
18324,294870,2020-05-20,0.0675,20000,21350,1350,3483217,294870.0,HDC현대산업개발보통주
18325,294870,2020-05-15,0.0833333333333333,18600,20150,1550,3702843,294870.0,HDC현대산업개발보통주
18326,294870,2020-05-11,0.050531914893617,18800,19750,950,1344418,294870.0,HDC현대산업개발보통주
18327,294870,2020-04-29,0.0710227272727272,17600,18850,1250,1808606,294870.0,HDC현대산업개발보통주
18328,294870,2020-04-24,0.0591397849462365,18600,17500,-1100,941691,294870.0,HDC현대산업개발보통주
18329,294870,2020-04-14,0.065155807365439,17650,18800,1150,923303,294870.0,HDC현대산업개발보통주
18330,294870,2020-04-07,0.0626780626780626,17550,18650,1100,3049443,294870.0,HDC현대산업개발보통주
18331,294870,2020-04-02,0.0955414012738853,15700,17200,1500,2207031,294870.0,HDC현대산업개발보통주
18332,294870,2020-03-25,0.0771929824561403,14250,15350,1100,1235641,294870.0,HDC현대산업개발보통주
18333,294870,2020-03-23,0.125,16000,14000,-2000,692331,294870.0,HDC현대산업개발보통주
18334,294870,2020-03-20,0.2698412698412698,12600,16000,3400,702553,294870.0,HDC현대산업개발보통주
18335,294870,2020-03-19,0.0769230769230769,13650,12600,-1050,990604,294870.0,HDC현대산업개발보통주
18336,294870,2020-03-12,0.0575079872204472,15650,14750,-900,1094286,294870.0,HDC현대산업개발보통주
18337,294870,2020-03-09,0.0451807228915662,16600,15850,-750,628672,294870.0,HDC현대산업개발보통주
18338,294870,2020-03-02,0.0498614958448753,18050,17150,-900,1030649,294870.0,HDC현대산업개발보통주
18339,294870,2020-02-27,0.051490514905149,18450,17500,-950,1175906,294870.0,HDC현대산업개발보통주
18340,294870,2020-02-21,0.0426065162907268,19950,19100,-850,786306,294870.0,HDC현대산업개발보통주
18341,294870,2020-02-06,0.0620347394540942,20150,21400,1250,645633,294870.0,HDC현대산업개발보통주
18342,294870,2020-01-14,0.0420353982300885,22600,23550,950,651685,294870.0,HDC현대산업개발보통주
18343,294870,2020-01-13,0.0464135021097046,23700,22600,-1100,791179,294870.0,HDC현대산업개발보통주
18344,294870,2020-01-08,0.0594262295081967,24400,22950,-1450,468828,294870.0,HDC현대산업개발보통주
18345,294870,2019-12-11,0.0561797752808988,26700,25200,-1500,915672,294870.0,HDC현대산업개발보통주
18346,294870,2019-11-14,0.0547263681592039,30150,28500,-1650,1136035,294870.0,HDC현대산업개발보통주
18347,294870,2019-11-08,0.0731343283582089,33500,31050,-2450,1201428,294870.0,HDC현대산업개발보통주
18348,294870,2019-09-03,0.0943134535367545,36050,32650,-3400,1002380,294870.0,HDC현대산업개발보통주
18349,294870,2019-08-08,0.0488165680473372,33800,35450,1650,174508,294870.0,HDC현대산업개발보통주
18350,294870,2019-08-07,0.0478873239436619,35500,33800,-1700,184629,294870.0,HDC현대산업개발보통주
18351,294870,2019-07-09,0.0644361833952912,40350,37750,-2600,359413,294870.0,HDC현대산업개발보통주
18352,294870,2019-07-08,0.0438388625592417,42200,40350,-1850,119689,294870.0,HDC현대산업개발보통주
18353,294870,2019-06-10,0.0498839907192575,43100,45250,2150,173531,294870.0,HDC현대산업개발보통주
18354,294870,2019-05-28,0.040650406504065,43050,41300,-1750,351287,294870.0,HDC현대산업개발보통주
18355,294870,2019-04-26,0.0483689538807649,44450,46600,2150,262320,294870.0,HDC현대산업개발보통주
18356,294870,2019-03-19,0.0493454179254783,49650,52100,2450,250607,294870.0,HDC현대산업개발보통주
18357,294870,2019-02-28,0.0686653771760154,51700,48150,-3550,288763,294870.0,HDC현대산업개발보통주
18358,294870,2019-02-12,0.0697190426638917,48050,51400,3350,319240,294870.0,HDC현대산업개발보통주
18359,294870,2019-01-30,0.0811965811965812,46800,50600,3800,657452,294870.0,HDC현대산업개발보통주
18360,294870,2019-01-29,0.0458100558659217,44750,46800,2050,306328,294870.0,HDC현대산업개발보통주
18361,294870,2019-01-09,0.0632054176072234,44300,47100,2800,175557,294870.0,HDC현대산업개발보통주
18362,294870,2018-12-20,0.053030303030303,46200,48650,2450,316298,294870.0,HDC현대산업개발보통주
18363,294870,2018-12-18,0.0892018779342723,42600,46400,3800,569233,294870.0,HDC현대산업개발보통주
18364,294870,2018-12-17,0.0402930402930402,40950,42600,1650,212440,294870.0,HDC현대산업개발보통주
18365,294870,2018-11-14,0.0433734939759036,41500,39700,-1800,227489,294870.0,HDC현대산업개발보통주
18366,294870,2018-11-05,0.0478309232480533,44950,42800,-2150,229241,294870.0,HDC현대산업개발보통주
18367,294870,2018-10-30,0.0422195416164053,41450,43200,1750,151800,294870.0,HDC현대산업개발보통주
18368,294870,2018-10-26,0.0732519422863485,45050,41750,-3300,233121,294870.0,HDC현대산업개발보통주
18369,294870,2018-10-11,0.0601336302895322,44900,42200,-2700,352729,294870.0,HDC현대산업개발보통주
18370,294870,2018-10-10,0.0836734693877551,49000,44900,-4100,726638,294870.0,HDC현대산업개발보통주
18371,294870,2018-10-01,0.0451866404715127,50900,53200,2300,316865,294870.0,HDC현대산업개발보통주
18372,294870,2018-09-27,0.0504504504504504,55500,52700,-2800,509693,294870.0,HDC현대산업개발보통주
18373,294870,2018-09-20,0.0402802101576182,57100,54800,-2300,686079,294870.0,HDC현대산업개발보통주
18374,294870,2018-09-19,0.0419463087248322,59600,57100,-2500,432356,294870.0,HDC현대산업개발보통주
18375,294870,2018-09-18,0.0402576489533011,62100,59600,-2500,366042,294870.0,HDC현대산업개발보통주
18376,294870,2018-09-10,0.1205673758865248,56400,63200,6800,858884,294870.0,HDC현대산업개발보통주
18377,294870,2018-07-31,0.0527182866556836,60700,57500,-3200,286973,294870.0,HDC현대산업개발보통주
18378,294870,2018-07-25,0.0672566371681415,56500,60300,3800,519777,294870.0,HDC현대산업개발보통주
18379,294870,2018-07-24,0.0680529300567107,52900,56500,3600,525366,294870.0,HDC현대산업개발보통주
18380,294870,2018-07-20,0.0662650602409638,49800,53100,3300,315253,294870.0,HDC현대산업개발보통주
18381,294870,2018-07-19,0.0404624277456647,51900,49800,-2100,245698,294870.0,HDC현대산업개발보통주
18382,294870,2018-07-16,0.0459363957597173,56600,54000,-2600,247299,294870.0,HDC현대산업개발보통주
18383,294870,2018-07-03,0.0558659217877094,53700,56700,3000,634945,294870.0,HDC현대산업개발보통주
18384,294870,2018-06-29,0.0758483033932135,50100,53900,3800,464182,294870.0,HDC현대산업개발보통주
18385,294870,2018-06-28,0.0457142857142857,52500,50100,-2400,379801,294870.0,HDC현대산업개발보통주
18386,294870,2018-06-26,0.0442477876106194,56500,54000,-2500,372448,294870.0,HDC현대산업개발보통주
18387,294870,2018-06-19,0.0983606557377049,61000,55000,-6000,968919,294870.0,HDC현대산업개발보통주
18388,294870,2018-06-18,0.0799396681749622,66300,61000,-5300,854098,294870.0,HDC현대산업개발보통주
18389,294870,2018-06-15,0.0595744680851063,70500,66300,-4200,573753,294870.0,HDC현대산업개발보통주
18390,294870,2018-06-14,0.0674603174603174,75600,70500,-5100,1164317,294870.0,HDC현대산업개발보통주
18391,294870,2018-06-19,0.0983606557377049,61000,55000,-6000,968919,294870.0,HDC현대산업개발보통주
18392,294870,2018-06-18,0.0799396681749622,66300,61000,-5300,854098,294870.0,HDC현대산업개발보통주
18393,294870,2018-06-15,0.0595744680851063,70500,66300,-4200,573753,294870.0,HDC현대산업개발보통주
18394,294870,2018-06-14,0.0674603174603174,75600,70500,-5100,1164317,294870.0,HDC현대산업개발보통주
18395,294870,2018-06-19,0.0983606557377049,61000,55000,-6000,968919,294870.0,HDC현대산업개발보통주
18396,294870,2018-06-18,0.0799396681749622,66300,61000,-5300,854098,294870.0,HDC현대산업개발보통주
18397,294870,2018-06-15,0.0595744680851063,70500,66300,-4200,573753,294870.0,HDC현대산업개발보통주
18398,294870,2018-06-14,0.0674603174603174,75600,70500,-5100,1164317,294870.0,HDC현대산업개발보통주
18399,294870,2018-06-19,0.0983606557377049,61000,55000,-6000,968919,294870.0,HDC현대산업개발보통주
18400,294870,2018-06-18,0.0799396681749622,66300,61000,-5300,854098,294870.0,HDC현대산업개발보통주
18401,294870,2018-06-15,0.0595744680851063,70500,66300,-4200,573753,294870.0,HDC현대산업개발보통주
18402,294870,2018-06-14,0.0674603174603174,75600,70500,-5100,1164317,294870.0,HDC현대산업개발보통주
18403,294870,2018-06-19,0.0983606557377049,61000,55000,-6000,968919,294870.0,HDC현대산업개발보통주
18404,294870,2018-06-18,0.0799396681749622,66300,61000,-5300,854098,294870.0,HDC현대산업개발보통주
18405,294870,2018-06-15,0.0595744680851063,70500,66300,-4200,573753,294870.0,HDC현대산업개발보통주
18406,294870,2018-06-14,0.0674603174603174,75600,70500,-5100,1164317,294870.0,HDC현대산업개발보통주
18407,294870,2018-06-19,0.0983606557377049,61000,55000,-6000,968919,294870.0,HDC현대산업개발보통주
18408,294870,2018-06-18,0.0799396681749622,66300,61000,-5300,854098,294870.0,HDC현대산업개발보통주
18409,294870,2018-06-15,0.0595744680851063,70500,66300,-4200,573753,294870.0,HDC현대산업개발보통주
18410,294870,2018-06-14,0.0674603174603174,75600,70500,-5100,1164317,294870.0,HDC현대산업개발보통주
18411,294870,2018-06-19,0.0983606557377049,61000,55000,-6000,968919,294870.0,HDC현대산업개발보통주
18412,294870,2018-06-18,0.0799396681749622,66300,61000,-5300,854098,294870.0,HDC현대산업개발보통주
18413,294870,2018-06-15,0.0595744680851063,70500,66300,-4200,573753,294870.0,HDC현대산업개발보통주
18414,294870,2018-06-14,0.0674603174603174,75600,70500,-5100,1164317,294870.0,HDC현대산업개발보통주
18415,294870,2018-06-19,0.0983606557377049,61000,55000,-6000,968919,294870.0,HDC현대산업개발보통주
18416,294870,2018-06-18,0.0799396681749622,66300,61000,-5300,854098,294870.0,HDC현대산업개발보통주
18417,294870,2018-06-15,0.0595744680851063,70500,66300,-4200,573753,294870.0,HDC현대산업개발보통주
18418,294870,2018-06-14,0.0674603174603174,75600,70500,-5100,1164317,294870.0,HDC현대산업개발보통주
18419,294870,2018-06-19,0.0983606557377049,61000,55000,-6000,968919,294870.0,HDC현대산업개발보통주
18420,294870,2018-06-18,0.0799396681749622,66300,61000,-5300,854098,294870.0,HDC현대산업개발보통주
18421,294870,2018-06-15,0.0595744680851063,70500,66300,-4200,573753,294870.0,HDC현대산업개발보통주
18422,294870,2018-06-14,0.0674603174603174,75600,70500,-5100,1164317,294870.0,HDC현대산업개발보통주
18423,294870,2018-06-19,0.0983606557377049,61000,55000,-6000,968919,294870.0,HDC현대산업개발보통주
18424,294870,2018-06-18,0.0799396681749622,66300,61000,-5300,854098,294870.0,HDC현대산업개발보통주
18425,294870,2018-06-15,0.0595744680851063,70500,66300,-4200,573753,294870.0,HDC현대산업개발보통주
18426,294870,2018-06-14,0.0674603174603174,75600,70500,-5100,1164317,294870.0,HDC현대산업개발보통주
18427,294870,2018-06-19,0.0983606557377049,61000,55000,-6000,968919,294870.0,HDC현대산업개발보통주
18428,294870,2018-06-18,0.0799396681749622,66300,61000,-5300,854098,294870.0,HDC현대산업개발보통주
18429,294870,2018-06-15,0.0595744680851063,70500,66300,-4200,573753,294870.0,HDC현대산업개발보통주
18430,294870,2018-06-14,0.0674603174603174,75600,70500,-5100,1164317,294870.0,HDC현대산업개발보통주
18431,294870,2018-06-19,0.0983606557377049,61000,55000,-6000,968919,294870.0,HDC현대산업개발보통주
18432,294870,2018-06-18,0.0799396681749622,66300,61000,-5300,854098,294870.0,HDC현대산업개발보통주
18433,294870,2018-06-15,0.0595744680851063,70500,66300,-4200,573753,294870.0,HDC현대산업개발보통주
18434,294870,2018-06-14,0.0674603174603174,75600,70500,-5100,1164317,294870.0,HDC현대산업개발보통주
18435,294870,2018-06-19,0.0983606557377049,61000,55000,-6000,968919,294870.0,HDC현대산업개발보통주
18436,294870,2018-06-18,0.0799396681749622,66300,61000,-5300,854098,294870.0,HDC현대산업개발보통주
18437,294870,2018-06-15,0.0595744680851063,70500,66300,-4200,573753,294870.0,HDC현대산업개발보통주
18438,294870,2018-06-14,0.0674603174603174,75600,70500,-5100,1164317,294870.0,HDC현대산업개발보통주
18439,294870,2018-06-19,0.0983606557377049,61000,55000,-6000,968919,294870.0,HDC현대산업개발보통주
18440,294870,2018-06-18,0.0799396681749622,66300,61000,-5300,854098,294870.0,HDC현대산업개발보통주
18441,294870,2018-06-15,0.0595744680851063,70500,66300,-4200,573753,294870.0,HDC현대산업개발보통주
18442,294870,2018-06-14,0.0674603174603174,75600,70500,-5100,1164317,294870.0,HDC현대산업개발보통주
18443,294870,2018-06-19,0.0983606557377049,61000,55000,-6000,968919,294870.0,HDC현대산업개발보통주
18444,294870,2018-06-18,0.0799396681749622,66300,61000,-5300,854098,294870.0,HDC현대산업개발보통주
18445,294870,2018-06-15,0.0595744680851063,70500,66300,-4200,573753,294870.0,HDC현대산업개발보통주
18446,294870,2018-06-14,0.0674603174603174,75600,70500,-5100,1164317,294870.0,HDC현대산업개발보통주
18447,294870,2018-06-19,0.0983606557377049,61000,55000,-6000,968919,294870.0,HDC현대산업개발보통주
18448,294870,2018-06-18,0.0799396681749622,66300,61000,-5300,854098,294870.0,HDC현대산업개발보통주
18449,294870,2018-06-15,0.0595744680851063,70500,66300,-4200,573753,294870.0,HDC현대산업개발보통주
18450,294870,2018-06-14,0.0674603174603174,75600,70500,-5100,1164317,294870.0,HDC현대산업개발보통주
18451,294870,2018-06-19,0.0983606557377049,61000,55000,-6000,968919,294870.0,HDC현대산업개발보통주
18452,294870,2018-06-18,0.0799396681749622,66300,61000,-5300,854098,294870.0,HDC현대산업개발보통주
18453,294870,2018-06-15,0.0595744680851063,70500,66300,-4200,573753,294870.0,HDC현대산업개발보통주
18454,294870,2018-06-14,0.0674603174603174,75600,70500,-5100,1164317,294870.0,HDC현대산업개발보통주
18455,294870,2018-06-19,0.0983606557377049,61000,55000,-6000,968919,294870.0,HDC현대산업개발보통주
18456,294870,2018-06-18,0.0799396681749622,66300,61000,-5300,854098,294870.0,HDC현대산업개발보통주
18457,294870,2018-06-15,0.0595744680851063,70500,66300,-4200,573753,294870.0,HDC현대산업개발보통주
18458,294870,2018-06-14,0.0674603174603174,75600,70500,-5100,1164317,294870.0,HDC현대산업개발보통주
18459,294870,2018-06-19,0.0983606557377049,61000,55000,-6000,968919,294870.0,HDC현대산업개발보통주
18460,294870,2018-06-18,0.0799396681749622,66300,61000,-5300,854098,294870.0,HDC현대산업개발보통주
18461,294870,2018-06-15,0.0595744680851063,70500,66300,-4200,573753,294870.0,HDC현대산업개발보통주
18462,294870,2018-06-14,0.0674603174603174,75600,70500,-5100,1164317,294870.0,HDC현대산업개발보통주
18463,294870,2018-06-19,0.0983606557377049,61000,55000,-6000,968919,294870.0,HDC현대산업개발보통주
18464,294870,2018-06-18,0.0799396681749622,66300,61000,-5300,854098,294870.0,HDC현대산업개발보통주
18465,294870,2018-06-15,0.0595744680851063,70500,66300,-4200,573753,294870.0,HDC현대산업개발보통주
18466,294870,2018-06-14,0.0674603174603174,75600,70500,-5100,1164317,294870.0,HDC현대산업개발보통주
18467,294870,2018-06-19,0.0983606557377049,61000,55000,-6000,968919,294870.0,HDC현대산업개발보통주
18468,294870,2018-06-18,0.0799396681749622,66300,61000,-5300,854098,294870.0,HDC현대산업개발보통주
18469,294870,2018-06-15,0.0595744680851063,70500,66300,-4200,573753,294870.0,HDC현대산업개발보통주
18470,294870,2018-06-14,0.0674603174603174,75600,70500,-5100,1164317,294870.0,HDC현대산업개발보통주
18471,294870,2018-06-19,0.0983606557377049,61000,55000,-6000,968919,294870.0,HDC현대산업개발보통주
18472,294870,2018-06-18,0.0799396681749622,66300,61000,-5300,854098,294870.0,HDC현대산업개발보통주
18473,294870,2018-06-15,0.0595744680851063,70500,66300,-4200,573753,294870.0,HDC현대산업개발보통주
18474,294870,2018-06-14,0.0674603174603174,75600,70500,-5100,1164317,294870.0,HDC현대산업개발보통주
18475,294870,2018-06-19,0.0983606557377049,61000,55000,-6000,968919,294870.0,HDC현대산업개발보통주
18476,294870,2018-06-18,0.0799396681749622,66300,61000,-5300,854098,294870.0,HDC현대산업개발보통주
18477,294870,2018-06-15,0.0595744680851063,70500,66300,-4200,573753,294870.0,HDC현대산업개발보통주
18478,294870,2018-06-14,0.0674603174603174,75600,70500,-5100,1164317,294870.0,HDC현대산업개발보통주
18479,294870,2018-06-19,0.0983606557377049,61000,55000,-6000,968919,294870.0,HDC현대산업개발보통주
18480,294870,2018-06-18,0.0799396681749622,66300,61000,-5300,854098,294870.0,HDC현대산업개발보통주
18481,294870,2018-06-15,0.0595744680851063,70500,66300,-4200,573753,294870.0,HDC현대산업개발보통주
18482,294870,2018-06-14,0.0674603174603174,75600,70500,-5100,1164317,294870.0,HDC현대산업개발보통주
18483,294870,2018-06-19,0.0983606557377049,61000,55000,-6000,968919,294870.0,HDC현대산업개발보통주
18484,294870,2018-06-18,0.0799396681749622,66300,61000,-5300,854098,294870.0,HDC현대산업개발보통주
18485,294870,2018-06-15,0.0595744680851063,70500,66300,-4200,573753,294870.0,HDC현대산업개발보통주
18486,294870,2018-06-14,0.0674603174603174,75600,70500,-5100,1164317,294870.0,HDC현대산업개발보통주
18487,294870,2018-06-19,0.0983606557377049,61000,55000,-6000,968919,294870.0,HDC현대산업개발보통주
18488,294870,2018-06-18,0.0799396681749622,66300,61000,-5300,854098,294870.0,HDC현대산업개발보통주
18489,294870,2018-06-15,0.0595744680851063,70500,66300,-4200,573753,294870.0,HDC현대산업개발보통주
18490,294870,2018-06-14,0.0674603174603174,75600,70500,-5100,1164317,294870.0,HDC현대산업개발보통주
18491,294870,2018-06-19,0.0983606557377049,61000,55000,-6000,968919,294870.0,HDC현대산업개발보통주
18492,294870,2018-06-18,0.0799396681749622,66300,61000,-5300,854098,294870.0,HDC현대산업개발보통주
18493,294870,2018-06-15,0.0595744680851063,70500,66300,-4200,573753,294870.0,HDC현대산업개발보통주
18494,294870,2018-06-14,0.0674603174603174,75600,70500,-5100,1164317,294870.0,HDC현대산업개발보통주
18495,294870,2018-06-19,0.0983606557377049,61000,55000,-6000,968919,294870.0,HDC현대산업개발보통주
18496,294870,2018-06-18,0.0799396681749622,66300,61000,-5300,854098,294870.0,HDC현대산업개발보통주
18497,294870,2018-06-15,0.0595744680851063,70500,66300,-4200,573753,294870.0,HDC현대산업개발보통주
18498,294870,2018-06-14,0.0674603174603174,75600,70500,-5100,1164317,294870.0,HDC현대산업개발보통주
18499,294870,2018-06-19,0.0983606557377049,61000,55000,-6000,968919,294870.0,HDC현대산업개발보통주
18500,294870,2018-06-18,0.0799396681749622,66300,61000,-5300,854098,294870.0,HDC현대산업개발보통주
18501,294870,2018-06-15,0.0595744680851063,70500,66300,-4200,573753,294870.0,HDC현대산업개발보통주
18502,294870,2018-06-14,0.0674603174603174,75600,70500,-5100,1164317,294870.0,HDC현대산업개발보통주
18503,294870,2018-06-19,0.0983606557377049,61000,55000,-6000,968919,294870.0,HDC현대산업개발보통주
18504,294870,2018-06-18,0.0799396681749622,66300,61000,-5300,854098,294870.0,HDC현대산업개발보통주
18505,294870,2018-06-15,0.0595744680851063,70500,66300,-4200,573753,294870.0,HDC현대산업개발보통주
18506,294870,2018-06-14,0.0674603174603174,75600,70500,-5100,1164317,294870.0,HDC현대산업개발보통주
18507,294870,2018-06-19,0.0983606557377049,61000,55000,-6000,968919,294870.0,HDC현대산업개발보통주
18508,294870,2018-06-18,0.0799396681749622,66300,61000,-5300,854098,294870.0,HDC현대산업개발보통주
18509,294870,2018-06-15,0.0595744680851063,70500,66300,-4200,573753,294870.0,HDC현대산업개발보통주
18510,294870,2018-06-14,0.0674603174603174,75600,70500,-5100,1164317,294870.0,HDC현대산업개발보통주
18511,294870,2018-06-19,0.0983606557377049,61000,55000,-6000,968919,294870.0,HDC현대산업개발보통주
18512,294870,2018-06-18,0.0799396681749622,66300,61000,-5300,854098,294870.0,HDC현대산업개발보통주
18513,294870,2018-06-15,0.0595744680851063,70500,66300,-4200,573753,294870.0,HDC현대산업개발보통주
18514,294870,2018-06-14,0.0674603174603174,75600,70500,-5100,1164317,294870.0,HDC현대산업개발보통주
18515,294870,2018-06-19,0.0983606557377049,61000,55000,-6000,968919,294870.0,HDC현대산업개발보통주
18516,294870,2018-06-18,0.0799396681749622,66300,61000,-5300,854098,294870.0,HDC현대산업개발보통주
18517,294870,2018-06-15,0.0595744680851063,70500,66300,-4200,573753,294870.0,HDC현대산업개발보통주
18518,294870,2018-06-14,0.0674603174603174,75600,70500,-5100,1164317,294870.0,HDC현대산업개발보통주
18519,294870,2018-06-19,0.0983606557377049,61000,55000,-6000,968919,294870.0,HDC현대산업개발보통주
18520,294870,2018-06-18,0.0799396681749622,66300,61000,-5300,854098,294870.0,HDC현대산업개발보통주
18521,294870,2018-06-15,0.0595744680851063,70500,66300,-4200,573753,294870.0,HDC현대산업개발보통주
18522,294870,2018-06-14,0.0674603174603174,75600,70500,-5100,1164317,294870.0,HDC현대산업개발보통주
18523,294870,2018-06-19,0.0983606557377049,61000,55000,-6000,968919,294870.0,HDC현대산업개발보통주
18524,294870,2018-06-18,0.0799396681749622,66300,61000,-5300,854098,294870.0,HDC현대산업개발보통주
18525,294870,2018-06-15,0.0595744680851063,70500,66300,-4200,573753,294870.0,HDC현대산업개발보통주
18526,294870,2018-06-14,0.0674603174603174,75600,70500,-5100,1164317,294870.0,HDC현대산업개발보통주
18527,294870,2018-06-19,0.0983606557377049,61000,55000,-6000,968919,294870.0,HDC현대산업개발보통주
18528,294870,2018-06-18,0.0799396681749622,66300,61000,-5300,854098,294870.0,HDC현대산업개발보통주
18529,294870,2018-06-15,0.0595744680851063,70500,66300,-4200,573753,294870.0,HDC현대산업개발보통주
18530,294870,2018-06-14,0.0674603174603174,75600,70500,-5100,1164317,294870.0,HDC현대산업개발보통주
18531,294870,2018-06-19,0.0983606557377049,61000,55000,-6000,968919,294870.0,HDC현대산업개발보통주
18532,294870,2018-06-18,0.0799396681749622,66300,61000,-5300,854098,294870.0,HDC현대산업개발보통주
18533,294870,2018-06-15,0.0595744680851063,70500,66300,-4200,573753,294870.0,HDC현대산업개발보통주
18534,294870,2018-06-14,0.0674603174603174,75600,70500,-5100,1164317,294870.0,HDC현대산업개발보통주
18535,294870,2018-06-19,0.0983606557377049,61000,55000,-6000,968919,294870.0,HDC현대산업개발보통주
18536,294870,2018-06-18,0.0799396681749622,66300,61000,-5300,854098,294870.0,HDC현대산업개발보통주
18537,294870,2018-06-15,0.0595744680851063,70500,66300,-4200,573753,294870.0,HDC현대산업개발보통주
18538,294870,2018-06-14,0.0674603174603174,75600,70500,-5100,1164317,294870.0,HDC현대산업개발보통주
18539,294870,2018-06-19,0.0983606557377049,61000,55000,-6000,968919,294870.0,HDC현대산업개발보통주
18540,294870,2018-06-18,0.0799396681749622,66300,61000,-5300,854098,294870.0,HDC현대산업개발보통주
18541,294870,2018-06-15,0.0595744680851063,70500,66300,-4200,573753,294870.0,HDC현대산업개발보통주
18542,294870,2018-06-14,0.0674603174603174,75600,70500,-5100,1164317,294870.0,HDC현대산업개발보통주
18543,294870,2018-06-19,0.0983606557377049,61000,55000,-6000,968919,294870.0,HDC현대산업개발보통주
18544,294870,2018-06-18,0.0799396681749622,66300,61000,-5300,854098,294870.0,HDC현대산업개발보통주
18545,294870,2018-06-15,0.0595744680851063,70500,66300,-4200,573753,294870.0,HDC현대산업개발보통주
18546,294870,2018-06-14,0.0674603174603174,75600,70500,-5100,1164317,294870.0,HDC현대산업개발보통주
18547,294870,2018-06-19,0.0983606557377049,61000,55000,-6000,968919,294870.0,HDC현대산업개발보통주
18548,294870,2018-06-18,0.0799396681749622,66300,61000,-5300,854098,294870.0,HDC현대산업개발보통주
18549,294870,2018-06-15,0.0595744680851063,70500,66300,-4200,573753,294870.0,HDC현대산업개발보통주
18550,294870,2018-06-14,0.0674603174603174,75600,70500,-5100,1164317,294870.0,HDC현대산업개발보통주
18551,294870,2018-06-19,0.0983606557377049,61000,55000,-6000,968919,294870.0,HDC현대산업개발보통주
18552,294870,2018-06-18,0.0799396681749622,66300,61000,-5300,854098,294870.0,HDC현대산업개발보통주
18553,294870,2018-06-15,0.0595744680851063,70500,66300,-4200,573753,294870.0,HDC현대산업개발보통주
18554,294870,2018-06-14,0.0674603174603174,75600,70500,-5100,1164317,294870.0,HDC현대산업개발보통주
18555,294870,2018-06-19,0.0983606557377049,61000,55000,-6000,968919,294870.0,HDC현대산업개발보통주
18556,294870,2018-06-18,0.0799396681749622,66300,61000,-5300,854098,294870.0,HDC현대산업개발보통주
18557,294870,2018-06-15,0.0595744680851063,70500,66300,-4200,573753,294870.0,HDC현대산업개발보통주
18558,294870,2018-06-14,0.0674603174603174,75600,70500,-5100,1164317,294870.0,HDC현대산업개발보통주
18559,294870,2018-06-19,0.0983606557377049,61000,55000,-6000,968919,294870.0,HDC현대산업개발보통주
18560,294870,2018-06-18,0.0799396681749622,66300,61000,-5300,854098,294870.0,HDC현대산업개발보통주
18561,294870,2018-06-15,0.0595744680851063,70500,66300,-4200,573753,294870.0,HDC현대산업개발보통주
18562,294870,2018-06-14,0.0674603174603174,75600,70500,-5100,1164317,294870.0,HDC현대산업개발보통주
18563,294870,2018-06-19,0.0983606557377049,61000,55000,-6000,968919,294870.0,HDC현대산업개발보통주
18564,294870,2018-06-18,0.0799396681749622,66300,61000,-5300,854098,294870.0,HDC현대산업개발보통주
18565,294870,2018-06-15,0.0595744680851063,70500,66300,-4200,573753,294870.0,HDC현대산업개발보통주
18566,294870,2018-06-14,0.0674603174603174,75600,70500,-5100,1164317,294870.0,HDC현대산업개발보통주
18567,294870,2018-06-19,0.0983606557377049,61000,55000,-6000,968919,294870.0,HDC현대산업개발보통주
18568,294870,2018-06-18,0.0799396681749622,66300,61000,-5300,854098,294870.0,HDC현대산업개발보통주
18569,294870,2018-06-15,0.0595744680851063,70500,66300,-4200,573753,294870.0,HDC현대산업개발보통주
18570,294870,2018-06-14,0.0674603174603174,75600,70500,-5100,1164317,294870.0,HDC현대산업개발보통주
18571,298020,2021-05-14,0.0429184549356223,699000,729000,30000,93808,298020.0,효성티앤씨보통주
18572,298020,2021-05-06,0.056786703601108,722000,763000,41000,129199,298020.0,효성티앤씨보통주
18573,298020,2021-04-27,0.0607287449392712,741000,696000,-45000,202519,298020.0,효성티앤씨보통주
18574,298020,2021-04-16,0.1666666666666666,600000,700000,100000,350288,298020.0,효성티앤씨보통주
18575,298020,2021-04-07,0.0521582733812949,556000,585000,29000,113834,298020.0,효성티앤씨보통주
18576,298020,2021-03-29,0.0671031096563011,611000,570000,-41000,167180,298020.0,효성티앤씨보통주
18577,298020,2021-03-25,0.0648648648648648,555000,591000,36000,210637,298020.0,효성티앤씨보통주
18578,298020,2021-03-16,0.0505836575875486,514000,540000,26000,112905,298020.0,효성티앤씨보통주
18579,298020,2021-03-15,0.0641821946169772,483000,514000,31000,122835,298020.0,효성티앤씨보통주
18580,298020,2021-03-11,0.1191588785046729,428000,479000,51000,216460,298020.0,효성티앤씨보통주
18581,298020,2021-02-25,0.0595690747782002,394500,418000,23500,80529,298020.0,효성티앤씨보통주
18582,298020,2021-02-24,0.0607142857142857,420000,394500,-25500,101424,298020.0,효성티앤씨보통주
18583,298020,2021-02-18,0.0440835266821345,431000,412000,-19000,119173,298020.0,효성티앤씨보통주
18584,298020,2021-02-08,0.0542797494780793,479000,453000,-26000,192765,298020.0,효성티앤씨보통주
18585,298020,2021-02-05,0.066815144766147,449000,479000,30000,264110,298020.0,효성티앤씨보통주
18586,298020,2021-02-03,0.063701923076923,416000,442500,26500,828536,298020.0,효성티앤씨보통주
18587,298020,2021-02-02,0.0694087403598971,389000,416000,27000,538484,298020.0,효성티앤씨보통주
18588,298020,2021-02-01,0.2988313856427379,299500,389000,89500,233497,298020.0,효성티앤씨보통주
18589,298020,2021-01-29,0.0507131537242472,315500,299500,-16000,237605,298020.0,효성티앤씨보통주
18590,298020,2021-01-28,0.0676818950930626,295500,315500,20000,225905,298020.0,효성티앤씨보통주
18591,298020,2021-01-27,0.0404929577464788,284000,295500,11500,171427,298020.0,효성티앤씨보통주
18592,298020,2021-01-21,0.0452898550724637,276000,288500,12500,110392,298020.0,효성티앤씨보통주
18593,298020,2021-01-20,0.0974155069582504,251500,276000,24500,169921,298020.0,효성티앤씨보통주
18594,298020,2021-01-15,0.0964912280701754,228000,250000,22000,283325,298020.0,효성티앤씨보통주
18595,298020,2021-01-14,0.0604651162790697,215000,228000,13000,152790,298020.0,효성티앤씨보통주
18596,298020,2021-01-11,0.0507726269315673,226500,215000,-11500,89472,298020.0,효성티앤씨보통주
18597,298020,2021-01-07,0.0666666666666666,210000,224000,14000,96702,298020.0,효성티앤씨보통주
18598,298020,2020-12-29,0.058080808080808,198000,209500,11500,99324,298020.0,효성티앤씨보통주
18599,298020,2020-12-18,0.0655339805825242,206000,219500,13500,87015,298020.0,효성티앤씨보통주
18600,298020,2020-12-17,0.0701298701298701,192500,206000,13500,120083,298020.0,효성티앤씨보통주
18601,298020,2020-11-18,0.0756302521008403,178500,192000,13500,119127,298020.0,효성티앤씨보통주
18602,298020,2020-11-12,0.0451977401129943,177000,185000,8000,92900,298020.0,효성티앤씨보통주
18603,298020,2020-11-09,0.0476190476190476,168000,176000,8000,113833,298020.0,효성티앤씨보통주
18604,298020,2020-11-05,0.0539682539682539,157500,166000,8500,88112,298020.0,효성티앤씨보통주
18605,298020,2020-11-03,0.045016077170418,155500,162500,7000,126046,298020.0,효성티앤씨보통주
18606,298020,2020-11-02,0.0874125874125874,143000,155500,12500,205995,298020.0,효성티앤씨보통주
18607,298020,2020-10-12,0.092250922509225,135500,148000,12500,123529,298020.0,효성티앤씨보통주
18608,298020,2020-10-07,0.0428015564202334,128500,134000,5500,34845,298020.0,효성티앤씨보통주
18609,298020,2020-09-21,0.0460251046025104,119500,114000,-5500,27127,298020.0,효성티앤씨보통주
18610,298020,2020-09-15,0.081081081081081,111000,120000,9000,214081,298020.0,효성티앤씨보통주
18611,298020,2020-09-10,0.0560747663551401,107000,113000,6000,65013,298020.0,효성티앤씨보통주
18612,298020,2020-09-07,0.0743380855397148,98200,105500,7300,68514,298020.0,효성티앤씨보통주
18613,298020,2020-08-20,0.0601851851851851,108000,101500,-6500,22993,298020.0,효성티앤씨보통주
18614,298020,2020-08-18,0.0476190476190476,115500,110000,-5500,24495,298020.0,효성티앤씨보통주
18615,298020,2020-08-10,0.0424528301886792,106000,110500,4500,40028,298020.0,효성티앤씨보통주
18616,298020,2020-08-07,0.0495049504950495,101000,106000,5000,44455,298020.0,효성티앤씨보통주
18617,298020,2020-08-03,0.0837004405286343,113500,104000,-9500,77858,298020.0,효성티앤씨보통주
18618,298020,2020-07-14,0.04,125000,120000,-5000,25147,298020.0,효성티앤씨보통주
18619,298020,2020-07-10,0.0671641791044776,134000,125000,-9000,20443,298020.0,효성티앤씨보통주
18620,298020,2020-07-08,0.0717131474103585,125500,134500,9000,29348,298020.0,효성티앤씨보통주
18621,298020,2020-07-02,0.0936170212765957,117500,128500,11000,22320,298020.0,효성티앤씨보통주
18622,298020,2020-07-01,0.0491071428571428,112000,117500,5500,23979,298020.0,효성티앤씨보통주
18623,298020,2020-06-29,0.0429184549356223,116500,111500,-5000,8456,298020.0,효성티앤씨보통주
18624,298020,2020-06-25,0.0454545454545454,121000,115500,-5500,12207,298020.0,효성티앤씨보통주
18625,298020,2020-04-29,0.044,125000,130500,5500,16996,298020.0,효성티앤씨보통주
18626,298020,2020-04-07,0.05,110000,115500,5500,16184,298020.0,효성티앤씨보통주
18627,298020,2020-04-06,0.0476190476190476,105000,110000,5000,15670,298020.0,효성티앤씨보통주
18628,298020,2020-04-01,0.0588235294117647,110500,104000,-6500,28887,298020.0,효성티앤씨보통주
18629,298020,2020-03-31,0.099502487562189,100500,110500,10000,18801,298020.0,효성티앤씨보통주
18630,298020,2020-03-26,0.0410094637223974,95100,99000,3900,19160,298020.0,효성티앤씨보통주
18631,298020,2020-03-25,0.1045296167247386,86100,95100,9000,16198,298020.0,효성티앤씨보통주
18632,298020,2020-03-24,0.0982142857142857,78400,86100,7700,15262,298020.0,효성티앤씨보통주
18633,298020,2020-03-23,0.1080773606370876,87900,78400,-9500,19046,298020.0,효성티앤씨보통주
18634,298020,2020-03-20,0.1240409207161125,78200,87900,9700,24182,298020.0,효성티앤씨보통주
18635,298020,2020-03-19,0.2116935483870967,99200,78200,-21000,33647,298020.0,효성티앤씨보통주
18636,298020,2020-03-18,0.0461538461538461,104000,99200,-4800,16398,298020.0,효성티앤씨보통주
18637,298020,2020-03-16,0.0657894736842105,114000,106500,-7500,26120,298020.0,효성티앤씨보통주
18638,298020,2020-03-13,0.0952380952380952,126000,114000,-12000,59850,298020.0,효성티앤씨보통주
18639,298020,2020-03-12,0.0802919708029197,137000,126000,-11000,27640,298020.0,효성티앤씨보통주
18640,298020,2020-03-11,0.0486111111111111,144000,137000,-7000,11185,298020.0,효성티앤씨보통주
18641,298020,2020-02-24,0.0402476780185758,161500,155000,-6500,12506,298020.0,효성티앤씨보통주
18642,298020,2020-01-15,0.0693069306930693,151500,162000,10500,19364,298020.0,효성티앤씨보통주
18643,298020,2019-09-20,0.0462046204620462,151500,158500,7000,55860,298020.0,효성티앤씨보통주
18644,298020,2019-09-18,0.0513698630136986,146000,153500,7500,40013,298020.0,효성티앤씨보통주
18645,298020,2019-08-01,0.0590277777777777,144000,152500,8500,94093,298020.0,효성티앤씨보통주
18646,298020,2019-07-08,0.0446735395189003,145500,139000,-6500,8393,298020.0,효성티앤씨보통주
18647,298020,2019-06-21,0.06,150000,141000,-9000,14522,298020.0,효성티앤씨보통주
18648,298020,2019-06-11,0.0459363957597173,141500,148000,6500,16160,298020.0,효성티앤씨보통주
18649,298020,2019-05-24,0.0498338870431893,150500,143000,-7500,20340,298020.0,효성티앤씨보통주
18650,298020,2019-05-09,0.0501474926253687,169500,161000,-8500,10214,298020.0,효성티앤씨보통주
18651,298020,2019-03-28,0.0434782608695652,184000,176000,-8000,13692,298020.0,효성티앤씨보통주
18652,298020,2019-03-18,0.0710059171597633,169000,181000,12000,31624,298020.0,효성티앤씨보통주
18653,298020,2018-10-31,0.0512048192771084,166000,174500,8500,14726,298020.0,효성티앤씨보통주
18654,298020,2018-10-30,0.0573248407643312,157000,166000,9000,13957,298020.0,효성티앤씨보통주
18655,298020,2018-10-11,0.0558823529411764,170000,160500,-9500,36018,298020.0,효성티앤씨보통주
18656,298020,2018-10-04,0.046195652173913,184000,175500,-8500,34848,298020.0,효성티앤씨보통주
18657,298020,2018-08-23,0.053475935828877,187000,177000,-10000,66146,298020.0,효성티앤씨보통주
18658,298020,2018-08-22,0.06265664160401,199500,187000,-12500,114151,298020.0,효성티앤씨보통주
18659,298020,2018-07-23,0.0456730769230769,208000,198500,-9500,92693,298020.0,효성티앤씨보통주
18660,298020,2018-07-19,0.0541871921182266,203000,214000,11000,188354,298020.0,효성티앤씨보통주
18661,298020,2018-07-18,0.064516129032258,217000,203000,-14000,154226,298020.0,효성티앤씨보통주
18662,298020,2018-07-16,0.105050505050505,247500,221500,-26000,331498,298020.0,효성티앤씨보통주
18663,298020,2018-07-13,0.0898617511520737,217000,247500,30500,858526,298020.0,효성티앤씨보통주
18664,298020,2018-07-16,0.105050505050505,247500,221500,-26000,331498,298020.0,효성티앤씨보통주
18665,298020,2018-07-13,0.0898617511520737,217000,247500,30500,858526,298020.0,효성티앤씨보통주
18666,298020,2018-07-16,0.105050505050505,247500,221500,-26000,331498,298020.0,효성티앤씨보통주
18667,298020,2018-07-13,0.0898617511520737,217000,247500,30500,858526,298020.0,효성티앤씨보통주
18668,298020,2018-07-16,0.105050505050505,247500,221500,-26000,331498,298020.0,효성티앤씨보통주
18669,298020,2018-07-13,0.0898617511520737,217000,247500,30500,858526,298020.0,효성티앤씨보통주
18670,298020,2018-07-16,0.105050505050505,247500,221500,-26000,331498,298020.0,효성티앤씨보통주
18671,298020,2018-07-13,0.0898617511520737,217000,247500,30500,858526,298020.0,효성티앤씨보통주
18672,298020,2018-07-16,0.105050505050505,247500,221500,-26000,331498,298020.0,효성티앤씨보통주
18673,298020,2018-07-13,0.0898617511520737,217000,247500,30500,858526,298020.0,효성티앤씨보통주
18674,298020,2018-07-16,0.105050505050505,247500,221500,-26000,331498,298020.0,효성티앤씨보통주
18675,298020,2018-07-13,0.0898617511520737,217000,247500,30500,858526,298020.0,효성티앤씨보통주
18676,298020,2018-07-16,0.105050505050505,247500,221500,-26000,331498,298020.0,효성티앤씨보통주
18677,298020,2018-07-13,0.0898617511520737,217000,247500,30500,858526,298020.0,효성티앤씨보통주
18678,298020,2018-07-16,0.105050505050505,247500,221500,-26000,331498,298020.0,효성티앤씨보통주
18679,298020,2018-07-13,0.0898617511520737,217000,247500,30500,858526,298020.0,효성티앤씨보통주
18680,298020,2018-07-16,0.105050505050505,247500,221500,-26000,331498,298020.0,효성티앤씨보통주
18681,298020,2018-07-13,0.0898617511520737,217000,247500,30500,858526,298020.0,효성티앤씨보통주
18682,298020,2018-07-16,0.105050505050505,247500,221500,-26000,331498,298020.0,효성티앤씨보통주
18683,298020,2018-07-13,0.0898617511520737,217000,247500,30500,858526,298020.0,효성티앤씨보통주
18684,298020,2018-07-16,0.105050505050505,247500,221500,-26000,331498,298020.0,효성티앤씨보통주
18685,298020,2018-07-13,0.0898617511520737,217000,247500,30500,858526,298020.0,효성티앤씨보통주
18686,298020,2018-07-16,0.105050505050505,247500,221500,-26000,331498,298020.0,효성티앤씨보통주
18687,298020,2018-07-13,0.0898617511520737,217000,247500,30500,858526,298020.0,효성티앤씨보통주
18688,298020,2018-07-16,0.105050505050505,247500,221500,-26000,331498,298020.0,효성티앤씨보통주
18689,298020,2018-07-13,0.0898617511520737,217000,247500,30500,858526,298020.0,효성티앤씨보통주
18690,298020,2018-07-16,0.105050505050505,247500,221500,-26000,331498,298020.0,효성티앤씨보통주
18691,298020,2018-07-13,0.0898617511520737,217000,247500,30500,858526,298020.0,효성티앤씨보통주
18692,298020,2018-07-16,0.105050505050505,247500,221500,-26000,331498,298020.0,효성티앤씨보통주
18693,298020,2018-07-13,0.0898617511520737,217000,247500,30500,858526,298020.0,효성티앤씨보통주
18694,298020,2018-07-16,0.105050505050505,247500,221500,-26000,331498,298020.0,효성티앤씨보통주
18695,298020,2018-07-13,0.0898617511520737,217000,247500,30500,858526,298020.0,효성티앤씨보통주
18696,298020,2018-07-16,0.105050505050505,247500,221500,-26000,331498,298020.0,효성티앤씨보통주
18697,298020,2018-07-13,0.0898617511520737,217000,247500,30500,858526,298020.0,효성티앤씨보통주
18698,298020,2018-07-16,0.105050505050505,247500,221500,-26000,331498,298020.0,효성티앤씨보통주
18699,298020,2018-07-13,0.0898617511520737,217000,247500,30500,858526,298020.0,효성티앤씨보통주
18700,298020,2018-07-16,0.105050505050505,247500,221500,-26000,331498,298020.0,효성티앤씨보통주
18701,298020,2018-07-13,0.0898617511520737,217000,247500,30500,858526,298020.0,효성티앤씨보통주
18702,298020,2018-07-16,0.105050505050505,247500,221500,-26000,331498,298020.0,효성티앤씨보통주
18703,298020,2018-07-13,0.0898617511520737,217000,247500,30500,858526,298020.0,효성티앤씨보통주
18704,298020,2018-07-16,0.105050505050505,247500,221500,-26000,331498,298020.0,효성티앤씨보통주
18705,298020,2018-07-13,0.0898617511520737,217000,247500,30500,858526,298020.0,효성티앤씨보통주
18706,298020,2018-07-16,0.105050505050505,247500,221500,-26000,331498,298020.0,효성티앤씨보통주
18707,298020,2018-07-13,0.0898617511520737,217000,247500,30500,858526,298020.0,효성티앤씨보통주
18708,298020,2018-07-16,0.105050505050505,247500,221500,-26000,331498,298020.0,효성티앤씨보통주
18709,298020,2018-07-13,0.0898617511520737,217000,247500,30500,858526,298020.0,효성티앤씨보통주
18710,298020,2018-07-16,0.105050505050505,247500,221500,-26000,331498,298020.0,효성티앤씨보통주
18711,298020,2018-07-13,0.0898617511520737,217000,247500,30500,858526,298020.0,효성티앤씨보통주
18712,298020,2018-07-16,0.105050505050505,247500,221500,-26000,331498,298020.0,효성티앤씨보통주
18713,298020,2018-07-13,0.0898617511520737,217000,247500,30500,858526,298020.0,효성티앤씨보통주
18714,298020,2018-07-16,0.105050505050505,247500,221500,-26000,331498,298020.0,효성티앤씨보통주
18715,298020,2018-07-13,0.0898617511520737,217000,247500,30500,858526,298020.0,효성티앤씨보통주
18716,298020,2018-07-16,0.105050505050505,247500,221500,-26000,331498,298020.0,효성티앤씨보통주
18717,298020,2018-07-13,0.0898617511520737,217000,247500,30500,858526,298020.0,효성티앤씨보통주
18718,298020,2018-07-16,0.105050505050505,247500,221500,-26000,331498,298020.0,효성티앤씨보통주
18719,298020,2018-07-13,0.0898617511520737,217000,247500,30500,858526,298020.0,효성티앤씨보통주
18720,298020,2018-07-16,0.105050505050505,247500,221500,-26000,331498,298020.0,효성티앤씨보통주
18721,298020,2018-07-13,0.0898617511520737,217000,247500,30500,858526,298020.0,효성티앤씨보통주
18722,298020,2018-07-16,0.105050505050505,247500,221500,-26000,331498,298020.0,효성티앤씨보통주
18723,298020,2018-07-13,0.0898617511520737,217000,247500,30500,858526,298020.0,효성티앤씨보통주
18724,298020,2018-07-16,0.105050505050505,247500,221500,-26000,331498,298020.0,효성티앤씨보통주
18725,298020,2018-07-13,0.0898617511520737,217000,247500,30500,858526,298020.0,효성티앤씨보통주
18726,298020,2018-07-16,0.105050505050505,247500,221500,-26000,331498,298020.0,효성티앤씨보통주
18727,298020,2018-07-13,0.0898617511520737,217000,247500,30500,858526,298020.0,효성티앤씨보통주
18728,298020,2018-07-16,0.105050505050505,247500,221500,-26000,331498,298020.0,효성티앤씨보통주
18729,298020,2018-07-13,0.0898617511520737,217000,247500,30500,858526,298020.0,효성티앤씨보통주
18730,298020,2018-07-16,0.105050505050505,247500,221500,-26000,331498,298020.0,효성티앤씨보통주
18731,298020,2018-07-13,0.0898617511520737,217000,247500,30500,858526,298020.0,효성티앤씨보통주
18732,298020,2018-07-16,0.105050505050505,247500,221500,-26000,331498,298020.0,효성티앤씨보통주
18733,298020,2018-07-13,0.0898617511520737,217000,247500,30500,858526,298020.0,효성티앤씨보통주
18734,298020,2018-07-16,0.105050505050505,247500,221500,-26000,331498,298020.0,효성티앤씨보통주
18735,298020,2018-07-13,0.0898617511520737,217000,247500,30500,858526,298020.0,효성티앤씨보통주
18736,298020,2018-07-16,0.105050505050505,247500,221500,-26000,331498,298020.0,효성티앤씨보통주
18737,298020,2018-07-13,0.0898617511520737,217000,247500,30500,858526,298020.0,효성티앤씨보통주
18738,298020,2018-07-16,0.105050505050505,247500,221500,-26000,331498,298020.0,효성티앤씨보통주
18739,298020,2018-07-13,0.0898617511520737,217000,247500,30500,858526,298020.0,효성티앤씨보통주
18740,298020,2018-07-16,0.105050505050505,247500,221500,-26000,331498,298020.0,효성티앤씨보통주
18741,298020,2018-07-13,0.0898617511520737,217000,247500,30500,858526,298020.0,효성티앤씨보통주
18742,298020,2018-07-16,0.105050505050505,247500,221500,-26000,331498,298020.0,효성티앤씨보통주
18743,298020,2018-07-13,0.0898617511520737,217000,247500,30500,858526,298020.0,효성티앤씨보통주
18744,298020,2018-07-16,0.105050505050505,247500,221500,-26000,331498,298020.0,효성티앤씨보통주
18745,298020,2018-07-13,0.0898617511520737,217000,247500,30500,858526,298020.0,효성티앤씨보통주
18746,298020,2018-07-16,0.105050505050505,247500,221500,-26000,331498,298020.0,효성티앤씨보통주
18747,298020,2018-07-13,0.0898617511520737,217000,247500,30500,858526,298020.0,효성티앤씨보통주
18748,298020,2018-07-16,0.105050505050505,247500,221500,-26000,331498,298020.0,효성티앤씨보통주
18749,298020,2018-07-13,0.0898617511520737,217000,247500,30500,858526,298020.0,효성티앤씨보통주
18750,298020,2018-07-16,0.105050505050505,247500,221500,-26000,331498,298020.0,효성티앤씨보통주
18751,298020,2018-07-13,0.0898617511520737,217000,247500,30500,858526,298020.0,효성티앤씨보통주
18752,298020,2018-07-16,0.105050505050505,247500,221500,-26000,331498,298020.0,효성티앤씨보통주
18753,298020,2018-07-13,0.0898617511520737,217000,247500,30500,858526,298020.0,효성티앤씨보통주
18754,298020,2018-07-16,0.105050505050505,247500,221500,-26000,331498,298020.0,효성티앤씨보통주
18755,298020,2018-07-13,0.0898617511520737,217000,247500,30500,858526,298020.0,효성티앤씨보통주
18756,298020,2018-07-16,0.105050505050505,247500,221500,-26000,331498,298020.0,효성티앤씨보통주
18757,298050,2021-05-18,0.05,350000,367500,17500,74475,298050.0,효성첨단소재보통주
18758,298050,2021-04-20,0.0511860174781523,400500,421000,20500,305844,298050.0,효성첨단소재보통주
18759,298050,2021-04-16,0.0611183355006502,384500,408000,23500,252344,298050.0,효성첨단소재보통주
18760,298050,2021-03-29,0.0710843373493975,415000,385500,-29500,259347,298050.0,효성첨단소재보통주
18761,298050,2021-03-26,0.0892388451443569,381000,415000,34000,261403,298050.0,효성첨단소재보통주
18762,298050,2021-03-24,0.0888252148997134,349000,380000,31000,209538,298050.0,효성첨단소재보통주
18763,298050,2021-03-15,0.1049284578696343,314500,347500,33000,301832,298050.0,효성첨단소재보통주
18764,298050,2021-03-11,0.042517006802721,294000,306500,12500,105199,298050.0,효성첨단소재보통주
18765,298050,2021-03-08,0.0496894409937888,322000,306000,-16000,135130,298050.0,효성첨단소재보통주
18766,298050,2021-03-04,0.0884808013355592,299500,326000,26500,446327,298050.0,효성첨단소재보통주
18767,298050,2021-02-24,0.0489038785834738,296500,282000,-14500,140221,298050.0,효성첨단소재보통주
18768,298050,2021-02-22,0.0466666666666666,300000,286000,-14000,121876,298050.0,효성첨단소재보통주
18769,298050,2021-02-17,0.0446280991735537,302500,316000,13500,258763,298050.0,효성첨단소재보통주
18770,298050,2021-02-08,0.0549273021001615,309500,292500,-17000,304090,298050.0,효성첨단소재보통주
18771,298050,2021-02-05,0.0527210884353741,294000,309500,15500,335300,298050.0,효성첨단소재보통주
18772,298050,2021-02-01,0.2185430463576159,226500,276000,49500,1276187,298050.0,효성첨단소재보통주
18773,298050,2021-01-28,0.076036866359447,217000,233500,16500,477284,298050.0,효성첨단소재보통주
18774,298050,2021-01-25,0.1711229946524064,187000,219000,32000,840509,298050.0,효성첨단소재보통주
18775,298050,2021-01-22,0.1097922848664688,168500,187000,18500,562044,298050.0,효성첨단소재보통주
18776,298050,2021-01-18,0.0483383685800604,165500,157500,-8000,81197,298050.0,효성첨단소재보통주
18777,298050,2021-01-13,0.0774193548387096,155000,167000,12000,281313,298050.0,효성첨단소재보통주
18778,298050,2021-01-07,0.0423452768729641,153500,160000,6500,178260,298050.0,효성첨단소재보통주
18779,298050,2020-12-29,0.0421052631578947,142500,148500,6000,87926,298050.0,효성첨단소재보통주
18780,298050,2020-11-09,0.0669014084507042,142000,151500,9500,117557,298050.0,효성첨단소재보통주
18781,298050,2020-11-02,0.0449438202247191,133500,139500,6000,56427,298050.0,효성첨단소재보통주
18782,298050,2020-10-29,0.0415094339622641,132500,138000,5500,86007,298050.0,효성첨단소재보통주
18783,298050,2020-10-28,0.0728744939271255,123500,132500,9000,46102,298050.0,효성첨단소재보통주
18784,298050,2020-10-26,0.054054054054054,129500,122500,-7000,59192,298050.0,효성첨단소재보통주
18785,298050,2020-09-24,0.0541516245487364,138500,131000,-7500,98552,298050.0,효성첨단소재보통주
18786,298050,2020-09-22,0.0437710437710437,148500,142000,-6500,102946,298050.0,효성첨단소재보통주
18787,298050,2020-09-10,0.0686274509803921,153000,163500,10500,259291,298050.0,효성첨단소재보통주
18788,298050,2020-09-08,0.0586419753086419,162000,152500,-9500,217328,298050.0,효성첨단소재보통주
18789,298050,2020-09-03,0.0625,144000,153000,9000,310179,298050.0,효성첨단소재보통주
18790,298050,2020-09-01,0.0551470588235294,136000,143500,7500,216262,298050.0,효성첨단소재보통주
18791,298050,2020-08-18,0.0598591549295774,142000,133500,-8500,180645,298050.0,효성첨단소재보통주
18792,298050,2020-08-14,0.0437710437710437,148500,142000,-6500,142007,298050.0,효성첨단소재보통주
18793,298050,2020-08-11,0.0439189189189189,148000,154500,6500,388533,298050.0,효성첨단소재보통주
18794,298050,2020-08-10,0.0571428571428571,140000,148000,8000,282941,298050.0,효성첨단소재보통주
18795,298050,2020-08-03,0.0606060606060606,132000,140000,8000,316443,298050.0,효성첨단소재보통주
18796,298050,2020-07-31,0.0517928286852589,125500,132000,6500,289919,298050.0,효성첨단소재보통주
18797,298050,2020-07-27,0.0928270042194092,118500,129500,11000,403469,298050.0,효성첨단소재보통주
18798,298050,2020-07-24,0.0443548387096774,124000,118500,-5500,107733,298050.0,효성첨단소재보통주
18799,298050,2020-07-22,0.0646551724137931,116000,123500,7500,318952,298050.0,효성첨단소재보통주
18800,298050,2020-07-06,0.0542986425339366,110500,116500,6000,121557,298050.0,효성첨단소재보통주
18801,298050,2020-07-01,0.043859649122807,114000,109000,-5000,111671,298050.0,효성첨단소재보통주
18802,298050,2020-06-26,0.0931174089068826,123500,112000,-11500,344626,298050.0,효성첨단소재보통주
18803,298050,2020-06-25,0.0817843866171003,134500,123500,-11000,284459,298050.0,효성첨단소재보통주
18804,298050,2020-06-24,0.0717131474103585,125500,134500,9000,491782,298050.0,효성첨단소재보통주
18805,298050,2020-06-23,0.0726495726495726,117000,125500,8500,228280,298050.0,효성첨단소재보통주
18806,298050,2020-06-18,0.0676328502415458,103500,110500,7000,116833,298050.0,효성첨단소재보통주
18807,298050,2020-06-12,0.0457856399583766,96100,100500,4400,266168,298050.0,효성첨단소재보통주
18808,298050,2020-06-11,0.126611957796014,85300,96100,10800,514763,298050.0,효성첨단소재보통주
18809,298050,2020-06-03,0.0412735849056603,84800,88300,3500,76781,298050.0,효성첨단소재보통주
18810,298050,2020-05-14,0.0592255125284738,87800,82600,-5200,62905,298050.0,효성첨단소재보통주
18811,298050,2020-05-11,0.0414746543778801,86800,90400,3600,45852,298050.0,효성첨단소재보통주
18812,298050,2020-04-29,0.0408684546615581,78300,81500,3200,51465,298050.0,효성첨단소재보통주
18813,298050,2020-04-28,0.0412234042553191,75200,78300,3100,25361,298050.0,효성첨단소재보통주
18814,298050,2020-04-23,0.0438957475994513,72900,76100,3200,24155,298050.0,효성첨단소재보통주
18815,298050,2020-04-17,0.0531609195402298,69600,73300,3700,53549,298050.0,효성첨단소재보통주
18816,298050,2020-04-07,0.0595611285266457,63800,67600,3800,52840,298050.0,효성첨단소재보통주
18817,298050,2020-03-26,0.0752293577981651,54500,58600,4100,96955,298050.0,효성첨단소재보통주
18818,298050,2020-03-25,0.1657754010695187,46750,54500,7750,92114,298050.0,효성첨단소재보통주
18819,298050,2020-03-24,0.0600907029478458,44100,46750,2650,54422,298050.0,효성첨단소재보통주
18820,298050,2020-03-23,0.08125,48000,44100,-3900,47528,298050.0,효성첨단소재보통주
18821,298050,2020-03-20,0.0491803278688524,45750,48000,2250,79278,298050.0,효성첨단소재보통주
18822,298050,2020-03-19,0.1873889875666074,56300,45750,-10550,82025,298050.0,효성첨단소재보통주
18823,298050,2020-03-18,0.0709570957095709,60600,56300,-4300,33332,298050.0,효성첨단소재보통주
18824,298050,2020-03-16,0.0671641791044776,67000,62500,-4500,34759,298050.0,효성첨단소재보통주
18825,298050,2020-03-13,0.0921409214092141,73800,67000,-6800,66228,298050.0,효성첨단소재보통주
18826,298050,2020-03-12,0.0798004987531172,80200,73800,-6400,39808,298050.0,효성첨단소재보통주
18827,298050,2020-02-24,0.0520607375271149,92200,87400,-4800,32693,298050.0,효성첨단소재보통주
18828,298050,2020-01-28,0.0412844036697247,109000,104500,-4500,30311,298050.0,효성첨단소재보통주
18829,298050,2020-01-08,0.041860465116279,107500,103000,-4500,41910,298050.0,효성첨단소재보통주
18830,298050,2019-10-31,0.0478260869565217,115000,109500,-5500,106104,298050.0,효성첨단소재보통주
18831,298050,2019-10-16,0.0401606425702811,124500,129500,5000,57932,298050.0,효성첨단소재보통주
18832,298050,2019-08-23,0.0538461538461538,130000,137000,7000,259272,298050.0,효성첨단소재보통주
18833,298050,2019-08-19,0.0886075949367088,118500,129000,10500,114669,298050.0,효성첨단소재보통주
18834,298050,2019-08-16,0.0486725663716814,113000,118500,5500,46925,298050.0,효성첨단소재보통주
18835,298050,2019-08-06,0.0489795918367346,122500,116500,-6000,84126,298050.0,효성첨단소재보통주
18836,298050,2019-08-02,0.0603448275862069,116000,123000,7000,101754,298050.0,효성첨단소재보통주
18837,298050,2019-07-25,0.0436507936507936,126000,120500,-5500,29578,298050.0,효성첨단소재보통주
18838,298050,2019-07-16,0.0483870967741935,124000,130000,6000,63558,298050.0,효성첨단소재보통주
18839,298050,2019-07-02,0.0416666666666666,120000,125000,5000,23113,298050.0,효성첨단소재보통주
18840,298050,2019-06-11,0.0407239819004524,110500,115000,4500,69541,298050.0,효성첨단소재보통주
18841,298050,2019-05-16,0.0403225806451612,124000,119000,-5000,29168,298050.0,효성첨단소재보통주
18842,298050,2019-05-09,0.0503875968992248,129000,122500,-6500,31965,298050.0,효성첨단소재보통주
18843,298050,2019-03-18,0.0769230769230769,123500,133000,9500,50261,298050.0,효성첨단소재보통주
18844,298050,2019-02-14,0.040983606557377,122000,127000,5000,27499,298050.0,효성첨단소재보통주
18845,298050,2019-02-12,0.0517241379310344,116000,122000,6000,32760,298050.0,효성첨단소재보통주
18846,298050,2019-01-28,0.0440528634361233,113500,118500,5000,21528,298050.0,효성첨단소재보통주
18847,298050,2019-01-14,0.0531400966183574,103500,109000,5500,29692,298050.0,효성첨단소재보통주
18848,298050,2018-12-21,0.0552995391705069,108500,102500,-6000,70334,298050.0,효성첨단소재보통주
18849,298050,2018-11-26,0.0434782608695652,103500,108000,4500,9782,298050.0,효성첨단소재보통주
18850,298050,2018-10-31,0.0491967871485943,99600,104500,4900,33263,298050.0,효성첨단소재보통주
18851,298050,2018-10-25,0.0506912442396313,108500,103000,-5500,41314,298050.0,효성첨단소재보통주
18852,298050,2018-10-24,0.0565217391304347,115000,108500,-6500,40098,298050.0,효성첨단소재보통주
18853,298050,2018-10-11,0.052,125000,118500,-6500,58573,298050.0,효성첨단소재보통주
18854,298050,2018-10-10,0.0421455938697318,130500,125000,-5500,25391,298050.0,효성첨단소재보통주
18855,298050,2018-09-20,0.040133779264214,149500,143500,-6000,26386,298050.0,효성첨단소재보통주
18856,298050,2018-08-02,0.050595238095238,168000,159500,-8500,44807,298050.0,효성첨단소재보통주
18857,298050,2018-07-30,0.040625,160000,166500,6500,45047,298050.0,효성첨단소재보통주
18858,298050,2018-07-23,0.0521472392638036,163000,154500,-8500,79709,298050.0,효성첨단소재보통주
18859,298050,2018-07-19,0.043076923076923,162500,169500,7000,192445,298050.0,효성첨단소재보통주
18860,298050,2018-07-18,0.0660919540229885,174000,162500,-11500,172571,298050.0,효성첨단소재보통주
18861,298050,2018-07-16,0.0875,160000,174000,14000,667957,298050.0,효성첨단소재보통주
18862,298050,2018-07-13,0.3620689655172414,174000,160000,-14000,890434,298050.0,효성첨단소재보통주
18863,298050,2018-07-16,0.0875,160000,174000,14000,667957,298050.0,효성첨단소재보통주
18864,298050,2018-07-13,0.3620689655172414,174000,160000,-14000,890434,298050.0,효성첨단소재보통주
18865,298050,2018-07-16,0.0875,160000,174000,14000,667957,298050.0,효성첨단소재보통주
18866,298050,2018-07-13,0.3620689655172414,174000,160000,-14000,890434,298050.0,효성첨단소재보통주
18867,298050,2018-07-16,0.0875,160000,174000,14000,667957,298050.0,효성첨단소재보통주
18868,298050,2018-07-13,0.3620689655172414,174000,160000,-14000,890434,298050.0,효성첨단소재보통주
18869,298050,2018-07-16,0.0875,160000,174000,14000,667957,298050.0,효성첨단소재보통주
18870,298050,2018-07-13,0.3620689655172414,174000,160000,-14000,890434,298050.0,효성첨단소재보통주
18871,298050,2018-07-16,0.0875,160000,174000,14000,667957,298050.0,효성첨단소재보통주
18872,298050,2018-07-13,0.3620689655172414,174000,160000,-14000,890434,298050.0,효성첨단소재보통주
18873,298050,2018-07-16,0.0875,160000,174000,14000,667957,298050.0,효성첨단소재보통주
18874,298050,2018-07-13,0.3620689655172414,174000,160000,-14000,890434,298050.0,효성첨단소재보통주
18875,298050,2018-07-16,0.0875,160000,174000,14000,667957,298050.0,효성첨단소재보통주
18876,298050,2018-07-13,0.3620689655172414,174000,160000,-14000,890434,298050.0,효성첨단소재보통주
18877,298050,2018-07-16,0.0875,160000,174000,14000,667957,298050.0,효성첨단소재보통주
18878,298050,2018-07-13,0.3620689655172414,174000,160000,-14000,890434,298050.0,효성첨단소재보통주
18879,298050,2018-07-16,0.0875,160000,174000,14000,667957,298050.0,효성첨단소재보통주
18880,298050,2018-07-13,0.3620689655172414,174000,160000,-14000,890434,298050.0,효성첨단소재보통주
18881,298050,2018-07-16,0.0875,160000,174000,14000,667957,298050.0,효성첨단소재보통주
18882,298050,2018-07-13,0.3620689655172414,174000,160000,-14000,890434,298050.0,효성첨단소재보통주
18883,298050,2018-07-16,0.0875,160000,174000,14000,667957,298050.0,효성첨단소재보통주
18884,298050,2018-07-13,0.3620689655172414,174000,160000,-14000,890434,298050.0,효성첨단소재보통주
18885,298050,2018-07-16,0.0875,160000,174000,14000,667957,298050.0,효성첨단소재보통주
18886,298050,2018-07-13,0.3620689655172414,174000,160000,-14000,890434,298050.0,효성첨단소재보통주
18887,298050,2018-07-16,0.0875,160000,174000,14000,667957,298050.0,효성첨단소재보통주
18888,298050,2018-07-13,0.3620689655172414,174000,160000,-14000,890434,298050.0,효성첨단소재보통주
18889,298050,2018-07-16,0.0875,160000,174000,14000,667957,298050.0,효성첨단소재보통주
18890,298050,2018-07-13,0.3620689655172414,174000,160000,-14000,890434,298050.0,효성첨단소재보통주
18891,298050,2018-07-16,0.0875,160000,174000,14000,667957,298050.0,효성첨단소재보통주
18892,298050,2018-07-13,0.3620689655172414,174000,160000,-14000,890434,298050.0,효성첨단소재보통주
18893,298050,2018-07-16,0.0875,160000,174000,14000,667957,298050.0,효성첨단소재보통주
18894,298050,2018-07-13,0.3620689655172414,174000,160000,-14000,890434,298050.0,효성첨단소재보통주
18895,298050,2018-07-16,0.0875,160000,174000,14000,667957,298050.0,효성첨단소재보통주
18896,298050,2018-07-13,0.3620689655172414,174000,160000,-14000,890434,298050.0,효성첨단소재보통주
18897,298050,2018-07-16,0.0875,160000,174000,14000,667957,298050.0,효성첨단소재보통주
18898,298050,2018-07-13,0.3620689655172414,174000,160000,-14000,890434,298050.0,효성첨단소재보통주
18899,298050,2018-07-16,0.0875,160000,174000,14000,667957,298050.0,효성첨단소재보통주
18900,298050,2018-07-13,0.3620689655172414,174000,160000,-14000,890434,298050.0,효성첨단소재보통주
18901,298050,2018-07-16,0.0875,160000,174000,14000,667957,298050.0,효성첨단소재보통주
18902,298050,2018-07-13,0.3620689655172414,174000,160000,-14000,890434,298050.0,효성첨단소재보통주
18903,298050,2018-07-16,0.0875,160000,174000,14000,667957,298050.0,효성첨단소재보통주
18904,298050,2018-07-13,0.3620689655172414,174000,160000,-14000,890434,298050.0,효성첨단소재보통주
18905,298050,2018-07-16,0.0875,160000,174000,14000,667957,298050.0,효성첨단소재보통주
18906,298050,2018-07-13,0.3620689655172414,174000,160000,-14000,890434,298050.0,효성첨단소재보통주
18907,298050,2018-07-16,0.0875,160000,174000,14000,667957,298050.0,효성첨단소재보통주
18908,298050,2018-07-13,0.3620689655172414,174000,160000,-14000,890434,298050.0,효성첨단소재보통주
18909,298050,2018-07-16,0.0875,160000,174000,14000,667957,298050.0,효성첨단소재보통주
18910,298050,2018-07-13,0.3620689655172414,174000,160000,-14000,890434,298050.0,효성첨단소재보통주
18911,298050,2018-07-16,0.0875,160000,174000,14000,667957,298050.0,효성첨단소재보통주
18912,298050,2018-07-13,0.3620689655172414,174000,160000,-14000,890434,298050.0,효성첨단소재보통주
18913,298050,2018-07-16,0.0875,160000,174000,14000,667957,298050.0,효성첨단소재보통주
18914,298050,2018-07-13,0.3620689655172414,174000,160000,-14000,890434,298050.0,효성첨단소재보통주
18915,298050,2018-07-16,0.0875,160000,174000,14000,667957,298050.0,효성첨단소재보통주
18916,298050,2018-07-13,0.3620689655172414,174000,160000,-14000,890434,298050.0,효성첨단소재보통주
18917,298050,2018-07-16,0.0875,160000,174000,14000,667957,298050.0,효성첨단소재보통주
18918,298050,2018-07-13,0.3620689655172414,174000,160000,-14000,890434,298050.0,효성첨단소재보통주
18919,298050,2018-07-16,0.0875,160000,174000,14000,667957,298050.0,효성첨단소재보통주
18920,298050,2018-07-13,0.3620689655172414,174000,160000,-14000,890434,298050.0,효성첨단소재보통주
18921,298050,2018-07-16,0.0875,160000,174000,14000,667957,298050.0,효성첨단소재보통주
18922,298050,2018-07-13,0.3620689655172414,174000,160000,-14000,890434,298050.0,효성첨단소재보통주
18923,298050,2018-07-16,0.0875,160000,174000,14000,667957,298050.0,효성첨단소재보통주
18924,298050,2018-07-13,0.3620689655172414,174000,160000,-14000,890434,298050.0,효성첨단소재보통주
18925,298050,2018-07-16,0.0875,160000,174000,14000,667957,298050.0,효성첨단소재보통주
18926,298050,2018-07-13,0.3620689655172414,174000,160000,-14000,890434,298050.0,효성첨단소재보통주
18927,298050,2018-07-16,0.0875,160000,174000,14000,667957,298050.0,효성첨단소재보통주
18928,298050,2018-07-13,0.3620689655172414,174000,160000,-14000,890434,298050.0,효성첨단소재보통주
18929,298050,2018-07-16,0.0875,160000,174000,14000,667957,298050.0,효성첨단소재보통주
18930,298050,2018-07-13,0.3620689655172414,174000,160000,-14000,890434,298050.0,효성첨단소재보통주
18931,298050,2018-07-16,0.0875,160000,174000,14000,667957,298050.0,효성첨단소재보통주
18932,298050,2018-07-13,0.3620689655172414,174000,160000,-14000,890434,298050.0,효성첨단소재보통주
18933,298050,2018-07-16,0.0875,160000,174000,14000,667957,298050.0,효성첨단소재보통주
18934,298050,2018-07-13,0.3620689655172414,174000,160000,-14000,890434,298050.0,효성첨단소재보통주
18935,298050,2018-07-16,0.0875,160000,174000,14000,667957,298050.0,효성첨단소재보통주
18936,298050,2018-07-13,0.3620689655172414,174000,160000,-14000,890434,298050.0,효성첨단소재보통주
18937,298050,2018-07-16,0.0875,160000,174000,14000,667957,298050.0,효성첨단소재보통주
18938,298050,2018-07-13,0.3620689655172414,174000,160000,-14000,890434,298050.0,효성첨단소재보통주
18939,298050,2018-07-16,0.0875,160000,174000,14000,667957,298050.0,효성첨단소재보통주
18940,298050,2018-07-13,0.3620689655172414,174000,160000,-14000,890434,298050.0,효성첨단소재보통주
18941,298050,2018-07-16,0.0875,160000,174000,14000,667957,298050.0,효성첨단소재보통주
18942,298050,2018-07-13,0.3620689655172414,174000,160000,-14000,890434,298050.0,효성첨단소재보통주
18943,298050,2018-07-16,0.0875,160000,174000,14000,667957,298050.0,효성첨단소재보통주
18944,298050,2018-07-13,0.3620689655172414,174000,160000,-14000,890434,298050.0,효성첨단소재보통주
18945,298050,2018-07-16,0.0875,160000,174000,14000,667957,298050.0,효성첨단소재보통주
18946,298050,2018-07-13,0.3620689655172414,174000,160000,-14000,890434,298050.0,효성첨단소재보통주
18947,298050,2018-07-16,0.0875,160000,174000,14000,667957,298050.0,효성첨단소재보통주
18948,298050,2018-07-13,0.3620689655172414,174000,160000,-14000,890434,298050.0,효성첨단소재보통주
18949,298050,2018-07-16,0.0875,160000,174000,14000,667957,298050.0,효성첨단소재보통주
18950,298050,2018-07-13,0.3620689655172414,174000,160000,-14000,890434,298050.0,효성첨단소재보통주
18951,298050,2018-07-16,0.0875,160000,174000,14000,667957,298050.0,효성첨단소재보통주
18952,298050,2018-07-13,0.3620689655172414,174000,160000,-14000,890434,298050.0,효성첨단소재보통주
18953,298050,2018-07-16,0.0875,160000,174000,14000,667957,298050.0,효성첨단소재보통주
18954,298050,2018-07-13,0.3620689655172414,174000,160000,-14000,890434,298050.0,효성첨단소재보통주
18955,298050,2018-07-16,0.0875,160000,174000,14000,667957,298050.0,효성첨단소재보통주
18956,302440,2021-06-03,0.0506756756756756,148000,155500,7500,544525,302440.0,에스케이바이오사이언스보통주
18957,302440,2021-05-17,0.0924657534246575,146000,159500,13500,1262922,302440.0,에스케이바이오사이언스보통주
18958,302440,2021-05-12,0.0495049504950495,151500,144000,-7500,725156,302440.0,에스케이바이오사이언스보통주
18959,302440,2021-05-11,0.0619195046439628,161500,151500,-10000,880658,302440.0,에스케이바이오사이언스보통주
18960,302440,2021-05-04,0.060200668896321,149500,158500,9000,1322862,302440.0,에스케이바이오사이언스보통주
18961,302440,2021-04-29,0.0795107033639143,163500,150500,-13000,1864655,302440.0,에스케이바이오사이언스보통주
18962,302440,2021-04-28,0.0447284345047923,156500,163500,7000,1697376,302440.0,에스케이바이오사이언스보통주
18963,302440,2021-04-21,0.07168458781362,139500,149500,10000,2251136,302440.0,에스케이바이오사이언스보통주
18964,302440,2021-04-19,0.0643939393939393,132000,140500,8500,3002561,302440.0,에스케이바이오사이언스보통주
18965,302440,2021-04-15,0.040590405904059,135500,130000,-5500,854852,302440.0,에스케이바이오사이언스보통주
18966,302440,2021-04-13,0.0416666666666666,132000,137500,5500,1445824,302440.0,에스케이바이오사이언스보통주
18967,302440,2021-04-08,0.0960698689956331,114500,125500,11000,2546750,302440.0,에스케이바이오사이언스보통주
18968,302440,2021-03-31,0.0474308300395256,126500,120500,-6000,1016714,302440.0,에스케이바이오사이언스보통주
18969,302440,2021-03-29,0.0643939393939393,132000,123500,-8500,1412312,302440.0,에스케이바이오사이언스보통주
18970,302440,2021-03-22,0.1351351351351351,166500,144000,-22500,4675116,302440.0,에스케이바이오사이언스보통주
18971,302440,2021-03-18,0.2857142857142857,136500,169000,32500,876189,302440.0,에스케이바이오사이언스보통주
18972,302440,2021-03-22,0.1351351351351351,166500,144000,-22500,4675116,302440.0,에스케이바이오사이언스보통주
18973,302440,2021-03-18,0.2857142857142857,136500,169000,32500,876189,302440.0,에스케이바이오사이언스보통주
18974,302440,2021-03-22,0.1351351351351351,166500,144000,-22500,4675116,302440.0,에스케이바이오사이언스보통주
18975,302440,2021-03-18,0.2857142857142857,136500,169000,32500,876189,302440.0,에스케이바이오사이언스보통주
18976,302440,2021-03-22,0.1351351351351351,166500,144000,-22500,4675116,302440.0,에스케이바이오사이언스보통주
18977,302440,2021-03-18,0.2857142857142857,136500,169000,32500,876189,302440.0,에스케이바이오사이언스보통주
18978,302440,2021-03-22,0.1351351351351351,166500,144000,-22500,4675116,302440.0,에스케이바이오사이언스보통주
18979,302440,2021-03-18,0.2857142857142857,136500,169000,32500,876189,302440.0,에스케이바이오사이언스보통주
18980,302440,2021-03-22,0.1351351351351351,166500,144000,-22500,4675116,302440.0,에스케이바이오사이언스보통주
18981,302440,2021-03-18,0.2857142857142857,136500,169000,32500,876189,302440.0,에스케이바이오사이언스보통주
18982,302440,2021-03-22,0.1351351351351351,166500,144000,-22500,4675116,302440.0,에스케이바이오사이언스보통주
18983,302440,2021-03-18,0.2857142857142857,136500,169000,32500,876189,302440.0,에스케이바이오사이언스보통주
18984,302440,2021-03-22,0.1351351351351351,166500,144000,-22500,4675116,302440.0,에스케이바이오사이언스보통주
18985,302440,2021-03-18,0.2857142857142857,136500,169000,32500,876189,302440.0,에스케이바이오사이언스보통주
18986,302440,2021-03-22,0.1351351351351351,166500,144000,-22500,4675116,302440.0,에스케이바이오사이언스보통주
18987,302440,2021-03-18,0.2857142857142857,136500,169000,32500,876189,302440.0,에스케이바이오사이언스보통주
18988,302440,2021-03-22,0.1351351351351351,166500,144000,-22500,4675116,302440.0,에스케이바이오사이언스보통주
18989,302440,2021-03-18,0.2857142857142857,136500,169000,32500,876189,302440.0,에스케이바이오사이언스보통주
18990,302440,2021-03-22,0.1351351351351351,166500,144000,-22500,4675116,302440.0,에스케이바이오사이언스보통주
18991,302440,2021-03-18,0.2857142857142857,136500,169000,32500,876189,302440.0,에스케이바이오사이언스보통주
18992,302440,2021-03-22,0.1351351351351351,166500,144000,-22500,4675116,302440.0,에스케이바이오사이언스보통주
18993,302440,2021-03-18,0.2857142857142857,136500,169000,32500,876189,302440.0,에스케이바이오사이언스보통주
18994,302440,2021-03-22,0.1351351351351351,166500,144000,-22500,4675116,302440.0,에스케이바이오사이언스보통주
18995,302440,2021-03-18,0.2857142857142857,136500,169000,32500,876189,302440.0,에스케이바이오사이언스보통주
18996,302440,2021-03-22,0.1351351351351351,166500,144000,-22500,4675116,302440.0,에스케이바이오사이언스보통주
18997,302440,2021-03-18,0.2857142857142857,136500,169000,32500,876189,302440.0,에스케이바이오사이언스보통주
18998,302440,2021-03-22,0.1351351351351351,166500,144000,-22500,4675116,302440.0,에스케이바이오사이언스보통주
18999,302440,2021-03-18,0.2857142857142857,136500,169000,32500,876189,302440.0,에스케이바이오사이언스보통주
19000,302440,2021-03-22,0.1351351351351351,166500,144000,-22500,4675116,302440.0,에스케이바이오사이언스보통주
19001,302440,2021-03-18,0.2857142857142857,136500,169000,32500,876189,302440.0,에스케이바이오사이언스보통주
19002,302440,2021-03-22,0.1351351351351351,166500,144000,-22500,4675116,302440.0,에스케이바이오사이언스보통주
19003,302440,2021-03-18,0.2857142857142857,136500,169000,32500,876189,302440.0,에스케이바이오사이언스보통주
19004,302440,2021-03-22,0.1351351351351351,166500,144000,-22500,4675116,302440.0,에스케이바이오사이언스보통주
19005,302440,2021-03-18,0.2857142857142857,136500,169000,32500,876189,302440.0,에스케이바이오사이언스보통주
19006,302440,2021-03-22,0.1351351351351351,166500,144000,-22500,4675116,302440.0,에스케이바이오사이언스보통주
19007,302440,2021-03-18,0.2857142857142857,136500,169000,32500,876189,302440.0,에스케이바이오사이언스보통주
19008,302440,2021-03-22,0.1351351351351351,166500,144000,-22500,4675116,302440.0,에스케이바이오사이언스보통주
19009,302440,2021-03-18,0.2857142857142857,136500,169000,32500,876189,302440.0,에스케이바이오사이언스보통주
19010,302440,2021-03-22,0.1351351351351351,166500,144000,-22500,4675116,302440.0,에스케이바이오사이언스보통주
19011,302440,2021-03-18,0.2857142857142857,136500,169000,32500,876189,302440.0,에스케이바이오사이언스보통주
19012,302440,2021-03-22,0.1351351351351351,166500,144000,-22500,4675116,302440.0,에스케이바이오사이언스보통주
19013,302440,2021-03-18,0.2857142857142857,136500,169000,32500,876189,302440.0,에스케이바이오사이언스보통주
19014,302440,2021-03-22,0.1351351351351351,166500,144000,-22500,4675116,302440.0,에스케이바이오사이언스보통주
19015,302440,2021-03-18,0.2857142857142857,136500,169000,32500,876189,302440.0,에스케이바이오사이언스보통주
19016,302440,2021-03-22,0.1351351351351351,166500,144000,-22500,4675116,302440.0,에스케이바이오사이언스보통주
19017,302440,2021-03-18,0.2857142857142857,136500,169000,32500,876189,302440.0,에스케이바이오사이언스보통주
19018,302440,2021-03-22,0.1351351351351351,166500,144000,-22500,4675116,302440.0,에스케이바이오사이언스보통주
19019,302440,2021-03-18,0.2857142857142857,136500,169000,32500,876189,302440.0,에스케이바이오사이언스보통주
19020,302440,2021-03-22,0.1351351351351351,166500,144000,-22500,4675116,302440.0,에스케이바이오사이언스보통주
19021,302440,2021-03-18,0.2857142857142857,136500,169000,32500,876189,302440.0,에스케이바이오사이언스보통주
19022,302440,2021-03-22,0.1351351351351351,166500,144000,-22500,4675116,302440.0,에스케이바이오사이언스보통주
19023,302440,2021-03-18,0.2857142857142857,136500,169000,32500,876189,302440.0,에스케이바이오사이언스보통주
19024,302440,2021-03-22,0.1351351351351351,166500,144000,-22500,4675116,302440.0,에스케이바이오사이언스보통주
19025,302440,2021-03-18,0.2857142857142857,136500,169000,32500,876189,302440.0,에스케이바이오사이언스보통주
19026,302440,2021-03-22,0.1351351351351351,166500,144000,-22500,4675116,302440.0,에스케이바이오사이언스보통주
19027,302440,2021-03-18,0.2857142857142857,136500,169000,32500,876189,302440.0,에스케이바이오사이언스보통주
19028,302440,2021-03-22,0.1351351351351351,166500,144000,-22500,4675116,302440.0,에스케이바이오사이언스보통주
19029,302440,2021-03-18,0.2857142857142857,136500,169000,32500,876189,302440.0,에스케이바이오사이언스보통주
19030,302440,2021-03-22,0.1351351351351351,166500,144000,-22500,4675116,302440.0,에스케이바이오사이언스보통주
19031,302440,2021-03-18,0.2857142857142857,136500,169000,32500,876189,302440.0,에스케이바이오사이언스보통주
19032,302440,2021-03-22,0.1351351351351351,166500,144000,-22500,4675116,302440.0,에스케이바이오사이언스보통주
19033,302440,2021-03-18,0.2857142857142857,136500,169000,32500,876189,302440.0,에스케이바이오사이언스보통주
19034,302440,2021-03-22,0.1351351351351351,166500,144000,-22500,4675116,302440.0,에스케이바이오사이언스보통주
19035,302440,2021-03-18,0.2857142857142857,136500,169000,32500,876189,302440.0,에스케이바이오사이언스보통주
19036,302440,2021-03-22,0.1351351351351351,166500,144000,-22500,4675116,302440.0,에스케이바이오사이언스보통주
19037,302440,2021-03-18,0.2857142857142857,136500,169000,32500,876189,302440.0,에스케이바이오사이언스보통주
19038,302440,2021-03-22,0.1351351351351351,166500,144000,-22500,4675116,302440.0,에스케이바이오사이언스보통주
19039,302440,2021-03-18,0.2857142857142857,136500,169000,32500,876189,302440.0,에스케이바이오사이언스보통주
19040,302440,2021-03-22,0.1351351351351351,166500,144000,-22500,4675116,302440.0,에스케이바이오사이언스보통주
19041,302440,2021-03-18,0.2857142857142857,136500,169000,32500,876189,302440.0,에스케이바이오사이언스보통주
19042,302440,2021-03-22,0.1351351351351351,166500,144000,-22500,4675116,302440.0,에스케이바이오사이언스보통주
19043,302440,2021-03-18,0.2857142857142857,136500,169000,32500,876189,302440.0,에스케이바이오사이언스보통주
19044,302440,2021-03-22,0.1351351351351351,166500,144000,-22500,4675116,302440.0,에스케이바이오사이언스보통주
19045,302440,2021-03-18,0.2857142857142857,136500,169000,32500,876189,302440.0,에스케이바이오사이언스보통주
19046,302440,2021-03-22,0.1351351351351351,166500,144000,-22500,4675116,302440.0,에스케이바이오사이언스보통주
19047,302440,2021-03-18,0.2857142857142857,136500,169000,32500,876189,302440.0,에스케이바이오사이언스보통주
19048,302440,2021-03-22,0.1351351351351351,166500,144000,-22500,4675116,302440.0,에스케이바이오사이언스보통주
19049,302440,2021-03-18,0.2857142857142857,136500,169000,32500,876189,302440.0,에스케이바이오사이언스보통주
19050,302440,2021-03-22,0.1351351351351351,166500,144000,-22500,4675116,302440.0,에스케이바이오사이언스보통주
19051,302440,2021-03-18,0.2857142857142857,136500,169000,32500,876189,302440.0,에스케이바이오사이언스보통주
19052,302440,2021-03-22,0.1351351351351351,166500,144000,-22500,4675116,302440.0,에스케이바이오사이언스보통주
19053,302440,2021-03-18,0.2857142857142857,136500,169000,32500,876189,302440.0,에스케이바이오사이언스보통주
19054,302440,2021-03-22,0.1351351351351351,166500,144000,-22500,4675116,302440.0,에스케이바이오사이언스보통주
19055,302440,2021-03-18,0.2857142857142857,136500,169000,32500,876189,302440.0,에스케이바이오사이언스보통주
19056,302440,2021-03-22,0.1351351351351351,166500,144000,-22500,4675116,302440.0,에스케이바이오사이언스보통주
19057,302440,2021-03-18,0.2857142857142857,136500,169000,32500,876189,302440.0,에스케이바이오사이언스보통주
19058,302440,2021-03-22,0.1351351351351351,166500,144000,-22500,4675116,302440.0,에스케이바이오사이언스보통주
19059,302440,2021-03-18,0.2857142857142857,136500,169000,32500,876189,302440.0,에스케이바이오사이언스보통주
19060,302440,2021-03-22,0.1351351351351351,166500,144000,-22500,4675116,302440.0,에스케이바이오사이언스보통주
19061,302440,2021-03-18,0.2857142857142857,136500,169000,32500,876189,302440.0,에스케이바이오사이언스보통주
19062,302440,2021-03-22,0.1351351351351351,166500,144000,-22500,4675116,302440.0,에스케이바이오사이언스보통주
19063,302440,2021-03-18,0.2857142857142857,136500,169000,32500,876189,302440.0,에스케이바이오사이언스보통주
19064,302440,2021-03-22,0.1351351351351351,166500,144000,-22500,4675116,302440.0,에스케이바이오사이언스보통주
19065,302440,2021-03-18,0.2857142857142857,136500,169000,32500,876189,302440.0,에스케이바이오사이언스보통주
19066,302440,2021-03-22,0.1351351351351351,166500,144000,-22500,4675116,302440.0,에스케이바이오사이언스보통주
19067,302440,2021-03-18,0.2857142857142857,136500,169000,32500,876189,302440.0,에스케이바이오사이언스보통주
19068,302440,2021-03-22,0.1351351351351351,166500,144000,-22500,4675116,302440.0,에스케이바이오사이언스보통주
19069,302440,2021-03-18,0.2857142857142857,136500,169000,32500,876189,302440.0,에스케이바이오사이언스보통주
19070,302440,2021-03-22,0.1351351351351351,166500,144000,-22500,4675116,302440.0,에스케이바이오사이언스보통주
19071,302440,2021-03-18,0.2857142857142857,136500,169000,32500,876189,302440.0,에스케이바이오사이언스보통주
19072,302440,2021-03-22,0.1351351351351351,166500,144000,-22500,4675116,302440.0,에스케이바이오사이언스보통주
19073,302440,2021-03-18,0.2857142857142857,136500,169000,32500,876189,302440.0,에스케이바이오사이언스보통주
19074,302440,2021-03-22,0.1351351351351351,166500,144000,-22500,4675116,302440.0,에스케이바이오사이언스보통주
19075,302440,2021-03-18,0.2857142857142857,136500,169000,32500,876189,302440.0,에스케이바이오사이언스보통주
19076,302440,2021-03-22,0.1351351351351351,166500,144000,-22500,4675116,302440.0,에스케이바이오사이언스보통주
19077,302440,2021-03-18,0.2857142857142857,136500,169000,32500,876189,302440.0,에스케이바이오사이언스보통주
19078,302440,2021-03-22,0.1351351351351351,166500,144000,-22500,4675116,302440.0,에스케이바이오사이언스보통주
19079,302440,2021-03-18,0.2857142857142857,136500,169000,32500,876189,302440.0,에스케이바이오사이언스보통주
19080,302440,2021-03-22,0.1351351351351351,166500,144000,-22500,4675116,302440.0,에스케이바이오사이언스보통주
19081,302440,2021-03-18,0.2857142857142857,136500,169000,32500,876189,302440.0,에스케이바이오사이언스보통주
19082,302440,2021-03-22,0.1351351351351351,166500,144000,-22500,4675116,302440.0,에스케이바이오사이언스보통주
19083,302440,2021-03-18,0.2857142857142857,136500,169000,32500,876189,302440.0,에스케이바이오사이언스보통주
19084,302440,2021-03-22,0.1351351351351351,166500,144000,-22500,4675116,302440.0,에스케이바이오사이언스보통주
19085,302440,2021-03-18,0.2857142857142857,136500,169000,32500,876189,302440.0,에스케이바이오사이언스보통주
19086,302440,2021-03-22,0.1351351351351351,166500,144000,-22500,4675116,302440.0,에스케이바이오사이언스보통주
19087,302440,2021-03-18,0.2857142857142857,136500,169000,32500,876189,302440.0,에스케이바이오사이언스보통주
19088,302440,2021-03-22,0.1351351351351351,166500,144000,-22500,4675116,302440.0,에스케이바이오사이언스보통주
19089,302440,2021-03-18,0.2857142857142857,136500,169000,32500,876189,302440.0,에스케이바이오사이언스보통주
19090,302440,2021-03-22,0.1351351351351351,166500,144000,-22500,4675116,302440.0,에스케이바이오사이언스보통주
19091,302440,2021-03-18,0.2857142857142857,136500,169000,32500,876189,302440.0,에스케이바이오사이언스보통주
19092,302440,2021-03-22,0.1351351351351351,166500,144000,-22500,4675116,302440.0,에스케이바이오사이언스보통주
19093,302440,2021-03-18,0.2857142857142857,136500,169000,32500,876189,302440.0,에스케이바이오사이언스보통주
19094,302440,2021-03-22,0.1351351351351351,166500,144000,-22500,4675116,302440.0,에스케이바이오사이언스보통주
19095,302440,2021-03-18,0.2857142857142857,136500,169000,32500,876189,302440.0,에스케이바이오사이언스보통주
19096,302440,2021-03-22,0.1351351351351351,166500,144000,-22500,4675116,302440.0,에스케이바이오사이언스보통주
19097,302440,2021-03-18,0.2857142857142857,136500,169000,32500,876189,302440.0,에스케이바이오사이언스보통주
19098,302440,2021-03-22,0.1351351351351351,166500,144000,-22500,4675116,302440.0,에스케이바이오사이언스보통주
19099,302440,2021-03-18,0.2857142857142857,136500,169000,32500,876189,302440.0,에스케이바이오사이언스보통주
19100,302440,2021-03-22,0.1351351351351351,166500,144000,-22500,4675116,302440.0,에스케이바이오사이언스보통주
19101,302440,2021-03-18,0.2857142857142857,136500,169000,32500,876189,302440.0,에스케이바이오사이언스보통주
19102,302440,2021-03-22,0.1351351351351351,166500,144000,-22500,4675116,302440.0,에스케이바이오사이언스보통주
19103,302440,2021-03-18,0.2857142857142857,136500,169000,32500,876189,302440.0,에스케이바이오사이언스보통주
19104,302440,2021-03-22,0.1351351351351351,166500,144000,-22500,4675116,302440.0,에스케이바이오사이언스보통주
19105,302440,2021-03-18,0.2857142857142857,136500,169000,32500,876189,302440.0,에스케이바이오사이언스보통주
19106,302440,2021-03-22,0.1351351351351351,166500,144000,-22500,4675116,302440.0,에스케이바이오사이언스보통주
19107,302440,2021-03-18,0.2857142857142857,136500,169000,32500,876189,302440.0,에스케이바이오사이언스보통주
19108,302440,2021-03-22,0.1351351351351351,166500,144000,-22500,4675116,302440.0,에스케이바이오사이언스보통주
19109,302440,2021-03-18,0.2857142857142857,136500,169000,32500,876189,302440.0,에스케이바이오사이언스보통주
19110,302440,2021-03-22,0.1351351351351351,166500,144000,-22500,4675116,302440.0,에스케이바이오사이언스보통주
19111,302440,2021-03-18,0.2857142857142857,136500,169000,32500,876189,302440.0,에스케이바이오사이언스보통주
19112,302440,2021-03-22,0.1351351351351351,166500,144000,-22500,4675116,302440.0,에스케이바이오사이언스보통주
19113,302440,2021-03-18,0.2857142857142857,136500,169000,32500,876189,302440.0,에스케이바이오사이언스보통주
19114,302440,2021-03-22,0.1351351351351351,166500,144000,-22500,4675116,302440.0,에스케이바이오사이언스보통주
19115,302440,2021-03-18,0.2857142857142857,136500,169000,32500,876189,302440.0,에스케이바이오사이언스보통주
19116,302440,2021-03-22,0.1351351351351351,166500,144000,-22500,4675116,302440.0,에스케이바이오사이언스보통주
19117,302440,2021-03-18,0.2857142857142857,136500,169000,32500,876189,302440.0,에스케이바이오사이언스보통주
19118,302440,2021-03-22,0.1351351351351351,166500,144000,-22500,4675116,302440.0,에스케이바이오사이언스보통주
19119,302440,2021-03-18,0.2857142857142857,136500,169000,32500,876189,302440.0,에스케이바이오사이언스보통주
19120,302440,2021-03-22,0.1351351351351351,166500,144000,-22500,4675116,302440.0,에스케이바이오사이언스보통주
19121,302440,2021-03-18,0.2857142857142857,136500,169000,32500,876189,302440.0,에스케이바이오사이언스보통주
19122,302440,2021-03-22,0.1351351351351351,166500,144000,-22500,4675116,302440.0,에스케이바이오사이언스보통주
19123,302440,2021-03-18,0.2857142857142857,136500,169000,32500,876189,302440.0,에스케이바이오사이언스보통주
19124,302440,2021-03-22,0.1351351351351351,166500,144000,-22500,4675116,302440.0,에스케이바이오사이언스보통주
19125,302440,2021-03-18,0.2857142857142857,136500,169000,32500,876189,302440.0,에스케이바이오사이언스보통주
19126,302440,2021-03-22,0.1351351351351351,166500,144000,-22500,4675116,302440.0,에스케이바이오사이언스보통주
19127,302440,2021-03-18,0.2857142857142857,136500,169000,32500,876189,302440.0,에스케이바이오사이언스보통주
19128,302440,2021-03-22,0.1351351351351351,166500,144000,-22500,4675116,302440.0,에스케이바이오사이언스보통주
19129,302440,2021-03-18,0.2857142857142857,136500,169000,32500,876189,302440.0,에스케이바이오사이언스보통주
19130,302440,2021-03-22,0.1351351351351351,166500,144000,-22500,4675116,302440.0,에스케이바이오사이언스보통주
19131,302440,2021-03-18,0.2857142857142857,136500,169000,32500,876189,302440.0,에스케이바이오사이언스보통주
19132,302440,2021-03-22,0.1351351351351351,166500,144000,-22500,4675116,302440.0,에스케이바이오사이언스보통주
19133,302440,2021-03-18,0.2857142857142857,136500,169000,32500,876189,302440.0,에스케이바이오사이언스보통주
19134,302440,2021-03-22,0.1351351351351351,166500,144000,-22500,4675116,302440.0,에스케이바이오사이언스보통주
19135,302440,2021-03-18,0.2857142857142857,136500,169000,32500,876189,302440.0,에스케이바이오사이언스보통주
19136,302440,2021-03-22,0.1351351351351351,166500,144000,-22500,4675116,302440.0,에스케이바이오사이언스보통주
19137,302440,2021-03-18,0.2857142857142857,136500,169000,32500,876189,302440.0,에스케이바이오사이언스보통주
19138,302440,2021-03-22,0.1351351351351351,166500,144000,-22500,4675116,302440.0,에스케이바이오사이언스보통주
19139,302440,2021-03-18,0.2857142857142857,136500,169000,32500,876189,302440.0,에스케이바이오사이언스보통주
19140,302440,2021-03-22,0.1351351351351351,166500,144000,-22500,4675116,302440.0,에스케이바이오사이언스보통주
19141,302440,2021-03-18,0.2857142857142857,136500,169000,32500,876189,302440.0,에스케이바이오사이언스보통주
19142,302440,2021-03-22,0.1351351351351351,166500,144000,-22500,4675116,302440.0,에스케이바이오사이언스보통주
19143,302440,2021-03-18,0.2857142857142857,136500,169000,32500,876189,302440.0,에스케이바이오사이언스보통주
19144,302440,2021-03-22,0.1351351351351351,166500,144000,-22500,4675116,302440.0,에스케이바이오사이언스보통주
19145,302440,2021-03-18,0.2857142857142857,136500,169000,32500,876189,302440.0,에스케이바이오사이언스보통주
19146,302440,2021-03-22,0.1351351351351351,166500,144000,-22500,4675116,302440.0,에스케이바이오사이언스보통주
19147,302440,2021-03-18,0.2857142857142857,136500,169000,32500,876189,302440.0,에스케이바이오사이언스보통주
19148,302440,2021-03-22,0.1351351351351351,166500,144000,-22500,4675116,302440.0,에스케이바이오사이언스보통주
19149,302440,2021-03-18,0.2857142857142857,136500,169000,32500,876189,302440.0,에스케이바이오사이언스보통주
19150,302440,2021-03-22,0.1351351351351351,166500,144000,-22500,4675116,302440.0,에스케이바이오사이언스보통주
19151,302440,2021-03-18,0.2857142857142857,136500,169000,32500,876189,302440.0,에스케이바이오사이언스보통주
19152,302440,2021-03-22,0.1351351351351351,166500,144000,-22500,4675116,302440.0,에스케이바이오사이언스보통주
19153,302440,2021-03-18,0.2857142857142857,136500,169000,32500,876189,302440.0,에스케이바이오사이언스보통주
19154,302440,2021-03-22,0.1351351351351351,166500,144000,-22500,4675116,302440.0,에스케이바이오사이언스보통주
19155,302440,2021-03-18,0.2857142857142857,136500,169000,32500,876189,302440.0,에스케이바이오사이언스보통주
19156,302440,2021-03-22,0.1351351351351351,166500,144000,-22500,4675116,302440.0,에스케이바이오사이언스보통주
19157,302440,2021-03-18,0.2857142857142857,136500,169000,32500,876189,302440.0,에스케이바이오사이언스보통주
19158,302440,2021-03-22,0.1351351351351351,166500,144000,-22500,4675116,302440.0,에스케이바이오사이언스보통주
19159,302440,2021-03-18,0.2857142857142857,136500,169000,32500,876189,302440.0,에스케이바이오사이언스보통주
19160,302440,2021-03-22,0.1351351351351351,166500,144000,-22500,4675116,302440.0,에스케이바이오사이언스보통주
19161,302440,2021-03-18,0.2857142857142857,136500,169000,32500,876189,302440.0,에스케이바이오사이언스보통주
19162,302440,2021-03-22,0.1351351351351351,166500,144000,-22500,4675116,302440.0,에스케이바이오사이언스보통주
19163,302440,2021-03-18,0.2857142857142857,136500,169000,32500,876189,302440.0,에스케이바이오사이언스보통주
19164,302440,2021-03-22,0.1351351351351351,166500,144000,-22500,4675116,302440.0,에스케이바이오사이언스보통주
19165,302440,2021-03-18,0.2857142857142857,136500,169000,32500,876189,302440.0,에스케이바이오사이언스보통주
19166,302440,2021-03-22,0.1351351351351351,166500,144000,-22500,4675116,302440.0,에스케이바이오사이언스보통주
19167,302440,2021-03-18,0.2857142857142857,136500,169000,32500,876189,302440.0,에스케이바이오사이언스보통주
19168,302440,2021-03-22,0.1351351351351351,166500,144000,-22500,4675116,302440.0,에스케이바이오사이언스보통주
19169,302440,2021-03-18,0.2857142857142857,136500,169000,32500,876189,302440.0,에스케이바이오사이언스보통주
19170,302440,2021-03-22,0.1351351351351351,166500,144000,-22500,4675116,302440.0,에스케이바이오사이언스보통주
19171,302440,2021-03-18,0.2857142857142857,136500,169000,32500,876189,302440.0,에스케이바이오사이언스보통주
19172,302440,2021-03-22,0.1351351351351351,166500,144000,-22500,4675116,302440.0,에스케이바이오사이언스보통주
19173,302440,2021-03-18,0.2857142857142857,136500,169000,32500,876189,302440.0,에스케이바이오사이언스보통주
19174,302440,2021-03-22,0.1351351351351351,166500,144000,-22500,4675116,302440.0,에스케이바이오사이언스보통주
19175,302440,2021-03-18,0.2857142857142857,136500,169000,32500,876189,302440.0,에스케이바이오사이언스보통주
19176,302440,2021-03-22,0.1351351351351351,166500,144000,-22500,4675116,302440.0,에스케이바이오사이언스보통주
19177,302440,2021-03-18,0.2857142857142857,136500,169000,32500,876189,302440.0,에스케이바이오사이언스보통주
19178,302440,2021-03-22,0.1351351351351351,166500,144000,-22500,4675116,302440.0,에스케이바이오사이언스보통주
19179,302440,2021-03-18,0.2857142857142857,136500,169000,32500,876189,302440.0,에스케이바이오사이언스보통주
19180,302440,2021-03-22,0.1351351351351351,166500,144000,-22500,4675116,302440.0,에스케이바이오사이언스보통주
19181,302440,2021-03-18,0.2857142857142857,136500,169000,32500,876189,302440.0,에스케이바이오사이언스보통주
19182,302440,2021-03-22,0.1351351351351351,166500,144000,-22500,4675116,302440.0,에스케이바이오사이언스보통주
19183,302440,2021-03-18,0.2857142857142857,136500,169000,32500,876189,302440.0,에스케이바이오사이언스보통주
19184,302440,2021-03-22,0.1351351351351351,166500,144000,-22500,4675116,302440.0,에스케이바이오사이언스보통주
19185,302440,2021-03-18,0.2857142857142857,136500,169000,32500,876189,302440.0,에스케이바이오사이언스보통주
19186,302440,2021-03-22,0.1351351351351351,166500,144000,-22500,4675116,302440.0,에스케이바이오사이언스보통주
19187,302440,2021-03-18,0.2857142857142857,136500,169000,32500,876189,302440.0,에스케이바이오사이언스보통주
19188,302440,2021-03-22,0.1351351351351351,166500,144000,-22500,4675116,302440.0,에스케이바이오사이언스보통주
19189,302440,2021-03-18,0.2857142857142857,136500,169000,32500,876189,302440.0,에스케이바이오사이언스보통주
19190,302440,2021-03-22,0.1351351351351351,166500,144000,-22500,4675116,302440.0,에스케이바이오사이언스보통주
19191,302440,2021-03-18,0.2857142857142857,136500,169000,32500,876189,302440.0,에스케이바이오사이언스보통주
19192,302440,2021-03-22,0.1351351351351351,166500,144000,-22500,4675116,302440.0,에스케이바이오사이언스보통주
19193,302440,2021-03-18,0.2857142857142857,136500,169000,32500,876189,302440.0,에스케이바이오사이언스보통주
19194,302440,2021-03-22,0.1351351351351351,166500,144000,-22500,4675116,302440.0,에스케이바이오사이언스보통주
19195,302440,2021-03-18,0.2857142857142857,136500,169000,32500,876189,302440.0,에스케이바이오사이언스보통주
19196,302440,2021-03-22,0.1351351351351351,166500,144000,-22500,4675116,302440.0,에스케이바이오사이언스보통주
19197,305720,2021-03-11,0.0539466212379329,17610,18560,950,1594966,,
19198,305720,2021-03-08,0.0417106652587117,18940,18150,-790,1819357,,
19199,305720,2021-02-24,0.0470020325203252,19680,18755,-925,3512493,,
19200,305720,2021-01-08,0.0410172272354388,18285,19035,750,10010566,,
19201,305720,2021-01-04,0.0976,15625,17150,1525,7018933,,
19202,305720,2020-11-05,0.0418074324324324,11840,12335,495,1805005,,
19203,305720,2020-11-03,0.0430579964850615,11380,11870,490,948603,,
19204,305720,2020-09-24,0.0577405857740585,11950,11260,-690,1195146,,
19205,305720,2020-08-20,0.0445524503847711,12345,11795,-550,1522880,,
19206,305720,2020-08-07,0.0599190283400809,12350,13090,740,3652049,,
19207,305720,2020-08-05,0.0706352732119058,11255,12050,795,1576419,,
19208,305720,2020-08-03,0.0491343004211511,10685,11210,525,1049527,,
19209,305720,2020-06-16,0.0833333333333333,8700,9425,725,454559,,
19210,305720,2020-06-15,0.0744680851063829,9400,8700,-700,540305,,
19211,305720,2020-05-26,0.0622817229336437,8590,9125,535,733925,,
19212,305720,2020-05-13,0.0542210020590253,7285,7680,395,351674,,
19213,305720,2020-04-16,0.041458184417441,6995,7285,290,298671,,
19214,305720,2020-03-25,0.0789692435577722,6015,6490,475,334117,,
19215,305720,2020-03-24,0.1036697247706422,5450,6015,565,260099,,
19216,305720,2020-03-20,0.1446028513238289,4910,5620,710,254111,,
19217,305720,2020-03-19,0.1670907548770144,5895,4910,-985,517082,,
19218,305720,2020-03-18,0.0853374709076803,6445,5895,-550,439617,,
19219,305720,2020-03-16,0.0754583921015514,7090,6555,-535,230654,,
19220,305720,2020-03-12,0.0471271788250484,7745,7380,-365,328269,,
19221,305720,2020-03-09,0.0638675340035482,8455,7915,-540,405130,,
19222,305720,2020-02-28,0.0456161137440758,8440,8055,-385,450023,,
19223,305720,2020-02-11,0.045125348189415,8975,9380,405,651318,,
19224,305720,2020-02-04,0.0521844660194174,8240,8670,430,220728,,
19225,305720,2020-01-10,0.0412105602060528,7765,8085,320,404534,,
19226,305720,2019-09-25,0.048284625158831,7870,7490,-380,171601,,
19227,305720,2019-08-05,0.0411652944901836,7895,7570,-325,84068,,
19228,305720,2019-05-09,0.0452380952380952,8400,8020,-380,40608,,
19229,305720,2019-01-07,0.0464547677261613,8180,8560,380,712570,,
19230,305720,2018-12-03,0.0400232018561484,8620,8965,345,253437,,
19231,305720,2018-11-02,0.0491441192711209,9055,9500,445,285190,,
19232,305720,2018-10-23,0.0438104941416199,9815,9385,-430,644986,,
19233,305720,2018-10-12,0.0452261306532663,8955,9360,405,502650,,
19234,305720,2018-10-11,0.0437800320341697,9365,8955,-410,469796,,
19235,307950,2021-05-27,0.056338028169014,106500,112500,6000,91867,307950.0,현대오토에버보통주
19236,307950,2021-05-10,0.0511627906976744,107500,113000,5500,147417,307950.0,현대오토에버보통주
19237,307950,2021-04-02,0.0818965517241379,116000,125500,9500,429644,307950.0,현대오토에버보통주
19238,307950,2021-03-11,0.0405405405405405,111000,115500,4500,53957,307950.0,현대오토에버보통주
19239,307950,2021-03-08,0.0571428571428571,122500,115500,-7000,132104,307950.0,현대오토에버보통주
19240,307950,2021-02-24,0.0557620817843866,134500,127000,-7500,135260,307950.0,현대오토에버보통주
19241,307950,2021-02-19,0.0426356589147286,129000,134500,5500,142687,307950.0,현대오토에버보통주
19242,307950,2021-02-18,0.047970479704797,135500,129000,-6500,95302,307950.0,현대오토에버보통주
19243,307950,2021-02-16,0.0421455938697318,130500,136000,5500,190169,307950.0,현대오토에버보통주
19244,307950,2021-02-09,0.0655737704918032,122000,130000,8000,221390,307950.0,현대오토에버보통주
19245,307950,2021-02-01,0.0571428571428571,122500,129500,7000,132633,307950.0,현대오토에버보통주
19246,307950,2021-01-29,0.0648854961832061,131000,122500,-8500,182496,307950.0,현대오토에버보통주
19247,307950,2021-01-20,0.1088709677419354,124000,137500,13500,356867,307950.0,현대오토에버보통주
19248,307950,2021-01-11,0.0424028268551236,141500,135500,-6000,545565,307950.0,현대오토에버보통주
19249,307950,2021-01-04,0.1214574898785425,123500,138500,15000,634892,307950.0,현대오토에버보통주
19250,307950,2020-12-30,0.0600858369098712,116500,123500,7000,396484,307950.0,현대오토에버보통주
19251,307950,2020-12-23,0.0488888888888888,112500,118000,5500,532046,307950.0,현대오토에버보통주
19252,307950,2020-12-21,0.0493827160493827,121500,115500,-6000,370650,307950.0,현대오토에버보통주
19253,307950,2020-12-15,0.1434977578475336,111500,127500,16000,1581998,307950.0,현대오토에버보통주
19254,307950,2020-12-14,0.0931372549019607,102000,111500,9500,1118606,307950.0,현대오토에버보통주
19255,307950,2020-12-10,0.0648648648648648,92500,98500,6000,313772,307950.0,현대오토에버보통주
19256,307950,2020-12-03,0.077277970011534,86700,93400,6700,375682,307950.0,현대오토에버보통주
19257,307950,2020-12-01,0.0435323383084577,80400,83900,3500,202281,307950.0,현대오토에버보통주
19258,307950,2020-11-17,0.0749682337992376,78700,84600,5900,345277,307950.0,현대오토에버보통주
19259,307950,2020-11-13,0.0686015831134564,75800,81000,5200,520838,307950.0,현대오토에버보통주
19260,307950,2020-11-12,0.0631136044880785,71300,75800,4500,342747,307950.0,현대오토에버보통주
19261,307950,2020-11-11,0.0485294117647058,68000,71300,3300,366220,307950.0,현대오토에버보통주
19262,307950,2020-11-09,0.0433436532507739,64600,67400,2800,159183,307950.0,현대오토에버보통주
19263,307950,2020-10-30,0.0444444444444444,67500,64500,-3000,149379,307950.0,현대오토에버보통주
19264,307950,2020-10-28,0.0537124802527646,63300,66700,3400,138348,307950.0,현대오토에버보통주
19265,307950,2020-10-22,0.0597014925373134,67000,63000,-4000,181143,307950.0,현대오토에버보통주
19266,307950,2020-10-20,0.0874403815580286,62900,68400,5500,854068,307950.0,현대오토에버보통주
19267,307950,2020-10-19,0.075,68000,62900,-5100,327283,307950.0,현대오토에버보통주
19268,307950,2020-10-15,0.0646616541353383,66500,70800,4300,418711,307950.0,현대오토에버보통주
19269,307950,2020-10-05,0.08562197092084,61900,67200,5300,355104,307950.0,현대오토에버보통주
19270,307950,2020-09-28,0.1022927689594356,56700,62500,5800,485511,307950.0,현대오토에버보통주
19271,307950,2020-09-23,0.0571428571428571,56000,59200,3200,301667,307950.0,현대오토에버보통주
19272,307950,2020-09-22,0.0524534686971235,59100,56000,-3100,252091,307950.0,현대오토에버보통주
19273,307950,2020-09-17,0.0449050086355785,57900,60500,2600,337657,307950.0,현대오토에버보통주
19274,307950,2020-09-14,0.117533718689788,51900,58000,6100,873821,307950.0,현대오토에버보통주
19275,307950,2020-09-10,0.0643153526970954,48200,51300,3100,613665,307950.0,현대오토에버보통주
19276,307950,2020-09-09,0.0868094701240135,44350,48200,3850,506493,307950.0,현대오토에버보통주
19277,307950,2020-08-28,0.0717821782178217,40400,43300,2900,296910,307950.0,현대오토에버보통주
19278,307950,2020-08-25,0.048469387755102,39200,41100,1900,73596,307950.0,현대오토에버보통주
19279,307950,2020-08-18,0.0420560747663551,42800,41000,-1800,118290,307950.0,현대오토에버보통주
19280,307950,2020-08-12,0.0596658711217183,41900,44400,2500,108811,307950.0,현대오토에버보통주
19281,307950,2020-08-06,0.0459183673469387,39200,41000,1800,113075,307950.0,현대오토에버보통주
19282,307950,2020-06-15,0.0435323383084577,40200,38450,-1750,46975,307950.0,현대오토에버보통주
19283,307950,2020-06-12,0.0451306413301662,42100,40200,-1900,62099,307950.0,현대오토에버보통주
19284,307950,2020-05-25,0.0670731707317073,41000,43750,2750,134131,307950.0,현대오토에버보통주
19285,307950,2020-05-11,0.0432748538011695,42750,44600,1850,91691,307950.0,현대오토에버보통주
19286,307950,2020-04-14,0.0425240054869684,36450,38000,1550,39708,307950.0,현대오토에버보통주
19287,307950,2020-04-13,0.0617760617760617,38850,36450,-2400,58870,307950.0,현대오토에버보통주
19288,307950,2020-04-09,0.0781032078103207,35850,38650,2800,74720,307950.0,현대오토에버보통주
19289,307950,2020-04-08,0.0406386066763425,34450,35850,1400,48003,307950.0,현대오토에버보통주
19290,307950,2020-03-27,0.063573883161512,29100,30950,1850,103747,307950.0,현대오토에버보통주
19291,307950,2020-03-25,0.1498973305954825,24350,28000,3650,117102,307950.0,현대오토에버보통주
19292,307950,2020-03-24,0.077433628318584,22600,24350,1750,37164,307950.0,현대오토에버보통주
19293,307950,2020-03-23,0.0718685831622176,24350,22600,-1750,41596,307950.0,현대오토에버보통주
19294,307950,2020-03-20,0.1169724770642201,21800,24350,2550,66240,307950.0,현대오토에버보통주
19295,307950,2020-03-19,0.1383399209486166,25300,21800,-3500,99529,307950.0,현대오토에버보통주
19296,307950,2020-03-18,0.1107205623901581,28450,25300,-3150,74083,307950.0,현대오토에버보통주
19297,307950,2020-03-17,0.0516666666666666,30000,28450,-1550,98806,307950.0,현대오토에버보통주
19298,307950,2020-03-16,0.0697674418604651,32250,30000,-2250,58836,307950.0,현대오토에버보통주
19299,307950,2020-03-13,0.0652173913043478,34500,32250,-2250,124362,307950.0,현대오토에버보통주
19300,307950,2020-03-12,0.0750670241286863,37300,34500,-2800,74904,307950.0,현대오토에버보통주
19301,307950,2020-02-25,0.0460526315789473,38000,39750,1750,81786,307950.0,현대오토에버보통주
19302,307950,2020-02-24,0.0547263681592039,40200,38000,-2200,90258,307950.0,현대오토에버보통주
19303,307950,2020-01-28,0.0489795918367346,49000,46600,-2400,45058,307950.0,현대오토에버보통주
19304,307950,2020-01-10,0.0506186726659167,44450,46700,2250,47685,307950.0,현대오토에버보통주
19305,307950,2020-01-08,0.0563829787234042,47000,44350,-2650,72261,307950.0,현대오토에버보통주
19306,307950,2019-08-26,0.0505226480836236,57400,54500,-2900,490999,307950.0,현대오토에버보통주
19307,307950,2019-08-19,0.0411214953271028,53500,55700,2200,45924,307950.0,현대오토에버보통주
19308,307950,2019-08-07,0.1170212765957446,47000,52500,5500,117671,307950.0,현대오토에버보통주
19309,307950,2019-08-05,0.060576923076923,52000,48850,-3150,51705,307950.0,현대오토에버보통주
19310,307950,2019-07-29,0.0408163265306122,53900,51700,-2200,25489,307950.0,현대오토에버보통주
19311,307950,2019-07-19,0.04296875,51200,53400,2200,49236,307950.0,현대오토에버보통주
19312,307950,2019-07-09,0.041015625,51200,53300,2100,84566,307950.0,현대오토에버보통주
19313,307950,2019-07-08,0.079136690647482,55600,51200,-4400,109598,307950.0,현대오토에버보통주
19314,307950,2019-06-11,0.0566615620214395,65300,69000,3700,103764,307950.0,현대오토에버보통주
19315,307950,2019-06-10,0.060064935064935,61600,65300,3700,47809,307950.0,현대오토에버보통주
19316,307950,2019-05-30,0.0604026845637583,59600,63200,3600,52816,307950.0,현대오토에버보통주
19317,307950,2019-05-28,0.0627177700348432,57400,61000,3600,41565,307950.0,현대오토에버보통주
19318,307950,2019-05-27,0.0480928689883913,60300,57400,-2900,67040,307950.0,현대오토에버보통주
19319,307950,2019-05-14,0.0677466863033873,67900,63300,-4600,173465,307950.0,현대오토에버보통주
19320,307950,2019-05-13,0.0724043715846994,73200,67900,-5300,99364,307950.0,현대오토에버보통주
19321,307950,2019-05-08,0.0504774897680764,73300,77000,3700,83513,307950.0,현대오토에버보통주
19322,307950,2019-04-18,0.0488636363636363,88000,83700,-4300,93744,307950.0,현대오토에버보통주
19323,307950,2019-04-11,0.0594530321046373,84100,89100,5000,290864,307950.0,현대오토에버보통주
19324,307950,2019-04-10,0.0473225404732254,80300,84100,3800,398111,307950.0,현대오토에버보통주
19325,307950,2019-04-09,0.0469361147327249,76700,80300,3600,241415,307950.0,현대오토에버보통주
19326,307950,2019-03-29,0.0744081172491544,88700,82100,-6600,1131418,307950.0,현대오토에버보통주
19327,307950,2019-03-28,0.1607795371498173,82100,88700,6600,4171304,307950.0,현대오토에버보통주
19328,307950,2019-03-29,0.0744081172491544,88700,82100,-6600,1131418,307950.0,현대오토에버보통주
19329,307950,2019-03-28,0.1607795371498173,82100,88700,6600,4171304,307950.0,현대오토에버보통주
19330,307950,2019-03-29,0.0744081172491544,88700,82100,-6600,1131418,307950.0,현대오토에버보통주
19331,307950,2019-03-28,0.1607795371498173,82100,88700,6600,4171304,307950.0,현대오토에버보통주
19332,307950,2019-03-29,0.0744081172491544,88700,82100,-6600,1131418,307950.0,현대오토에버보통주
19333,307950,2019-03-28,0.1607795371498173,82100,88700,6600,4171304,307950.0,현대오토에버보통주
19334,307950,2019-03-29,0.0744081172491544,88700,82100,-6600,1131418,307950.0,현대오토에버보통주
19335,307950,2019-03-28,0.1607795371498173,82100,88700,6600,4171304,307950.0,현대오토에버보통주
19336,307950,2019-03-29,0.0744081172491544,88700,82100,-6600,1131418,307950.0,현대오토에버보통주
19337,307950,2019-03-28,0.1607795371498173,82100,88700,6600,4171304,307950.0,현대오토에버보통주
19338,307950,2019-03-29,0.0744081172491544,88700,82100,-6600,1131418,307950.0,현대오토에버보통주
19339,307950,2019-03-28,0.1607795371498173,82100,88700,6600,4171304,307950.0,현대오토에버보통주
19340,307950,2019-03-29,0.0744081172491544,88700,82100,-6600,1131418,307950.0,현대오토에버보통주
19341,307950,2019-03-28,0.1607795371498173,82100,88700,6600,4171304,307950.0,현대오토에버보통주
19342,307950,2019-03-29,0.0744081172491544,88700,82100,-6600,1131418,307950.0,현대오토에버보통주
19343,307950,2019-03-28,0.1607795371498173,82100,88700,6600,4171304,307950.0,현대오토에버보통주
19344,307950,2019-03-29,0.0744081172491544,88700,82100,-6600,1131418,307950.0,현대오토에버보통주
19345,307950,2019-03-28,0.1607795371498173,82100,88700,6600,4171304,307950.0,현대오토에버보통주
19346,307950,2019-03-29,0.0744081172491544,88700,82100,-6600,1131418,307950.0,현대오토에버보통주
19347,307950,2019-03-28,0.1607795371498173,82100,88700,6600,4171304,307950.0,현대오토에버보통주
19348,307950,2019-03-29,0.0744081172491544,88700,82100,-6600,1131418,307950.0,현대오토에버보통주
19349,307950,2019-03-28,0.1607795371498173,82100,88700,6600,4171304,307950.0,현대오토에버보통주
19350,307950,2019-03-29,0.0744081172491544,88700,82100,-6600,1131418,307950.0,현대오토에버보통주
19351,307950,2019-03-28,0.1607795371498173,82100,88700,6600,4171304,307950.0,현대오토에버보통주
19352,307950,2019-03-29,0.0744081172491544,88700,82100,-6600,1131418,307950.0,현대오토에버보통주
19353,307950,2019-03-28,0.1607795371498173,82100,88700,6600,4171304,307950.0,현대오토에버보통주
19354,307950,2019-03-29,0.0744081172491544,88700,82100,-6600,1131418,307950.0,현대오토에버보통주
19355,307950,2019-03-28,0.1607795371498173,82100,88700,6600,4171304,307950.0,현대오토에버보통주
19356,307950,2019-03-29,0.0744081172491544,88700,82100,-6600,1131418,307950.0,현대오토에버보통주
19357,307950,2019-03-28,0.1607795371498173,82100,88700,6600,4171304,307950.0,현대오토에버보통주
19358,307950,2019-03-29,0.0744081172491544,88700,82100,-6600,1131418,307950.0,현대오토에버보통주
19359,307950,2019-03-28,0.1607795371498173,82100,88700,6600,4171304,307950.0,현대오토에버보통주
19360,307950,2019-03-29,0.0744081172491544,88700,82100,-6600,1131418,307950.0,현대오토에버보통주
19361,307950,2019-03-28,0.1607795371498173,82100,88700,6600,4171304,307950.0,현대오토에버보통주
19362,307950,2019-03-29,0.0744081172491544,88700,82100,-6600,1131418,307950.0,현대오토에버보통주
19363,307950,2019-03-28,0.1607795371498173,82100,88700,6600,4171304,307950.0,현대오토에버보통주
19364,307950,2019-03-29,0.0744081172491544,88700,82100,-6600,1131418,307950.0,현대오토에버보통주
19365,307950,2019-03-28,0.1607795371498173,82100,88700,6600,4171304,307950.0,현대오토에버보통주
19366,307950,2019-03-29,0.0744081172491544,88700,82100,-6600,1131418,307950.0,현대오토에버보통주
19367,307950,2019-03-28,0.1607795371498173,82100,88700,6600,4171304,307950.0,현대오토에버보통주
19368,307950,2019-03-29,0.0744081172491544,88700,82100,-6600,1131418,307950.0,현대오토에버보통주
19369,307950,2019-03-28,0.1607795371498173,82100,88700,6600,4171304,307950.0,현대오토에버보통주
19370,307950,2019-03-29,0.0744081172491544,88700,82100,-6600,1131418,307950.0,현대오토에버보통주
19371,307950,2019-03-28,0.1607795371498173,82100,88700,6600,4171304,307950.0,현대오토에버보통주
19372,307950,2019-03-29,0.0744081172491544,88700,82100,-6600,1131418,307950.0,현대오토에버보통주
19373,307950,2019-03-28,0.1607795371498173,82100,88700,6600,4171304,307950.0,현대오토에버보통주
19374,307950,2019-03-29,0.0744081172491544,88700,82100,-6600,1131418,307950.0,현대오토에버보통주
19375,307950,2019-03-28,0.1607795371498173,82100,88700,6600,4171304,307950.0,현대오토에버보통주
19376,307950,2019-03-29,0.0744081172491544,88700,82100,-6600,1131418,307950.0,현대오토에버보통주
19377,307950,2019-03-28,0.1607795371498173,82100,88700,6600,4171304,307950.0,현대오토에버보통주
19378,307950,2019-03-29,0.0744081172491544,88700,82100,-6600,1131418,307950.0,현대오토에버보통주
19379,307950,2019-03-28,0.1607795371498173,82100,88700,6600,4171304,307950.0,현대오토에버보통주
19380,307950,2019-03-29,0.0744081172491544,88700,82100,-6600,1131418,307950.0,현대오토에버보통주
19381,307950,2019-03-28,0.1607795371498173,82100,88700,6600,4171304,307950.0,현대오토에버보통주
19382,307950,2019-03-29,0.0744081172491544,88700,82100,-6600,1131418,307950.0,현대오토에버보통주
19383,307950,2019-03-28,0.1607795371498173,82100,88700,6600,4171304,307950.0,현대오토에버보통주
19384,307950,2019-03-29,0.0744081172491544,88700,82100,-6600,1131418,307950.0,현대오토에버보통주
19385,307950,2019-03-28,0.1607795371498173,82100,88700,6600,4171304,307950.0,현대오토에버보통주
19386,307950,2019-03-29,0.0744081172491544,88700,82100,-6600,1131418,307950.0,현대오토에버보통주
19387,307950,2019-03-28,0.1607795371498173,82100,88700,6600,4171304,307950.0,현대오토에버보통주
19388,307950,2019-03-29,0.0744081172491544,88700,82100,-6600,1131418,307950.0,현대오토에버보통주
19389,307950,2019-03-28,0.1607795371498173,82100,88700,6600,4171304,307950.0,현대오토에버보통주
19390,307950,2019-03-29,0.0744081172491544,88700,82100,-6600,1131418,307950.0,현대오토에버보통주
19391,307950,2019-03-28,0.1607795371498173,82100,88700,6600,4171304,307950.0,현대오토에버보통주
19392,307950,2019-03-29,0.0744081172491544,88700,82100,-6600,1131418,307950.0,현대오토에버보통주
19393,307950,2019-03-28,0.1607795371498173,82100,88700,6600,4171304,307950.0,현대오토에버보통주
19394,307950,2019-03-29,0.0744081172491544,88700,82100,-6600,1131418,307950.0,현대오토에버보통주
19395,307950,2019-03-28,0.1607795371498173,82100,88700,6600,4171304,307950.0,현대오토에버보통주
19396,307950,2019-03-29,0.0744081172491544,88700,82100,-6600,1131418,307950.0,현대오토에버보통주
19397,307950,2019-03-28,0.1607795371498173,82100,88700,6600,4171304,307950.0,현대오토에버보통주
19398,307950,2019-03-29,0.0744081172491544,88700,82100,-6600,1131418,307950.0,현대오토에버보통주
19399,307950,2019-03-28,0.1607795371498173,82100,88700,6600,4171304,307950.0,현대오토에버보통주
19400,307950,2019-03-29,0.0744081172491544,88700,82100,-6600,1131418,307950.0,현대오토에버보통주
19401,307950,2019-03-28,0.1607795371498173,82100,88700,6600,4171304,307950.0,현대오토에버보통주
19402,307950,2019-03-29,0.0744081172491544,88700,82100,-6600,1131418,307950.0,현대오토에버보통주
19403,307950,2019-03-28,0.1607795371498173,82100,88700,6600,4171304,307950.0,현대오토에버보통주
19404,307950,2019-03-29,0.0744081172491544,88700,82100,-6600,1131418,307950.0,현대오토에버보통주
19405,307950,2019-03-28,0.1607795371498173,82100,88700,6600,4171304,307950.0,현대오토에버보통주
19406,307950,2019-03-29,0.0744081172491544,88700,82100,-6600,1131418,307950.0,현대오토에버보통주
19407,307950,2019-03-28,0.1607795371498173,82100,88700,6600,4171304,307950.0,현대오토에버보통주
19408,307950,2019-03-29,0.0744081172491544,88700,82100,-6600,1131418,307950.0,현대오토에버보통주
19409,307950,2019-03-28,0.1607795371498173,82100,88700,6600,4171304,307950.0,현대오토에버보통주
19410,307950,2019-03-29,0.0744081172491544,88700,82100,-6600,1131418,307950.0,현대오토에버보통주
19411,307950,2019-03-28,0.1607795371498173,82100,88700,6600,4171304,307950.0,현대오토에버보통주
19412,307950,2019-03-29,0.0744081172491544,88700,82100,-6600,1131418,307950.0,현대오토에버보통주
19413,307950,2019-03-28,0.1607795371498173,82100,88700,6600,4171304,307950.0,현대오토에버보통주
19414,307950,2019-03-29,0.0744081172491544,88700,82100,-6600,1131418,307950.0,현대오토에버보통주
19415,307950,2019-03-28,0.1607795371498173,82100,88700,6600,4171304,307950.0,현대오토에버보통주
19416,307950,2019-03-29,0.0744081172491544,88700,82100,-6600,1131418,307950.0,현대오토에버보통주
19417,307950,2019-03-28,0.1607795371498173,82100,88700,6600,4171304,307950.0,현대오토에버보통주
19418,307950,2019-03-29,0.0744081172491544,88700,82100,-6600,1131418,307950.0,현대오토에버보통주
19419,307950,2019-03-28,0.1607795371498173,82100,88700,6600,4171304,307950.0,현대오토에버보통주
19420,307950,2019-03-29,0.0744081172491544,88700,82100,-6600,1131418,307950.0,현대오토에버보통주
19421,307950,2019-03-28,0.1607795371498173,82100,88700,6600,4171304,307950.0,현대오토에버보통주
19422,307950,2019-03-29,0.0744081172491544,88700,82100,-6600,1131418,307950.0,현대오토에버보통주
19423,307950,2019-03-28,0.1607795371498173,82100,88700,6600,4171304,307950.0,현대오토에버보통주
19424,307950,2019-03-29,0.0744081172491544,88700,82100,-6600,1131418,307950.0,현대오토에버보통주
19425,307950,2019-03-28,0.1607795371498173,82100,88700,6600,4171304,307950.0,현대오토에버보통주
19426,307950,2019-03-29,0.0744081172491544,88700,82100,-6600,1131418,307950.0,현대오토에버보통주
19427,307950,2019-03-28,0.1607795371498173,82100,88700,6600,4171304,307950.0,현대오토에버보통주
19428,307950,2019-03-29,0.0744081172491544,88700,82100,-6600,1131418,307950.0,현대오토에버보통주
19429,307950,2019-03-28,0.1607795371498173,82100,88700,6600,4171304,307950.0,현대오토에버보통주
19430,307950,2019-03-29,0.0744081172491544,88700,82100,-6600,1131418,307950.0,현대오토에버보통주
19431,307950,2019-03-28,0.1607795371498173,82100,88700,6600,4171304,307950.0,현대오토에버보통주
19432,307950,2019-03-29,0.0744081172491544,88700,82100,-6600,1131418,307950.0,현대오토에버보통주
19433,307950,2019-03-28,0.1607795371498173,82100,88700,6600,4171304,307950.0,현대오토에버보통주
19434,307950,2019-03-29,0.0744081172491544,88700,82100,-6600,1131418,307950.0,현대오토에버보통주
19435,307950,2019-03-28,0.1607795371498173,82100,88700,6600,4171304,307950.0,현대오토에버보통주
19436,307950,2019-03-29,0.0744081172491544,88700,82100,-6600,1131418,307950.0,현대오토에버보통주
19437,307950,2019-03-28,0.1607795371498173,82100,88700,6600,4171304,307950.0,현대오토에버보통주
19438,307950,2019-03-29,0.0744081172491544,88700,82100,-6600,1131418,307950.0,현대오토에버보통주
19439,307950,2019-03-28,0.1607795371498173,82100,88700,6600,4171304,307950.0,현대오토에버보통주
19440,307950,2019-03-29,0.0744081172491544,88700,82100,-6600,1131418,307950.0,현대오토에버보통주
19441,307950,2019-03-28,0.1607795371498173,82100,88700,6600,4171304,307950.0,현대오토에버보통주
19442,307950,2019-03-29,0.0744081172491544,88700,82100,-6600,1131418,307950.0,현대오토에버보통주
19443,307950,2019-03-28,0.1607795371498173,82100,88700,6600,4171304,307950.0,현대오토에버보통주
19444,307950,2019-03-29,0.0744081172491544,88700,82100,-6600,1131418,307950.0,현대오토에버보통주
19445,307950,2019-03-28,0.1607795371498173,82100,88700,6600,4171304,307950.0,현대오토에버보통주
19446,307950,2019-03-29,0.0744081172491544,88700,82100,-6600,1131418,307950.0,현대오토에버보통주
19447,307950,2019-03-28,0.1607795371498173,82100,88700,6600,4171304,307950.0,현대오토에버보통주
19448,307950,2019-03-29,0.0744081172491544,88700,82100,-6600,1131418,307950.0,현대오토에버보통주
19449,307950,2019-03-28,0.1607795371498173,82100,88700,6600,4171304,307950.0,현대오토에버보통주
19450,307950,2019-03-29,0.0744081172491544,88700,82100,-6600,1131418,307950.0,현대오토에버보통주
19451,307950,2019-03-28,0.1607795371498173,82100,88700,6600,4171304,307950.0,현대오토에버보통주
19452,307950,2019-03-29,0.0744081172491544,88700,82100,-6600,1131418,307950.0,현대오토에버보통주
19453,307950,2019-03-28,0.1607795371498173,82100,88700,6600,4171304,307950.0,현대오토에버보통주
19454,307950,2019-03-29,0.0744081172491544,88700,82100,-6600,1131418,307950.0,현대오토에버보통주
19455,316140,2021-05-06,0.0428571428571428,10500,10950,450,4710798,316140.0,우리금융지주보통주
19456,316140,2021-04-07,0.0544554455445544,10100,10650,550,6075671,316140.0,우리금융지주보통주
19457,316140,2020-12-29,0.0453201970443349,10150,9690,-460,4206637,316140.0,우리금융지주보통주
19458,316140,2020-06-16,0.063063063063063,8880,9440,560,2269007,316140.0,우리금융지주보통주
19459,316140,2020-06-15,0.0502673796791443,9350,8880,-470,2780928,316140.0,우리금융지주보통주
19460,316140,2020-06-03,0.0670103092783505,9700,10350,650,4612618,316140.0,우리금융지주보통주
19461,316140,2020-06-02,0.0635964912280701,9120,9700,580,4494389,316140.0,우리금융지주보통주
19462,316140,2020-05-29,0.0446224256292906,8740,9130,390,6520075,316140.0,우리금융지주보통주
19463,316140,2020-05-28,0.0454545454545454,8360,8740,380,7434397,316140.0,우리금융지주보통주
19464,316140,2020-05-04,0.0521327014218009,8440,8000,-440,3931182,316140.0,우리금융지주보통주
19465,316140,2020-04-27,0.0611464968152866,7850,8330,480,4592760,316140.0,우리금융지주보통주
19466,316140,2020-04-10,0.0431937172774869,7640,7970,330,4688039,316140.0,우리금융지주보통주
19467,316140,2020-04-06,0.0438356164383561,7300,7620,320,2366158,316140.0,우리금융지주보통주
19468,316140,2020-04-01,0.049673202614379,7650,7270,-380,2763532,316140.0,우리금융지주보통주
19469,316140,2020-03-27,0.0410958904109589,7300,7600,300,4177831,316140.0,우리금융지주보통주
19470,316140,2020-03-25,0.0661870503597122,6950,7410,460,5753690,316140.0,우리금융지주보통주
19471,316140,2020-03-24,0.0594512195121951,6560,6950,390,3259220,316140.0,우리금융지주보통주
19472,316140,2020-03-23,0.1182795698924731,7440,6560,-880,3892290,316140.0,우리금융지주보통주
19473,316140,2020-03-20,0.1341463414634146,6560,7440,880,4574529,316140.0,우리금융지주보통주
19474,316140,2020-03-19,0.0628571428571428,7000,6560,-440,3761628,316140.0,우리금융지주보통주
19475,316140,2020-03-18,0.042407660738714,7310,7000,-310,3167429,316140.0,우리금융지주보통주
19476,316140,2020-03-17,0.0419397116644823,7630,7310,-320,3269796,316140.0,우리금융지주보통주
19477,316140,2020-03-13,0.0547445255474452,8220,7770,-450,4111531,316140.0,우리금융지주보통주
19478,316140,2020-03-12,0.0408401400233372,8570,8220,-350,4539764,316140.0,우리금융지주보통주
19479,316140,2020-03-09,0.0652173913043478,9200,8600,-600,3813212,316140.0,우리금융지주보통주
19480,316140,2020-02-25,0.0414893617021276,9400,9790,390,2806191,316140.0,우리금융지주보통주
19481,316140,2020-02-24,0.0417940876656473,9810,9400,-410,2931508,316140.0,우리금융지주보통주
19482,316140,2020-01-28,0.0416666666666666,10800,10350,-450,2165380,316140.0,우리금융지주보통주
19483,316140,2020-01-08,0.0405405405405405,11100,10650,-450,2640130,316140.0,우리금융지주보통주
19484,316140,2019-12-27,0.0489795918367346,12250,11650,-600,2953576,316140.0,우리금융지주보통주
19485,316140,2019-10-10,0.0468085106382978,11750,11200,-550,3462956,316140.0,우리금융지주보통주
19486,316140,2019-08-30,0.0577777777777777,11250,11900,650,1603022,316140.0,우리금융지주보통주
19487,316140,2019-08-02,0.0419847328244274,13100,12550,-550,1241170,316140.0,우리금융지주보통주
19488,316140,2019-03-25,0.0462633451957295,14050,13400,-650,3167652,316140.0,우리금융지주보통주
19489,316140,2019-03-22,0.0409556313993174,14650,14050,-600,23513784,316140.0,우리금융지주보통주
19490,316140,2019-02-14,0.0457516339869281,15300,16000,700,2626606,316140.0,우리금융지주보통주
19491,316140,2019-02-14,0.0457516339869281,15300,16000,700,2626606,316140.0,우리금융지주보통주
19492,316140,2019-02-14,0.0457516339869281,15300,16000,700,2626606,316140.0,우리금융지주보통주
19493,316140,2019-02-14,0.0457516339869281,15300,16000,700,2626606,316140.0,우리금융지주보통주
19494,316140,2019-02-14,0.0457516339869281,15300,16000,700,2626606,316140.0,우리금융지주보통주
19495,316140,2019-02-14,0.0457516339869281,15300,16000,700,2626606,316140.0,우리금융지주보통주
19496,316140,2019-02-14,0.0457516339869281,15300,16000,700,2626606,316140.0,우리금융지주보통주
19497,316140,2019-02-14,0.0457516339869281,15300,16000,700,2626606,316140.0,우리금융지주보통주
19498,316140,2019-02-14,0.0457516339869281,15300,16000,700,2626606,316140.0,우리금융지주보통주
19499,316140,2019-02-14,0.0457516339869281,15300,16000,700,2626606,316140.0,우리금융지주보통주
19500,316140,2019-02-14,0.0457516339869281,15300,16000,700,2626606,316140.0,우리금융지주보통주
19501,316140,2019-02-14,0.0457516339869281,15300,16000,700,2626606,316140.0,우리금융지주보통주
19502,316140,2019-02-14,0.0457516339869281,15300,16000,700,2626606,316140.0,우리금융지주보통주
19503,316140,2019-02-14,0.0457516339869281,15300,16000,700,2626606,316140.0,우리금융지주보통주
19504,316140,2019-02-14,0.0457516339869281,15300,16000,700,2626606,316140.0,우리금융지주보통주
19505,316140,2019-02-14,0.0457516339869281,15300,16000,700,2626606,316140.0,우리금융지주보통주
19506,316140,2019-02-14,0.0457516339869281,15300,16000,700,2626606,316140.0,우리금융지주보통주
19507,316140,2019-02-14,0.0457516339869281,15300,16000,700,2626606,316140.0,우리금융지주보통주
19508,316140,2019-02-14,0.0457516339869281,15300,16000,700,2626606,316140.0,우리금융지주보통주
19509,316140,2019-02-14,0.0457516339869281,15300,16000,700,2626606,316140.0,우리금융지주보통주
19510,316140,2019-02-14,0.0457516339869281,15300,16000,700,2626606,316140.0,우리금융지주보통주
19511,316140,2019-02-14,0.0457516339869281,15300,16000,700,2626606,316140.0,우리금융지주보통주
19512,316140,2019-02-14,0.0457516339869281,15300,16000,700,2626606,316140.0,우리금융지주보통주
19513,316140,2019-02-14,0.0457516339869281,15300,16000,700,2626606,316140.0,우리금융지주보통주
19514,316140,2019-02-14,0.0457516339869281,15300,16000,700,2626606,316140.0,우리금융지주보통주
19515,316140,2019-02-14,0.0457516339869281,15300,16000,700,2626606,316140.0,우리금융지주보통주
19516,316140,2019-02-14,0.0457516339869281,15300,16000,700,2626606,316140.0,우리금융지주보통주
19517,316140,2019-02-14,0.0457516339869281,15300,16000,700,2626606,316140.0,우리금융지주보통주
19518,316140,2019-02-14,0.0457516339869281,15300,16000,700,2626606,316140.0,우리금융지주보통주
19519,316140,2019-02-14,0.0457516339869281,15300,16000,700,2626606,316140.0,우리금융지주보통주
19520,316140,2019-02-14,0.0457516339869281,15300,16000,700,2626606,316140.0,우리금융지주보통주
19521,316140,2019-02-14,0.0457516339869281,15300,16000,700,2626606,316140.0,우리금융지주보통주
19522,316140,2019-02-14,0.0457516339869281,15300,16000,700,2626606,316140.0,우리금융지주보통주
19523,316140,2019-02-14,0.0457516339869281,15300,16000,700,2626606,316140.0,우리금융지주보통주
19524,316140,2019-02-14,0.0457516339869281,15300,16000,700,2626606,316140.0,우리금융지주보통주
19525,316140,2019-02-14,0.0457516339869281,15300,16000,700,2626606,316140.0,우리금융지주보통주
19526,316140,2019-02-14,0.0457516339869281,15300,16000,700,2626606,316140.0,우리금융지주보통주
19527,316140,2019-02-14,0.0457516339869281,15300,16000,700,2626606,316140.0,우리금융지주보통주
19528,316140,2019-02-14,0.0457516339869281,15300,16000,700,2626606,316140.0,우리금융지주보통주
19529,316140,2019-02-14,0.0457516339869281,15300,16000,700,2626606,316140.0,우리금융지주보통주
19530,316140,2019-02-14,0.0457516339869281,15300,16000,700,2626606,316140.0,우리금융지주보통주
19531,316140,2019-02-14,0.0457516339869281,15300,16000,700,2626606,316140.0,우리금융지주보통주
19532,316140,2019-02-14,0.0457516339869281,15300,16000,700,2626606,316140.0,우리금융지주보통주
19533,316140,2019-02-14,0.0457516339869281,15300,16000,700,2626606,316140.0,우리금융지주보통주
19534,316140,2019-02-14,0.0457516339869281,15300,16000,700,2626606,316140.0,우리금융지주보통주
19535,316140,2019-02-14,0.0457516339869281,15300,16000,700,2626606,316140.0,우리금융지주보통주
19536,316140,2019-02-14,0.0457516339869281,15300,16000,700,2626606,316140.0,우리금융지주보통주
19537,316140,2019-02-14,0.0457516339869281,15300,16000,700,2626606,316140.0,우리금융지주보통주
19538,316140,2019-02-14,0.0457516339869281,15300,16000,700,2626606,316140.0,우리금융지주보통주
19539,316140,2019-02-14,0.0457516339869281,15300,16000,700,2626606,316140.0,우리금융지주보통주
19540,316140,2019-02-14,0.0457516339869281,15300,16000,700,2626606,316140.0,우리금융지주보통주
19541,316140,2019-02-14,0.0457516339869281,15300,16000,700,2626606,316140.0,우리금융지주보통주
19542,316140,2019-02-14,0.0457516339869281,15300,16000,700,2626606,316140.0,우리금융지주보통주
19543,316140,2019-02-14,0.0457516339869281,15300,16000,700,2626606,316140.0,우리금융지주보통주
19544,316140,2019-02-14,0.0457516339869281,15300,16000,700,2626606,316140.0,우리금융지주보통주
19545,316140,2019-02-14,0.0457516339869281,15300,16000,700,2626606,316140.0,우리금융지주보통주
19546,316140,2019-02-14,0.0457516339869281,15300,16000,700,2626606,316140.0,우리금융지주보통주
19547,316140,2019-02-14,0.0457516339869281,15300,16000,700,2626606,316140.0,우리금융지주보통주
19548,316140,2019-02-14,0.0457516339869281,15300,16000,700,2626606,316140.0,우리금융지주보통주
19549,316140,2019-02-14,0.0457516339869281,15300,16000,700,2626606,316140.0,우리금융지주보통주
19550,316140,2019-02-14,0.0457516339869281,15300,16000,700,2626606,316140.0,우리금융지주보통주
19551,316140,2019-02-14,0.0457516339869281,15300,16000,700,2626606,316140.0,우리금융지주보통주
19552,326030,2021-04-20,0.0484581497797356,113500,119000,5500,727766,326030.0,에스케이바이오팜보통주
19553,326030,2021-03-02,0.0508474576271186,118000,112000,-6000,1558796,326030.0,에스케이바이오팜보통주
19554,326030,2021-02-26,0.0634920634920634,126000,118000,-8000,1993882,326030.0,에스케이바이오팜보통주
19555,326030,2021-02-24,0.1728813559322033,147500,122000,-25500,12426682,326030.0,에스케이바이오팜보통주
19556,326030,2021-01-04,0.0857988165680473,169000,154500,-14500,3338448,326030.0,에스케이바이오팜보통주
19557,326030,2020-12-01,0.0533333333333333,187500,177500,-10000,667685,326030.0,에스케이바이오팜보통주
19558,326030,2020-11-27,0.0501392757660167,179500,188500,9000,911681,326030.0,에스케이바이오팜보통주
19559,326030,2020-11-04,0.0628930817610062,159000,169000,10000,913673,326030.0,에스케이바이오팜보통주
19560,326030,2020-10-21,0.0419354838709677,155000,161500,6500,449038,326030.0,에스케이바이오팜보통주
19561,326030,2020-10-05,0.1022364217252396,156500,140500,-16000,1368552,326030.0,에스케이바이오팜보통주
19562,326030,2020-09-11,0.051490514905149,184500,175000,-9500,827865,326030.0,에스케이바이오팜보통주
19563,326030,2020-09-04,0.0439560439560439,182000,190000,8000,1263233,326030.0,에스케이바이오팜보통주
19564,326030,2020-09-02,0.0614035087719298,171000,181500,10500,1273960,326030.0,에스케이바이오팜보통주
19565,326030,2020-09-01,0.0458715596330275,163500,171000,7500,388140,326030.0,에스케이바이오팜보통주
19566,326030,2020-08-18,0.042016806722689,178500,171000,-7500,429385,326030.0,에스케이바이오팜보통주
19567,326030,2020-08-14,0.0403225806451612,186000,178500,-7500,512876,326030.0,에스케이바이오팜보통주
19568,326030,2020-08-10,0.0754189944134078,179000,192500,13500,1791403,326030.0,에스케이바이오팜보통주
19569,326030,2020-07-17,0.0408719346049046,183500,191000,7500,1109080,326030.0,에스케이바이오팜보통주
19570,326030,2020-07-15,0.0610079575596817,188500,177000,-11500,1859251,326030.0,에스케이바이오팜보통주
19571,326030,2020-07-14,0.0527638190954773,199000,188500,-10500,1389588,326030.0,에스케이바이오팜보통주
19572,326030,2020-07-09,0.0529953917050691,217000,205500,-11500,1897646,326030.0,에스케이바이오팜보통주
19573,326030,2020-07-06,0.3,165000,214500,49500,7126211,326030.0,에스케이바이오팜보통주
19574,326030,2020-07-03,0.2992125984251969,127000,165000,38000,711921,326030.0,에스케이바이오팜보통주
19575,326030,2020-07-02,0.1538461538461538,188500,127000,-61500,698642,326030.0,에스케이바이오팜보통주
19576,326030,2020-07-14,0.0527638190954773,199000,188500,-10500,1389588,326030.0,에스케이바이오팜보통주
19577,326030,2020-07-09,0.0529953917050691,217000,205500,-11500,1897646,326030.0,에스케이바이오팜보통주
19578,326030,2020-07-06,0.3,165000,214500,49500,7126211,326030.0,에스케이바이오팜보통주
19579,326030,2020-07-03,0.2992125984251969,127000,165000,38000,711921,326030.0,에스케이바이오팜보통주
19580,326030,2020-07-02,0.1538461538461538,188500,127000,-61500,698642,326030.0,에스케이바이오팜보통주
19581,326030,2020-07-14,0.0527638190954773,199000,188500,-10500,1389588,326030.0,에스케이바이오팜보통주
19582,326030,2020-07-09,0.0529953917050691,217000,205500,-11500,1897646,326030.0,에스케이바이오팜보통주
19583,326030,2020-07-06,0.3,165000,214500,49500,7126211,326030.0,에스케이바이오팜보통주
19584,326030,2020-07-03,0.2992125984251969,127000,165000,38000,711921,326030.0,에스케이바이오팜보통주
19585,326030,2020-07-02,0.1538461538461538,188500,127000,-61500,698642,326030.0,에스케이바이오팜보통주
19586,326030,2020-07-14,0.0527638190954773,199000,188500,-10500,1389588,326030.0,에스케이바이오팜보통주
19587,326030,2020-07-09,0.0529953917050691,217000,205500,-11500,1897646,326030.0,에스케이바이오팜보통주
19588,326030,2020-07-06,0.3,165000,214500,49500,7126211,326030.0,에스케이바이오팜보통주
19589,326030,2020-07-03,0.2992125984251969,127000,165000,38000,711921,326030.0,에스케이바이오팜보통주
19590,326030,2020-07-02,0.1538461538461538,188500,127000,-61500,698642,326030.0,에스케이바이오팜보통주
19591,326030,2020-07-14,0.0527638190954773,199000,188500,-10500,1389588,326030.0,에스케이바이오팜보통주
19592,326030,2020-07-09,0.0529953917050691,217000,205500,-11500,1897646,326030.0,에스케이바이오팜보통주
19593,326030,2020-07-06,0.3,165000,214500,49500,7126211,326030.0,에스케이바이오팜보통주
19594,326030,2020-07-03,0.2992125984251969,127000,165000,38000,711921,326030.0,에스케이바이오팜보통주
19595,326030,2020-07-02,0.1538461538461538,188500,127000,-61500,698642,326030.0,에스케이바이오팜보통주
19596,326030,2020-07-14,0.0527638190954773,199000,188500,-10500,1389588,326030.0,에스케이바이오팜보통주
19597,326030,2020-07-09,0.0529953917050691,217000,205500,-11500,1897646,326030.0,에스케이바이오팜보통주
19598,326030,2020-07-06,0.3,165000,214500,49500,7126211,326030.0,에스케이바이오팜보통주
19599,326030,2020-07-03,0.2992125984251969,127000,165000,38000,711921,326030.0,에스케이바이오팜보통주
19600,326030,2020-07-02,0.1538461538461538,188500,127000,-61500,698642,326030.0,에스케이바이오팜보통주
19601,326030,2020-07-14,0.0527638190954773,199000,188500,-10500,1389588,326030.0,에스케이바이오팜보통주
19602,326030,2020-07-09,0.0529953917050691,217000,205500,-11500,1897646,326030.0,에스케이바이오팜보통주
19603,326030,2020-07-06,0.3,165000,214500,49500,7126211,326030.0,에스케이바이오팜보통주
19604,326030,2020-07-03,0.2992125984251969,127000,165000,38000,711921,326030.0,에스케이바이오팜보통주
19605,326030,2020-07-02,0.1538461538461538,188500,127000,-61500,698642,326030.0,에스케이바이오팜보통주
19606,326030,2020-07-14,0.0527638190954773,199000,188500,-10500,1389588,326030.0,에스케이바이오팜보통주
19607,326030,2020-07-09,0.0529953917050691,217000,205500,-11500,1897646,326030.0,에스케이바이오팜보통주
19608,326030,2020-07-06,0.3,165000,214500,49500,7126211,326030.0,에스케이바이오팜보통주
19609,326030,2020-07-03,0.2992125984251969,127000,165000,38000,711921,326030.0,에스케이바이오팜보통주
19610,326030,2020-07-02,0.1538461538461538,188500,127000,-61500,698642,326030.0,에스케이바이오팜보통주
19611,326030,2020-07-14,0.0527638190954773,199000,188500,-10500,1389588,326030.0,에스케이바이오팜보통주
19612,326030,2020-07-09,0.0529953917050691,217000,205500,-11500,1897646,326030.0,에스케이바이오팜보통주
19613,326030,2020-07-06,0.3,165000,214500,49500,7126211,326030.0,에스케이바이오팜보통주
19614,326030,2020-07-03,0.2992125984251969,127000,165000,38000,711921,326030.0,에스케이바이오팜보통주
19615,326030,2020-07-02,0.1538461538461538,188500,127000,-61500,698642,326030.0,에스케이바이오팜보통주
19616,326030,2020-07-14,0.0527638190954773,199000,188500,-10500,1389588,326030.0,에스케이바이오팜보통주
19617,326030,2020-07-09,0.0529953917050691,217000,205500,-11500,1897646,326030.0,에스케이바이오팜보통주
19618,326030,2020-07-06,0.3,165000,214500,49500,7126211,326030.0,에스케이바이오팜보통주
19619,326030,2020-07-03,0.2992125984251969,127000,165000,38000,711921,326030.0,에스케이바이오팜보통주
19620,326030,2020-07-02,0.1538461538461538,188500,127000,-61500,698642,326030.0,에스케이바이오팜보통주
19621,326030,2020-07-14,0.0527638190954773,199000,188500,-10500,1389588,326030.0,에스케이바이오팜보통주
19622,326030,2020-07-09,0.0529953917050691,217000,205500,-11500,1897646,326030.0,에스케이바이오팜보통주
19623,326030,2020-07-06,0.3,165000,214500,49500,7126211,326030.0,에스케이바이오팜보통주
19624,326030,2020-07-03,0.2992125984251969,127000,165000,38000,711921,326030.0,에스케이바이오팜보통주
19625,326030,2020-07-02,0.1538461538461538,188500,127000,-61500,698642,326030.0,에스케이바이오팜보통주
19626,326030,2020-07-14,0.0527638190954773,199000,188500,-10500,1389588,326030.0,에스케이바이오팜보통주
19627,326030,2020-07-09,0.0529953917050691,217000,205500,-11500,1897646,326030.0,에스케이바이오팜보통주
19628,326030,2020-07-06,0.3,165000,214500,49500,7126211,326030.0,에스케이바이오팜보통주
19629,326030,2020-07-03,0.2992125984251969,127000,165000,38000,711921,326030.0,에스케이바이오팜보통주
19630,326030,2020-07-02,0.1538461538461538,188500,127000,-61500,698642,326030.0,에스케이바이오팜보통주
19631,326030,2020-07-14,0.0527638190954773,199000,188500,-10500,1389588,326030.0,에스케이바이오팜보통주
19632,326030,2020-07-09,0.0529953917050691,217000,205500,-11500,1897646,326030.0,에스케이바이오팜보통주
19633,326030,2020-07-06,0.3,165000,214500,49500,7126211,326030.0,에스케이바이오팜보통주
19634,326030,2020-07-03,0.2992125984251969,127000,165000,38000,711921,326030.0,에스케이바이오팜보통주
19635,326030,2020-07-02,0.1538461538461538,188500,127000,-61500,698642,326030.0,에스케이바이오팜보통주
19636,326030,2020-07-14,0.0527638190954773,199000,188500,-10500,1389588,326030.0,에스케이바이오팜보통주
19637,326030,2020-07-09,0.0529953917050691,217000,205500,-11500,1897646,326030.0,에스케이바이오팜보통주
19638,326030,2020-07-06,0.3,165000,214500,49500,7126211,326030.0,에스케이바이오팜보통주
19639,326030,2020-07-03,0.2992125984251969,127000,165000,38000,711921,326030.0,에스케이바이오팜보통주
19640,326030,2020-07-02,0.1538461538461538,188500,127000,-61500,698642,326030.0,에스케이바이오팜보통주
19641,326030,2020-07-14,0.0527638190954773,199000,188500,-10500,1389588,326030.0,에스케이바이오팜보통주
19642,326030,2020-07-09,0.0529953917050691,217000,205500,-11500,1897646,326030.0,에스케이바이오팜보통주
19643,326030,2020-07-06,0.3,165000,214500,49500,7126211,326030.0,에스케이바이오팜보통주
19644,326030,2020-07-03,0.2992125984251969,127000,165000,38000,711921,326030.0,에스케이바이오팜보통주
19645,326030,2020-07-02,0.1538461538461538,188500,127000,-61500,698642,326030.0,에스케이바이오팜보통주
19646,326030,2020-07-14,0.0527638190954773,199000,188500,-10500,1389588,326030.0,에스케이바이오팜보통주
19647,326030,2020-07-09,0.0529953917050691,217000,205500,-11500,1897646,326030.0,에스케이바이오팜보통주
19648,326030,2020-07-06,0.3,165000,214500,49500,7126211,326030.0,에스케이바이오팜보통주
19649,326030,2020-07-03,0.2992125984251969,127000,165000,38000,711921,326030.0,에스케이바이오팜보통주
19650,326030,2020-07-02,0.1538461538461538,188500,127000,-61500,698642,326030.0,에스케이바이오팜보통주
19651,326030,2020-07-14,0.0527638190954773,199000,188500,-10500,1389588,326030.0,에스케이바이오팜보통주
19652,326030,2020-07-09,0.0529953917050691,217000,205500,-11500,1897646,326030.0,에스케이바이오팜보통주
19653,326030,2020-07-06,0.3,165000,214500,49500,7126211,326030.0,에스케이바이오팜보통주
19654,326030,2020-07-03,0.2992125984251969,127000,165000,38000,711921,326030.0,에스케이바이오팜보통주
19655,326030,2020-07-02,0.1538461538461538,188500,127000,-61500,698642,326030.0,에스케이바이오팜보통주
19656,326030,2020-07-14,0.0527638190954773,199000,188500,-10500,1389588,326030.0,에스케이바이오팜보통주
19657,326030,2020-07-09,0.0529953917050691,217000,205500,-11500,1897646,326030.0,에스케이바이오팜보통주
19658,326030,2020-07-06,0.3,165000,214500,49500,7126211,326030.0,에스케이바이오팜보통주
19659,326030,2020-07-03,0.2992125984251969,127000,165000,38000,711921,326030.0,에스케이바이오팜보통주
19660,326030,2020-07-02,0.1538461538461538,188500,127000,-61500,698642,326030.0,에스케이바이오팜보통주
19661,326030,2020-07-14,0.0527638190954773,199000,188500,-10500,1389588,326030.0,에스케이바이오팜보통주
19662,326030,2020-07-09,0.0529953917050691,217000,205500,-11500,1897646,326030.0,에스케이바이오팜보통주
19663,326030,2020-07-06,0.3,165000,214500,49500,7126211,326030.0,에스케이바이오팜보통주
19664,326030,2020-07-03,0.2992125984251969,127000,165000,38000,711921,326030.0,에스케이바이오팜보통주
19665,326030,2020-07-02,0.1538461538461538,188500,127000,-61500,698642,326030.0,에스케이바이오팜보통주
19666,326030,2020-07-14,0.0527638190954773,199000,188500,-10500,1389588,326030.0,에스케이바이오팜보통주
19667,326030,2020-07-09,0.0529953917050691,217000,205500,-11500,1897646,326030.0,에스케이바이오팜보통주
19668,326030,2020-07-06,0.3,165000,214500,49500,7126211,326030.0,에스케이바이오팜보통주
19669,326030,2020-07-03,0.2992125984251969,127000,165000,38000,711921,326030.0,에스케이바이오팜보통주
19670,326030,2020-07-02,0.1538461538461538,188500,127000,-61500,698642,326030.0,에스케이바이오팜보통주
19671,326030,2020-07-14,0.0527638190954773,199000,188500,-10500,1389588,326030.0,에스케이바이오팜보통주
19672,326030,2020-07-09,0.0529953917050691,217000,205500,-11500,1897646,326030.0,에스케이바이오팜보통주
19673,326030,2020-07-06,0.3,165000,214500,49500,7126211,326030.0,에스케이바이오팜보통주
19674,326030,2020-07-03,0.2992125984251969,127000,165000,38000,711921,326030.0,에스케이바이오팜보통주
19675,326030,2020-07-02,0.1538461538461538,188500,127000,-61500,698642,326030.0,에스케이바이오팜보통주
19676,326030,2020-07-14,0.0527638190954773,199000,188500,-10500,1389588,326030.0,에스케이바이오팜보통주
19677,326030,2020-07-09,0.0529953917050691,217000,205500,-11500,1897646,326030.0,에스케이바이오팜보통주
19678,326030,2020-07-06,0.3,165000,214500,49500,7126211,326030.0,에스케이바이오팜보통주
19679,326030,2020-07-03,0.2992125984251969,127000,165000,38000,711921,326030.0,에스케이바이오팜보통주
19680,326030,2020-07-02,0.1538461538461538,188500,127000,-61500,698642,326030.0,에스케이바이오팜보통주
19681,326030,2020-07-14,0.0527638190954773,199000,188500,-10500,1389588,326030.0,에스케이바이오팜보통주
19682,326030,2020-07-09,0.0529953917050691,217000,205500,-11500,1897646,326030.0,에스케이바이오팜보통주
19683,326030,2020-07-06,0.3,165000,214500,49500,7126211,326030.0,에스케이바이오팜보통주
19684,326030,2020-07-03,0.2992125984251969,127000,165000,38000,711921,326030.0,에스케이바이오팜보통주
19685,326030,2020-07-02,0.1538461538461538,188500,127000,-61500,698642,326030.0,에스케이바이오팜보통주
19686,326030,2020-07-14,0.0527638190954773,199000,188500,-10500,1389588,326030.0,에스케이바이오팜보통주
19687,326030,2020-07-09,0.0529953917050691,217000,205500,-11500,1897646,326030.0,에스케이바이오팜보통주
19688,326030,2020-07-06,0.3,165000,214500,49500,7126211,326030.0,에스케이바이오팜보통주
19689,326030,2020-07-03,0.2992125984251969,127000,165000,38000,711921,326030.0,에스케이바이오팜보통주
19690,326030,2020-07-02,0.1538461538461538,188500,127000,-61500,698642,326030.0,에스케이바이오팜보통주
19691,326030,2020-07-14,0.0527638190954773,199000,188500,-10500,1389588,326030.0,에스케이바이오팜보통주
19692,326030,2020-07-09,0.0529953917050691,217000,205500,-11500,1897646,326030.0,에스케이바이오팜보통주
19693,326030,2020-07-06,0.3,165000,214500,49500,7126211,326030.0,에스케이바이오팜보통주
19694,326030,2020-07-03,0.2992125984251969,127000,165000,38000,711921,326030.0,에스케이바이오팜보통주
19695,326030,2020-07-02,0.1538461538461538,188500,127000,-61500,698642,326030.0,에스케이바이오팜보통주
19696,326030,2020-07-14,0.0527638190954773,199000,188500,-10500,1389588,326030.0,에스케이바이오팜보통주
19697,326030,2020-07-09,0.0529953917050691,217000,205500,-11500,1897646,326030.0,에스케이바이오팜보통주
19698,326030,2020-07-06,0.3,165000,214500,49500,7126211,326030.0,에스케이바이오팜보통주
19699,326030,2020-07-03,0.2992125984251969,127000,165000,38000,711921,326030.0,에스케이바이오팜보통주
19700,326030,2020-07-02,0.1538461538461538,188500,127000,-61500,698642,326030.0,에스케이바이오팜보통주
19701,326030,2020-07-14,0.0527638190954773,199000,188500,-10500,1389588,326030.0,에스케이바이오팜보통주
19702,326030,2020-07-09,0.0529953917050691,217000,205500,-11500,1897646,326030.0,에스케이바이오팜보통주
19703,326030,2020-07-06,0.3,165000,214500,49500,7126211,326030.0,에스케이바이오팜보통주
19704,326030,2020-07-03,0.2992125984251969,127000,165000,38000,711921,326030.0,에스케이바이오팜보통주
19705,326030,2020-07-02,0.1538461538461538,188500,127000,-61500,698642,326030.0,에스케이바이오팜보통주
19706,326030,2020-07-14,0.0527638190954773,199000,188500,-10500,1389588,326030.0,에스케이바이오팜보통주
19707,326030,2020-07-09,0.0529953917050691,217000,205500,-11500,1897646,326030.0,에스케이바이오팜보통주
19708,326030,2020-07-06,0.3,165000,214500,49500,7126211,326030.0,에스케이바이오팜보통주
19709,326030,2020-07-03,0.2992125984251969,127000,165000,38000,711921,326030.0,에스케이바이오팜보통주
19710,326030,2020-07-02,0.1538461538461538,188500,127000,-61500,698642,326030.0,에스케이바이오팜보통주
19711,326030,2020-07-14,0.0527638190954773,199000,188500,-10500,1389588,326030.0,에스케이바이오팜보통주
19712,326030,2020-07-09,0.0529953917050691,217000,205500,-11500,1897646,326030.0,에스케이바이오팜보통주
19713,326030,2020-07-06,0.3,165000,214500,49500,7126211,326030.0,에스케이바이오팜보통주
19714,326030,2020-07-03,0.2992125984251969,127000,165000,38000,711921,326030.0,에스케이바이오팜보통주
19715,326030,2020-07-02,0.1538461538461538,188500,127000,-61500,698642,326030.0,에스케이바이오팜보통주
19716,326030,2020-07-14,0.0527638190954773,199000,188500,-10500,1389588,326030.0,에스케이바이오팜보통주
19717,326030,2020-07-09,0.0529953917050691,217000,205500,-11500,1897646,326030.0,에스케이바이오팜보통주
19718,326030,2020-07-06,0.3,165000,214500,49500,7126211,326030.0,에스케이바이오팜보통주
19719,326030,2020-07-03,0.2992125984251969,127000,165000,38000,711921,326030.0,에스케이바이오팜보통주
19720,326030,2020-07-02,0.1538461538461538,188500,127000,-61500,698642,326030.0,에스케이바이오팜보통주
19721,326030,2020-07-14,0.0527638190954773,199000,188500,-10500,1389588,326030.0,에스케이바이오팜보통주
19722,326030,2020-07-09,0.0529953917050691,217000,205500,-11500,1897646,326030.0,에스케이바이오팜보통주
19723,326030,2020-07-06,0.3,165000,214500,49500,7126211,326030.0,에스케이바이오팜보통주
19724,326030,2020-07-03,0.2992125984251969,127000,165000,38000,711921,326030.0,에스케이바이오팜보통주
19725,326030,2020-07-02,0.1538461538461538,188500,127000,-61500,698642,326030.0,에스케이바이오팜보통주
19726,326030,2020-07-14,0.0527638190954773,199000,188500,-10500,1389588,326030.0,에스케이바이오팜보통주
19727,326030,2020-07-09,0.0529953917050691,217000,205500,-11500,1897646,326030.0,에스케이바이오팜보통주
19728,326030,2020-07-06,0.3,165000,214500,49500,7126211,326030.0,에스케이바이오팜보통주
19729,326030,2020-07-03,0.2992125984251969,127000,165000,38000,711921,326030.0,에스케이바이오팜보통주
19730,326030,2020-07-02,0.1538461538461538,188500,127000,-61500,698642,326030.0,에스케이바이오팜보통주
19731,326030,2020-07-14,0.0527638190954773,199000,188500,-10500,1389588,326030.0,에스케이바이오팜보통주
19732,326030,2020-07-09,0.0529953917050691,217000,205500,-11500,1897646,326030.0,에스케이바이오팜보통주
19733,326030,2020-07-06,0.3,165000,214500,49500,7126211,326030.0,에스케이바이오팜보통주
19734,326030,2020-07-03,0.2992125984251969,127000,165000,38000,711921,326030.0,에스케이바이오팜보통주
19735,326030,2020-07-02,0.1538461538461538,188500,127000,-61500,698642,326030.0,에스케이바이오팜보통주
19736,326030,2020-07-14,0.0527638190954773,199000,188500,-10500,1389588,326030.0,에스케이바이오팜보통주
19737,326030,2020-07-09,0.0529953917050691,217000,205500,-11500,1897646,326030.0,에스케이바이오팜보통주
19738,326030,2020-07-06,0.3,165000,214500,49500,7126211,326030.0,에스케이바이오팜보통주
19739,326030,2020-07-03,0.2992125984251969,127000,165000,38000,711921,326030.0,에스케이바이오팜보통주
19740,326030,2020-07-02,0.1538461538461538,188500,127000,-61500,698642,326030.0,에스케이바이오팜보통주
19741,326030,2020-07-14,0.0527638190954773,199000,188500,-10500,1389588,326030.0,에스케이바이오팜보통주
19742,326030,2020-07-09,0.0529953917050691,217000,205500,-11500,1897646,326030.0,에스케이바이오팜보통주
19743,326030,2020-07-06,0.3,165000,214500,49500,7126211,326030.0,에스케이바이오팜보통주
19744,326030,2020-07-03,0.2992125984251969,127000,165000,38000,711921,326030.0,에스케이바이오팜보통주
19745,326030,2020-07-02,0.1538461538461538,188500,127000,-61500,698642,326030.0,에스케이바이오팜보통주
19746,326030,2020-07-14,0.0527638190954773,199000,188500,-10500,1389588,326030.0,에스케이바이오팜보통주
19747,326030,2020-07-09,0.0529953917050691,217000,205500,-11500,1897646,326030.0,에스케이바이오팜보통주
19748,326030,2020-07-06,0.3,165000,214500,49500,7126211,326030.0,에스케이바이오팜보통주
19749,326030,2020-07-03,0.2992125984251969,127000,165000,38000,711921,326030.0,에스케이바이오팜보통주
19750,326030,2020-07-02,0.1538461538461538,188500,127000,-61500,698642,326030.0,에스케이바이오팜보통주
19751,326030,2020-07-14,0.0527638190954773,199000,188500,-10500,1389588,326030.0,에스케이바이오팜보통주
19752,326030,2020-07-09,0.0529953917050691,217000,205500,-11500,1897646,326030.0,에스케이바이오팜보통주
19753,326030,2020-07-06,0.3,165000,214500,49500,7126211,326030.0,에스케이바이오팜보통주
19754,326030,2020-07-03,0.2992125984251969,127000,165000,38000,711921,326030.0,에스케이바이오팜보통주
19755,326030,2020-07-02,0.1538461538461538,188500,127000,-61500,698642,326030.0,에스케이바이오팜보통주
19756,326030,2020-07-14,0.0527638190954773,199000,188500,-10500,1389588,326030.0,에스케이바이오팜보통주
19757,326030,2020-07-09,0.0529953917050691,217000,205500,-11500,1897646,326030.0,에스케이바이오팜보통주
19758,326030,2020-07-06,0.3,165000,214500,49500,7126211,326030.0,에스케이바이오팜보통주
19759,326030,2020-07-03,0.2992125984251969,127000,165000,38000,711921,326030.0,에스케이바이오팜보통주
19760,326030,2020-07-02,0.1538461538461538,188500,127000,-61500,698642,326030.0,에스케이바이오팜보통주
19761,326030,2020-07-14,0.0527638190954773,199000,188500,-10500,1389588,326030.0,에스케이바이오팜보통주
19762,326030,2020-07-09,0.0529953917050691,217000,205500,-11500,1897646,326030.0,에스케이바이오팜보통주
19763,326030,2020-07-06,0.3,165000,214500,49500,7126211,326030.0,에스케이바이오팜보통주
19764,326030,2020-07-03,0.2992125984251969,127000,165000,38000,711921,326030.0,에스케이바이오팜보통주
19765,326030,2020-07-02,0.1538461538461538,188500,127000,-61500,698642,326030.0,에스케이바이오팜보통주
19766,326030,2020-07-14,0.0527638190954773,199000,188500,-10500,1389588,326030.0,에스케이바이오팜보통주
19767,326030,2020-07-09,0.0529953917050691,217000,205500,-11500,1897646,326030.0,에스케이바이오팜보통주
19768,326030,2020-07-06,0.3,165000,214500,49500,7126211,326030.0,에스케이바이오팜보통주
19769,326030,2020-07-03,0.2992125984251969,127000,165000,38000,711921,326030.0,에스케이바이오팜보통주
19770,326030,2020-07-02,0.1538461538461538,188500,127000,-61500,698642,326030.0,에스케이바이오팜보통주
19771,326030,2020-07-14,0.0527638190954773,199000,188500,-10500,1389588,326030.0,에스케이바이오팜보통주
19772,326030,2020-07-09,0.0529953917050691,217000,205500,-11500,1897646,326030.0,에스케이바이오팜보통주
19773,326030,2020-07-06,0.3,165000,214500,49500,7126211,326030.0,에스케이바이오팜보통주
19774,326030,2020-07-03,0.2992125984251969,127000,165000,38000,711921,326030.0,에스케이바이오팜보통주
19775,326030,2020-07-02,0.1538461538461538,188500,127000,-61500,698642,326030.0,에스케이바이오팜보통주
19776,326030,2020-07-14,0.0527638190954773,199000,188500,-10500,1389588,326030.0,에스케이바이오팜보통주
19777,326030,2020-07-09,0.0529953917050691,217000,205500,-11500,1897646,326030.0,에스케이바이오팜보통주
19778,326030,2020-07-06,0.3,165000,214500,49500,7126211,326030.0,에스케이바이오팜보통주
19779,326030,2020-07-03,0.2992125984251969,127000,165000,38000,711921,326030.0,에스케이바이오팜보통주
19780,326030,2020-07-02,0.1538461538461538,188500,127000,-61500,698642,326030.0,에스케이바이오팜보통주
19781,326030,2020-07-14,0.0527638190954773,199000,188500,-10500,1389588,326030.0,에스케이바이오팜보통주
19782,326030,2020-07-09,0.0529953917050691,217000,205500,-11500,1897646,326030.0,에스케이바이오팜보통주
19783,326030,2020-07-06,0.3,165000,214500,49500,7126211,326030.0,에스케이바이오팜보통주
19784,326030,2020-07-03,0.2992125984251969,127000,165000,38000,711921,326030.0,에스케이바이오팜보통주
19785,326030,2020-07-02,0.1538461538461538,188500,127000,-61500,698642,326030.0,에스케이바이오팜보통주
19786,326030,2020-07-14,0.0527638190954773,199000,188500,-10500,1389588,326030.0,에스케이바이오팜보통주
19787,326030,2020-07-09,0.0529953917050691,217000,205500,-11500,1897646,326030.0,에스케이바이오팜보통주
19788,326030,2020-07-06,0.3,165000,214500,49500,7126211,326030.0,에스케이바이오팜보통주
19789,326030,2020-07-03,0.2992125984251969,127000,165000,38000,711921,326030.0,에스케이바이오팜보통주
19790,326030,2020-07-02,0.1538461538461538,188500,127000,-61500,698642,326030.0,에스케이바이오팜보통주
19791,326030,2020-07-14,0.0527638190954773,199000,188500,-10500,1389588,326030.0,에스케이바이오팜보통주
19792,326030,2020-07-09,0.0529953917050691,217000,205500,-11500,1897646,326030.0,에스케이바이오팜보통주
19793,326030,2020-07-06,0.3,165000,214500,49500,7126211,326030.0,에스케이바이오팜보통주
19794,326030,2020-07-03,0.2992125984251969,127000,165000,38000,711921,326030.0,에스케이바이오팜보통주
19795,326030,2020-07-02,0.1538461538461538,188500,127000,-61500,698642,326030.0,에스케이바이오팜보통주
19796,326030,2020-07-14,0.0527638190954773,199000,188500,-10500,1389588,326030.0,에스케이바이오팜보통주
19797,326030,2020-07-09,0.0529953917050691,217000,205500,-11500,1897646,326030.0,에스케이바이오팜보통주
19798,326030,2020-07-06,0.3,165000,214500,49500,7126211,326030.0,에스케이바이오팜보통주
19799,326030,2020-07-03,0.2992125984251969,127000,165000,38000,711921,326030.0,에스케이바이오팜보통주
19800,326030,2020-07-02,0.1538461538461538,188500,127000,-61500,698642,326030.0,에스케이바이오팜보통주
19801,326030,2020-07-14,0.0527638190954773,199000,188500,-10500,1389588,326030.0,에스케이바이오팜보통주
19802,326030,2020-07-09,0.0529953917050691,217000,205500,-11500,1897646,326030.0,에스케이바이오팜보통주
19803,326030,2020-07-06,0.3,165000,214500,49500,7126211,326030.0,에스케이바이오팜보통주
19804,326030,2020-07-03,0.2992125984251969,127000,165000,38000,711921,326030.0,에스케이바이오팜보통주
19805,326030,2020-07-02,0.1538461538461538,188500,127000,-61500,698642,326030.0,에스케이바이오팜보통주
19806,326030,2020-07-14,0.0527638190954773,199000,188500,-10500,1389588,326030.0,에스케이바이오팜보통주
19807,326030,2020-07-09,0.0529953917050691,217000,205500,-11500,1897646,326030.0,에스케이바이오팜보통주
19808,326030,2020-07-06,0.3,165000,214500,49500,7126211,326030.0,에스케이바이오팜보통주
19809,326030,2020-07-03,0.2992125984251969,127000,165000,38000,711921,326030.0,에스케이바이오팜보통주
19810,326030,2020-07-02,0.1538461538461538,188500,127000,-61500,698642,326030.0,에스케이바이오팜보통주
19811,326030,2020-07-14,0.0527638190954773,199000,188500,-10500,1389588,326030.0,에스케이바이오팜보통주
19812,326030,2020-07-09,0.0529953917050691,217000,205500,-11500,1897646,326030.0,에스케이바이오팜보통주
19813,326030,2020-07-06,0.3,165000,214500,49500,7126211,326030.0,에스케이바이오팜보통주
19814,326030,2020-07-03,0.2992125984251969,127000,165000,38000,711921,326030.0,에스케이바이오팜보통주
19815,326030,2020-07-02,0.1538461538461538,188500,127000,-61500,698642,326030.0,에스케이바이오팜보통주
19816,326030,2020-07-14,0.0527638190954773,199000,188500,-10500,1389588,326030.0,에스케이바이오팜보통주
19817,326030,2020-07-09,0.0529953917050691,217000,205500,-11500,1897646,326030.0,에스케이바이오팜보통주
19818,326030,2020-07-06,0.3,165000,214500,49500,7126211,326030.0,에스케이바이오팜보통주
19819,326030,2020-07-03,0.2992125984251969,127000,165000,38000,711921,326030.0,에스케이바이오팜보통주
19820,326030,2020-07-02,0.1538461538461538,188500,127000,-61500,698642,326030.0,에스케이바이오팜보통주
19821,326030,2020-07-14,0.0527638190954773,199000,188500,-10500,1389588,326030.0,에스케이바이오팜보통주
19822,326030,2020-07-09,0.0529953917050691,217000,205500,-11500,1897646,326030.0,에스케이바이오팜보통주
19823,326030,2020-07-06,0.3,165000,214500,49500,7126211,326030.0,에스케이바이오팜보통주
19824,326030,2020-07-03,0.2992125984251969,127000,165000,38000,711921,326030.0,에스케이바이오팜보통주
19825,326030,2020-07-02,0.1538461538461538,188500,127000,-61500,698642,326030.0,에스케이바이오팜보통주
19826,326030,2020-07-14,0.0527638190954773,199000,188500,-10500,1389588,326030.0,에스케이바이오팜보통주
19827,326030,2020-07-09,0.0529953917050691,217000,205500,-11500,1897646,326030.0,에스케이바이오팜보통주
19828,326030,2020-07-06,0.3,165000,214500,49500,7126211,326030.0,에스케이바이오팜보통주
19829,326030,2020-07-03,0.2992125984251969,127000,165000,38000,711921,326030.0,에스케이바이오팜보통주
19830,326030,2020-07-02,0.1538461538461538,188500,127000,-61500,698642,326030.0,에스케이바이오팜보통주
19831,326030,2020-07-14,0.0527638190954773,199000,188500,-10500,1389588,326030.0,에스케이바이오팜보통주
19832,326030,2020-07-09,0.0529953917050691,217000,205500,-11500,1897646,326030.0,에스케이바이오팜보통주
19833,326030,2020-07-06,0.3,165000,214500,49500,7126211,326030.0,에스케이바이오팜보통주
19834,326030,2020-07-03,0.2992125984251969,127000,165000,38000,711921,326030.0,에스케이바이오팜보통주
19835,326030,2020-07-02,0.1538461538461538,188500,127000,-61500,698642,326030.0,에스케이바이오팜보통주
19836,326030,2020-07-14,0.0527638190954773,199000,188500,-10500,1389588,326030.0,에스케이바이오팜보통주
19837,326030,2020-07-09,0.0529953917050691,217000,205500,-11500,1897646,326030.0,에스케이바이오팜보통주
19838,326030,2020-07-06,0.3,165000,214500,49500,7126211,326030.0,에스케이바이오팜보통주
19839,326030,2020-07-03,0.2992125984251969,127000,165000,38000,711921,326030.0,에스케이바이오팜보통주
19840,326030,2020-07-02,0.1538461538461538,188500,127000,-61500,698642,326030.0,에스케이바이오팜보통주
19841,326030,2020-07-14,0.0527638190954773,199000,188500,-10500,1389588,326030.0,에스케이바이오팜보통주
19842,326030,2020-07-09,0.0529953917050691,217000,205500,-11500,1897646,326030.0,에스케이바이오팜보통주
19843,326030,2020-07-06,0.3,165000,214500,49500,7126211,326030.0,에스케이바이오팜보통주
19844,326030,2020-07-03,0.2992125984251969,127000,165000,38000,711921,326030.0,에스케이바이오팜보통주
19845,326030,2020-07-02,0.1538461538461538,188500,127000,-61500,698642,326030.0,에스케이바이오팜보통주
19846,326030,2020-07-14,0.0527638190954773,199000,188500,-10500,1389588,326030.0,에스케이바이오팜보통주
19847,326030,2020-07-09,0.0529953917050691,217000,205500,-11500,1897646,326030.0,에스케이바이오팜보통주
19848,326030,2020-07-06,0.3,165000,214500,49500,7126211,326030.0,에스케이바이오팜보통주
19849,326030,2020-07-03,0.2992125984251969,127000,165000,38000,711921,326030.0,에스케이바이오팜보통주
19850,326030,2020-07-02,0.1538461538461538,188500,127000,-61500,698642,326030.0,에스케이바이오팜보통주
19851,326030,2020-07-14,0.0527638190954773,199000,188500,-10500,1389588,326030.0,에스케이바이오팜보통주
19852,326030,2020-07-09,0.0529953917050691,217000,205500,-11500,1897646,326030.0,에스케이바이오팜보통주
19853,326030,2020-07-06,0.3,165000,214500,49500,7126211,326030.0,에스케이바이오팜보통주
19854,326030,2020-07-03,0.2992125984251969,127000,165000,38000,711921,326030.0,에스케이바이오팜보통주
19855,326030,2020-07-02,0.1538461538461538,188500,127000,-61500,698642,326030.0,에스케이바이오팜보통주
19856,326030,2020-07-14,0.0527638190954773,199000,188500,-10500,1389588,326030.0,에스케이바이오팜보통주
19857,326030,2020-07-09,0.0529953917050691,217000,205500,-11500,1897646,326030.0,에스케이바이오팜보통주
19858,326030,2020-07-06,0.3,165000,214500,49500,7126211,326030.0,에스케이바이오팜보통주
19859,326030,2020-07-03,0.2992125984251969,127000,165000,38000,711921,326030.0,에스케이바이오팜보통주
19860,326030,2020-07-02,0.1538461538461538,188500,127000,-61500,698642,326030.0,에스케이바이오팜보통주
19861,326030,2020-07-14,0.0527638190954773,199000,188500,-10500,1389588,326030.0,에스케이바이오팜보통주
19862,326030,2020-07-09,0.0529953917050691,217000,205500,-11500,1897646,326030.0,에스케이바이오팜보통주
19863,326030,2020-07-06,0.3,165000,214500,49500,7126211,326030.0,에스케이바이오팜보통주
19864,326030,2020-07-03,0.2992125984251969,127000,165000,38000,711921,326030.0,에스케이바이오팜보통주
19865,326030,2020-07-02,0.1538461538461538,188500,127000,-61500,698642,326030.0,에스케이바이오팜보통주
19866,326030,2020-07-14,0.0527638190954773,199000,188500,-10500,1389588,326030.0,에스케이바이오팜보통주
19867,326030,2020-07-09,0.0529953917050691,217000,205500,-11500,1897646,326030.0,에스케이바이오팜보통주
19868,326030,2020-07-06,0.3,165000,214500,49500,7126211,326030.0,에스케이바이오팜보통주
19869,326030,2020-07-03,0.2992125984251969,127000,165000,38000,711921,326030.0,에스케이바이오팜보통주
19870,326030,2020-07-02,0.1538461538461538,188500,127000,-61500,698642,326030.0,에스케이바이오팜보통주
19871,326030,2020-07-14,0.0527638190954773,199000,188500,-10500,1389588,326030.0,에스케이바이오팜보통주
19872,326030,2020-07-09,0.0529953917050691,217000,205500,-11500,1897646,326030.0,에스케이바이오팜보통주
19873,326030,2020-07-06,0.3,165000,214500,49500,7126211,326030.0,에스케이바이오팜보통주
19874,326030,2020-07-03,0.2992125984251969,127000,165000,38000,711921,326030.0,에스케이바이오팜보통주
19875,326030,2020-07-02,0.1538461538461538,188500,127000,-61500,698642,326030.0,에스케이바이오팜보통주
19876,326030,2020-07-14,0.0527638190954773,199000,188500,-10500,1389588,326030.0,에스케이바이오팜보통주
19877,326030,2020-07-09,0.0529953917050691,217000,205500,-11500,1897646,326030.0,에스케이바이오팜보통주
19878,326030,2020-07-06,0.3,165000,214500,49500,7126211,326030.0,에스케이바이오팜보통주
19879,326030,2020-07-03,0.2992125984251969,127000,165000,38000,711921,326030.0,에스케이바이오팜보통주
19880,326030,2020-07-02,0.1538461538461538,188500,127000,-61500,698642,326030.0,에스케이바이오팜보통주
19881,326030,2020-07-14,0.0527638190954773,199000,188500,-10500,1389588,326030.0,에스케이바이오팜보통주
19882,326030,2020-07-09,0.0529953917050691,217000,205500,-11500,1897646,326030.0,에스케이바이오팜보통주
19883,326030,2020-07-06,0.3,165000,214500,49500,7126211,326030.0,에스케이바이오팜보통주
19884,326030,2020-07-03,0.2992125984251969,127000,165000,38000,711921,326030.0,에스케이바이오팜보통주
19885,326030,2020-07-02,0.1538461538461538,188500,127000,-61500,698642,326030.0,에스케이바이오팜보통주
19886,326030,2020-07-14,0.0527638190954773,199000,188500,-10500,1389588,326030.0,에스케이바이오팜보통주
19887,326030,2020-07-09,0.0529953917050691,217000,205500,-11500,1897646,326030.0,에스케이바이오팜보통주
19888,326030,2020-07-06,0.3,165000,214500,49500,7126211,326030.0,에스케이바이오팜보통주
19889,326030,2020-07-03,0.2992125984251969,127000,165000,38000,711921,326030.0,에스케이바이오팜보통주
19890,326030,2020-07-02,0.1538461538461538,188500,127000,-61500,698642,326030.0,에스케이바이오팜보통주
19891,326030,2020-07-14,0.0527638190954773,199000,188500,-10500,1389588,326030.0,에스케이바이오팜보통주
19892,326030,2020-07-09,0.0529953917050691,217000,205500,-11500,1897646,326030.0,에스케이바이오팜보통주
19893,326030,2020-07-06,0.3,165000,214500,49500,7126211,326030.0,에스케이바이오팜보통주
19894,326030,2020-07-03,0.2992125984251969,127000,165000,38000,711921,326030.0,에스케이바이오팜보통주
19895,326030,2020-07-02,0.1538461538461538,188500,127000,-61500,698642,326030.0,에스케이바이오팜보통주
19896,326030,2020-07-14,0.0527638190954773,199000,188500,-10500,1389588,326030.0,에스케이바이오팜보통주
19897,326030,2020-07-09,0.0529953917050691,217000,205500,-11500,1897646,326030.0,에스케이바이오팜보통주
19898,326030,2020-07-06,0.3,165000,214500,49500,7126211,326030.0,에스케이바이오팜보통주
19899,326030,2020-07-03,0.2992125984251969,127000,165000,38000,711921,326030.0,에스케이바이오팜보통주
19900,326030,2020-07-02,0.1538461538461538,188500,127000,-61500,698642,326030.0,에스케이바이오팜보통주
19901,326030,2020-07-14,0.0527638190954773,199000,188500,-10500,1389588,326030.0,에스케이바이오팜보통주
19902,326030,2020-07-09,0.0529953917050691,217000,205500,-11500,1897646,326030.0,에스케이바이오팜보통주
19903,326030,2020-07-06,0.3,165000,214500,49500,7126211,326030.0,에스케이바이오팜보통주
19904,326030,2020-07-03,0.2992125984251969,127000,165000,38000,711921,326030.0,에스케이바이오팜보통주
19905,326030,2020-07-02,0.1538461538461538,188500,127000,-61500,698642,326030.0,에스케이바이오팜보통주
19906,326030,2020-07-14,0.0527638190954773,199000,188500,-10500,1389588,326030.0,에스케이바이오팜보통주
19907,326030,2020-07-09,0.0529953917050691,217000,205500,-11500,1897646,326030.0,에스케이바이오팜보통주
19908,326030,2020-07-06,0.3,165000,214500,49500,7126211,326030.0,에스케이바이오팜보통주
19909,326030,2020-07-03,0.2992125984251969,127000,165000,38000,711921,326030.0,에스케이바이오팜보통주
19910,326030,2020-07-02,0.1538461538461538,188500,127000,-61500,698642,326030.0,에스케이바이오팜보통주
19911,326030,2020-07-14,0.0527638190954773,199000,188500,-10500,1389588,326030.0,에스케이바이오팜보통주
19912,326030,2020-07-09,0.0529953917050691,217000,205500,-11500,1897646,326030.0,에스케이바이오팜보통주
19913,326030,2020-07-06,0.3,165000,214500,49500,7126211,326030.0,에스케이바이오팜보통주
19914,326030,2020-07-03,0.2992125984251969,127000,165000,38000,711921,326030.0,에스케이바이오팜보통주
19915,326030,2020-07-02,0.1538461538461538,188500,127000,-61500,698642,326030.0,에스케이바이오팜보통주
19916,326030,2020-07-14,0.0527638190954773,199000,188500,-10500,1389588,326030.0,에스케이바이오팜보통주
19917,326030,2020-07-09,0.0529953917050691,217000,205500,-11500,1897646,326030.0,에스케이바이오팜보통주
19918,326030,2020-07-06,0.3,165000,214500,49500,7126211,326030.0,에스케이바이오팜보통주
19919,326030,2020-07-03,0.2992125984251969,127000,165000,38000,711921,326030.0,에스케이바이오팜보통주
19920,326030,2020-07-02,0.1538461538461538,188500,127000,-61500,698642,326030.0,에스케이바이오팜보통주
19921,326030,2020-07-14,0.0527638190954773,199000,188500,-10500,1389588,326030.0,에스케이바이오팜보통주
19922,326030,2020-07-09,0.0529953917050691,217000,205500,-11500,1897646,326030.0,에스케이바이오팜보통주
19923,326030,2020-07-06,0.3,165000,214500,49500,7126211,326030.0,에스케이바이오팜보통주
19924,326030,2020-07-03,0.2992125984251969,127000,165000,38000,711921,326030.0,에스케이바이오팜보통주
19925,326030,2020-07-02,0.1538461538461538,188500,127000,-61500,698642,326030.0,에스케이바이오팜보통주
19926,326030,2020-07-14,0.0527638190954773,199000,188500,-10500,1389588,326030.0,에스케이바이오팜보통주
19927,326030,2020-07-09,0.0529953917050691,217000,205500,-11500,1897646,326030.0,에스케이바이오팜보통주
19928,326030,2020-07-06,0.3,165000,214500,49500,7126211,326030.0,에스케이바이오팜보통주
19929,326030,2020-07-03,0.2992125984251969,127000,165000,38000,711921,326030.0,에스케이바이오팜보통주
19930,326030,2020-07-02,0.1538461538461538,188500,127000,-61500,698642,326030.0,에스케이바이오팜보통주
19931,326030,2020-07-14,0.0527638190954773,199000,188500,-10500,1389588,326030.0,에스케이바이오팜보통주
19932,326030,2020-07-09,0.0529953917050691,217000,205500,-11500,1897646,326030.0,에스케이바이오팜보통주
19933,326030,2020-07-06,0.3,165000,214500,49500,7126211,326030.0,에스케이바이오팜보통주
19934,326030,2020-07-03,0.2992125984251969,127000,165000,38000,711921,326030.0,에스케이바이오팜보통주
19935,326030,2020-07-02,0.1538461538461538,188500,127000,-61500,698642,326030.0,에스케이바이오팜보통주
19936,326030,2020-07-14,0.0527638190954773,199000,188500,-10500,1389588,326030.0,에스케이바이오팜보통주
19937,326030,2020-07-09,0.0529953917050691,217000,205500,-11500,1897646,326030.0,에스케이바이오팜보통주
19938,326030,2020-07-06,0.3,165000,214500,49500,7126211,326030.0,에스케이바이오팜보통주
19939,326030,2020-07-03,0.2992125984251969,127000,165000,38000,711921,326030.0,에스케이바이오팜보통주
19940,326030,2020-07-02,0.1538461538461538,188500,127000,-61500,698642,326030.0,에스케이바이오팜보통주
19941,326030,2020-07-14,0.0527638190954773,199000,188500,-10500,1389588,326030.0,에스케이바이오팜보통주
19942,326030,2020-07-09,0.0529953917050691,217000,205500,-11500,1897646,326030.0,에스케이바이오팜보통주
19943,326030,2020-07-06,0.3,165000,214500,49500,7126211,326030.0,에스케이바이오팜보통주
19944,326030,2020-07-03,0.2992125984251969,127000,165000,38000,711921,326030.0,에스케이바이오팜보통주
19945,326030,2020-07-02,0.1538461538461538,188500,127000,-61500,698642,326030.0,에스케이바이오팜보통주
19946,326030,2020-07-14,0.0527638190954773,199000,188500,-10500,1389588,326030.0,에스케이바이오팜보통주
19947,326030,2020-07-09,0.0529953917050691,217000,205500,-11500,1897646,326030.0,에스케이바이오팜보통주
19948,326030,2020-07-06,0.3,165000,214500,49500,7126211,326030.0,에스케이바이오팜보통주
19949,326030,2020-07-03,0.2992125984251969,127000,165000,38000,711921,326030.0,에스케이바이오팜보통주
19950,326030,2020-07-02,0.1538461538461538,188500,127000,-61500,698642,326030.0,에스케이바이오팜보통주
19951,326030,2020-07-14,0.0527638190954773,199000,188500,-10500,1389588,326030.0,에스케이바이오팜보통주
19952,326030,2020-07-09,0.0529953917050691,217000,205500,-11500,1897646,326030.0,에스케이바이오팜보통주
19953,326030,2020-07-06,0.3,165000,214500,49500,7126211,326030.0,에스케이바이오팜보통주
19954,326030,2020-07-03,0.2992125984251969,127000,165000,38000,711921,326030.0,에스케이바이오팜보통주
19955,326030,2020-07-02,0.1538461538461538,188500,127000,-61500,698642,326030.0,에스케이바이오팜보통주
19956,326030,2020-07-14,0.0527638190954773,199000,188500,-10500,1389588,326030.0,에스케이바이오팜보통주
19957,326030,2020-07-09,0.0529953917050691,217000,205500,-11500,1897646,326030.0,에스케이바이오팜보통주
19958,326030,2020-07-06,0.3,165000,214500,49500,7126211,326030.0,에스케이바이오팜보통주
19959,326030,2020-07-03,0.2992125984251969,127000,165000,38000,711921,326030.0,에스케이바이오팜보통주
19960,326030,2020-07-02,0.1538461538461538,188500,127000,-61500,698642,326030.0,에스케이바이오팜보통주
19961,326030,2020-07-14,0.0527638190954773,199000,188500,-10500,1389588,326030.0,에스케이바이오팜보통주
19962,326030,2020-07-09,0.0529953917050691,217000,205500,-11500,1897646,326030.0,에스케이바이오팜보통주
19963,326030,2020-07-06,0.3,165000,214500,49500,7126211,326030.0,에스케이바이오팜보통주
19964,326030,2020-07-03,0.2992125984251969,127000,165000,38000,711921,326030.0,에스케이바이오팜보통주
19965,326030,2020-07-02,0.1538461538461538,188500,127000,-61500,698642,326030.0,에스케이바이오팜보통주
19966,326030,2020-07-14,0.0527638190954773,199000,188500,-10500,1389588,326030.0,에스케이바이오팜보통주
19967,326030,2020-07-09,0.0529953917050691,217000,205500,-11500,1897646,326030.0,에스케이바이오팜보통주
19968,326030,2020-07-06,0.3,165000,214500,49500,7126211,326030.0,에스케이바이오팜보통주
19969,326030,2020-07-03,0.2992125984251969,127000,165000,38000,711921,326030.0,에스케이바이오팜보통주
19970,326030,2020-07-02,0.1538461538461538,188500,127000,-61500,698642,326030.0,에스케이바이오팜보통주
19971,326030,2020-07-14,0.0527638190954773,199000,188500,-10500,1389588,326030.0,에스케이바이오팜보통주
19972,326030,2020-07-09,0.0529953917050691,217000,205500,-11500,1897646,326030.0,에스케이바이오팜보통주
19973,326030,2020-07-06,0.3,165000,214500,49500,7126211,326030.0,에스케이바이오팜보통주
19974,326030,2020-07-03,0.2992125984251969,127000,165000,38000,711921,326030.0,에스케이바이오팜보통주
19975,326030,2020-07-02,0.1538461538461538,188500,127000,-61500,698642,326030.0,에스케이바이오팜보통주
19976,326030,2020-07-14,0.0527638190954773,199000,188500,-10500,1389588,326030.0,에스케이바이오팜보통주
19977,326030,2020-07-09,0.0529953917050691,217000,205500,-11500,1897646,326030.0,에스케이바이오팜보통주
19978,326030,2020-07-06,0.3,165000,214500,49500,7126211,326030.0,에스케이바이오팜보통주
19979,326030,2020-07-03,0.2992125984251969,127000,165000,38000,711921,326030.0,에스케이바이오팜보통주
19980,326030,2020-07-02,0.1538461538461538,188500,127000,-61500,698642,326030.0,에스케이바이오팜보통주
19981,326030,2020-07-14,0.0527638190954773,199000,188500,-10500,1389588,326030.0,에스케이바이오팜보통주
19982,326030,2020-07-09,0.0529953917050691,217000,205500,-11500,1897646,326030.0,에스케이바이오팜보통주
19983,326030,2020-07-06,0.3,165000,214500,49500,7126211,326030.0,에스케이바이오팜보통주
19984,326030,2020-07-03,0.2992125984251969,127000,165000,38000,711921,326030.0,에스케이바이오팜보통주
19985,326030,2020-07-02,0.1538461538461538,188500,127000,-61500,698642,326030.0,에스케이바이오팜보통주
19986,326030,2020-07-14,0.0527638190954773,199000,188500,-10500,1389588,326030.0,에스케이바이오팜보통주
19987,326030,2020-07-09,0.0529953917050691,217000,205500,-11500,1897646,326030.0,에스케이바이오팜보통주
19988,326030,2020-07-06,0.3,165000,214500,49500,7126211,326030.0,에스케이바이오팜보통주
19989,326030,2020-07-03,0.2992125984251969,127000,165000,38000,711921,326030.0,에스케이바이오팜보통주
19990,326030,2020-07-02,0.1538461538461538,188500,127000,-61500,698642,326030.0,에스케이바이오팜보통주
19991,326030,2020-07-14,0.0527638190954773,199000,188500,-10500,1389588,326030.0,에스케이바이오팜보통주
19992,326030,2020-07-09,0.0529953917050691,217000,205500,-11500,1897646,326030.0,에스케이바이오팜보통주
19993,326030,2020-07-06,0.3,165000,214500,49500,7126211,326030.0,에스케이바이오팜보통주
19994,326030,2020-07-03,0.2992125984251969,127000,165000,38000,711921,326030.0,에스케이바이오팜보통주
19995,326030,2020-07-02,0.1538461538461538,188500,127000,-61500,698642,326030.0,에스케이바이오팜보통주
19996,326030,2020-07-14,0.0527638190954773,199000,188500,-10500,1389588,326030.0,에스케이바이오팜보통주
19997,326030,2020-07-09,0.0529953917050691,217000,205500,-11500,1897646,326030.0,에스케이바이오팜보통주
19998,326030,2020-07-06,0.3,165000,214500,49500,7126211,326030.0,에스케이바이오팜보통주
19999,326030,2020-07-03,0.2992125984251969,127000,165000,38000,711921,326030.0,에스케이바이오팜보통주
20000,326030,2020-07-02,0.1538461538461538,188500,127000,-61500,698642,326030.0,에스케이바이오팜보통주
20001,326030,2020-07-14,0.0527638190954773,199000,188500,-10500,1389588,326030.0,에스케이바이오팜보통주
20002,326030,2020-07-09,0.0529953917050691,217000,205500,-11500,1897646,326030.0,에스케이바이오팜보통주
20003,326030,2020-07-06,0.3,165000,214500,49500,7126211,326030.0,에스케이바이오팜보통주
20004,326030,2020-07-03,0.2992125984251969,127000,165000,38000,711921,326030.0,에스케이바이오팜보통주
20005,326030,2020-07-02,0.1538461538461538,188500,127000,-61500,698642,326030.0,에스케이바이오팜보통주
20006,326030,2020-07-14,0.0527638190954773,199000,188500,-10500,1389588,326030.0,에스케이바이오팜보통주
20007,326030,2020-07-09,0.0529953917050691,217000,205500,-11500,1897646,326030.0,에스케이바이오팜보통주
20008,326030,2020-07-06,0.3,165000,214500,49500,7126211,326030.0,에스케이바이오팜보통주
20009,326030,2020-07-03,0.2992125984251969,127000,165000,38000,711921,326030.0,에스케이바이오팜보통주
20010,326030,2020-07-02,0.1538461538461538,188500,127000,-61500,698642,326030.0,에스케이바이오팜보통주
20011,326030,2020-07-14,0.0527638190954773,199000,188500,-10500,1389588,326030.0,에스케이바이오팜보통주
20012,326030,2020-07-09,0.0529953917050691,217000,205500,-11500,1897646,326030.0,에스케이바이오팜보통주
20013,326030,2020-07-06,0.3,165000,214500,49500,7126211,326030.0,에스케이바이오팜보통주
20014,326030,2020-07-03,0.2992125984251969,127000,165000,38000,711921,326030.0,에스케이바이오팜보통주
20015,326030,2020-07-02,0.1538461538461538,188500,127000,-61500,698642,326030.0,에스케이바이오팜보통주
20016,326030,2020-07-14,0.0527638190954773,199000,188500,-10500,1389588,326030.0,에스케이바이오팜보통주
20017,326030,2020-07-09,0.0529953917050691,217000,205500,-11500,1897646,326030.0,에스케이바이오팜보통주
20018,326030,2020-07-06,0.3,165000,214500,49500,7126211,326030.0,에스케이바이오팜보통주
20019,326030,2020-07-03,0.2992125984251969,127000,165000,38000,711921,326030.0,에스케이바이오팜보통주
20020,326030,2020-07-02,0.1538461538461538,188500,127000,-61500,698642,326030.0,에스케이바이오팜보통주
20021,326030,2020-07-14,0.0527638190954773,199000,188500,-10500,1389588,326030.0,에스케이바이오팜보통주
20022,326030,2020-07-09,0.0529953917050691,217000,205500,-11500,1897646,326030.0,에스케이바이오팜보통주
20023,326030,2020-07-06,0.3,165000,214500,49500,7126211,326030.0,에스케이바이오팜보통주
20024,326030,2020-07-03,0.2992125984251969,127000,165000,38000,711921,326030.0,에스케이바이오팜보통주
20025,326030,2020-07-02,0.1538461538461538,188500,127000,-61500,698642,326030.0,에스케이바이오팜보통주
20026,326030,2020-07-14,0.0527638190954773,199000,188500,-10500,1389588,326030.0,에스케이바이오팜보통주
20027,326030,2020-07-09,0.0529953917050691,217000,205500,-11500,1897646,326030.0,에스케이바이오팜보통주
20028,326030,2020-07-06,0.3,165000,214500,49500,7126211,326030.0,에스케이바이오팜보통주
20029,326030,2020-07-03,0.2992125984251969,127000,165000,38000,711921,326030.0,에스케이바이오팜보통주
20030,326030,2020-07-02,0.1538461538461538,188500,127000,-61500,698642,326030.0,에스케이바이오팜보통주
20031,326030,2020-07-14,0.0527638190954773,199000,188500,-10500,1389588,326030.0,에스케이바이오팜보통주
20032,326030,2020-07-09,0.0529953917050691,217000,205500,-11500,1897646,326030.0,에스케이바이오팜보통주
20033,326030,2020-07-06,0.3,165000,214500,49500,7126211,326030.0,에스케이바이오팜보통주
20034,326030,2020-07-03,0.2992125984251969,127000,165000,38000,711921,326030.0,에스케이바이오팜보통주
20035,326030,2020-07-02,0.1538461538461538,188500,127000,-61500,698642,326030.0,에스케이바이오팜보통주
20036,326030,2020-07-14,0.0527638190954773,199000,188500,-10500,1389588,326030.0,에스케이바이오팜보통주
20037,326030,2020-07-09,0.0529953917050691,217000,205500,-11500,1897646,326030.0,에스케이바이오팜보통주
20038,326030,2020-07-06,0.3,165000,214500,49500,7126211,326030.0,에스케이바이오팜보통주
20039,326030,2020-07-03,0.2992125984251969,127000,165000,38000,711921,326030.0,에스케이바이오팜보통주
20040,326030,2020-07-02,0.1538461538461538,188500,127000,-61500,698642,326030.0,에스케이바이오팜보통주
20041,326030,2020-07-14,0.0527638190954773,199000,188500,-10500,1389588,326030.0,에스케이바이오팜보통주
20042,326030,2020-07-09,0.0529953917050691,217000,205500,-11500,1897646,326030.0,에스케이바이오팜보통주
20043,326030,2020-07-06,0.3,165000,214500,49500,7126211,326030.0,에스케이바이오팜보통주
20044,326030,2020-07-03,0.2992125984251969,127000,165000,38000,711921,326030.0,에스케이바이오팜보통주
20045,326030,2020-07-02,0.1538461538461538,188500,127000,-61500,698642,326030.0,에스케이바이오팜보통주
20046,326030,2020-07-14,0.0527638190954773,199000,188500,-10500,1389588,326030.0,에스케이바이오팜보통주
20047,326030,2020-07-09,0.0529953917050691,217000,205500,-11500,1897646,326030.0,에스케이바이오팜보통주
20048,326030,2020-07-06,0.3,165000,214500,49500,7126211,326030.0,에스케이바이오팜보통주
20049,326030,2020-07-03,0.2992125984251969,127000,165000,38000,711921,326030.0,에스케이바이오팜보통주
20050,326030,2020-07-02,0.1538461538461538,188500,127000,-61500,698642,326030.0,에스케이바이오팜보통주
20051,326030,2020-07-14,0.0527638190954773,199000,188500,-10500,1389588,326030.0,에스케이바이오팜보통주
20052,326030,2020-07-09,0.0529953917050691,217000,205500,-11500,1897646,326030.0,에스케이바이오팜보통주
20053,326030,2020-07-06,0.3,165000,214500,49500,7126211,326030.0,에스케이바이오팜보통주
20054,326030,2020-07-03,0.2992125984251969,127000,165000,38000,711921,326030.0,에스케이바이오팜보통주
20055,330590,2020-03-23,0.0438034188034188,4680,4475,-205,945277,330590.0,롯데리츠보통주
20056,330590,2020-03-19,0.0602409638554216,4980,4680,-300,1279344,330590.0,롯데리츠보통주
20057,330590,2020-03-13,0.0591085271317829,5160,4855,-305,1861648,330590.0,롯데리츠보통주
20058,330590,2020-02-28,0.0450281425891182,5330,5090,-240,1384005,330590.0,롯데리츠보통주
20059,330590,2019-10-30,0.2286585365853658,6560,6500,-60,46404235,330590.0,롯데리츠보통주
20060,330590,2019-10-30,0.2286585365853658,6560,6500,-60,46404235,330590.0,롯데리츠보통주
20061,330590,2019-10-30,0.2286585365853658,6560,6500,-60,46404235,330590.0,롯데리츠보통주
20062,330590,2019-10-30,0.2286585365853658,6560,6500,-60,46404235,330590.0,롯데리츠보통주
20063,330590,2019-10-30,0.2286585365853658,6560,6500,-60,46404235,330590.0,롯데리츠보통주
20064,330590,2019-10-30,0.2286585365853658,6560,6500,-60,46404235,330590.0,롯데리츠보통주
20065,330590,2019-10-30,0.2286585365853658,6560,6500,-60,46404235,330590.0,롯데리츠보통주
20066,330590,2019-10-30,0.2286585365853658,6560,6500,-60,46404235,330590.0,롯데리츠보통주
20067,330590,2019-10-30,0.2286585365853658,6560,6500,-60,46404235,330590.0,롯데리츠보통주
20068,330590,2019-10-30,0.2286585365853658,6560,6500,-60,46404235,330590.0,롯데리츠보통주
20069,330590,2019-10-30,0.2286585365853658,6560,6500,-60,46404235,330590.0,롯데리츠보통주
20070,330590,2019-10-30,0.2286585365853658,6560,6500,-60,46404235,330590.0,롯데리츠보통주
20071,330590,2019-10-30,0.2286585365853658,6560,6500,-60,46404235,330590.0,롯데리츠보통주
20072,330590,2019-10-30,0.2286585365853658,6560,6500,-60,46404235,330590.0,롯데리츠보통주
20073,330590,2019-10-30,0.2286585365853658,6560,6500,-60,46404235,330590.0,롯데리츠보통주
20074,330590,2019-10-30,0.2286585365853658,6560,6500,-60,46404235,330590.0,롯데리츠보통주
20075,330590,2019-10-30,0.2286585365853658,6560,6500,-60,46404235,330590.0,롯데리츠보통주
20076,330590,2019-10-30,0.2286585365853658,6560,6500,-60,46404235,330590.0,롯데리츠보통주
20077,330590,2019-10-30,0.2286585365853658,6560,6500,-60,46404235,330590.0,롯데리츠보통주
20078,330590,2019-10-30,0.2286585365853658,6560,6500,-60,46404235,330590.0,롯데리츠보통주
20079,330590,2019-10-30,0.2286585365853658,6560,6500,-60,46404235,330590.0,롯데리츠보통주
20080,330590,2019-10-30,0.2286585365853658,6560,6500,-60,46404235,330590.0,롯데리츠보통주
20081,330590,2019-10-30,0.2286585365853658,6560,6500,-60,46404235,330590.0,롯데리츠보통주
20082,330590,2019-10-30,0.2286585365853658,6560,6500,-60,46404235,330590.0,롯데리츠보통주
20083,330590,2019-10-30,0.2286585365853658,6560,6500,-60,46404235,330590.0,롯데리츠보통주
20084,330590,2019-10-30,0.2286585365853658,6560,6500,-60,46404235,330590.0,롯데리츠보통주
20085,330590,2019-10-30,0.2286585365853658,6560,6500,-60,46404235,330590.0,롯데리츠보통주
20086,330590,2019-10-30,0.2286585365853658,6560,6500,-60,46404235,330590.0,롯데리츠보통주
20087,330590,2019-10-30,0.2286585365853658,6560,6500,-60,46404235,330590.0,롯데리츠보통주
20088,330590,2019-10-30,0.2286585365853658,6560,6500,-60,46404235,330590.0,롯데리츠보통주
20089,330590,2019-10-30,0.2286585365853658,6560,6500,-60,46404235,330590.0,롯데리츠보통주
20090,330590,2019-10-30,0.2286585365853658,6560,6500,-60,46404235,330590.0,롯데리츠보통주
20091,330590,2019-10-30,0.2286585365853658,6560,6500,-60,46404235,330590.0,롯데리츠보통주
20092,330590,2019-10-30,0.2286585365853658,6560,6500,-60,46404235,330590.0,롯데리츠보통주
20093,330590,2019-10-30,0.2286585365853658,6560,6500,-60,46404235,330590.0,롯데리츠보통주
20094,330590,2019-10-30,0.2286585365853658,6560,6500,-60,46404235,330590.0,롯데리츠보통주
20095,330590,2019-10-30,0.2286585365853658,6560,6500,-60,46404235,330590.0,롯데리츠보통주
20096,330590,2019-10-30,0.2286585365853658,6560,6500,-60,46404235,330590.0,롯데리츠보통주
20097,330590,2019-10-30,0.2286585365853658,6560,6500,-60,46404235,330590.0,롯데리츠보통주
20098,330590,2019-10-30,0.2286585365853658,6560,6500,-60,46404235,330590.0,롯데리츠보통주
20099,330590,2019-10-30,0.2286585365853658,6560,6500,-60,46404235,330590.0,롯데리츠보통주
20100,330590,2019-10-30,0.2286585365853658,6560,6500,-60,46404235,330590.0,롯데리츠보통주
20101,330590,2019-10-30,0.2286585365853658,6560,6500,-60,46404235,330590.0,롯데리츠보통주
20102,330590,2019-10-30,0.2286585365853658,6560,6500,-60,46404235,330590.0,롯데리츠보통주
20103,330590,2019-10-30,0.2286585365853658,6560,6500,-60,46404235,330590.0,롯데리츠보통주
20104,330590,2019-10-30,0.2286585365853658,6560,6500,-60,46404235,330590.0,롯데리츠보통주
20105,330590,2019-10-30,0.2286585365853658,6560,6500,-60,46404235,330590.0,롯데리츠보통주
20106,330590,2019-10-30,0.2286585365853658,6560,6500,-60,46404235,330590.0,롯데리츠보통주
20107,330590,2019-10-30,0.2286585365853658,6560,6500,-60,46404235,330590.0,롯데리츠보통주
20108,330590,2019-10-30,0.2286585365853658,6560,6500,-60,46404235,330590.0,롯데리츠보통주
20109,330590,2019-10-30,0.2286585365853658,6560,6500,-60,46404235,330590.0,롯데리츠보통주
20110,330590,2019-10-30,0.2286585365853658,6560,6500,-60,46404235,330590.0,롯데리츠보통주
20111,330590,2019-10-30,0.2286585365853658,6560,6500,-60,46404235,330590.0,롯데리츠보통주
20112,330590,2019-10-30,0.2286585365853658,6560,6500,-60,46404235,330590.0,롯데리츠보통주
20113,330590,2019-10-30,0.2286585365853658,6560,6500,-60,46404235,330590.0,롯데리츠보통주
20114,330590,2019-10-30,0.2286585365853658,6560,6500,-60,46404235,330590.0,롯데리츠보통주
20115,330590,2019-10-30,0.2286585365853658,6560,6500,-60,46404235,330590.0,롯데리츠보통주
20116,330590,2019-10-30,0.2286585365853658,6560,6500,-60,46404235,330590.0,롯데리츠보통주
20117,330590,2019-10-30,0.2286585365853658,6560,6500,-60,46404235,330590.0,롯데리츠보통주
20118,330590,2019-10-30,0.2286585365853658,6560,6500,-60,46404235,330590.0,롯데리츠보통주
20119,330590,2019-10-30,0.2286585365853658,6560,6500,-60,46404235,330590.0,롯데리츠보통주
20120,330590,2019-10-30,0.2286585365853658,6560,6500,-60,46404235,330590.0,롯데리츠보통주
20121,330590,2019-10-30,0.2286585365853658,6560,6500,-60,46404235,330590.0,롯데리츠보통주
20122,330590,2019-10-30,0.2286585365853658,6560,6500,-60,46404235,330590.0,롯데리츠보통주
20123,330590,2019-10-30,0.2286585365853658,6560,6500,-60,46404235,330590.0,롯데리츠보통주
20124,330590,2019-10-30,0.2286585365853658,6560,6500,-60,46404235,330590.0,롯데리츠보통주
20125,330590,2019-10-30,0.2286585365853658,6560,6500,-60,46404235,330590.0,롯데리츠보통주
20126,330590,2019-10-30,0.2286585365853658,6560,6500,-60,46404235,330590.0,롯데리츠보통주
20127,330590,2019-10-30,0.2286585365853658,6560,6500,-60,46404235,330590.0,롯데리츠보통주
20128,330590,2019-10-30,0.2286585365853658,6560,6500,-60,46404235,330590.0,롯데리츠보통주
20129,330590,2019-10-30,0.2286585365853658,6560,6500,-60,46404235,330590.0,롯데리츠보통주
20130,330590,2019-10-30,0.2286585365853658,6560,6500,-60,46404235,330590.0,롯데리츠보통주
20131,330590,2019-10-30,0.2286585365853658,6560,6500,-60,46404235,330590.0,롯데리츠보통주
20132,330590,2019-10-30,0.2286585365853658,6560,6500,-60,46404235,330590.0,롯데리츠보통주
20133,330590,2019-10-30,0.2286585365853658,6560,6500,-60,46404235,330590.0,롯데리츠보통주
20134,330590,2019-10-30,0.2286585365853658,6560,6500,-60,46404235,330590.0,롯데리츠보통주
20135,330590,2019-10-30,0.2286585365853658,6560,6500,-60,46404235,330590.0,롯데리츠보통주
20136,330590,2019-10-30,0.2286585365853658,6560,6500,-60,46404235,330590.0,롯데리츠보통주
20137,330590,2019-10-30,0.2286585365853658,6560,6500,-60,46404235,330590.0,롯데리츠보통주
20138,336260,2021-06-02,0.0676605504587156,43600,46550,2950,2758739,336260.0,두산퓨얼셀보통주
20139,336260,2021-05-26,0.0422885572139303,40200,41900,1700,1245684,336260.0,두산퓨얼셀보통주
20140,336260,2021-05-10,0.0631313131313131,39600,42100,2500,1370585,336260.0,두산퓨얼셀보통주
20141,336260,2021-05-03,0.1097560975609756,45100,40150,-4950,2904200,336260.0,두산퓨얼셀보통주
20142,336260,2021-04-28,0.054582904222451,48550,45900,-2650,1998236,336260.0,두산퓨얼셀보통주
20143,336260,2021-04-09,0.042,50000,52100,2100,1344234,336260.0,두산퓨얼셀보통주
20144,336260,2021-03-12,0.061822125813449,46100,48950,2850,1100650,336260.0,두산퓨얼셀보통주
20145,336260,2021-03-09,0.067,50000,46650,-3350,1768216,336260.0,두산퓨얼셀보통주
20146,336260,2021-03-03,0.0728346456692913,50800,54500,3700,2031946,336260.0,두산퓨얼셀보통주
20147,336260,2021-02-26,0.0671641791044776,53600,50000,-3600,1473679,336260.0,두산퓨얼셀보통주
20148,336260,2021-02-24,0.0714285714285714,56000,52000,-4000,1375099,336260.0,두산퓨얼셀보통주
20149,336260,2021-02-22,0.0405405405405405,59200,56800,-2400,954573,336260.0,두산퓨얼셀보통주
20150,336260,2021-02-15,0.0545454545454545,60500,63800,3300,3157007,336260.0,두산퓨얼셀보통주
20151,336260,2021-01-29,0.0638655462184873,59500,55700,-3800,1970433,336260.0,두산퓨얼셀보통주
20152,336260,2021-01-26,0.0443037974683544,63200,60400,-2800,1976696,336260.0,두산퓨얼셀보통주
20153,336260,2021-01-22,0.1101243339253996,56300,62500,6200,12972968,336260.0,두산퓨얼셀보통주
20154,336260,2021-01-12,0.0470383275261324,57400,54700,-2700,2162242,336260.0,두산퓨얼셀보통주
20155,336260,2021-01-06,0.043859649122807,57000,54500,-2500,10395186,336260.0,두산퓨얼셀보통주
20156,336260,2021-01-04,0.0523364485981308,53500,56300,2800,1561427,336260.0,두산퓨얼셀보통주
20157,336260,2020-12-29,0.0517928286852589,50200,52800,2600,1988246,336260.0,두산퓨얼셀보통주
20158,336260,2020-12-28,0.0419847328244274,52400,50200,-2200,1676904,336260.0,두산퓨얼셀보통주
20159,336260,2020-12-24,0.0472727272727272,55000,52400,-2600,3152998,336260.0,두산퓨얼셀보통주
20160,336260,2020-12-22,0.0602409638554216,58100,54600,-3500,1432594,336260.0,두산퓨얼셀보통주
20161,336260,2020-12-18,0.0519713261648745,55800,58700,2900,2223066,336260.0,두산퓨얼셀보통주
20162,336260,2020-12-14,0.1070336391437308,49050,54300,5250,4618141,336260.0,두산퓨얼셀보통주
20163,336260,2020-12-09,0.0645879732739421,44900,47800,2900,1590434,336260.0,두산퓨얼셀보통주
20164,336260,2020-12-03,0.0538793103448275,46400,43900,-2500,2675120,336260.0,두산퓨얼셀보통주
20165,336260,2020-12-01,0.0410821643286573,49900,47850,-2050,1109690,336260.0,두산퓨얼셀보통주
20166,336260,2020-11-24,0.1287605294825511,41550,46900,5350,5658057,336260.0,두산퓨얼셀보통주
20167,336260,2020-11-10,0.0575793184488836,42550,45000,2450,2215460,336260.0,두산퓨얼셀보통주
20168,336260,2020-10-28,0.0847029077117572,39550,42900,3350,1112963,336260.0,두산퓨얼셀보통주
20169,336260,2020-10-26,0.0753186558516801,43150,39900,-3250,1641223,336260.0,두산퓨얼셀보통주
20170,336260,2020-10-23,0.0710441334768568,46450,43150,-3300,1672825,336260.0,두산퓨얼셀보통주
20171,336260,2020-10-15,0.0548977395048439,46450,49000,2550,4364787,336260.0,두산퓨얼셀보통주
20172,336260,2020-10-13,0.0667408231368186,44950,47950,3000,2919018,336260.0,두산퓨얼셀보통주
20173,336260,2020-10-12,0.0753588516746411,41800,44950,3150,3101551,336260.0,두산퓨얼셀보통주
20174,336260,2020-10-08,0.050251256281407,39800,41800,2000,2768314,336260.0,두산퓨얼셀보통주
20175,336260,2020-10-07,0.0599201065246338,37550,39800,2250,4632027,336260.0,두산퓨얼셀보통주
20176,336260,2020-10-06,0.1317919075144508,43250,37550,-5700,17277063,336260.0,두산퓨얼셀보통주
20177,336260,2020-09-29,0.0641975308641975,40500,43100,2600,2555118,336260.0,두산퓨얼셀보통주
20178,336260,2020-09-28,0.0424710424710424,38850,40500,1650,798022,336260.0,두산퓨얼셀보통주
20179,336260,2020-09-24,0.0933179723502304,43400,39350,-4050,1542925,336260.0,두산퓨얼셀보통주
20180,336260,2020-09-23,0.0585683297180043,46100,43400,-2700,1261686,336260.0,두산퓨얼셀보통주
20181,336260,2020-09-21,0.0908203125,51200,46550,-4650,2278370,336260.0,두산퓨얼셀보통주
20182,336260,2020-09-18,0.0429906542056074,53500,51200,-2300,897528,336260.0,두산퓨얼셀보통주
20183,336260,2020-09-09,0.0638297872340425,56400,52800,-3600,2959899,336260.0,두산퓨얼셀보통주
20184,336260,2020-09-08,0.0489038785834738,59300,56400,-2900,9082733,336260.0,두산퓨얼셀보통주
20185,336260,2020-09-07,0.2990142387732749,45650,59300,13650,15047099,336260.0,두산퓨얼셀보통주
20186,336260,2020-09-03,0.0489510489510489,42900,45000,2100,3543447,336260.0,두산퓨얼셀보통주
20187,336260,2020-08-26,0.0609452736318407,40200,42650,2450,1421474,336260.0,두산퓨얼셀보통주
20188,336260,2020-08-20,0.060122699386503,40750,38300,-2450,1385239,336260.0,두산퓨얼셀보통주
20189,336260,2020-08-19,0.0667539267015706,38200,40750,2550,1169094,336260.0,두산퓨얼셀보통주
20190,336260,2020-08-18,0.1053864168618267,42700,38200,-4500,1927928,336260.0,두산퓨얼셀보통주
20191,336260,2020-08-12,0.0459893048128342,46750,44600,-2150,956296,336260.0,두산퓨얼셀보통주
20192,336260,2020-08-10,0.0731981981981982,44400,47650,3250,2944462,336260.0,두산퓨얼셀보통주
20193,336260,2020-07-27,0.0891566265060241,41500,45200,3700,5306799,336260.0,두산퓨얼셀보통주
20194,336260,2020-07-21,0.0421455938697318,39150,40800,1650,3611390,336260.0,두산퓨얼셀보통주
20195,336260,2020-07-15,0.0521262002743484,36450,38350,1900,5651960,336260.0,두산퓨얼셀보통주
20196,336260,2020-07-14,0.1142162818955042,41150,36450,-4700,8525283,336260.0,두산퓨얼셀보통주
20197,336260,2020-07-13,0.2210682492581602,33700,41150,7450,11098084,336260.0,두산퓨얼셀보통주
20198,336260,2020-07-10,0.0514820592823713,32050,33700,1650,2181200,336260.0,두산퓨얼셀보통주
20199,336260,2020-07-09,0.0647840531561461,30100,32050,1950,1821190,336260.0,두산퓨얼셀보통주
20200,336260,2020-07-01,0.0725308641975308,32400,30050,-2350,1423417,336260.0,두산퓨얼셀보통주
20201,336260,2020-06-23,0.2981744421906693,24650,32000,7350,13230183,336260.0,두산퓨얼셀보통주
20202,336260,2020-06-22,0.074074074074074,22950,24650,1700,2513663,336260.0,두산퓨얼셀보통주
20203,336260,2020-06-19,0.0613496932515337,24450,22950,-1500,1762206,336260.0,두산퓨얼셀보통주
20204,336260,2020-06-17,0.0679405520169851,23550,25150,1600,4375788,336260.0,두산퓨얼셀보통주
20205,336260,2020-06-16,0.1322115384615384,20800,23550,2750,3693032,336260.0,두산퓨얼셀보통주
20206,336260,2020-06-15,0.1595959595959596,24750,20800,-3950,7626365,336260.0,두산퓨얼셀보통주
20207,336260,2020-06-11,0.213235294117647,20400,24750,4350,6552619,336260.0,두산퓨얼셀보통주
20208,336260,2020-06-10,0.1895043731778425,17150,20400,3250,6063670,336260.0,두산퓨얼셀보통주
20209,336260,2020-06-09,0.1100323624595469,15450,17150,1700,2887836,336260.0,두산퓨얼셀보통주
20210,336260,2020-06-08,0.0842105263157894,14250,15450,1200,1380468,336260.0,두산퓨얼셀보통주
20211,336260,2020-06-04,0.0792079207920792,15150,13950,-1200,1813361,336260.0,두산퓨얼셀보통주
20212,336260,2020-05-29,0.0477707006369426,15700,14950,-750,1731042,336260.0,두산퓨얼셀보통주
20213,336260,2020-05-28,0.0790378006872852,14550,15700,1150,15695055,336260.0,두산퓨얼셀보통주
20214,336260,2020-05-26,0.1821862348178137,12350,14600,2250,24237621,336260.0,두산퓨얼셀보통주
20215,336260,2020-05-25,0.0600858369098712,11650,12350,700,12634004,336260.0,두산퓨얼셀보통주
20216,336260,2020-05-22,0.0688073394495412,10900,11650,750,8251282,336260.0,두산퓨얼셀보통주
20217,336260,2020-05-20,0.073170731707317,10250,11000,750,6216589,336260.0,두산퓨얼셀보통주
20218,336260,2020-05-13,0.0402010050251256,9950,10350,400,11504252,336260.0,두산퓨얼셀보통주
20219,336260,2020-05-11,0.2998678996036988,7570,9840,2270,21166142,336260.0,두산퓨얼셀보통주
20220,336260,2020-04-24,0.0430809399477806,7660,7330,-330,981239,336260.0,두산퓨얼셀보통주
20221,336260,2020-04-14,0.1782608695652174,6900,8130,1230,25364531,336260.0,두산퓨얼셀보통주
20222,336260,2020-04-10,0.0625,7360,6900,-460,2912924,336260.0,두산퓨얼셀보통주
20223,336260,2020-04-09,0.0589928057553956,6950,7360,410,8030647,336260.0,두산퓨얼셀보통주
20224,336260,2020-04-08,0.1819727891156462,5880,6950,1070,4786388,336260.0,두산퓨얼셀보통주
20225,336260,2020-04-03,0.04,5500,5720,220,965691,336260.0,두산퓨얼셀보통주
20226,336260,2020-03-27,0.048780487804878,4920,5160,240,1387499,336260.0,두산퓨얼셀보통주
20227,336260,2020-03-25,0.0700218818380744,4570,4890,320,945421,336260.0,두산퓨얼셀보통주
20228,336260,2020-03-24,0.0778301886792452,4240,4570,330,715317,336260.0,두산퓨얼셀보통주
20229,336260,2020-03-23,0.0514541387024608,4470,4240,-230,565699,336260.0,두산퓨얼셀보통주
20230,336260,2020-03-20,0.069377990430622,4180,4470,290,1144363,336260.0,두산퓨얼셀보통주
20231,336260,2020-03-19,0.1538461538461538,4940,4180,-760,990240,336260.0,두산퓨얼셀보통주
20232,336260,2020-03-18,0.0626185958254269,5270,4940,-330,633351,336260.0,두산퓨얼셀보통주
20233,336260,2020-03-16,0.0612612612612612,5550,5210,-340,686741,336260.0,두산퓨얼셀보통주
20234,336260,2020-03-13,0.0703517587939698,5970,5550,-420,1553981,336260.0,두산퓨얼셀보통주
20235,336260,2020-03-12,0.1062874251497006,6680,5970,-710,1320670,336260.0,두산퓨얼셀보통주
20236,336260,2020-03-11,0.0709318497913769,7190,6680,-510,1294209,336260.0,두산퓨얼셀보통주
20237,336260,2020-03-09,0.075197889182058,7580,7010,-570,826363,336260.0,두산퓨얼셀보통주
20238,336260,2020-03-04,0.0549450549450549,7280,7680,400,820640,336260.0,두산퓨얼셀보통주
20239,336260,2020-03-02,0.0595238095238095,6720,7120,400,691041,336260.0,두산퓨얼셀보통주
20240,336260,2020-02-28,0.0627615062761506,7170,6720,-450,1053634,336260.0,두산퓨얼셀보통주
20241,336260,2020-02-27,0.044,7500,7170,-330,1184849,336260.0,두산퓨얼셀보통주
20242,336260,2020-02-24,0.0510948905109489,8220,7800,-420,1408148,336260.0,두산퓨얼셀보통주
20243,336260,2020-02-21,0.0551724137931034,8700,8220,-480,2536545,336260.0,두산퓨얼셀보통주
20244,336260,2020-02-20,0.1462450592885375,7590,8700,1110,4344072,336260.0,두산퓨얼셀보통주
20245,336260,2020-02-04,0.0411140583554376,7540,7850,310,461686,336260.0,두산퓨얼셀보통주
20246,336260,2020-01-31,0.0517676767676767,7920,7510,-410,881162,336260.0,두산퓨얼셀보통주
20247,336260,2020-01-28,0.0448113207547169,8480,8100,-380,1043561,336260.0,두산퓨얼셀보통주
20248,336260,2020-01-09,0.0400516795865633,7740,8050,310,815944,336260.0,두산퓨얼셀보통주
20249,336260,2020-01-08,0.0572472594397076,8210,7740,-470,1878484,336260.0,두산퓨얼셀보통주
20250,336260,2020-01-06,0.0414269275028768,8690,8330,-360,1109156,336260.0,두산퓨얼셀보통주
20251,336260,2019-12-17,0.0490081680280046,8570,8150,-420,1804612,336260.0,두산퓨얼셀보통주
20252,336260,2019-12-11,0.0414572864321608,7960,8290,330,1228865,336260.0,두산퓨얼셀보통주
20253,336260,2019-12-04,0.0505415162454873,8310,7890,-420,1289983,336260.0,두산퓨얼셀보통주
20254,336260,2019-12-03,0.0400500625782227,7990,8310,320,7217850,336260.0,두산퓨얼셀보통주
20255,336260,2019-11-29,0.0495169082125603,8280,7870,-410,1405419,336260.0,두산퓨얼셀보통주
20256,336260,2019-11-21,0.0422222222222222,9000,8620,-380,2539869,336260.0,두산퓨얼셀보통주
20257,336260,2019-11-20,0.0435706695005313,9410,9000,-410,8425856,336260.0,두산퓨얼셀보통주
20258,336260,2019-11-15,0.1204055766793409,7890,8840,950,35194759,336260.0,두산퓨얼셀보통주
20259,336260,2019-11-13,0.0447957839262187,7590,7930,340,3471460,336260.0,두산퓨얼셀보통주
20260,336260,2019-10-30,0.1964285714285714,6720,8040,1320,30865340,336260.0,두산퓨얼셀보통주
20261,336260,2019-10-28,0.0594744121715076,7230,6800,-430,3999829,336260.0,두산퓨얼셀보통주
20262,336260,2019-10-25,0.073076923076923,7800,7230,-570,13216860,336260.0,두산퓨얼셀보통주
20263,336260,2019-10-23,0.1119820828667413,8930,7930,-1000,28203889,336260.0,두산퓨얼셀보통주
20264,336260,2019-10-22,0.2472067039106145,7160,8930,1770,39020768,336260.0,두산퓨얼셀보통주
20265,336260,2019-10-21,0.2994555353901996,5510,7160,1650,21919889,336260.0,두산퓨얼셀보통주
20266,336260,2019-10-18,0.1601513240857503,7930,5510,-2420,370645,336260.0,두산퓨얼셀보통주
20267,336260,2019-10-23,0.1119820828667413,8930,7930,-1000,28203889,336260.0,두산퓨얼셀보통주
20268,336260,2019-10-22,0.2472067039106145,7160,8930,1770,39020768,336260.0,두산퓨얼셀보통주
20269,336260,2019-10-21,0.2994555353901996,5510,7160,1650,21919889,336260.0,두산퓨얼셀보통주
20270,336260,2019-10-18,0.1601513240857503,7930,5510,-2420,370645,336260.0,두산퓨얼셀보통주
20271,336260,2019-10-23,0.1119820828667413,8930,7930,-1000,28203889,336260.0,두산퓨얼셀보통주
20272,336260,2019-10-22,0.2472067039106145,7160,8930,1770,39020768,336260.0,두산퓨얼셀보통주
20273,336260,2019-10-21,0.2994555353901996,5510,7160,1650,21919889,336260.0,두산퓨얼셀보통주
20274,336260,2019-10-18,0.1601513240857503,7930,5510,-2420,370645,336260.0,두산퓨얼셀보통주
20275,336260,2019-10-23,0.1119820828667413,8930,7930,-1000,28203889,336260.0,두산퓨얼셀보통주
20276,336260,2019-10-22,0.2472067039106145,7160,8930,1770,39020768,336260.0,두산퓨얼셀보통주
20277,336260,2019-10-21,0.2994555353901996,5510,7160,1650,21919889,336260.0,두산퓨얼셀보통주
20278,336260,2019-10-18,0.1601513240857503,7930,5510,-2420,370645,336260.0,두산퓨얼셀보통주
20279,336260,2019-10-23,0.1119820828667413,8930,7930,-1000,28203889,336260.0,두산퓨얼셀보통주
20280,336260,2019-10-22,0.2472067039106145,7160,8930,1770,39020768,336260.0,두산퓨얼셀보통주
20281,336260,2019-10-21,0.2994555353901996,5510,7160,1650,21919889,336260.0,두산퓨얼셀보통주
20282,336260,2019-10-18,0.1601513240857503,7930,5510,-2420,370645,336260.0,두산퓨얼셀보통주
20283,336260,2019-10-23,0.1119820828667413,8930,7930,-1000,28203889,336260.0,두산퓨얼셀보통주
20284,336260,2019-10-22,0.2472067039106145,7160,8930,1770,39020768,336260.0,두산퓨얼셀보통주
20285,336260,2019-10-21,0.2994555353901996,5510,7160,1650,21919889,336260.0,두산퓨얼셀보통주
20286,336260,2019-10-18,0.1601513240857503,7930,5510,-2420,370645,336260.0,두산퓨얼셀보통주
20287,336260,2019-10-23,0.1119820828667413,8930,7930,-1000,28203889,336260.0,두산퓨얼셀보통주
20288,336260,2019-10-22,0.2472067039106145,7160,8930,1770,39020768,336260.0,두산퓨얼셀보통주
20289,336260,2019-10-21,0.2994555353901996,5510,7160,1650,21919889,336260.0,두산퓨얼셀보통주
20290,336260,2019-10-18,0.1601513240857503,7930,5510,-2420,370645,336260.0,두산퓨얼셀보통주
20291,336260,2019-10-23,0.1119820828667413,8930,7930,-1000,28203889,336260.0,두산퓨얼셀보통주
20292,336260,2019-10-22,0.2472067039106145,7160,8930,1770,39020768,336260.0,두산퓨얼셀보통주
20293,336260,2019-10-21,0.2994555353901996,5510,7160,1650,21919889,336260.0,두산퓨얼셀보통주
20294,336260,2019-10-18,0.1601513240857503,7930,5510,-2420,370645,336260.0,두산퓨얼셀보통주
20295,336260,2019-10-23,0.1119820828667413,8930,7930,-1000,28203889,336260.0,두산퓨얼셀보통주
20296,336260,2019-10-22,0.2472067039106145,7160,8930,1770,39020768,336260.0,두산퓨얼셀보통주
20297,336260,2019-10-21,0.2994555353901996,5510,7160,1650,21919889,336260.0,두산퓨얼셀보통주
20298,336260,2019-10-18,0.1601513240857503,7930,5510,-2420,370645,336260.0,두산퓨얼셀보통주
20299,336260,2019-10-23,0.1119820828667413,8930,7930,-1000,28203889,336260.0,두산퓨얼셀보통주
20300,336260,2019-10-22,0.2472067039106145,7160,8930,1770,39020768,336260.0,두산퓨얼셀보통주
20301,336260,2019-10-21,0.2994555353901996,5510,7160,1650,21919889,336260.0,두산퓨얼셀보통주
20302,336260,2019-10-18,0.1601513240857503,7930,5510,-2420,370645,336260.0,두산퓨얼셀보통주
20303,336260,2019-10-23,0.1119820828667413,8930,7930,-1000,28203889,336260.0,두산퓨얼셀보통주
20304,336260,2019-10-22,0.2472067039106145,7160,8930,1770,39020768,336260.0,두산퓨얼셀보통주
20305,336260,2019-10-21,0.2994555353901996,5510,7160,1650,21919889,336260.0,두산퓨얼셀보통주
20306,336260,2019-10-18,0.1601513240857503,7930,5510,-2420,370645,336260.0,두산퓨얼셀보통주
20307,336260,2019-10-23,0.1119820828667413,8930,7930,-1000,28203889,336260.0,두산퓨얼셀보통주
20308,336260,2019-10-22,0.2472067039106145,7160,8930,1770,39020768,336260.0,두산퓨얼셀보통주
20309,336260,2019-10-21,0.2994555353901996,5510,7160,1650,21919889,336260.0,두산퓨얼셀보통주
20310,336260,2019-10-18,0.1601513240857503,7930,5510,-2420,370645,336260.0,두산퓨얼셀보통주
20311,336260,2019-10-23,0.1119820828667413,8930,7930,-1000,28203889,336260.0,두산퓨얼셀보통주
20312,336260,2019-10-22,0.2472067039106145,7160,8930,1770,39020768,336260.0,두산퓨얼셀보통주
20313,336260,2019-10-21,0.2994555353901996,5510,7160,1650,21919889,336260.0,두산퓨얼셀보통주
20314,336260,2019-10-18,0.1601513240857503,7930,5510,-2420,370645,336260.0,두산퓨얼셀보통주
20315,336260,2019-10-23,0.1119820828667413,8930,7930,-1000,28203889,336260.0,두산퓨얼셀보통주
20316,336260,2019-10-22,0.2472067039106145,7160,8930,1770,39020768,336260.0,두산퓨얼셀보통주
20317,336260,2019-10-21,0.2994555353901996,5510,7160,1650,21919889,336260.0,두산퓨얼셀보통주
20318,336260,2019-10-18,0.1601513240857503,7930,5510,-2420,370645,336260.0,두산퓨얼셀보통주
20319,336260,2019-10-23,0.1119820828667413,8930,7930,-1000,28203889,336260.0,두산퓨얼셀보통주
20320,336260,2019-10-22,0.2472067039106145,7160,8930,1770,39020768,336260.0,두산퓨얼셀보통주
20321,336260,2019-10-21,0.2994555353901996,5510,7160,1650,21919889,336260.0,두산퓨얼셀보통주
20322,336260,2019-10-18,0.1601513240857503,7930,5510,-2420,370645,336260.0,두산퓨얼셀보통주
20323,336260,2019-10-23,0.1119820828667413,8930,7930,-1000,28203889,336260.0,두산퓨얼셀보통주
20324,336260,2019-10-22,0.2472067039106145,7160,8930,1770,39020768,336260.0,두산퓨얼셀보통주
20325,336260,2019-10-21,0.2994555353901996,5510,7160,1650,21919889,336260.0,두산퓨얼셀보통주
20326,336260,2019-10-18,0.1601513240857503,7930,5510,-2420,370645,336260.0,두산퓨얼셀보통주
20327,336260,2019-10-23,0.1119820828667413,8930,7930,-1000,28203889,336260.0,두산퓨얼셀보통주
20328,336260,2019-10-22,0.2472067039106145,7160,8930,1770,39020768,336260.0,두산퓨얼셀보통주
20329,336260,2019-10-21,0.2994555353901996,5510,7160,1650,21919889,336260.0,두산퓨얼셀보통주
20330,336260,2019-10-18,0.1601513240857503,7930,5510,-2420,370645,336260.0,두산퓨얼셀보통주
20331,336260,2019-10-23,0.1119820828667413,8930,7930,-1000,28203889,336260.0,두산퓨얼셀보통주
20332,336260,2019-10-22,0.2472067039106145,7160,8930,1770,39020768,336260.0,두산퓨얼셀보통주
20333,336260,2019-10-21,0.2994555353901996,5510,7160,1650,21919889,336260.0,두산퓨얼셀보통주
20334,336260,2019-10-18,0.1601513240857503,7930,5510,-2420,370645,336260.0,두산퓨얼셀보통주
20335,336260,2019-10-23,0.1119820828667413,8930,7930,-1000,28203889,336260.0,두산퓨얼셀보통주
20336,336260,2019-10-22,0.2472067039106145,7160,8930,1770,39020768,336260.0,두산퓨얼셀보통주
20337,336260,2019-10-21,0.2994555353901996,5510,7160,1650,21919889,336260.0,두산퓨얼셀보통주
20338,336260,2019-10-18,0.1601513240857503,7930,5510,-2420,370645,336260.0,두산퓨얼셀보통주
20339,336260,2019-10-23,0.1119820828667413,8930,7930,-1000,28203889,336260.0,두산퓨얼셀보통주
20340,336260,2019-10-22,0.2472067039106145,7160,8930,1770,39020768,336260.0,두산퓨얼셀보통주
20341,336260,2019-10-21,0.2994555353901996,5510,7160,1650,21919889,336260.0,두산퓨얼셀보통주
20342,336260,2019-10-18,0.1601513240857503,7930,5510,-2420,370645,336260.0,두산퓨얼셀보통주
20343,336260,2019-10-23,0.1119820828667413,8930,7930,-1000,28203889,336260.0,두산퓨얼셀보통주
20344,336260,2019-10-22,0.2472067039106145,7160,8930,1770,39020768,336260.0,두산퓨얼셀보통주
20345,336260,2019-10-21,0.2994555353901996,5510,7160,1650,21919889,336260.0,두산퓨얼셀보통주
20346,336260,2019-10-18,0.1601513240857503,7930,5510,-2420,370645,336260.0,두산퓨얼셀보통주
20347,336260,2019-10-23,0.1119820828667413,8930,7930,-1000,28203889,336260.0,두산퓨얼셀보통주
20348,336260,2019-10-22,0.2472067039106145,7160,8930,1770,39020768,336260.0,두산퓨얼셀보통주
20349,336260,2019-10-21,0.2994555353901996,5510,7160,1650,21919889,336260.0,두산퓨얼셀보통주
20350,336260,2019-10-18,0.1601513240857503,7930,5510,-2420,370645,336260.0,두산퓨얼셀보통주
20351,336260,2019-10-23,0.1119820828667413,8930,7930,-1000,28203889,336260.0,두산퓨얼셀보통주
20352,336260,2019-10-22,0.2472067039106145,7160,8930,1770,39020768,336260.0,두산퓨얼셀보통주
20353,336260,2019-10-21,0.2994555353901996,5510,7160,1650,21919889,336260.0,두산퓨얼셀보통주
20354,336260,2019-10-18,0.1601513240857503,7930,5510,-2420,370645,336260.0,두산퓨얼셀보통주
20355,336260,2019-10-23,0.1119820828667413,8930,7930,-1000,28203889,336260.0,두산퓨얼셀보통주
20356,336260,2019-10-22,0.2472067039106145,7160,8930,1770,39020768,336260.0,두산퓨얼셀보통주
20357,336260,2019-10-21,0.2994555353901996,5510,7160,1650,21919889,336260.0,두산퓨얼셀보통주
20358,336260,2019-10-18,0.1601513240857503,7930,5510,-2420,370645,336260.0,두산퓨얼셀보통주
20359,336260,2019-10-23,0.1119820828667413,8930,7930,-1000,28203889,336260.0,두산퓨얼셀보통주
20360,336260,2019-10-22,0.2472067039106145,7160,8930,1770,39020768,336260.0,두산퓨얼셀보통주
20361,336260,2019-10-21,0.2994555353901996,5510,7160,1650,21919889,336260.0,두산퓨얼셀보통주
20362,336260,2019-10-18,0.1601513240857503,7930,5510,-2420,370645,336260.0,두산퓨얼셀보통주
20363,336260,2019-10-23,0.1119820828667413,8930,7930,-1000,28203889,336260.0,두산퓨얼셀보통주
20364,336260,2019-10-22,0.2472067039106145,7160,8930,1770,39020768,336260.0,두산퓨얼셀보통주
20365,336260,2019-10-21,0.2994555353901996,5510,7160,1650,21919889,336260.0,두산퓨얼셀보통주
20366,336260,2019-10-18,0.1601513240857503,7930,5510,-2420,370645,336260.0,두산퓨얼셀보통주
20367,336260,2019-10-23,0.1119820828667413,8930,7930,-1000,28203889,336260.0,두산퓨얼셀보통주
20368,336260,2019-10-22,0.2472067039106145,7160,8930,1770,39020768,336260.0,두산퓨얼셀보통주
20369,336260,2019-10-21,0.2994555353901996,5510,7160,1650,21919889,336260.0,두산퓨얼셀보통주
20370,336260,2019-10-18,0.1601513240857503,7930,5510,-2420,370645,336260.0,두산퓨얼셀보통주
20371,336260,2019-10-23,0.1119820828667413,8930,7930,-1000,28203889,336260.0,두산퓨얼셀보통주
20372,336260,2019-10-22,0.2472067039106145,7160,8930,1770,39020768,336260.0,두산퓨얼셀보통주
20373,336260,2019-10-21,0.2994555353901996,5510,7160,1650,21919889,336260.0,두산퓨얼셀보통주
20374,336260,2019-10-18,0.1601513240857503,7930,5510,-2420,370645,336260.0,두산퓨얼셀보통주
20375,336260,2019-10-23,0.1119820828667413,8930,7930,-1000,28203889,336260.0,두산퓨얼셀보통주
20376,336260,2019-10-22,0.2472067039106145,7160,8930,1770,39020768,336260.0,두산퓨얼셀보통주
20377,336260,2019-10-21,0.2994555353901996,5510,7160,1650,21919889,336260.0,두산퓨얼셀보통주
20378,336260,2019-10-18,0.1601513240857503,7930,5510,-2420,370645,336260.0,두산퓨얼셀보통주
20379,336260,2019-10-23,0.1119820828667413,8930,7930,-1000,28203889,336260.0,두산퓨얼셀보통주
20380,336260,2019-10-22,0.2472067039106145,7160,8930,1770,39020768,336260.0,두산퓨얼셀보통주
20381,336260,2019-10-21,0.2994555353901996,5510,7160,1650,21919889,336260.0,두산퓨얼셀보통주
20382,336260,2019-10-18,0.1601513240857503,7930,5510,-2420,370645,336260.0,두산퓨얼셀보통주
20383,336260,2019-10-23,0.1119820828667413,8930,7930,-1000,28203889,336260.0,두산퓨얼셀보통주
20384,336260,2019-10-22,0.2472067039106145,7160,8930,1770,39020768,336260.0,두산퓨얼셀보통주
20385,336260,2019-10-21,0.2994555353901996,5510,7160,1650,21919889,336260.0,두산퓨얼셀보통주
20386,336260,2019-10-18,0.1601513240857503,7930,5510,-2420,370645,336260.0,두산퓨얼셀보통주
20387,336260,2019-10-23,0.1119820828667413,8930,7930,-1000,28203889,336260.0,두산퓨얼셀보통주
20388,336260,2019-10-22,0.2472067039106145,7160,8930,1770,39020768,336260.0,두산퓨얼셀보통주
20389,336260,2019-10-21,0.2994555353901996,5510,7160,1650,21919889,336260.0,두산퓨얼셀보통주
20390,336260,2019-10-18,0.1601513240857503,7930,5510,-2420,370645,336260.0,두산퓨얼셀보통주
20391,336260,2019-10-23,0.1119820828667413,8930,7930,-1000,28203889,336260.0,두산퓨얼셀보통주
20392,336260,2019-10-22,0.2472067039106145,7160,8930,1770,39020768,336260.0,두산퓨얼셀보통주
20393,336260,2019-10-21,0.2994555353901996,5510,7160,1650,21919889,336260.0,두산퓨얼셀보통주
20394,336260,2019-10-18,0.1601513240857503,7930,5510,-2420,370645,336260.0,두산퓨얼셀보통주
20395,336260,2019-10-23,0.1119820828667413,8930,7930,-1000,28203889,336260.0,두산퓨얼셀보통주
20396,336260,2019-10-22,0.2472067039106145,7160,8930,1770,39020768,336260.0,두산퓨얼셀보통주
20397,336260,2019-10-21,0.2994555353901996,5510,7160,1650,21919889,336260.0,두산퓨얼셀보통주
20398,336260,2019-10-18,0.1601513240857503,7930,5510,-2420,370645,336260.0,두산퓨얼셀보통주
20399,336260,2019-10-23,0.1119820828667413,8930,7930,-1000,28203889,336260.0,두산퓨얼셀보통주
20400,336260,2019-10-22,0.2472067039106145,7160,8930,1770,39020768,336260.0,두산퓨얼셀보통주
20401,336260,2019-10-21,0.2994555353901996,5510,7160,1650,21919889,336260.0,두산퓨얼셀보통주
20402,336260,2019-10-18,0.1601513240857503,7930,5510,-2420,370645,336260.0,두산퓨얼셀보통주
20403,336260,2019-10-23,0.1119820828667413,8930,7930,-1000,28203889,336260.0,두산퓨얼셀보통주
20404,336260,2019-10-22,0.2472067039106145,7160,8930,1770,39020768,336260.0,두산퓨얼셀보통주
20405,336260,2019-10-21,0.2994555353901996,5510,7160,1650,21919889,336260.0,두산퓨얼셀보통주
20406,336260,2019-10-18,0.1601513240857503,7930,5510,-2420,370645,336260.0,두산퓨얼셀보통주
20407,336260,2019-10-23,0.1119820828667413,8930,7930,-1000,28203889,336260.0,두산퓨얼셀보통주
20408,336260,2019-10-22,0.2472067039106145,7160,8930,1770,39020768,336260.0,두산퓨얼셀보통주
20409,336260,2019-10-21,0.2994555353901996,5510,7160,1650,21919889,336260.0,두산퓨얼셀보통주
20410,336260,2019-10-18,0.1601513240857503,7930,5510,-2420,370645,336260.0,두산퓨얼셀보통주
20411,336260,2019-10-23,0.1119820828667413,8930,7930,-1000,28203889,336260.0,두산퓨얼셀보통주
20412,336260,2019-10-22,0.2472067039106145,7160,8930,1770,39020768,336260.0,두산퓨얼셀보통주
20413,336260,2019-10-21,0.2994555353901996,5510,7160,1650,21919889,336260.0,두산퓨얼셀보통주
20414,336260,2019-10-18,0.1601513240857503,7930,5510,-2420,370645,336260.0,두산퓨얼셀보통주
20415,336260,2019-10-23,0.1119820828667413,8930,7930,-1000,28203889,336260.0,두산퓨얼셀보통주
20416,336260,2019-10-22,0.2472067039106145,7160,8930,1770,39020768,336260.0,두산퓨얼셀보통주
20417,336260,2019-10-21,0.2994555353901996,5510,7160,1650,21919889,336260.0,두산퓨얼셀보통주
20418,336260,2019-10-18,0.1601513240857503,7930,5510,-2420,370645,336260.0,두산퓨얼셀보통주
20419,336260,2019-10-23,0.1119820828667413,8930,7930,-1000,28203889,336260.0,두산퓨얼셀보통주
20420,336260,2019-10-22,0.2472067039106145,7160,8930,1770,39020768,336260.0,두산퓨얼셀보통주
20421,336260,2019-10-21,0.2994555353901996,5510,7160,1650,21919889,336260.0,두산퓨얼셀보통주
20422,336260,2019-10-18,0.1601513240857503,7930,5510,-2420,370645,336260.0,두산퓨얼셀보통주
20423,336260,2019-10-23,0.1119820828667413,8930,7930,-1000,28203889,336260.0,두산퓨얼셀보통주
20424,336260,2019-10-22,0.2472067039106145,7160,8930,1770,39020768,336260.0,두산퓨얼셀보통주
20425,336260,2019-10-21,0.2994555353901996,5510,7160,1650,21919889,336260.0,두산퓨얼셀보통주
20426,336260,2019-10-18,0.1601513240857503,7930,5510,-2420,370645,336260.0,두산퓨얼셀보통주
20427,336260,2019-10-23,0.1119820828667413,8930,7930,-1000,28203889,336260.0,두산퓨얼셀보통주
20428,336260,2019-10-22,0.2472067039106145,7160,8930,1770,39020768,336260.0,두산퓨얼셀보통주
20429,336260,2019-10-21,0.2994555353901996,5510,7160,1650,21919889,336260.0,두산퓨얼셀보통주
20430,336260,2019-10-18,0.1601513240857503,7930,5510,-2420,370645,336260.0,두산퓨얼셀보통주
20431,336260,2019-10-23,0.1119820828667413,8930,7930,-1000,28203889,336260.0,두산퓨얼셀보통주
20432,336260,2019-10-22,0.2472067039106145,7160,8930,1770,39020768,336260.0,두산퓨얼셀보통주
20433,336260,2019-10-21,0.2994555353901996,5510,7160,1650,21919889,336260.0,두산퓨얼셀보통주
20434,336260,2019-10-18,0.1601513240857503,7930,5510,-2420,370645,336260.0,두산퓨얼셀보통주
20435,336260,2019-10-23,0.1119820828667413,8930,7930,-1000,28203889,336260.0,두산퓨얼셀보통주
20436,336260,2019-10-22,0.2472067039106145,7160,8930,1770,39020768,336260.0,두산퓨얼셀보통주
20437,336260,2019-10-21,0.2994555353901996,5510,7160,1650,21919889,336260.0,두산퓨얼셀보통주
20438,336260,2019-10-18,0.1601513240857503,7930,5510,-2420,370645,336260.0,두산퓨얼셀보통주
20439,336260,2019-10-23,0.1119820828667413,8930,7930,-1000,28203889,336260.0,두산퓨얼셀보통주
20440,336260,2019-10-22,0.2472067039106145,7160,8930,1770,39020768,336260.0,두산퓨얼셀보통주
20441,336260,2019-10-21,0.2994555353901996,5510,7160,1650,21919889,336260.0,두산퓨얼셀보통주
20442,336260,2019-10-18,0.1601513240857503,7930,5510,-2420,370645,336260.0,두산퓨얼셀보통주
20443,336260,2019-10-23,0.1119820828667413,8930,7930,-1000,28203889,336260.0,두산퓨얼셀보통주
20444,336260,2019-10-22,0.2472067039106145,7160,8930,1770,39020768,336260.0,두산퓨얼셀보통주
20445,336260,2019-10-21,0.2994555353901996,5510,7160,1650,21919889,336260.0,두산퓨얼셀보통주
20446,336260,2019-10-18,0.1601513240857503,7930,5510,-2420,370645,336260.0,두산퓨얼셀보통주
20447,336260,2019-10-23,0.1119820828667413,8930,7930,-1000,28203889,336260.0,두산퓨얼셀보통주
20448,336260,2019-10-22,0.2472067039106145,7160,8930,1770,39020768,336260.0,두산퓨얼셀보통주
20449,336260,2019-10-21,0.2994555353901996,5510,7160,1650,21919889,336260.0,두산퓨얼셀보통주
20450,336260,2019-10-18,0.1601513240857503,7930,5510,-2420,370645,336260.0,두산퓨얼셀보통주
20451,336260,2019-10-23,0.1119820828667413,8930,7930,-1000,28203889,336260.0,두산퓨얼셀보통주
20452,336260,2019-10-22,0.2472067039106145,7160,8930,1770,39020768,336260.0,두산퓨얼셀보통주
20453,336260,2019-10-21,0.2994555353901996,5510,7160,1650,21919889,336260.0,두산퓨얼셀보통주
20454,336260,2019-10-18,0.1601513240857503,7930,5510,-2420,370645,336260.0,두산퓨얼셀보통주
20455,336260,2019-10-23,0.1119820828667413,8930,7930,-1000,28203889,336260.0,두산퓨얼셀보통주
20456,336260,2019-10-22,0.2472067039106145,7160,8930,1770,39020768,336260.0,두산퓨얼셀보통주
20457,336260,2019-10-21,0.2994555353901996,5510,7160,1650,21919889,336260.0,두산퓨얼셀보통주
20458,336260,2019-10-18,0.1601513240857503,7930,5510,-2420,370645,336260.0,두산퓨얼셀보통주
20459,336260,2019-10-23,0.1119820828667413,8930,7930,-1000,28203889,336260.0,두산퓨얼셀보통주
20460,336260,2019-10-22,0.2472067039106145,7160,8930,1770,39020768,336260.0,두산퓨얼셀보통주
20461,336260,2019-10-21,0.2994555353901996,5510,7160,1650,21919889,336260.0,두산퓨얼셀보통주
20462,336260,2019-10-18,0.1601513240857503,7930,5510,-2420,370645,336260.0,두산퓨얼셀보통주
20463,336260,2019-10-23,0.1119820828667413,8930,7930,-1000,28203889,336260.0,두산퓨얼셀보통주
20464,336260,2019-10-22,0.2472067039106145,7160,8930,1770,39020768,336260.0,두산퓨얼셀보통주
20465,336260,2019-10-21,0.2994555353901996,5510,7160,1650,21919889,336260.0,두산퓨얼셀보통주
20466,336260,2019-10-18,0.1601513240857503,7930,5510,-2420,370645,336260.0,두산퓨얼셀보통주
20467,336260,2019-10-23,0.1119820828667413,8930,7930,-1000,28203889,336260.0,두산퓨얼셀보통주
20468,336260,2019-10-22,0.2472067039106145,7160,8930,1770,39020768,336260.0,두산퓨얼셀보통주
20469,336260,2019-10-21,0.2994555353901996,5510,7160,1650,21919889,336260.0,두산퓨얼셀보통주
20470,336260,2019-10-18,0.1601513240857503,7930,5510,-2420,370645,336260.0,두산퓨얼셀보통주
20471,336260,2019-10-23,0.1119820828667413,8930,7930,-1000,28203889,336260.0,두산퓨얼셀보통주
20472,336260,2019-10-22,0.2472067039106145,7160,8930,1770,39020768,336260.0,두산퓨얼셀보통주
20473,336260,2019-10-21,0.2994555353901996,5510,7160,1650,21919889,336260.0,두산퓨얼셀보통주
20474,336260,2019-10-18,0.1601513240857503,7930,5510,-2420,370645,336260.0,두산퓨얼셀보통주
20475,336260,2019-10-23,0.1119820828667413,8930,7930,-1000,28203889,336260.0,두산퓨얼셀보통주
20476,336260,2019-10-22,0.2472067039106145,7160,8930,1770,39020768,336260.0,두산퓨얼셀보통주
20477,336260,2019-10-21,0.2994555353901996,5510,7160,1650,21919889,336260.0,두산퓨얼셀보통주
20478,336260,2019-10-18,0.1601513240857503,7930,5510,-2420,370645,336260.0,두산퓨얼셀보통주
20479,336260,2019-10-23,0.1119820828667413,8930,7930,-1000,28203889,336260.0,두산퓨얼셀보통주
20480,336260,2019-10-22,0.2472067039106145,7160,8930,1770,39020768,336260.0,두산퓨얼셀보통주
20481,336260,2019-10-21,0.2994555353901996,5510,7160,1650,21919889,336260.0,두산퓨얼셀보통주
20482,336260,2019-10-18,0.1601513240857503,7930,5510,-2420,370645,336260.0,두산퓨얼셀보통주
20483,336260,2019-10-23,0.1119820828667413,8930,7930,-1000,28203889,336260.0,두산퓨얼셀보통주
20484,336260,2019-10-22,0.2472067039106145,7160,8930,1770,39020768,336260.0,두산퓨얼셀보통주
20485,336260,2019-10-21,0.2994555353901996,5510,7160,1650,21919889,336260.0,두산퓨얼셀보통주
20486,336260,2019-10-18,0.1601513240857503,7930,5510,-2420,370645,336260.0,두산퓨얼셀보통주
20487,336260,2019-10-23,0.1119820828667413,8930,7930,-1000,28203889,336260.0,두산퓨얼셀보통주
20488,336260,2019-10-22,0.2472067039106145,7160,8930,1770,39020768,336260.0,두산퓨얼셀보통주
20489,336260,2019-10-21,0.2994555353901996,5510,7160,1650,21919889,336260.0,두산퓨얼셀보통주
20490,336260,2019-10-18,0.1601513240857503,7930,5510,-2420,370645,336260.0,두산퓨얼셀보통주
20491,336260,2019-10-23,0.1119820828667413,8930,7930,-1000,28203889,336260.0,두산퓨얼셀보통주
20492,336260,2019-10-22,0.2472067039106145,7160,8930,1770,39020768,336260.0,두산퓨얼셀보통주
20493,336260,2019-10-21,0.2994555353901996,5510,7160,1650,21919889,336260.0,두산퓨얼셀보통주
20494,336260,2019-10-18,0.1601513240857503,7930,5510,-2420,370645,336260.0,두산퓨얼셀보통주
20495,336260,2019-10-23,0.1119820828667413,8930,7930,-1000,28203889,336260.0,두산퓨얼셀보통주
20496,336260,2019-10-22,0.2472067039106145,7160,8930,1770,39020768,336260.0,두산퓨얼셀보통주
20497,336260,2019-10-21,0.2994555353901996,5510,7160,1650,21919889,336260.0,두산퓨얼셀보통주
20498,336260,2019-10-18,0.1601513240857503,7930,5510,-2420,370645,336260.0,두산퓨얼셀보통주
20499,336260,2019-10-23,0.1119820828667413,8930,7930,-1000,28203889,336260.0,두산퓨얼셀보통주
20500,336260,2019-10-22,0.2472067039106145,7160,8930,1770,39020768,336260.0,두산퓨얼셀보통주
20501,336260,2019-10-21,0.2994555353901996,5510,7160,1650,21919889,336260.0,두산퓨얼셀보통주
20502,336260,2019-10-18,0.1601513240857503,7930,5510,-2420,370645,336260.0,두산퓨얼셀보통주
20503,336260,2019-10-23,0.1119820828667413,8930,7930,-1000,28203889,336260.0,두산퓨얼셀보통주
20504,336260,2019-10-22,0.2472067039106145,7160,8930,1770,39020768,336260.0,두산퓨얼셀보통주
20505,336260,2019-10-21,0.2994555353901996,5510,7160,1650,21919889,336260.0,두산퓨얼셀보통주
20506,336260,2019-10-18,0.1601513240857503,7930,5510,-2420,370645,336260.0,두산퓨얼셀보통주
20507,336260,2019-10-23,0.1119820828667413,8930,7930,-1000,28203889,336260.0,두산퓨얼셀보통주
20508,336260,2019-10-22,0.2472067039106145,7160,8930,1770,39020768,336260.0,두산퓨얼셀보통주
20509,336260,2019-10-21,0.2994555353901996,5510,7160,1650,21919889,336260.0,두산퓨얼셀보통주
20510,336260,2019-10-18,0.1601513240857503,7930,5510,-2420,370645,336260.0,두산퓨얼셀보통주
20511,336260,2019-10-23,0.1119820828667413,8930,7930,-1000,28203889,336260.0,두산퓨얼셀보통주
20512,336260,2019-10-22,0.2472067039106145,7160,8930,1770,39020768,336260.0,두산퓨얼셀보통주
20513,336260,2019-10-21,0.2994555353901996,5510,7160,1650,21919889,336260.0,두산퓨얼셀보통주
20514,336260,2019-10-18,0.1601513240857503,7930,5510,-2420,370645,336260.0,두산퓨얼셀보통주
20515,336260,2019-10-23,0.1119820828667413,8930,7930,-1000,28203889,336260.0,두산퓨얼셀보통주
20516,336260,2019-10-22,0.2472067039106145,7160,8930,1770,39020768,336260.0,두산퓨얼셀보통주
20517,336260,2019-10-21,0.2994555353901996,5510,7160,1650,21919889,336260.0,두산퓨얼셀보통주
20518,336260,2019-10-18,0.1601513240857503,7930,5510,-2420,370645,336260.0,두산퓨얼셀보통주
20519,336260,2019-10-23,0.1119820828667413,8930,7930,-1000,28203889,336260.0,두산퓨얼셀보통주
20520,336260,2019-10-22,0.2472067039106145,7160,8930,1770,39020768,336260.0,두산퓨얼셀보통주
20521,336260,2019-10-21,0.2994555353901996,5510,7160,1650,21919889,336260.0,두산퓨얼셀보통주
20522,336260,2019-10-18,0.1601513240857503,7930,5510,-2420,370645,336260.0,두산퓨얼셀보통주
20523,336260,2019-10-23,0.1119820828667413,8930,7930,-1000,28203889,336260.0,두산퓨얼셀보통주
20524,336260,2019-10-22,0.2472067039106145,7160,8930,1770,39020768,336260.0,두산퓨얼셀보통주
20525,336260,2019-10-21,0.2994555353901996,5510,7160,1650,21919889,336260.0,두산퓨얼셀보통주
20526,336260,2019-10-18,0.1601513240857503,7930,5510,-2420,370645,336260.0,두산퓨얼셀보통주
20527,336260,2019-10-23,0.1119820828667413,8930,7930,-1000,28203889,336260.0,두산퓨얼셀보통주
20528,336260,2019-10-22,0.2472067039106145,7160,8930,1770,39020768,336260.0,두산퓨얼셀보통주
20529,336260,2019-10-21,0.2994555353901996,5510,7160,1650,21919889,336260.0,두산퓨얼셀보통주
20530,336260,2019-10-18,0.1601513240857503,7930,5510,-2420,370645,336260.0,두산퓨얼셀보통주
20531,336260,2019-10-23,0.1119820828667413,8930,7930,-1000,28203889,336260.0,두산퓨얼셀보통주
20532,336260,2019-10-22,0.2472067039106145,7160,8930,1770,39020768,336260.0,두산퓨얼셀보통주
20533,336260,2019-10-21,0.2994555353901996,5510,7160,1650,21919889,336260.0,두산퓨얼셀보통주
20534,336260,2019-10-18,0.1601513240857503,7930,5510,-2420,370645,336260.0,두산퓨얼셀보통주
20535,336260,2019-10-23,0.1119820828667413,8930,7930,-1000,28203889,336260.0,두산퓨얼셀보통주
20536,336260,2019-10-22,0.2472067039106145,7160,8930,1770,39020768,336260.0,두산퓨얼셀보통주
20537,336260,2019-10-21,0.2994555353901996,5510,7160,1650,21919889,336260.0,두산퓨얼셀보통주
20538,336260,2019-10-18,0.1601513240857503,7930,5510,-2420,370645,336260.0,두산퓨얼셀보통주
20539,336260,2019-10-23,0.1119820828667413,8930,7930,-1000,28203889,336260.0,두산퓨얼셀보통주
20540,336260,2019-10-22,0.2472067039106145,7160,8930,1770,39020768,336260.0,두산퓨얼셀보통주
20541,336260,2019-10-21,0.2994555353901996,5510,7160,1650,21919889,336260.0,두산퓨얼셀보통주
20542,336260,2019-10-18,0.1601513240857503,7930,5510,-2420,370645,336260.0,두산퓨얼셀보통주
20543,336260,2019-10-23,0.1119820828667413,8930,7930,-1000,28203889,336260.0,두산퓨얼셀보통주
20544,336260,2019-10-22,0.2472067039106145,7160,8930,1770,39020768,336260.0,두산퓨얼셀보통주
20545,336260,2019-10-21,0.2994555353901996,5510,7160,1650,21919889,336260.0,두산퓨얼셀보통주
20546,336260,2019-10-18,0.1601513240857503,7930,5510,-2420,370645,336260.0,두산퓨얼셀보통주
20547,336260,2019-10-23,0.1119820828667413,8930,7930,-1000,28203889,336260.0,두산퓨얼셀보통주
20548,336260,2019-10-22,0.2472067039106145,7160,8930,1770,39020768,336260.0,두산퓨얼셀보통주
20549,336260,2019-10-21,0.2994555353901996,5510,7160,1650,21919889,336260.0,두산퓨얼셀보통주
20550,336260,2019-10-18,0.1601513240857503,7930,5510,-2420,370645,336260.0,두산퓨얼셀보통주
20551,336260,2019-10-23,0.1119820828667413,8930,7930,-1000,28203889,336260.0,두산퓨얼셀보통주
20552,336260,2019-10-22,0.2472067039106145,7160,8930,1770,39020768,336260.0,두산퓨얼셀보통주
20553,336260,2019-10-21,0.2994555353901996,5510,7160,1650,21919889,336260.0,두산퓨얼셀보통주
20554,336260,2019-10-18,0.1601513240857503,7930,5510,-2420,370645,336260.0,두산퓨얼셀보통주
20555,336260,2019-10-23,0.1119820828667413,8930,7930,-1000,28203889,336260.0,두산퓨얼셀보통주
20556,336260,2019-10-22,0.2472067039106145,7160,8930,1770,39020768,336260.0,두산퓨얼셀보통주
20557,336260,2019-10-21,0.2994555353901996,5510,7160,1650,21919889,336260.0,두산퓨얼셀보통주
20558,336260,2019-10-18,0.1601513240857503,7930,5510,-2420,370645,336260.0,두산퓨얼셀보통주
20559,336260,2019-10-23,0.1119820828667413,8930,7930,-1000,28203889,336260.0,두산퓨얼셀보통주
20560,336260,2019-10-22,0.2472067039106145,7160,8930,1770,39020768,336260.0,두산퓨얼셀보통주
20561,336260,2019-10-21,0.2994555353901996,5510,7160,1650,21919889,336260.0,두산퓨얼셀보통주
20562,336260,2019-10-18,0.1601513240857503,7930,5510,-2420,370645,336260.0,두산퓨얼셀보통주
20563,336260,2019-10-23,0.1119820828667413,8930,7930,-1000,28203889,336260.0,두산퓨얼셀보통주
20564,336260,2019-10-22,0.2472067039106145,7160,8930,1770,39020768,336260.0,두산퓨얼셀보통주
20565,336260,2019-10-21,0.2994555353901996,5510,7160,1650,21919889,336260.0,두산퓨얼셀보통주
20566,336260,2019-10-18,0.1601513240857503,7930,5510,-2420,370645,336260.0,두산퓨얼셀보통주
20567,336260,2019-10-23,0.1119820828667413,8930,7930,-1000,28203889,336260.0,두산퓨얼셀보통주
20568,336260,2019-10-22,0.2472067039106145,7160,8930,1770,39020768,336260.0,두산퓨얼셀보통주
20569,336260,2019-10-21,0.2994555353901996,5510,7160,1650,21919889,336260.0,두산퓨얼셀보통주
20570,336260,2019-10-18,0.1601513240857503,7930,5510,-2420,370645,336260.0,두산퓨얼셀보통주
20571,336260,2019-10-23,0.1119820828667413,8930,7930,-1000,28203889,336260.0,두산퓨얼셀보통주
20572,336260,2019-10-22,0.2472067039106145,7160,8930,1770,39020768,336260.0,두산퓨얼셀보통주
20573,336260,2019-10-21,0.2994555353901996,5510,7160,1650,21919889,336260.0,두산퓨얼셀보통주
20574,336260,2019-10-18,0.1601513240857503,7930,5510,-2420,370645,336260.0,두산퓨얼셀보통주
20575,336260,2019-10-23,0.1119820828667413,8930,7930,-1000,28203889,336260.0,두산퓨얼셀보통주
20576,336260,2019-10-22,0.2472067039106145,7160,8930,1770,39020768,336260.0,두산퓨얼셀보통주
20577,336260,2019-10-21,0.2994555353901996,5510,7160,1650,21919889,336260.0,두산퓨얼셀보통주
20578,336370,2021-05-13,0.046816479400749,53400,50900,-2500,546573,336370.0,솔루스첨단소재보통주
20579,336370,2021-05-10,0.055724417426545,49350,52100,2750,917706,336370.0,솔루스첨단소재보통주
20580,336370,2021-04-26,0.048582995951417,49400,51800,2400,1181172,336370.0,솔루스첨단소재보통주
20581,336370,2021-04-22,0.0696132596685082,45250,48400,3150,1059291,336370.0,솔루스첨단소재보통주
20582,336370,2021-04-13,0.0494949494949494,49500,47050,-2450,843062,336370.0,솔루스첨단소재보통주
20583,336370,2021-04-12,0.0622317596566523,46600,49500,2900,919797,336370.0,솔루스첨단소재보통주
20584,336370,2021-03-16,0.0917537746806039,43050,47000,3950,761719,336370.0,솔루스첨단소재보통주
20585,336370,2021-03-04,0.0413043478260869,46000,44100,-1900,374126,336370.0,솔루스첨단소재보통주
20586,336370,2021-02-24,0.0556701030927835,48500,45800,-2700,319018,336370.0,솔루스첨단소재보통주
20587,336370,2021-02-09,0.0534351145038167,52400,49600,-2800,1162492,336370.0,솔루스첨단소재보통주
20588,336370,2021-02-05,0.05175983436853,48300,50800,2500,534013,336370.0,솔루스첨단소재보통주
20589,336370,2021-01-29,0.0524193548387096,49600,47000,-2600,956372,336370.0,솔루스첨단소재보통주
20590,336370,2021-01-28,0.0534351145038167,52400,49600,-2800,863761,336370.0,솔루스첨단소재보통주
20591,336370,2021-01-25,0.0445269016697588,53900,56300,2400,1844348,336370.0,솔루스첨단소재보통주
20592,336370,2020-12-29,0.0439330543933054,47800,49900,2100,692453,336370.0,솔루스첨단소재보통주
20593,336370,2020-12-24,0.093235831809872,54700,49600,-5100,3129896,336370.0,솔루스첨단소재보통주
20594,336370,2020-12-23,0.0662768031189083,51300,54700,3400,1321889,336370.0,솔루스첨단소재보통주
20595,336370,2020-12-22,0.0655737704918032,54900,51300,-3600,1060499,336370.0,솔루스첨단소재보통주
20596,336370,2020-12-18,0.0584795321637426,51300,54300,3000,2248616,336370.0,솔루스첨단소재보통주
20597,336370,2020-12-17,0.0577319587628866,48500,51300,2800,1729112,336370.0,솔루스첨단소재보통주
20598,336370,2020-12-14,0.0400763358778625,52400,50300,-2100,482392,336370.0,솔루스첨단소재보통주
20599,336370,2020-12-08,0.0506822612085769,51300,53900,2600,1246135,336370.0,솔루스첨단소재보통주
20600,336370,2020-11-27,0.0669546436285097,46300,49400,3100,6437149,336370.0,솔루스첨단소재보통주
20601,336370,2020-11-26,0.0498866213151927,44100,46300,2200,1040951,336370.0,솔루스첨단소재보통주
20602,336370,2020-11-25,0.0575539568345323,41700,44100,2400,1358915,336370.0,솔루스첨단소재보통주
20603,336370,2020-11-12,0.0483221476510067,37250,39050,1800,489107,336370.0,솔루스첨단소재보통주
20604,336370,2020-11-02,0.0475435816164817,31550,33050,1500,95283,336370.0,솔루스첨단소재보통주
20605,336370,2020-10-26,0.0659670164917541,33350,31150,-2200,204346,336370.0,솔루스첨단소재보통주
20606,336370,2020-10-15,0.0471698113207547,37100,35350,-1750,342577,336370.0,솔루스첨단소재보통주
20607,336370,2020-09-22,0.065989847715736,39400,42000,2600,546560,336370.0,솔루스첨단소재보통주
20608,336370,2020-09-07,0.0675512665862484,41450,44250,2800,8992049,336370.0,솔루스첨단소재보통주
20609,336370,2020-08-20,0.061271676300578,43250,40600,-2650,697548,336370.0,솔루스첨단소재보통주
20610,336370,2020-08-18,0.0722100656455142,45700,42400,-3300,740491,336370.0,솔루스첨단소재보통주
20611,336370,2020-08-10,0.1221945137157107,40100,45000,4900,2568385,336370.0,솔루스첨단소재보통주
20612,336370,2020-07-28,0.048076923076923,36400,38150,1750,1764085,336370.0,솔루스첨단소재보통주
20613,336370,2020-07-09,0.0595238095238095,33600,35600,2000,765443,336370.0,솔루스첨단소재보통주
20614,336370,2020-07-03,0.079155672823219,37900,34900,-3000,894777,336370.0,솔루스첨단소재보통주
20615,336370,2020-07-02,0.1450151057401812,33100,37900,4800,2405717,336370.0,솔루스첨단소재보통주
20616,336370,2020-06-29,0.0426742532005689,35150,33650,-1500,393358,336370.0,솔루스첨단소재보통주
20617,336370,2020-06-16,0.0521512385919165,38350,40350,2000,1022612,336370.0,솔루스첨단소재보통주
20618,336370,2020-06-15,0.0923076923076923,42250,38350,-3900,1492268,336370.0,솔루스첨단소재보통주
20619,336370,2020-06-12,0.0509950248756218,40200,42250,2050,4397496,336370.0,솔루스첨단소재보통주
20620,336370,2020-06-05,0.0541237113402061,38800,40900,2100,850374,336370.0,솔루스첨단소재보통주
20621,336370,2020-06-04,0.0490196078431372,40800,38800,-2000,1015088,336370.0,솔루스첨단소재보통주
20622,336370,2020-06-03,0.0652920962199312,43650,40800,-2850,1634283,336370.0,솔루스첨단소재보통주
20623,336370,2020-05-29,0.0481622306717363,39450,41350,1900,1017130,336370.0,솔루스첨단소재보통주
20624,336370,2020-05-26,0.056282722513089,38200,40350,2150,3735712,336370.0,솔루스첨단소재보통주
20625,336370,2020-05-25,0.0537931034482758,36250,38200,1950,2504079,336370.0,솔루스첨단소재보통주
20626,336370,2020-05-20,0.0456553755522827,33950,35500,1550,1271124,336370.0,솔루스첨단소재보통주
20627,336370,2020-05-12,0.0424929178470254,35300,33800,-1500,1452514,336370.0,솔루스첨단소재보통주
20628,336370,2020-05-11,0.0745814307458143,32850,35300,2450,6801580,336370.0,솔루스첨단소재보통주
20629,336370,2020-04-27,0.0560131795716639,30350,32050,1700,1407401,336370.0,솔루스첨단소재보통주
20630,336370,2020-04-24,0.0632716049382716,32400,30350,-2050,1086862,336370.0,솔루스첨단소재보통주
20631,336370,2020-04-20,0.0495356037151702,32300,33900,1600,2789412,336370.0,솔루스첨단소재보통주
20632,336370,2020-04-14,0.1365248226950354,28200,32050,3850,5595812,336370.0,솔루스첨단소재보통주
20633,336370,2020-04-10,0.2020497803806735,34150,27250,-6900,6002221,336370.0,솔루스첨단소재보통주
20634,336370,2020-04-09,0.2284172661870503,27800,34150,6350,7397073,336370.0,솔루스첨단소재보통주
20635,336370,2020-04-08,0.1511387163561076,24150,27800,3650,4068815,336370.0,솔루스첨단소재보통주
20636,336370,2020-04-06,0.0560344827586206,23200,24500,1300,970922,336370.0,솔루스첨단소재보통주
20637,336370,2020-04-03,0.1317073170731707,20500,23200,2700,1380113,336370.0,솔루스첨단소재보통주
20638,336370,2020-04-02,0.0539845758354755,19450,20500,1050,505322,336370.0,솔루스첨단소재보통주
20639,336370,2020-04-01,0.05420054200542,18450,19450,1000,1348879,336370.0,솔루스첨단소재보통주
20640,336370,2020-03-25,0.1552238805970149,16750,19350,2600,1324510,336370.0,솔루스첨단소재보통주
20641,336370,2020-03-24,0.0771704180064308,15550,16750,1200,730743,336370.0,솔루스첨단소재보통주
20642,336370,2020-03-23,0.0460122699386503,16300,15550,-750,448821,336370.0,솔루스첨단소재보통주
20643,336370,2020-03-20,0.1319444444444444,14400,16300,1900,999099,336370.0,솔루스첨단소재보통주
20644,336370,2020-03-19,0.1747851002865329,17450,14400,-3050,883442,336370.0,솔루스첨단소재보통주
20645,336370,2020-03-18,0.0693333333333333,18750,17450,-1300,347516,336370.0,솔루스첨단소재보통주
20646,336370,2020-03-16,0.0620155038759689,19350,18150,-1200,476042,336370.0,솔루스첨단소재보통주
20647,336370,2020-03-13,0.042079207920792,20200,19350,-850,832845,336370.0,솔루스첨단소재보통주
20648,336370,2020-03-12,0.1255411255411255,23100,20200,-2900,1208060,336370.0,솔루스첨단소재보통주
20649,336370,2020-03-11,0.1149425287356321,26100,23100,-3000,1003763,336370.0,솔루스첨단소재보통주
20650,336370,2020-03-09,0.0831826401446654,27650,25350,-2300,612049,336370.0,솔루스첨단소재보통주
20651,336370,2020-03-04,0.0674157303370786,26700,28500,1800,678230,336370.0,솔루스첨단소재보통주
20652,336370,2020-03-02,0.0545454545454545,24750,26100,1350,330442,336370.0,솔루스첨단소재보통주
20653,336370,2020-02-28,0.048076923076923,26000,24750,-1250,423934,336370.0,솔루스첨단소재보통주
20654,336370,2020-02-27,0.0441176470588235,27200,26000,-1200,319978,336370.0,솔루스첨단소재보통주
20655,336370,2020-02-25,0.0460652591170825,26050,27250,1200,454823,336370.0,솔루스첨단소재보통주
20656,336370,2020-02-24,0.0492700729927007,27400,26050,-1350,686249,336370.0,솔루스첨단소재보통주
20657,336370,2020-02-12,0.0409982174688057,28050,26900,-1150,717940,336370.0,솔루스첨단소재보통주
20658,336370,2020-02-11,0.0893203883495145,25750,28050,2300,1078780,336370.0,솔루스첨단소재보통주
20659,336370,2020-02-04,0.0897196261682242,26750,29150,2400,1010998,336370.0,솔루스첨단소재보통주
20660,336370,2020-01-31,0.0921739130434782,28750,26100,-2650,702609,336370.0,솔루스첨단소재보통주
20661,336370,2020-01-28,0.0456204379562043,27400,28650,1250,617284,336370.0,솔루스첨단소재보통주
20662,336370,2020-01-22,0.1370449678800856,23350,26550,3200,1399465,336370.0,솔루스첨단소재보통주
20663,336370,2020-01-17,0.0426829268292682,24600,23550,-1050,227285,336370.0,솔루스첨단소재보통주
20664,336370,2020-01-16,0.0603448275862069,23200,24600,1400,406257,336370.0,솔루스첨단소재보통주
20665,336370,2020-01-13,0.0682730923694779,24900,23200,-1700,520084,336370.0,솔루스첨단소재보통주
20666,336370,2020-01-09,0.064516129032258,23250,24750,1500,479258,336370.0,솔루스첨단소재보통주
20667,336370,2020-01-03,0.1041162227602905,20650,22800,2150,1052337,336370.0,솔루스첨단소재보통주
20668,336370,2019-12-27,0.0603674540682414,19050,20200,1150,486922,336370.0,솔루스첨단소재보통주
20669,336370,2019-12-26,0.0583333333333333,18000,19050,1050,390355,336370.0,솔루스첨단소재보통주
20670,336370,2019-12-17,0.0497382198952879,19100,18150,-950,633690,336370.0,솔루스첨단소재보통주
20671,336370,2019-12-04,0.0406091370558375,19700,18900,-800,186359,336370.0,솔루스첨단소재보통주
20672,336370,2019-11-29,0.0452261306532663,19900,19000,-900,439911,336370.0,솔루스첨단소재보통주
20673,336370,2019-11-19,0.0450236966824644,21100,22050,950,771050,336370.0,솔루스첨단소재보통주
20674,336370,2019-11-15,0.0498753117206982,20050,21050,1000,2051376,336370.0,솔루스첨단소재보통주
20675,336370,2019-11-14,0.0442708333333333,19200,20050,850,669800,336370.0,솔루스첨단소재보통주
20676,336370,2019-11-06,0.0798816568047337,16900,18250,1350,931287,336370.0,솔루스첨단소재보통주
20677,336370,2019-11-01,0.0702247191011236,17800,16550,-1250,974913,336370.0,솔루스첨단소재보통주
20678,336370,2019-10-30,0.0701219512195122,16400,17550,1150,2537841,336370.0,솔루스첨단소재보통주
20679,336370,2019-10-24,0.2987551867219917,12050,15650,3600,579507,336370.0,솔루스첨단소재보통주
20680,336370,2019-10-23,0.2956989247311828,9300,12050,2750,154363,336370.0,솔루스첨단소재보통주
20681,336370,2019-10-22,0.2988826815642458,7160,9300,2140,45023,336370.0,솔루스첨단소재보통주
20682,336370,2019-10-21,0.2994555353901996,5510,7160,1650,27340,336370.0,솔루스첨단소재보통주
20683,336370,2019-10-18,0.1053941908713693,12050,5510,-6540,43470,336370.0,솔루스첨단소재보통주
20684,336370,2019-10-23,0.2956989247311828,9300,12050,2750,154363,336370.0,솔루스첨단소재보통주
20685,336370,2019-10-22,0.2988826815642458,7160,9300,2140,45023,336370.0,솔루스첨단소재보통주
20686,336370,2019-10-21,0.2994555353901996,5510,7160,1650,27340,336370.0,솔루스첨단소재보통주
20687,336370,2019-10-18,0.1053941908713693,12050,5510,-6540,43470,336370.0,솔루스첨단소재보통주
20688,336370,2019-10-23,0.2956989247311828,9300,12050,2750,154363,336370.0,솔루스첨단소재보통주
20689,336370,2019-10-22,0.2988826815642458,7160,9300,2140,45023,336370.0,솔루스첨단소재보통주
20690,336370,2019-10-21,0.2994555353901996,5510,7160,1650,27340,336370.0,솔루스첨단소재보통주
20691,336370,2019-10-18,0.1053941908713693,12050,5510,-6540,43470,336370.0,솔루스첨단소재보통주
20692,336370,2019-10-23,0.2956989247311828,9300,12050,2750,154363,336370.0,솔루스첨단소재보통주
20693,336370,2019-10-22,0.2988826815642458,7160,9300,2140,45023,336370.0,솔루스첨단소재보통주
20694,336370,2019-10-21,0.2994555353901996,5510,7160,1650,27340,336370.0,솔루스첨단소재보통주
20695,336370,2019-10-18,0.1053941908713693,12050,5510,-6540,43470,336370.0,솔루스첨단소재보통주
20696,336370,2019-10-23,0.2956989247311828,9300,12050,2750,154363,336370.0,솔루스첨단소재보통주
20697,336370,2019-10-22,0.2988826815642458,7160,9300,2140,45023,336370.0,솔루스첨단소재보통주
20698,336370,2019-10-21,0.2994555353901996,5510,7160,1650,27340,336370.0,솔루스첨단소재보통주
20699,336370,2019-10-18,0.1053941908713693,12050,5510,-6540,43470,336370.0,솔루스첨단소재보통주
20700,336370,2019-10-23,0.2956989247311828,9300,12050,2750,154363,336370.0,솔루스첨단소재보통주
20701,336370,2019-10-22,0.2988826815642458,7160,9300,2140,45023,336370.0,솔루스첨단소재보통주
20702,336370,2019-10-21,0.2994555353901996,5510,7160,1650,27340,336370.0,솔루스첨단소재보통주
20703,336370,2019-10-18,0.1053941908713693,12050,5510,-6540,43470,336370.0,솔루스첨단소재보통주
20704,336370,2019-10-23,0.2956989247311828,9300,12050,2750,154363,336370.0,솔루스첨단소재보통주
20705,336370,2019-10-22,0.2988826815642458,7160,9300,2140,45023,336370.0,솔루스첨단소재보통주
20706,336370,2019-10-21,0.2994555353901996,5510,7160,1650,27340,336370.0,솔루스첨단소재보통주
20707,336370,2019-10-18,0.1053941908713693,12050,5510,-6540,43470,336370.0,솔루스첨단소재보통주
20708,336370,2019-10-23,0.2956989247311828,9300,12050,2750,154363,336370.0,솔루스첨단소재보통주
20709,336370,2019-10-22,0.2988826815642458,7160,9300,2140,45023,336370.0,솔루스첨단소재보통주
20710,336370,2019-10-21,0.2994555353901996,5510,7160,1650,27340,336370.0,솔루스첨단소재보통주
20711,336370,2019-10-18,0.1053941908713693,12050,5510,-6540,43470,336370.0,솔루스첨단소재보통주
20712,336370,2019-10-23,0.2956989247311828,9300,12050,2750,154363,336370.0,솔루스첨단소재보통주
20713,336370,2019-10-22,0.2988826815642458,7160,9300,2140,45023,336370.0,솔루스첨단소재보통주
20714,336370,2019-10-21,0.2994555353901996,5510,7160,1650,27340,336370.0,솔루스첨단소재보통주
20715,336370,2019-10-18,0.1053941908713693,12050,5510,-6540,43470,336370.0,솔루스첨단소재보통주
20716,336370,2019-10-23,0.2956989247311828,9300,12050,2750,154363,336370.0,솔루스첨단소재보통주
20717,336370,2019-10-22,0.2988826815642458,7160,9300,2140,45023,336370.0,솔루스첨단소재보통주
20718,336370,2019-10-21,0.2994555353901996,5510,7160,1650,27340,336370.0,솔루스첨단소재보통주
20719,336370,2019-10-18,0.1053941908713693,12050,5510,-6540,43470,336370.0,솔루스첨단소재보통주
20720,336370,2019-10-23,0.2956989247311828,9300,12050,2750,154363,336370.0,솔루스첨단소재보통주
20721,336370,2019-10-22,0.2988826815642458,7160,9300,2140,45023,336370.0,솔루스첨단소재보통주
20722,336370,2019-10-21,0.2994555353901996,5510,7160,1650,27340,336370.0,솔루스첨단소재보통주
20723,336370,2019-10-18,0.1053941908713693,12050,5510,-6540,43470,336370.0,솔루스첨단소재보통주
20724,336370,2019-10-23,0.2956989247311828,9300,12050,2750,154363,336370.0,솔루스첨단소재보통주
20725,336370,2019-10-22,0.2988826815642458,7160,9300,2140,45023,336370.0,솔루스첨단소재보통주
20726,336370,2019-10-21,0.2994555353901996,5510,7160,1650,27340,336370.0,솔루스첨단소재보통주
20727,336370,2019-10-18,0.1053941908713693,12050,5510,-6540,43470,336370.0,솔루스첨단소재보통주
20728,336370,2019-10-23,0.2956989247311828,9300,12050,2750,154363,336370.0,솔루스첨단소재보통주
20729,336370,2019-10-22,0.2988826815642458,7160,9300,2140,45023,336370.0,솔루스첨단소재보통주
20730,336370,2019-10-21,0.2994555353901996,5510,7160,1650,27340,336370.0,솔루스첨단소재보통주
20731,336370,2019-10-18,0.1053941908713693,12050,5510,-6540,43470,336370.0,솔루스첨단소재보통주
20732,336370,2019-10-23,0.2956989247311828,9300,12050,2750,154363,336370.0,솔루스첨단소재보통주
20733,336370,2019-10-22,0.2988826815642458,7160,9300,2140,45023,336370.0,솔루스첨단소재보통주
20734,336370,2019-10-21,0.2994555353901996,5510,7160,1650,27340,336370.0,솔루스첨단소재보통주
20735,336370,2019-10-18,0.1053941908713693,12050,5510,-6540,43470,336370.0,솔루스첨단소재보통주
20736,336370,2019-10-23,0.2956989247311828,9300,12050,2750,154363,336370.0,솔루스첨단소재보통주
20737,336370,2019-10-22,0.2988826815642458,7160,9300,2140,45023,336370.0,솔루스첨단소재보통주
20738,336370,2019-10-21,0.2994555353901996,5510,7160,1650,27340,336370.0,솔루스첨단소재보통주
20739,336370,2019-10-18,0.1053941908713693,12050,5510,-6540,43470,336370.0,솔루스첨단소재보통주
20740,336370,2019-10-23,0.2956989247311828,9300,12050,2750,154363,336370.0,솔루스첨단소재보통주
20741,336370,2019-10-22,0.2988826815642458,7160,9300,2140,45023,336370.0,솔루스첨단소재보통주
20742,336370,2019-10-21,0.2994555353901996,5510,7160,1650,27340,336370.0,솔루스첨단소재보통주
20743,336370,2019-10-18,0.1053941908713693,12050,5510,-6540,43470,336370.0,솔루스첨단소재보통주
20744,336370,2019-10-23,0.2956989247311828,9300,12050,2750,154363,336370.0,솔루스첨단소재보통주
20745,336370,2019-10-22,0.2988826815642458,7160,9300,2140,45023,336370.0,솔루스첨단소재보통주
20746,336370,2019-10-21,0.2994555353901996,5510,7160,1650,27340,336370.0,솔루스첨단소재보통주
20747,336370,2019-10-18,0.1053941908713693,12050,5510,-6540,43470,336370.0,솔루스첨단소재보통주
20748,336370,2019-10-23,0.2956989247311828,9300,12050,2750,154363,336370.0,솔루스첨단소재보통주
20749,336370,2019-10-22,0.2988826815642458,7160,9300,2140,45023,336370.0,솔루스첨단소재보통주
20750,336370,2019-10-21,0.2994555353901996,5510,7160,1650,27340,336370.0,솔루스첨단소재보통주
20751,336370,2019-10-18,0.1053941908713693,12050,5510,-6540,43470,336370.0,솔루스첨단소재보통주
20752,336370,2019-10-23,0.2956989247311828,9300,12050,2750,154363,336370.0,솔루스첨단소재보통주
20753,336370,2019-10-22,0.2988826815642458,7160,9300,2140,45023,336370.0,솔루스첨단소재보통주
20754,336370,2019-10-21,0.2994555353901996,5510,7160,1650,27340,336370.0,솔루스첨단소재보통주
20755,336370,2019-10-18,0.1053941908713693,12050,5510,-6540,43470,336370.0,솔루스첨단소재보통주
20756,336370,2019-10-23,0.2956989247311828,9300,12050,2750,154363,336370.0,솔루스첨단소재보통주
20757,336370,2019-10-22,0.2988826815642458,7160,9300,2140,45023,336370.0,솔루스첨단소재보통주
20758,336370,2019-10-21,0.2994555353901996,5510,7160,1650,27340,336370.0,솔루스첨단소재보통주
20759,336370,2019-10-18,0.1053941908713693,12050,5510,-6540,43470,336370.0,솔루스첨단소재보통주
20760,336370,2019-10-23,0.2956989247311828,9300,12050,2750,154363,336370.0,솔루스첨단소재보통주
20761,336370,2019-10-22,0.2988826815642458,7160,9300,2140,45023,336370.0,솔루스첨단소재보통주
20762,336370,2019-10-21,0.2994555353901996,5510,7160,1650,27340,336370.0,솔루스첨단소재보통주
20763,336370,2019-10-18,0.1053941908713693,12050,5510,-6540,43470,336370.0,솔루스첨단소재보통주
20764,336370,2019-10-23,0.2956989247311828,9300,12050,2750,154363,336370.0,솔루스첨단소재보통주
20765,336370,2019-10-22,0.2988826815642458,7160,9300,2140,45023,336370.0,솔루스첨단소재보통주
20766,336370,2019-10-21,0.2994555353901996,5510,7160,1650,27340,336370.0,솔루스첨단소재보통주
20767,336370,2019-10-18,0.1053941908713693,12050,5510,-6540,43470,336370.0,솔루스첨단소재보통주
20768,336370,2019-10-23,0.2956989247311828,9300,12050,2750,154363,336370.0,솔루스첨단소재보통주
20769,336370,2019-10-22,0.2988826815642458,7160,9300,2140,45023,336370.0,솔루스첨단소재보통주
20770,336370,2019-10-21,0.2994555353901996,5510,7160,1650,27340,336370.0,솔루스첨단소재보통주
20771,336370,2019-10-18,0.1053941908713693,12050,5510,-6540,43470,336370.0,솔루스첨단소재보통주
20772,336370,2019-10-23,0.2956989247311828,9300,12050,2750,154363,336370.0,솔루스첨단소재보통주
20773,336370,2019-10-22,0.2988826815642458,7160,9300,2140,45023,336370.0,솔루스첨단소재보통주
20774,336370,2019-10-21,0.2994555353901996,5510,7160,1650,27340,336370.0,솔루스첨단소재보통주
20775,336370,2019-10-18,0.1053941908713693,12050,5510,-6540,43470,336370.0,솔루스첨단소재보통주
20776,336370,2019-10-23,0.2956989247311828,9300,12050,2750,154363,336370.0,솔루스첨단소재보통주
20777,336370,2019-10-22,0.2988826815642458,7160,9300,2140,45023,336370.0,솔루스첨단소재보통주
20778,336370,2019-10-21,0.2994555353901996,5510,7160,1650,27340,336370.0,솔루스첨단소재보통주
20779,336370,2019-10-18,0.1053941908713693,12050,5510,-6540,43470,336370.0,솔루스첨단소재보통주
20780,336370,2019-10-23,0.2956989247311828,9300,12050,2750,154363,336370.0,솔루스첨단소재보통주
20781,336370,2019-10-22,0.2988826815642458,7160,9300,2140,45023,336370.0,솔루스첨단소재보통주
20782,336370,2019-10-21,0.2994555353901996,5510,7160,1650,27340,336370.0,솔루스첨단소재보통주
20783,336370,2019-10-18,0.1053941908713693,12050,5510,-6540,43470,336370.0,솔루스첨단소재보통주
20784,336370,2019-10-23,0.2956989247311828,9300,12050,2750,154363,336370.0,솔루스첨단소재보통주
20785,336370,2019-10-22,0.2988826815642458,7160,9300,2140,45023,336370.0,솔루스첨단소재보통주
20786,336370,2019-10-21,0.2994555353901996,5510,7160,1650,27340,336370.0,솔루스첨단소재보통주
20787,336370,2019-10-18,0.1053941908713693,12050,5510,-6540,43470,336370.0,솔루스첨단소재보통주
20788,336370,2019-10-23,0.2956989247311828,9300,12050,2750,154363,336370.0,솔루스첨단소재보통주
20789,336370,2019-10-22,0.2988826815642458,7160,9300,2140,45023,336370.0,솔루스첨단소재보통주
20790,336370,2019-10-21,0.2994555353901996,5510,7160,1650,27340,336370.0,솔루스첨단소재보통주
20791,336370,2019-10-18,0.1053941908713693,12050,5510,-6540,43470,336370.0,솔루스첨단소재보통주
20792,336370,2019-10-23,0.2956989247311828,9300,12050,2750,154363,336370.0,솔루스첨단소재보통주
20793,336370,2019-10-22,0.2988826815642458,7160,9300,2140,45023,336370.0,솔루스첨단소재보통주
20794,336370,2019-10-21,0.2994555353901996,5510,7160,1650,27340,336370.0,솔루스첨단소재보통주
20795,336370,2019-10-18,0.1053941908713693,12050,5510,-6540,43470,336370.0,솔루스첨단소재보통주
20796,336370,2019-10-23,0.2956989247311828,9300,12050,2750,154363,336370.0,솔루스첨단소재보통주
20797,336370,2019-10-22,0.2988826815642458,7160,9300,2140,45023,336370.0,솔루스첨단소재보통주
20798,336370,2019-10-21,0.2994555353901996,5510,7160,1650,27340,336370.0,솔루스첨단소재보통주
20799,336370,2019-10-18,0.1053941908713693,12050,5510,-6540,43470,336370.0,솔루스첨단소재보통주
20800,336370,2019-10-23,0.2956989247311828,9300,12050,2750,154363,336370.0,솔루스첨단소재보통주
20801,336370,2019-10-22,0.2988826815642458,7160,9300,2140,45023,336370.0,솔루스첨단소재보통주
20802,336370,2019-10-21,0.2994555353901996,5510,7160,1650,27340,336370.0,솔루스첨단소재보통주
20803,336370,2019-10-18,0.1053941908713693,12050,5510,-6540,43470,336370.0,솔루스첨단소재보통주
20804,336370,2019-10-23,0.2956989247311828,9300,12050,2750,154363,336370.0,솔루스첨단소재보통주
20805,336370,2019-10-22,0.2988826815642458,7160,9300,2140,45023,336370.0,솔루스첨단소재보통주
20806,336370,2019-10-21,0.2994555353901996,5510,7160,1650,27340,336370.0,솔루스첨단소재보통주
20807,336370,2019-10-18,0.1053941908713693,12050,5510,-6540,43470,336370.0,솔루스첨단소재보통주
20808,336370,2019-10-23,0.2956989247311828,9300,12050,2750,154363,336370.0,솔루스첨단소재보통주
20809,336370,2019-10-22,0.2988826815642458,7160,9300,2140,45023,336370.0,솔루스첨단소재보통주
20810,336370,2019-10-21,0.2994555353901996,5510,7160,1650,27340,336370.0,솔루스첨단소재보통주
20811,336370,2019-10-18,0.1053941908713693,12050,5510,-6540,43470,336370.0,솔루스첨단소재보통주
20812,336370,2019-10-23,0.2956989247311828,9300,12050,2750,154363,336370.0,솔루스첨단소재보통주
20813,336370,2019-10-22,0.2988826815642458,7160,9300,2140,45023,336370.0,솔루스첨단소재보통주
20814,336370,2019-10-21,0.2994555353901996,5510,7160,1650,27340,336370.0,솔루스첨단소재보통주
20815,336370,2019-10-18,0.1053941908713693,12050,5510,-6540,43470,336370.0,솔루스첨단소재보통주
20816,336370,2019-10-23,0.2956989247311828,9300,12050,2750,154363,336370.0,솔루스첨단소재보통주
20817,336370,2019-10-22,0.2988826815642458,7160,9300,2140,45023,336370.0,솔루스첨단소재보통주
20818,336370,2019-10-21,0.2994555353901996,5510,7160,1650,27340,336370.0,솔루스첨단소재보통주
20819,336370,2019-10-18,0.1053941908713693,12050,5510,-6540,43470,336370.0,솔루스첨단소재보통주
20820,336370,2019-10-23,0.2956989247311828,9300,12050,2750,154363,336370.0,솔루스첨단소재보통주
20821,336370,2019-10-22,0.2988826815642458,7160,9300,2140,45023,336370.0,솔루스첨단소재보통주
20822,336370,2019-10-21,0.2994555353901996,5510,7160,1650,27340,336370.0,솔루스첨단소재보통주
20823,336370,2019-10-18,0.1053941908713693,12050,5510,-6540,43470,336370.0,솔루스첨단소재보통주
20824,336370,2019-10-23,0.2956989247311828,9300,12050,2750,154363,336370.0,솔루스첨단소재보통주
20825,336370,2019-10-22,0.2988826815642458,7160,9300,2140,45023,336370.0,솔루스첨단소재보통주
20826,336370,2019-10-21,0.2994555353901996,5510,7160,1650,27340,336370.0,솔루스첨단소재보통주
20827,336370,2019-10-18,0.1053941908713693,12050,5510,-6540,43470,336370.0,솔루스첨단소재보통주
20828,336370,2019-10-23,0.2956989247311828,9300,12050,2750,154363,336370.0,솔루스첨단소재보통주
20829,336370,2019-10-22,0.2988826815642458,7160,9300,2140,45023,336370.0,솔루스첨단소재보통주
20830,336370,2019-10-21,0.2994555353901996,5510,7160,1650,27340,336370.0,솔루스첨단소재보통주
20831,336370,2019-10-18,0.1053941908713693,12050,5510,-6540,43470,336370.0,솔루스첨단소재보통주
20832,336370,2019-10-23,0.2956989247311828,9300,12050,2750,154363,336370.0,솔루스첨단소재보통주
20833,336370,2019-10-22,0.2988826815642458,7160,9300,2140,45023,336370.0,솔루스첨단소재보통주
20834,336370,2019-10-21,0.2994555353901996,5510,7160,1650,27340,336370.0,솔루스첨단소재보통주
20835,336370,2019-10-18,0.1053941908713693,12050,5510,-6540,43470,336370.0,솔루스첨단소재보통주
20836,336370,2019-10-23,0.2956989247311828,9300,12050,2750,154363,336370.0,솔루스첨단소재보통주
20837,336370,2019-10-22,0.2988826815642458,7160,9300,2140,45023,336370.0,솔루스첨단소재보통주
20838,336370,2019-10-21,0.2994555353901996,5510,7160,1650,27340,336370.0,솔루스첨단소재보통주
20839,336370,2019-10-18,0.1053941908713693,12050,5510,-6540,43470,336370.0,솔루스첨단소재보통주
20840,336370,2019-10-23,0.2956989247311828,9300,12050,2750,154363,336370.0,솔루스첨단소재보통주
20841,336370,2019-10-22,0.2988826815642458,7160,9300,2140,45023,336370.0,솔루스첨단소재보통주
20842,336370,2019-10-21,0.2994555353901996,5510,7160,1650,27340,336370.0,솔루스첨단소재보통주
20843,336370,2019-10-18,0.1053941908713693,12050,5510,-6540,43470,336370.0,솔루스첨단소재보통주
20844,336370,2019-10-23,0.2956989247311828,9300,12050,2750,154363,336370.0,솔루스첨단소재보통주
20845,336370,2019-10-22,0.2988826815642458,7160,9300,2140,45023,336370.0,솔루스첨단소재보통주
20846,336370,2019-10-21,0.2994555353901996,5510,7160,1650,27340,336370.0,솔루스첨단소재보통주
20847,336370,2019-10-18,0.1053941908713693,12050,5510,-6540,43470,336370.0,솔루스첨단소재보통주
20848,336370,2019-10-23,0.2956989247311828,9300,12050,2750,154363,336370.0,솔루스첨단소재보통주
20849,336370,2019-10-22,0.2988826815642458,7160,9300,2140,45023,336370.0,솔루스첨단소재보통주
20850,336370,2019-10-21,0.2994555353901996,5510,7160,1650,27340,336370.0,솔루스첨단소재보통주
20851,336370,2019-10-18,0.1053941908713693,12050,5510,-6540,43470,336370.0,솔루스첨단소재보통주
20852,336370,2019-10-23,0.2956989247311828,9300,12050,2750,154363,336370.0,솔루스첨단소재보통주
20853,336370,2019-10-22,0.2988826815642458,7160,9300,2140,45023,336370.0,솔루스첨단소재보통주
20854,336370,2019-10-21,0.2994555353901996,5510,7160,1650,27340,336370.0,솔루스첨단소재보통주
20855,336370,2019-10-18,0.1053941908713693,12050,5510,-6540,43470,336370.0,솔루스첨단소재보통주
20856,336370,2019-10-23,0.2956989247311828,9300,12050,2750,154363,336370.0,솔루스첨단소재보통주
20857,336370,2019-10-22,0.2988826815642458,7160,9300,2140,45023,336370.0,솔루스첨단소재보통주
20858,336370,2019-10-21,0.2994555353901996,5510,7160,1650,27340,336370.0,솔루스첨단소재보통주
20859,336370,2019-10-18,0.1053941908713693,12050,5510,-6540,43470,336370.0,솔루스첨단소재보통주
20860,336370,2019-10-23,0.2956989247311828,9300,12050,2750,154363,336370.0,솔루스첨단소재보통주
20861,336370,2019-10-22,0.2988826815642458,7160,9300,2140,45023,336370.0,솔루스첨단소재보통주
20862,336370,2019-10-21,0.2994555353901996,5510,7160,1650,27340,336370.0,솔루스첨단소재보통주
20863,336370,2019-10-18,0.1053941908713693,12050,5510,-6540,43470,336370.0,솔루스첨단소재보통주
20864,336370,2019-10-23,0.2956989247311828,9300,12050,2750,154363,336370.0,솔루스첨단소재보통주
20865,336370,2019-10-22,0.2988826815642458,7160,9300,2140,45023,336370.0,솔루스첨단소재보통주
20866,336370,2019-10-21,0.2994555353901996,5510,7160,1650,27340,336370.0,솔루스첨단소재보통주
20867,336370,2019-10-18,0.1053941908713693,12050,5510,-6540,43470,336370.0,솔루스첨단소재보통주
20868,336370,2019-10-23,0.2956989247311828,9300,12050,2750,154363,336370.0,솔루스첨단소재보통주
20869,336370,2019-10-22,0.2988826815642458,7160,9300,2140,45023,336370.0,솔루스첨단소재보통주
20870,336370,2019-10-21,0.2994555353901996,5510,7160,1650,27340,336370.0,솔루스첨단소재보통주
20871,336370,2019-10-18,0.1053941908713693,12050,5510,-6540,43470,336370.0,솔루스첨단소재보통주
20872,336370,2019-10-23,0.2956989247311828,9300,12050,2750,154363,336370.0,솔루스첨단소재보통주
20873,336370,2019-10-22,0.2988826815642458,7160,9300,2140,45023,336370.0,솔루스첨단소재보통주
20874,336370,2019-10-21,0.2994555353901996,5510,7160,1650,27340,336370.0,솔루스첨단소재보통주
20875,336370,2019-10-18,0.1053941908713693,12050,5510,-6540,43470,336370.0,솔루스첨단소재보통주
20876,336370,2019-10-23,0.2956989247311828,9300,12050,2750,154363,336370.0,솔루스첨단소재보통주
20877,336370,2019-10-22,0.2988826815642458,7160,9300,2140,45023,336370.0,솔루스첨단소재보통주
20878,336370,2019-10-21,0.2994555353901996,5510,7160,1650,27340,336370.0,솔루스첨단소재보통주
20879,336370,2019-10-18,0.1053941908713693,12050,5510,-6540,43470,336370.0,솔루스첨단소재보통주
20880,336370,2019-10-23,0.2956989247311828,9300,12050,2750,154363,336370.0,솔루스첨단소재보통주
20881,336370,2019-10-22,0.2988826815642458,7160,9300,2140,45023,336370.0,솔루스첨단소재보통주
20882,336370,2019-10-21,0.2994555353901996,5510,7160,1650,27340,336370.0,솔루스첨단소재보통주
20883,336370,2019-10-18,0.1053941908713693,12050,5510,-6540,43470,336370.0,솔루스첨단소재보통주
20884,336370,2019-10-23,0.2956989247311828,9300,12050,2750,154363,336370.0,솔루스첨단소재보통주
20885,336370,2019-10-22,0.2988826815642458,7160,9300,2140,45023,336370.0,솔루스첨단소재보통주
20886,336370,2019-10-21,0.2994555353901996,5510,7160,1650,27340,336370.0,솔루스첨단소재보통주
20887,336370,2019-10-18,0.1053941908713693,12050,5510,-6540,43470,336370.0,솔루스첨단소재보통주
20888,336370,2019-10-23,0.2956989247311828,9300,12050,2750,154363,336370.0,솔루스첨단소재보통주
20889,336370,2019-10-22,0.2988826815642458,7160,9300,2140,45023,336370.0,솔루스첨단소재보통주
20890,336370,2019-10-21,0.2994555353901996,5510,7160,1650,27340,336370.0,솔루스첨단소재보통주
20891,336370,2019-10-18,0.1053941908713693,12050,5510,-6540,43470,336370.0,솔루스첨단소재보통주
20892,336370,2019-10-23,0.2956989247311828,9300,12050,2750,154363,336370.0,솔루스첨단소재보통주
20893,336370,2019-10-22,0.2988826815642458,7160,9300,2140,45023,336370.0,솔루스첨단소재보통주
20894,336370,2019-10-21,0.2994555353901996,5510,7160,1650,27340,336370.0,솔루스첨단소재보통주
20895,336370,2019-10-18,0.1053941908713693,12050,5510,-6540,43470,336370.0,솔루스첨단소재보통주
20896,336370,2019-10-23,0.2956989247311828,9300,12050,2750,154363,336370.0,솔루스첨단소재보통주
20897,336370,2019-10-22,0.2988826815642458,7160,9300,2140,45023,336370.0,솔루스첨단소재보통주
20898,336370,2019-10-21,0.2994555353901996,5510,7160,1650,27340,336370.0,솔루스첨단소재보통주
20899,336370,2019-10-18,0.1053941908713693,12050,5510,-6540,43470,336370.0,솔루스첨단소재보통주
20900,336370,2019-10-23,0.2956989247311828,9300,12050,2750,154363,336370.0,솔루스첨단소재보통주
20901,336370,2019-10-22,0.2988826815642458,7160,9300,2140,45023,336370.0,솔루스첨단소재보통주
20902,336370,2019-10-21,0.2994555353901996,5510,7160,1650,27340,336370.0,솔루스첨단소재보통주
20903,336370,2019-10-18,0.1053941908713693,12050,5510,-6540,43470,336370.0,솔루스첨단소재보통주
20904,336370,2019-10-23,0.2956989247311828,9300,12050,2750,154363,336370.0,솔루스첨단소재보통주
20905,336370,2019-10-22,0.2988826815642458,7160,9300,2140,45023,336370.0,솔루스첨단소재보통주
20906,336370,2019-10-21,0.2994555353901996,5510,7160,1650,27340,336370.0,솔루스첨단소재보통주
20907,336370,2019-10-18,0.1053941908713693,12050,5510,-6540,43470,336370.0,솔루스첨단소재보통주
20908,336370,2019-10-23,0.2956989247311828,9300,12050,2750,154363,336370.0,솔루스첨단소재보통주
20909,336370,2019-10-22,0.2988826815642458,7160,9300,2140,45023,336370.0,솔루스첨단소재보통주
20910,336370,2019-10-21,0.2994555353901996,5510,7160,1650,27340,336370.0,솔루스첨단소재보통주
20911,336370,2019-10-18,0.1053941908713693,12050,5510,-6540,43470,336370.0,솔루스첨단소재보통주
20912,336370,2019-10-23,0.2956989247311828,9300,12050,2750,154363,336370.0,솔루스첨단소재보통주
20913,336370,2019-10-22,0.2988826815642458,7160,9300,2140,45023,336370.0,솔루스첨단소재보통주
20914,336370,2019-10-21,0.2994555353901996,5510,7160,1650,27340,336370.0,솔루스첨단소재보통주
20915,336370,2019-10-18,0.1053941908713693,12050,5510,-6540,43470,336370.0,솔루스첨단소재보통주
20916,336370,2019-10-23,0.2956989247311828,9300,12050,2750,154363,336370.0,솔루스첨단소재보통주
20917,336370,2019-10-22,0.2988826815642458,7160,9300,2140,45023,336370.0,솔루스첨단소재보통주
20918,336370,2019-10-21,0.2994555353901996,5510,7160,1650,27340,336370.0,솔루스첨단소재보통주
20919,336370,2019-10-18,0.1053941908713693,12050,5510,-6540,43470,336370.0,솔루스첨단소재보통주
20920,336370,2019-10-23,0.2956989247311828,9300,12050,2750,154363,336370.0,솔루스첨단소재보통주
20921,336370,2019-10-22,0.2988826815642458,7160,9300,2140,45023,336370.0,솔루스첨단소재보통주
20922,336370,2019-10-21,0.2994555353901996,5510,7160,1650,27340,336370.0,솔루스첨단소재보통주
20923,336370,2019-10-18,0.1053941908713693,12050,5510,-6540,43470,336370.0,솔루스첨단소재보통주
20924,336370,2019-10-23,0.2956989247311828,9300,12050,2750,154363,336370.0,솔루스첨단소재보통주
20925,336370,2019-10-22,0.2988826815642458,7160,9300,2140,45023,336370.0,솔루스첨단소재보통주
20926,336370,2019-10-21,0.2994555353901996,5510,7160,1650,27340,336370.0,솔루스첨단소재보통주
20927,336370,2019-10-18,0.1053941908713693,12050,5510,-6540,43470,336370.0,솔루스첨단소재보통주
20928,336370,2019-10-23,0.2956989247311828,9300,12050,2750,154363,336370.0,솔루스첨단소재보통주
20929,336370,2019-10-22,0.2988826815642458,7160,9300,2140,45023,336370.0,솔루스첨단소재보통주
20930,336370,2019-10-21,0.2994555353901996,5510,7160,1650,27340,336370.0,솔루스첨단소재보통주
20931,336370,2019-10-18,0.1053941908713693,12050,5510,-6540,43470,336370.0,솔루스첨단소재보통주
20932,336370,2019-10-23,0.2956989247311828,9300,12050,2750,154363,336370.0,솔루스첨단소재보통주
20933,336370,2019-10-22,0.2988826815642458,7160,9300,2140,45023,336370.0,솔루스첨단소재보통주
20934,336370,2019-10-21,0.2994555353901996,5510,7160,1650,27340,336370.0,솔루스첨단소재보통주
20935,336370,2019-10-18,0.1053941908713693,12050,5510,-6540,43470,336370.0,솔루스첨단소재보통주
20936,336370,2019-10-23,0.2956989247311828,9300,12050,2750,154363,336370.0,솔루스첨단소재보통주
20937,336370,2019-10-22,0.2988826815642458,7160,9300,2140,45023,336370.0,솔루스첨단소재보통주
20938,336370,2019-10-21,0.2994555353901996,5510,7160,1650,27340,336370.0,솔루스첨단소재보통주
20939,336370,2019-10-18,0.1053941908713693,12050,5510,-6540,43470,336370.0,솔루스첨단소재보통주
20940,336370,2019-10-23,0.2956989247311828,9300,12050,2750,154363,336370.0,솔루스첨단소재보통주
20941,336370,2019-10-22,0.2988826815642458,7160,9300,2140,45023,336370.0,솔루스첨단소재보통주
20942,336370,2019-10-21,0.2994555353901996,5510,7160,1650,27340,336370.0,솔루스첨단소재보통주
20943,336370,2019-10-18,0.1053941908713693,12050,5510,-6540,43470,336370.0,솔루스첨단소재보통주
20944,336370,2019-10-23,0.2956989247311828,9300,12050,2750,154363,336370.0,솔루스첨단소재보통주
20945,336370,2019-10-22,0.2988826815642458,7160,9300,2140,45023,336370.0,솔루스첨단소재보통주
20946,336370,2019-10-21,0.2994555353901996,5510,7160,1650,27340,336370.0,솔루스첨단소재보통주
20947,336370,2019-10-18,0.1053941908713693,12050,5510,-6540,43470,336370.0,솔루스첨단소재보통주
20948,336370,2019-10-23,0.2956989247311828,9300,12050,2750,154363,336370.0,솔루스첨단소재보통주
20949,336370,2019-10-22,0.2988826815642458,7160,9300,2140,45023,336370.0,솔루스첨단소재보통주
20950,336370,2019-10-21,0.2994555353901996,5510,7160,1650,27340,336370.0,솔루스첨단소재보통주
20951,336370,2019-10-18,0.1053941908713693,12050,5510,-6540,43470,336370.0,솔루스첨단소재보통주
20952,336370,2019-10-23,0.2956989247311828,9300,12050,2750,154363,336370.0,솔루스첨단소재보통주
20953,336370,2019-10-22,0.2988826815642458,7160,9300,2140,45023,336370.0,솔루스첨단소재보통주
20954,336370,2019-10-21,0.2994555353901996,5510,7160,1650,27340,336370.0,솔루스첨단소재보통주
20955,336370,2019-10-18,0.1053941908713693,12050,5510,-6540,43470,336370.0,솔루스첨단소재보통주
20956,336370,2019-10-23,0.2956989247311828,9300,12050,2750,154363,336370.0,솔루스첨단소재보통주
20957,336370,2019-10-22,0.2988826815642458,7160,9300,2140,45023,336370.0,솔루스첨단소재보통주
20958,336370,2019-10-21,0.2994555353901996,5510,7160,1650,27340,336370.0,솔루스첨단소재보통주
20959,336370,2019-10-18,0.1053941908713693,12050,5510,-6540,43470,336370.0,솔루스첨단소재보통주
20960,336370,2019-10-23,0.2956989247311828,9300,12050,2750,154363,336370.0,솔루스첨단소재보통주
20961,336370,2019-10-22,0.2988826815642458,7160,9300,2140,45023,336370.0,솔루스첨단소재보통주
20962,336370,2019-10-21,0.2994555353901996,5510,7160,1650,27340,336370.0,솔루스첨단소재보통주
20963,336370,2019-10-18,0.1053941908713693,12050,5510,-6540,43470,336370.0,솔루스첨단소재보통주
20964,336370,2019-10-23,0.2956989247311828,9300,12050,2750,154363,336370.0,솔루스첨단소재보통주
20965,336370,2019-10-22,0.2988826815642458,7160,9300,2140,45023,336370.0,솔루스첨단소재보통주
20966,336370,2019-10-21,0.2994555353901996,5510,7160,1650,27340,336370.0,솔루스첨단소재보통주
20967,336370,2019-10-18,0.1053941908713693,12050,5510,-6540,43470,336370.0,솔루스첨단소재보통주
20968,336370,2019-10-23,0.2956989247311828,9300,12050,2750,154363,336370.0,솔루스첨단소재보통주
20969,336370,2019-10-22,0.2988826815642458,7160,9300,2140,45023,336370.0,솔루스첨단소재보통주
20970,336370,2019-10-21,0.2994555353901996,5510,7160,1650,27340,336370.0,솔루스첨단소재보통주
20971,336370,2019-10-18,0.1053941908713693,12050,5510,-6540,43470,336370.0,솔루스첨단소재보통주
20972,336370,2019-10-23,0.2956989247311828,9300,12050,2750,154363,336370.0,솔루스첨단소재보통주
20973,336370,2019-10-22,0.2988826815642458,7160,9300,2140,45023,336370.0,솔루스첨단소재보통주
20974,336370,2019-10-21,0.2994555353901996,5510,7160,1650,27340,336370.0,솔루스첨단소재보통주
20975,336370,2019-10-18,0.1053941908713693,12050,5510,-6540,43470,336370.0,솔루스첨단소재보통주
20976,336370,2019-10-23,0.2956989247311828,9300,12050,2750,154363,336370.0,솔루스첨단소재보통주
20977,336370,2019-10-22,0.2988826815642458,7160,9300,2140,45023,336370.0,솔루스첨단소재보통주
20978,336370,2019-10-21,0.2994555353901996,5510,7160,1650,27340,336370.0,솔루스첨단소재보통주
20979,336370,2019-10-18,0.1053941908713693,12050,5510,-6540,43470,336370.0,솔루스첨단소재보통주
20980,336370,2019-10-23,0.2956989247311828,9300,12050,2750,154363,336370.0,솔루스첨단소재보통주
20981,336370,2019-10-22,0.2988826815642458,7160,9300,2140,45023,336370.0,솔루스첨단소재보통주
20982,336370,2019-10-21,0.2994555353901996,5510,7160,1650,27340,336370.0,솔루스첨단소재보통주
20983,336370,2019-10-18,0.1053941908713693,12050,5510,-6540,43470,336370.0,솔루스첨단소재보통주
20984,336370,2019-10-23,0.2956989247311828,9300,12050,2750,154363,336370.0,솔루스첨단소재보통주
20985,336370,2019-10-22,0.2988826815642458,7160,9300,2140,45023,336370.0,솔루스첨단소재보통주
20986,336370,2019-10-21,0.2994555353901996,5510,7160,1650,27340,336370.0,솔루스첨단소재보통주
20987,336370,2019-10-18,0.1053941908713693,12050,5510,-6540,43470,336370.0,솔루스첨단소재보통주
20988,336370,2019-10-23,0.2956989247311828,9300,12050,2750,154363,336370.0,솔루스첨단소재보통주
20989,336370,2019-10-22,0.2988826815642458,7160,9300,2140,45023,336370.0,솔루스첨단소재보통주
20990,336370,2019-10-21,0.2994555353901996,5510,7160,1650,27340,336370.0,솔루스첨단소재보통주
20991,336370,2019-10-18,0.1053941908713693,12050,5510,-6540,43470,336370.0,솔루스첨단소재보통주
20992,336370,2019-10-23,0.2956989247311828,9300,12050,2750,154363,336370.0,솔루스첨단소재보통주
20993,336370,2019-10-22,0.2988826815642458,7160,9300,2140,45023,336370.0,솔루스첨단소재보통주
20994,336370,2019-10-21,0.2994555353901996,5510,7160,1650,27340,336370.0,솔루스첨단소재보통주
20995,352820,2021-05-18,0.0482897384305835,248500,260500,12000,395521,352820.0,하이브보통주
20996,352820,2021-05-12,0.0501930501930501,259000,246000,-13000,382142,352820.0,하이브보통주
20997,352820,2021-05-06,0.0480167014613778,239500,251000,11500,264248,352820.0,하이브보통주
20998,352820,2021-04-28,0.046875,256000,244000,-12000,412618,352820.0,하이브보통주
20999,352820,2021-04-22,0.0537190082644628,242000,255000,13000,446672,352820.0,하이브보통주
21000,352820,2021-04-15,0.0615711252653927,235500,250000,14500,1256775,352820.0,하이브보통주
21001,352820,2021-04-14,0.0673267326732673,252500,235500,-17000,1019699,352820.0,하이브보통주
21002,352820,2021-04-07,0.0656370656370656,259000,276000,17000,1032090,352820.0,하이브보통주
21003,352820,2021-04-06,0.0443548387096774,248000,259000,11000,922890,352820.0,하이브보통주
21004,352820,2021-03-25,0.0753424657534246,219000,235500,16500,306749,352820.0,하이브보통주
21005,352820,2021-03-17,0.0547945205479452,219000,231000,12000,387484,352820.0,하이브보통주
21006,352820,2021-03-15,0.043859649122807,228000,218000,-10000,355512,352820.0,하이브보통주
21007,352820,2021-03-12,0.0780141843971631,211500,228000,16500,461596,352820.0,하이브보통주
21008,352820,2021-03-11,0.0958549222797927,193000,211500,18500,446049,352820.0,하이브보통주
21009,352820,2021-02-24,0.0765864332603938,228500,211000,-17500,572749,352820.0,하이브보통주
21010,352820,2021-02-16,0.0949227373068432,226500,248000,21500,935265,352820.0,하이브보통주
21011,352820,2021-02-09,0.0590631364562118,245500,231000,-14500,583871,352820.0,하이브보통주
21012,352820,2021-02-02,0.0689655172413793,217500,232500,15000,1363038,352820.0,하이브보통주
21013,352820,2021-02-01,0.0635696821515892,204500,217500,13000,608089,352820.0,하이브보통주
21014,352820,2021-01-29,0.0704545454545454,220000,204500,-15500,773127,352820.0,하이브보통주
21015,352820,2021-01-28,0.0602409638554216,207500,220000,12500,1653828,352820.0,하이브보통주
21016,352820,2021-01-25,0.0571428571428571,192500,203500,11000,1884652,352820.0,하이브보통주
21017,352820,2021-01-22,0.1127167630057803,173000,192500,19500,2251812,352820.0,하이브보통주
21018,352820,2021-01-19,0.0483383685800604,165500,173500,8000,459733,352820.0,하이브보통주
21019,352820,2021-01-18,0.054140127388535,157000,165500,8500,630687,352820.0,하이브보통주
21020,352820,2021-01-15,0.0542168674698795,166000,157000,-9000,689611,352820.0,하이브보통주
21021,352820,2021-01-13,0.0977198697068403,153500,168500,15000,2079262,352820.0,하이브보통주
21022,352820,2020-12-17,0.0664739884393063,173000,161500,-11500,1122966,352820.0,하이브보통주
21023,352820,2020-12-03,0.0412087912087912,182000,189500,7500,666358,352820.0,하이브보통주
21024,352820,2020-11-17,0.0466472303206997,171500,179500,8000,925185,352820.0,하이브보통주
21025,352820,2020-11-16,0.071875,160000,171500,11500,1162127,352820.0,하이브보통주
21026,352820,2020-11-05,0.1006711409395973,149000,164000,15000,1565701,352820.0,하이브보통주
21027,352820,2020-11-03,0.0592334494773519,143500,152000,8500,689435,352820.0,하이브보통주
21028,352820,2020-10-30,0.0955414012738853,157000,142000,-15000,1142310,352820.0,하이브보통주
21029,352820,2020-10-27,0.0416666666666666,156000,162500,6500,1118487,352820.0,하이브보통주
21030,352820,2020-10-26,0.0956521739130434,172500,156000,-16500,987951,352820.0,하이브보통주
21031,352820,2020-10-23,0.0416666666666666,180000,172500,-7500,905547,352820.0,하이브보통주
21032,352820,2020-10-19,0.0573566084788029,200500,189000,-11500,1977996,352820.0,하이브보통주
21033,352820,2020-10-16,0.2228682170542635,258000,200500,-57500,4504395,352820.0,하이브보통주
21034,352820,2020-10-15,0.0738461538461538,162500,258000,95500,6557212,352820.0,하이브보통주
21035,352820,2020-10-27,0.0416666666666666,156000,162500,6500,1118487,352820.0,하이브보통주
21036,352820,2020-10-26,0.0956521739130434,172500,156000,-16500,987951,352820.0,하이브보통주
21037,352820,2020-10-23,0.0416666666666666,180000,172500,-7500,905547,352820.0,하이브보통주
21038,352820,2020-10-19,0.0573566084788029,200500,189000,-11500,1977996,352820.0,하이브보통주
21039,352820,2020-10-16,0.2228682170542635,258000,200500,-57500,4504395,352820.0,하이브보통주
21040,352820,2020-10-15,0.0738461538461538,162500,258000,95500,6557212,352820.0,하이브보통주
21041,352820,2020-10-27,0.0416666666666666,156000,162500,6500,1118487,352820.0,하이브보통주
21042,352820,2020-10-26,0.0956521739130434,172500,156000,-16500,987951,352820.0,하이브보통주
21043,352820,2020-10-23,0.0416666666666666,180000,172500,-7500,905547,352820.0,하이브보통주
21044,352820,2020-10-19,0.0573566084788029,200500,189000,-11500,1977996,352820.0,하이브보통주
21045,352820,2020-10-16,0.2228682170542635,258000,200500,-57500,4504395,352820.0,하이브보통주
21046,352820,2020-10-15,0.0738461538461538,162500,258000,95500,6557212,352820.0,하이브보통주
21047,352820,2020-10-27,0.0416666666666666,156000,162500,6500,1118487,352820.0,하이브보통주
21048,352820,2020-10-26,0.0956521739130434,172500,156000,-16500,987951,352820.0,하이브보통주
21049,352820,2020-10-23,0.0416666666666666,180000,172500,-7500,905547,352820.0,하이브보통주
21050,352820,2020-10-19,0.0573566084788029,200500,189000,-11500,1977996,352820.0,하이브보통주
21051,352820,2020-10-16,0.2228682170542635,258000,200500,-57500,4504395,352820.0,하이브보통주
21052,352820,2020-10-15,0.0738461538461538,162500,258000,95500,6557212,352820.0,하이브보통주
21053,352820,2020-10-27,0.0416666666666666,156000,162500,6500,1118487,352820.0,하이브보통주
21054,352820,2020-10-26,0.0956521739130434,172500,156000,-16500,987951,352820.0,하이브보통주
21055,352820,2020-10-23,0.0416666666666666,180000,172500,-7500,905547,352820.0,하이브보통주
21056,352820,2020-10-19,0.0573566084788029,200500,189000,-11500,1977996,352820.0,하이브보통주
21057,352820,2020-10-16,0.2228682170542635,258000,200500,-57500,4504395,352820.0,하이브보통주
21058,352820,2020-10-15,0.0738461538461538,162500,258000,95500,6557212,352820.0,하이브보통주
21059,352820,2020-10-27,0.0416666666666666,156000,162500,6500,1118487,352820.0,하이브보통주
21060,352820,2020-10-26,0.0956521739130434,172500,156000,-16500,987951,352820.0,하이브보통주
21061,352820,2020-10-23,0.0416666666666666,180000,172500,-7500,905547,352820.0,하이브보통주
21062,352820,2020-10-19,0.0573566084788029,200500,189000,-11500,1977996,352820.0,하이브보통주
21063,352820,2020-10-16,0.2228682170542635,258000,200500,-57500,4504395,352820.0,하이브보통주
21064,352820,2020-10-15,0.0738461538461538,162500,258000,95500,6557212,352820.0,하이브보통주
21065,352820,2020-10-27,0.0416666666666666,156000,162500,6500,1118487,352820.0,하이브보통주
21066,352820,2020-10-26,0.0956521739130434,172500,156000,-16500,987951,352820.0,하이브보통주
21067,352820,2020-10-23,0.0416666666666666,180000,172500,-7500,905547,352820.0,하이브보통주
21068,352820,2020-10-19,0.0573566084788029,200500,189000,-11500,1977996,352820.0,하이브보통주
21069,352820,2020-10-16,0.2228682170542635,258000,200500,-57500,4504395,352820.0,하이브보통주
21070,352820,2020-10-15,0.0738461538461538,162500,258000,95500,6557212,352820.0,하이브보통주
21071,352820,2020-10-27,0.0416666666666666,156000,162500,6500,1118487,352820.0,하이브보통주
21072,352820,2020-10-26,0.0956521739130434,172500,156000,-16500,987951,352820.0,하이브보통주
21073,352820,2020-10-23,0.0416666666666666,180000,172500,-7500,905547,352820.0,하이브보통주
21074,352820,2020-10-19,0.0573566084788029,200500,189000,-11500,1977996,352820.0,하이브보통주
21075,352820,2020-10-16,0.2228682170542635,258000,200500,-57500,4504395,352820.0,하이브보통주
21076,352820,2020-10-15,0.0738461538461538,162500,258000,95500,6557212,352820.0,하이브보통주
21077,352820,2020-10-27,0.0416666666666666,156000,162500,6500,1118487,352820.0,하이브보통주
21078,352820,2020-10-26,0.0956521739130434,172500,156000,-16500,987951,352820.0,하이브보통주
21079,352820,2020-10-23,0.0416666666666666,180000,172500,-7500,905547,352820.0,하이브보통주
21080,352820,2020-10-19,0.0573566084788029,200500,189000,-11500,1977996,352820.0,하이브보통주
21081,352820,2020-10-16,0.2228682170542635,258000,200500,-57500,4504395,352820.0,하이브보통주
21082,352820,2020-10-15,0.0738461538461538,162500,258000,95500,6557212,352820.0,하이브보통주
21083,352820,2020-10-27,0.0416666666666666,156000,162500,6500,1118487,352820.0,하이브보통주
21084,352820,2020-10-26,0.0956521739130434,172500,156000,-16500,987951,352820.0,하이브보통주
21085,352820,2020-10-23,0.0416666666666666,180000,172500,-7500,905547,352820.0,하이브보통주
21086,352820,2020-10-19,0.0573566084788029,200500,189000,-11500,1977996,352820.0,하이브보통주
21087,352820,2020-10-16,0.2228682170542635,258000,200500,-57500,4504395,352820.0,하이브보통주
21088,352820,2020-10-15,0.0738461538461538,162500,258000,95500,6557212,352820.0,하이브보통주
21089,352820,2020-10-27,0.0416666666666666,156000,162500,6500,1118487,352820.0,하이브보통주
21090,352820,2020-10-26,0.0956521739130434,172500,156000,-16500,987951,352820.0,하이브보통주
21091,352820,2020-10-23,0.0416666666666666,180000,172500,-7500,905547,352820.0,하이브보통주
21092,352820,2020-10-19,0.0573566084788029,200500,189000,-11500,1977996,352820.0,하이브보통주
21093,352820,2020-10-16,0.2228682170542635,258000,200500,-57500,4504395,352820.0,하이브보통주
21094,352820,2020-10-15,0.0738461538461538,162500,258000,95500,6557212,352820.0,하이브보통주
21095,352820,2020-10-27,0.0416666666666666,156000,162500,6500,1118487,352820.0,하이브보통주
21096,352820,2020-10-26,0.0956521739130434,172500,156000,-16500,987951,352820.0,하이브보통주
21097,352820,2020-10-23,0.0416666666666666,180000,172500,-7500,905547,352820.0,하이브보통주
21098,352820,2020-10-19,0.0573566084788029,200500,189000,-11500,1977996,352820.0,하이브보통주
21099,352820,2020-10-16,0.2228682170542635,258000,200500,-57500,4504395,352820.0,하이브보통주
21100,352820,2020-10-15,0.0738461538461538,162500,258000,95500,6557212,352820.0,하이브보통주
21101,352820,2020-10-27,0.0416666666666666,156000,162500,6500,1118487,352820.0,하이브보통주
21102,352820,2020-10-26,0.0956521739130434,172500,156000,-16500,987951,352820.0,하이브보통주
21103,352820,2020-10-23,0.0416666666666666,180000,172500,-7500,905547,352820.0,하이브보통주
21104,352820,2020-10-19,0.0573566084788029,200500,189000,-11500,1977996,352820.0,하이브보통주
21105,352820,2020-10-16,0.2228682170542635,258000,200500,-57500,4504395,352820.0,하이브보통주
21106,352820,2020-10-15,0.0738461538461538,162500,258000,95500,6557212,352820.0,하이브보통주
21107,352820,2020-10-27,0.0416666666666666,156000,162500,6500,1118487,352820.0,하이브보통주
21108,352820,2020-10-26,0.0956521739130434,172500,156000,-16500,987951,352820.0,하이브보통주
21109,352820,2020-10-23,0.0416666666666666,180000,172500,-7500,905547,352820.0,하이브보통주
21110,352820,2020-10-19,0.0573566084788029,200500,189000,-11500,1977996,352820.0,하이브보통주
21111,352820,2020-10-16,0.2228682170542635,258000,200500,-57500,4504395,352820.0,하이브보통주
21112,352820,2020-10-15,0.0738461538461538,162500,258000,95500,6557212,352820.0,하이브보통주
21113,352820,2020-10-27,0.0416666666666666,156000,162500,6500,1118487,352820.0,하이브보통주
21114,352820,2020-10-26,0.0956521739130434,172500,156000,-16500,987951,352820.0,하이브보통주
21115,352820,2020-10-23,0.0416666666666666,180000,172500,-7500,905547,352820.0,하이브보통주
21116,352820,2020-10-19,0.0573566084788029,200500,189000,-11500,1977996,352820.0,하이브보통주
21117,352820,2020-10-16,0.2228682170542635,258000,200500,-57500,4504395,352820.0,하이브보통주
21118,352820,2020-10-15,0.0738461538461538,162500,258000,95500,6557212,352820.0,하이브보통주
21119,352820,2020-10-27,0.0416666666666666,156000,162500,6500,1118487,352820.0,하이브보통주
21120,352820,2020-10-26,0.0956521739130434,172500,156000,-16500,987951,352820.0,하이브보통주
21121,352820,2020-10-23,0.0416666666666666,180000,172500,-7500,905547,352820.0,하이브보통주
21122,352820,2020-10-19,0.0573566084788029,200500,189000,-11500,1977996,352820.0,하이브보통주
21123,352820,2020-10-16,0.2228682170542635,258000,200500,-57500,4504395,352820.0,하이브보통주
21124,352820,2020-10-15,0.0738461538461538,162500,258000,95500,6557212,352820.0,하이브보통주
21125,352820,2020-10-27,0.0416666666666666,156000,162500,6500,1118487,352820.0,하이브보통주
21126,352820,2020-10-26,0.0956521739130434,172500,156000,-16500,987951,352820.0,하이브보통주
21127,352820,2020-10-23,0.0416666666666666,180000,172500,-7500,905547,352820.0,하이브보통주
21128,352820,2020-10-19,0.0573566084788029,200500,189000,-11500,1977996,352820.0,하이브보통주
21129,352820,2020-10-16,0.2228682170542635,258000,200500,-57500,4504395,352820.0,하이브보통주
21130,352820,2020-10-15,0.0738461538461538,162500,258000,95500,6557212,352820.0,하이브보통주
21131,352820,2020-10-27,0.0416666666666666,156000,162500,6500,1118487,352820.0,하이브보통주
21132,352820,2020-10-26,0.0956521739130434,172500,156000,-16500,987951,352820.0,하이브보통주
21133,352820,2020-10-23,0.0416666666666666,180000,172500,-7500,905547,352820.0,하이브보통주
21134,352820,2020-10-19,0.0573566084788029,200500,189000,-11500,1977996,352820.0,하이브보통주
21135,352820,2020-10-16,0.2228682170542635,258000,200500,-57500,4504395,352820.0,하이브보통주
21136,352820,2020-10-15,0.0738461538461538,162500,258000,95500,6557212,352820.0,하이브보통주
21137,352820,2020-10-27,0.0416666666666666,156000,162500,6500,1118487,352820.0,하이브보통주
21138,352820,2020-10-26,0.0956521739130434,172500,156000,-16500,987951,352820.0,하이브보통주
21139,352820,2020-10-23,0.0416666666666666,180000,172500,-7500,905547,352820.0,하이브보통주
21140,352820,2020-10-19,0.0573566084788029,200500,189000,-11500,1977996,352820.0,하이브보통주
21141,352820,2020-10-16,0.2228682170542635,258000,200500,-57500,4504395,352820.0,하이브보통주
21142,352820,2020-10-15,0.0738461538461538,162500,258000,95500,6557212,352820.0,하이브보통주
21143,352820,2020-10-27,0.0416666666666666,156000,162500,6500,1118487,352820.0,하이브보통주
21144,352820,2020-10-26,0.0956521739130434,172500,156000,-16500,987951,352820.0,하이브보통주
21145,352820,2020-10-23,0.0416666666666666,180000,172500,-7500,905547,352820.0,하이브보통주
21146,352820,2020-10-19,0.0573566084788029,200500,189000,-11500,1977996,352820.0,하이브보통주
21147,352820,2020-10-16,0.2228682170542635,258000,200500,-57500,4504395,352820.0,하이브보통주
21148,352820,2020-10-15,0.0738461538461538,162500,258000,95500,6557212,352820.0,하이브보통주
21149,352820,2020-10-27,0.0416666666666666,156000,162500,6500,1118487,352820.0,하이브보통주
21150,352820,2020-10-26,0.0956521739130434,172500,156000,-16500,987951,352820.0,하이브보통주
21151,352820,2020-10-23,0.0416666666666666,180000,172500,-7500,905547,352820.0,하이브보통주
21152,352820,2020-10-19,0.0573566084788029,200500,189000,-11500,1977996,352820.0,하이브보통주
21153,352820,2020-10-16,0.2228682170542635,258000,200500,-57500,4504395,352820.0,하이브보통주
21154,352820,2020-10-15,0.0738461538461538,162500,258000,95500,6557212,352820.0,하이브보통주
21155,352820,2020-10-27,0.0416666666666666,156000,162500,6500,1118487,352820.0,하이브보통주
21156,352820,2020-10-26,0.0956521739130434,172500,156000,-16500,987951,352820.0,하이브보통주
21157,352820,2020-10-23,0.0416666666666666,180000,172500,-7500,905547,352820.0,하이브보통주
21158,352820,2020-10-19,0.0573566084788029,200500,189000,-11500,1977996,352820.0,하이브보통주
21159,352820,2020-10-16,0.2228682170542635,258000,200500,-57500,4504395,352820.0,하이브보통주
21160,352820,2020-10-15,0.0738461538461538,162500,258000,95500,6557212,352820.0,하이브보통주
21161,352820,2020-10-27,0.0416666666666666,156000,162500,6500,1118487,352820.0,하이브보통주
21162,352820,2020-10-26,0.0956521739130434,172500,156000,-16500,987951,352820.0,하이브보통주
21163,352820,2020-10-23,0.0416666666666666,180000,172500,-7500,905547,352820.0,하이브보통주
21164,352820,2020-10-19,0.0573566084788029,200500,189000,-11500,1977996,352820.0,하이브보통주
21165,352820,2020-10-16,0.2228682170542635,258000,200500,-57500,4504395,352820.0,하이브보통주
21166,352820,2020-10-15,0.0738461538461538,162500,258000,95500,6557212,352820.0,하이브보통주
21167,352820,2020-10-27,0.0416666666666666,156000,162500,6500,1118487,352820.0,하이브보통주
21168,352820,2020-10-26,0.0956521739130434,172500,156000,-16500,987951,352820.0,하이브보통주
21169,352820,2020-10-23,0.0416666666666666,180000,172500,-7500,905547,352820.0,하이브보통주
21170,352820,2020-10-19,0.0573566084788029,200500,189000,-11500,1977996,352820.0,하이브보통주
21171,352820,2020-10-16,0.2228682170542635,258000,200500,-57500,4504395,352820.0,하이브보통주
21172,352820,2020-10-15,0.0738461538461538,162500,258000,95500,6557212,352820.0,하이브보통주
21173,352820,2020-10-27,0.0416666666666666,156000,162500,6500,1118487,352820.0,하이브보통주
21174,352820,2020-10-26,0.0956521739130434,172500,156000,-16500,987951,352820.0,하이브보통주
21175,352820,2020-10-23,0.0416666666666666,180000,172500,-7500,905547,352820.0,하이브보통주
21176,352820,2020-10-19,0.0573566084788029,200500,189000,-11500,1977996,352820.0,하이브보통주
21177,352820,2020-10-16,0.2228682170542635,258000,200500,-57500,4504395,352820.0,하이브보통주
21178,352820,2020-10-15,0.0738461538461538,162500,258000,95500,6557212,352820.0,하이브보통주
21179,352820,2020-10-27,0.0416666666666666,156000,162500,6500,1118487,352820.0,하이브보통주
21180,352820,2020-10-26,0.0956521739130434,172500,156000,-16500,987951,352820.0,하이브보통주
21181,352820,2020-10-23,0.0416666666666666,180000,172500,-7500,905547,352820.0,하이브보통주
21182,352820,2020-10-19,0.0573566084788029,200500,189000,-11500,1977996,352820.0,하이브보통주
21183,352820,2020-10-16,0.2228682170542635,258000,200500,-57500,4504395,352820.0,하이브보통주
21184,352820,2020-10-15,0.0738461538461538,162500,258000,95500,6557212,352820.0,하이브보통주
21185,352820,2020-10-27,0.0416666666666666,156000,162500,6500,1118487,352820.0,하이브보통주
21186,352820,2020-10-26,0.0956521739130434,172500,156000,-16500,987951,352820.0,하이브보통주
21187,352820,2020-10-23,0.0416666666666666,180000,172500,-7500,905547,352820.0,하이브보통주
21188,352820,2020-10-19,0.0573566084788029,200500,189000,-11500,1977996,352820.0,하이브보통주
21189,352820,2020-10-16,0.2228682170542635,258000,200500,-57500,4504395,352820.0,하이브보통주
21190,352820,2020-10-15,0.0738461538461538,162500,258000,95500,6557212,352820.0,하이브보통주
21191,352820,2020-10-27,0.0416666666666666,156000,162500,6500,1118487,352820.0,하이브보통주
21192,352820,2020-10-26,0.0956521739130434,172500,156000,-16500,987951,352820.0,하이브보통주
21193,352820,2020-10-23,0.0416666666666666,180000,172500,-7500,905547,352820.0,하이브보통주
21194,352820,2020-10-19,0.0573566084788029,200500,189000,-11500,1977996,352820.0,하이브보통주
21195,352820,2020-10-16,0.2228682170542635,258000,200500,-57500,4504395,352820.0,하이브보통주
21196,352820,2020-10-15,0.0738461538461538,162500,258000,95500,6557212,352820.0,하이브보통주
21197,352820,2020-10-27,0.0416666666666666,156000,162500,6500,1118487,352820.0,하이브보통주
21198,352820,2020-10-26,0.0956521739130434,172500,156000,-16500,987951,352820.0,하이브보통주
21199,352820,2020-10-23,0.0416666666666666,180000,172500,-7500,905547,352820.0,하이브보통주
21200,352820,2020-10-19,0.0573566084788029,200500,189000,-11500,1977996,352820.0,하이브보통주
21201,352820,2020-10-16,0.2228682170542635,258000,200500,-57500,4504395,352820.0,하이브보통주
21202,352820,2020-10-15,0.0738461538461538,162500,258000,95500,6557212,352820.0,하이브보통주
21203,352820,2020-10-27,0.0416666666666666,156000,162500,6500,1118487,352820.0,하이브보통주
21204,352820,2020-10-26,0.0956521739130434,172500,156000,-16500,987951,352820.0,하이브보통주
21205,352820,2020-10-23,0.0416666666666666,180000,172500,-7500,905547,352820.0,하이브보통주
21206,352820,2020-10-19,0.0573566084788029,200500,189000,-11500,1977996,352820.0,하이브보통주
21207,352820,2020-10-16,0.2228682170542635,258000,200500,-57500,4504395,352820.0,하이브보통주
21208,352820,2020-10-15,0.0738461538461538,162500,258000,95500,6557212,352820.0,하이브보통주
21209,352820,2020-10-27,0.0416666666666666,156000,162500,6500,1118487,352820.0,하이브보통주
21210,352820,2020-10-26,0.0956521739130434,172500,156000,-16500,987951,352820.0,하이브보통주
21211,352820,2020-10-23,0.0416666666666666,180000,172500,-7500,905547,352820.0,하이브보통주
21212,352820,2020-10-19,0.0573566084788029,200500,189000,-11500,1977996,352820.0,하이브보통주
21213,352820,2020-10-16,0.2228682170542635,258000,200500,-57500,4504395,352820.0,하이브보통주
21214,352820,2020-10-15,0.0738461538461538,162500,258000,95500,6557212,352820.0,하이브보통주
21215,352820,2020-10-27,0.0416666666666666,156000,162500,6500,1118487,352820.0,하이브보통주
21216,352820,2020-10-26,0.0956521739130434,172500,156000,-16500,987951,352820.0,하이브보통주
21217,352820,2020-10-23,0.0416666666666666,180000,172500,-7500,905547,352820.0,하이브보통주
21218,352820,2020-10-19,0.0573566084788029,200500,189000,-11500,1977996,352820.0,하이브보통주
21219,352820,2020-10-16,0.2228682170542635,258000,200500,-57500,4504395,352820.0,하이브보통주
21220,352820,2020-10-15,0.0738461538461538,162500,258000,95500,6557212,352820.0,하이브보통주
21221,352820,2020-10-27,0.0416666666666666,156000,162500,6500,1118487,352820.0,하이브보통주
21222,352820,2020-10-26,0.0956521739130434,172500,156000,-16500,987951,352820.0,하이브보통주
21223,352820,2020-10-23,0.0416666666666666,180000,172500,-7500,905547,352820.0,하이브보통주
21224,352820,2020-10-19,0.0573566084788029,200500,189000,-11500,1977996,352820.0,하이브보통주
21225,352820,2020-10-16,0.2228682170542635,258000,200500,-57500,4504395,352820.0,하이브보통주
21226,352820,2020-10-15,0.0738461538461538,162500,258000,95500,6557212,352820.0,하이브보통주
21227,352820,2020-10-27,0.0416666666666666,156000,162500,6500,1118487,352820.0,하이브보통주
21228,352820,2020-10-26,0.0956521739130434,172500,156000,-16500,987951,352820.0,하이브보통주
21229,352820,2020-10-23,0.0416666666666666,180000,172500,-7500,905547,352820.0,하이브보통주
21230,352820,2020-10-19,0.0573566084788029,200500,189000,-11500,1977996,352820.0,하이브보통주
21231,352820,2020-10-16,0.2228682170542635,258000,200500,-57500,4504395,352820.0,하이브보통주
21232,352820,2020-10-15,0.0738461538461538,162500,258000,95500,6557212,352820.0,하이브보통주
21233,352820,2020-10-27,0.0416666666666666,156000,162500,6500,1118487,352820.0,하이브보통주
21234,352820,2020-10-26,0.0956521739130434,172500,156000,-16500,987951,352820.0,하이브보통주
21235,352820,2020-10-23,0.0416666666666666,180000,172500,-7500,905547,352820.0,하이브보통주
21236,352820,2020-10-19,0.0573566084788029,200500,189000,-11500,1977996,352820.0,하이브보통주
21237,352820,2020-10-16,0.2228682170542635,258000,200500,-57500,4504395,352820.0,하이브보통주
21238,352820,2020-10-15,0.0738461538461538,162500,258000,95500,6557212,352820.0,하이브보통주
21239,352820,2020-10-27,0.0416666666666666,156000,162500,6500,1118487,352820.0,하이브보통주
21240,352820,2020-10-26,0.0956521739130434,172500,156000,-16500,987951,352820.0,하이브보통주
21241,352820,2020-10-23,0.0416666666666666,180000,172500,-7500,905547,352820.0,하이브보통주
21242,352820,2020-10-19,0.0573566084788029,200500,189000,-11500,1977996,352820.0,하이브보통주
21243,352820,2020-10-16,0.2228682170542635,258000,200500,-57500,4504395,352820.0,하이브보통주
21244,352820,2020-10-15,0.0738461538461538,162500,258000,95500,6557212,352820.0,하이브보통주
21245,352820,2020-10-27,0.0416666666666666,156000,162500,6500,1118487,352820.0,하이브보통주
21246,352820,2020-10-26,0.0956521739130434,172500,156000,-16500,987951,352820.0,하이브보통주
21247,352820,2020-10-23,0.0416666666666666,180000,172500,-7500,905547,352820.0,하이브보통주
21248,352820,2020-10-19,0.0573566084788029,200500,189000,-11500,1977996,352820.0,하이브보통주
21249,352820,2020-10-16,0.2228682170542635,258000,200500,-57500,4504395,352820.0,하이브보통주
21250,352820,2020-10-15,0.0738461538461538,162500,258000,95500,6557212,352820.0,하이브보통주
21251,352820,2020-10-27,0.0416666666666666,156000,162500,6500,1118487,352820.0,하이브보통주
21252,352820,2020-10-26,0.0956521739130434,172500,156000,-16500,987951,352820.0,하이브보통주
21253,352820,2020-10-23,0.0416666666666666,180000,172500,-7500,905547,352820.0,하이브보통주
21254,352820,2020-10-19,0.0573566084788029,200500,189000,-11500,1977996,352820.0,하이브보통주
21255,352820,2020-10-16,0.2228682170542635,258000,200500,-57500,4504395,352820.0,하이브보통주
21256,352820,2020-10-15,0.0738461538461538,162500,258000,95500,6557212,352820.0,하이브보통주
21257,352820,2020-10-27,0.0416666666666666,156000,162500,6500,1118487,352820.0,하이브보통주
21258,352820,2020-10-26,0.0956521739130434,172500,156000,-16500,987951,352820.0,하이브보통주
21259,352820,2020-10-23,0.0416666666666666,180000,172500,-7500,905547,352820.0,하이브보통주
21260,352820,2020-10-19,0.0573566084788029,200500,189000,-11500,1977996,352820.0,하이브보통주
21261,352820,2020-10-16,0.2228682170542635,258000,200500,-57500,4504395,352820.0,하이브보통주
21262,352820,2020-10-15,0.0738461538461538,162500,258000,95500,6557212,352820.0,하이브보통주
21263,352820,2020-10-27,0.0416666666666666,156000,162500,6500,1118487,352820.0,하이브보통주
21264,352820,2020-10-26,0.0956521739130434,172500,156000,-16500,987951,352820.0,하이브보통주
21265,352820,2020-10-23,0.0416666666666666,180000,172500,-7500,905547,352820.0,하이브보통주
21266,352820,2020-10-19,0.0573566084788029,200500,189000,-11500,1977996,352820.0,하이브보통주
21267,352820,2020-10-16,0.2228682170542635,258000,200500,-57500,4504395,352820.0,하이브보통주
21268,352820,2020-10-15,0.0738461538461538,162500,258000,95500,6557212,352820.0,하이브보통주
21269,352820,2020-10-27,0.0416666666666666,156000,162500,6500,1118487,352820.0,하이브보통주
21270,352820,2020-10-26,0.0956521739130434,172500,156000,-16500,987951,352820.0,하이브보통주
21271,352820,2020-10-23,0.0416666666666666,180000,172500,-7500,905547,352820.0,하이브보통주
21272,352820,2020-10-19,0.0573566084788029,200500,189000,-11500,1977996,352820.0,하이브보통주
21273,352820,2020-10-16,0.2228682170542635,258000,200500,-57500,4504395,352820.0,하이브보통주
21274,352820,2020-10-15,0.0738461538461538,162500,258000,95500,6557212,352820.0,하이브보통주
21275,352820,2020-10-27,0.0416666666666666,156000,162500,6500,1118487,352820.0,하이브보통주
21276,352820,2020-10-26,0.0956521739130434,172500,156000,-16500,987951,352820.0,하이브보통주
21277,352820,2020-10-23,0.0416666666666666,180000,172500,-7500,905547,352820.0,하이브보통주
21278,352820,2020-10-19,0.0573566084788029,200500,189000,-11500,1977996,352820.0,하이브보통주
21279,352820,2020-10-16,0.2228682170542635,258000,200500,-57500,4504395,352820.0,하이브보통주
21280,352820,2020-10-15,0.0738461538461538,162500,258000,95500,6557212,352820.0,하이브보통주
21281,352820,2020-10-27,0.0416666666666666,156000,162500,6500,1118487,352820.0,하이브보통주
21282,352820,2020-10-26,0.0956521739130434,172500,156000,-16500,987951,352820.0,하이브보통주
21283,352820,2020-10-23,0.0416666666666666,180000,172500,-7500,905547,352820.0,하이브보통주
21284,352820,2020-10-19,0.0573566084788029,200500,189000,-11500,1977996,352820.0,하이브보통주
21285,352820,2020-10-16,0.2228682170542635,258000,200500,-57500,4504395,352820.0,하이브보통주
21286,352820,2020-10-15,0.0738461538461538,162500,258000,95500,6557212,352820.0,하이브보통주
21287,352820,2020-10-27,0.0416666666666666,156000,162500,6500,1118487,352820.0,하이브보통주
21288,352820,2020-10-26,0.0956521739130434,172500,156000,-16500,987951,352820.0,하이브보통주
21289,352820,2020-10-23,0.0416666666666666,180000,172500,-7500,905547,352820.0,하이브보통주
21290,352820,2020-10-19,0.0573566084788029,200500,189000,-11500,1977996,352820.0,하이브보통주
21291,352820,2020-10-16,0.2228682170542635,258000,200500,-57500,4504395,352820.0,하이브보통주
21292,352820,2020-10-15,0.0738461538461538,162500,258000,95500,6557212,352820.0,하이브보통주
21293,352820,2020-10-27,0.0416666666666666,156000,162500,6500,1118487,352820.0,하이브보통주
21294,352820,2020-10-26,0.0956521739130434,172500,156000,-16500,987951,352820.0,하이브보통주
21295,352820,2020-10-23,0.0416666666666666,180000,172500,-7500,905547,352820.0,하이브보통주
21296,352820,2020-10-19,0.0573566084788029,200500,189000,-11500,1977996,352820.0,하이브보통주
21297,352820,2020-10-16,0.2228682170542635,258000,200500,-57500,4504395,352820.0,하이브보통주
21298,352820,2020-10-15,0.0738461538461538,162500,258000,95500,6557212,352820.0,하이브보통주
21299,352820,2020-10-27,0.0416666666666666,156000,162500,6500,1118487,352820.0,하이브보통주
21300,352820,2020-10-26,0.0956521739130434,172500,156000,-16500,987951,352820.0,하이브보통주
21301,352820,2020-10-23,0.0416666666666666,180000,172500,-7500,905547,352820.0,하이브보통주
21302,352820,2020-10-19,0.0573566084788029,200500,189000,-11500,1977996,352820.0,하이브보통주
21303,352820,2020-10-16,0.2228682170542635,258000,200500,-57500,4504395,352820.0,하이브보통주
21304,352820,2020-10-15,0.0738461538461538,162500,258000,95500,6557212,352820.0,하이브보통주
21305,352820,2020-10-27,0.0416666666666666,156000,162500,6500,1118487,352820.0,하이브보통주
21306,352820,2020-10-26,0.0956521739130434,172500,156000,-16500,987951,352820.0,하이브보통주
21307,352820,2020-10-23,0.0416666666666666,180000,172500,-7500,905547,352820.0,하이브보통주
21308,352820,2020-10-19,0.0573566084788029,200500,189000,-11500,1977996,352820.0,하이브보통주
21309,352820,2020-10-16,0.2228682170542635,258000,200500,-57500,4504395,352820.0,하이브보통주
21310,352820,2020-10-15,0.0738461538461538,162500,258000,95500,6557212,352820.0,하이브보통주
21311,352820,2020-10-27,0.0416666666666666,156000,162500,6500,1118487,352820.0,하이브보통주
21312,352820,2020-10-26,0.0956521739130434,172500,156000,-16500,987951,352820.0,하이브보통주
21313,352820,2020-10-23,0.0416666666666666,180000,172500,-7500,905547,352820.0,하이브보통주
21314,352820,2020-10-19,0.0573566084788029,200500,189000,-11500,1977996,352820.0,하이브보통주
21315,352820,2020-10-16,0.2228682170542635,258000,200500,-57500,4504395,352820.0,하이브보통주
21316,352820,2020-10-15,0.0738461538461538,162500,258000,95500,6557212,352820.0,하이브보통주
21317,352820,2020-10-27,0.0416666666666666,156000,162500,6500,1118487,352820.0,하이브보통주
21318,352820,2020-10-26,0.0956521739130434,172500,156000,-16500,987951,352820.0,하이브보통주
21319,352820,2020-10-23,0.0416666666666666,180000,172500,-7500,905547,352820.0,하이브보통주
21320,352820,2020-10-19,0.0573566084788029,200500,189000,-11500,1977996,352820.0,하이브보통주
21321,352820,2020-10-16,0.2228682170542635,258000,200500,-57500,4504395,352820.0,하이브보통주
21322,352820,2020-10-15,0.0738461538461538,162500,258000,95500,6557212,352820.0,하이브보통주
21323,352820,2020-10-27,0.0416666666666666,156000,162500,6500,1118487,352820.0,하이브보통주
21324,352820,2020-10-26,0.0956521739130434,172500,156000,-16500,987951,352820.0,하이브보통주
21325,352820,2020-10-23,0.0416666666666666,180000,172500,-7500,905547,352820.0,하이브보통주
21326,352820,2020-10-19,0.0573566084788029,200500,189000,-11500,1977996,352820.0,하이브보통주
21327,352820,2020-10-16,0.2228682170542635,258000,200500,-57500,4504395,352820.0,하이브보통주
21328,352820,2020-10-15,0.0738461538461538,162500,258000,95500,6557212,352820.0,하이브보통주
21329,352820,2020-10-27,0.0416666666666666,156000,162500,6500,1118487,352820.0,하이브보통주
21330,352820,2020-10-26,0.0956521739130434,172500,156000,-16500,987951,352820.0,하이브보통주
21331,352820,2020-10-23,0.0416666666666666,180000,172500,-7500,905547,352820.0,하이브보통주
21332,352820,2020-10-19,0.0573566084788029,200500,189000,-11500,1977996,352820.0,하이브보통주
21333,352820,2020-10-16,0.2228682170542635,258000,200500,-57500,4504395,352820.0,하이브보통주
21334,352820,2020-10-15,0.0738461538461538,162500,258000,95500,6557212,352820.0,하이브보통주
21335,352820,2020-10-27,0.0416666666666666,156000,162500,6500,1118487,352820.0,하이브보통주
21336,352820,2020-10-26,0.0956521739130434,172500,156000,-16500,987951,352820.0,하이브보통주
21337,352820,2020-10-23,0.0416666666666666,180000,172500,-7500,905547,352820.0,하이브보통주
21338,352820,2020-10-19,0.0573566084788029,200500,189000,-11500,1977996,352820.0,하이브보통주
21339,352820,2020-10-16,0.2228682170542635,258000,200500,-57500,4504395,352820.0,하이브보통주
21340,352820,2020-10-15,0.0738461538461538,162500,258000,95500,6557212,352820.0,하이브보통주
21341,352820,2020-10-27,0.0416666666666666,156000,162500,6500,1118487,352820.0,하이브보통주
21342,352820,2020-10-26,0.0956521739130434,172500,156000,-16500,987951,352820.0,하이브보통주
21343,352820,2020-10-23,0.0416666666666666,180000,172500,-7500,905547,352820.0,하이브보통주
21344,352820,2020-10-19,0.0573566084788029,200500,189000,-11500,1977996,352820.0,하이브보통주
21345,352820,2020-10-16,0.2228682170542635,258000,200500,-57500,4504395,352820.0,하이브보통주
21346,352820,2020-10-15,0.0738461538461538,162500,258000,95500,6557212,352820.0,하이브보통주
21347,352820,2020-10-27,0.0416666666666666,156000,162500,6500,1118487,352820.0,하이브보통주
21348,352820,2020-10-26,0.0956521739130434,172500,156000,-16500,987951,352820.0,하이브보통주
21349,352820,2020-10-23,0.0416666666666666,180000,172500,-7500,905547,352820.0,하이브보통주
21350,352820,2020-10-19,0.0573566084788029,200500,189000,-11500,1977996,352820.0,하이브보통주
21351,352820,2020-10-16,0.2228682170542635,258000,200500,-57500,4504395,352820.0,하이브보통주
21352,352820,2020-10-15,0.0738461538461538,162500,258000,95500,6557212,352820.0,하이브보통주
21353,352820,2020-10-27,0.0416666666666666,156000,162500,6500,1118487,352820.0,하이브보통주
21354,352820,2020-10-26,0.0956521739130434,172500,156000,-16500,987951,352820.0,하이브보통주
21355,352820,2020-10-23,0.0416666666666666,180000,172500,-7500,905547,352820.0,하이브보통주
21356,352820,2020-10-19,0.0573566084788029,200500,189000,-11500,1977996,352820.0,하이브보통주
21357,352820,2020-10-16,0.2228682170542635,258000,200500,-57500,4504395,352820.0,하이브보통주
21358,352820,2020-10-15,0.0738461538461538,162500,258000,95500,6557212,352820.0,하이브보통주
21359,352820,2020-10-27,0.0416666666666666,156000,162500,6500,1118487,352820.0,하이브보통주
21360,352820,2020-10-26,0.0956521739130434,172500,156000,-16500,987951,352820.0,하이브보통주
21361,352820,2020-10-23,0.0416666666666666,180000,172500,-7500,905547,352820.0,하이브보통주
21362,352820,2020-10-19,0.0573566084788029,200500,189000,-11500,1977996,352820.0,하이브보통주
21363,352820,2020-10-16,0.2228682170542635,258000,200500,-57500,4504395,352820.0,하이브보통주
21364,352820,2020-10-15,0.0738461538461538,162500,258000,95500,6557212,352820.0,하이브보통주
21365,352820,2020-10-27,0.0416666666666666,156000,162500,6500,1118487,352820.0,하이브보통주
21366,352820,2020-10-26,0.0956521739130434,172500,156000,-16500,987951,352820.0,하이브보통주
21367,352820,2020-10-23,0.0416666666666666,180000,172500,-7500,905547,352820.0,하이브보통주
21368,352820,2020-10-19,0.0573566084788029,200500,189000,-11500,1977996,352820.0,하이브보통주
21369,352820,2020-10-16,0.2228682170542635,258000,200500,-57500,4504395,352820.0,하이브보통주
21370,352820,2020-10-15,0.0738461538461538,162500,258000,95500,6557212,352820.0,하이브보통주
21371,352820,2020-10-27,0.0416666666666666,156000,162500,6500,1118487,352820.0,하이브보통주
21372,352820,2020-10-26,0.0956521739130434,172500,156000,-16500,987951,352820.0,하이브보통주
21373,352820,2020-10-23,0.0416666666666666,180000,172500,-7500,905547,352820.0,하이브보통주
21374,352820,2020-10-19,0.0573566084788029,200500,189000,-11500,1977996,352820.0,하이브보통주
21375,352820,2020-10-16,0.2228682170542635,258000,200500,-57500,4504395,352820.0,하이브보통주
21376,352820,2020-10-15,0.0738461538461538,162500,258000,95500,6557212,352820.0,하이브보통주
21377,352820,2020-10-27,0.0416666666666666,156000,162500,6500,1118487,352820.0,하이브보통주
21378,352820,2020-10-26,0.0956521739130434,172500,156000,-16500,987951,352820.0,하이브보통주
21379,352820,2020-10-23,0.0416666666666666,180000,172500,-7500,905547,352820.0,하이브보통주
21380,352820,2020-10-19,0.0573566084788029,200500,189000,-11500,1977996,352820.0,하이브보통주
21381,352820,2020-10-16,0.2228682170542635,258000,200500,-57500,4504395,352820.0,하이브보통주
21382,352820,2020-10-15,0.0738461538461538,162500,258000,95500,6557212,352820.0,하이브보통주
21383,352820,2020-10-27,0.0416666666666666,156000,162500,6500,1118487,352820.0,하이브보통주
21384,352820,2020-10-26,0.0956521739130434,172500,156000,-16500,987951,352820.0,하이브보통주
21385,352820,2020-10-23,0.0416666666666666,180000,172500,-7500,905547,352820.0,하이브보통주
21386,352820,2020-10-19,0.0573566084788029,200500,189000,-11500,1977996,352820.0,하이브보통주
21387,352820,2020-10-16,0.2228682170542635,258000,200500,-57500,4504395,352820.0,하이브보통주
21388,352820,2020-10-15,0.0738461538461538,162500,258000,95500,6557212,352820.0,하이브보통주
21389,352820,2020-10-27,0.0416666666666666,156000,162500,6500,1118487,352820.0,하이브보통주
21390,352820,2020-10-26,0.0956521739130434,172500,156000,-16500,987951,352820.0,하이브보통주
21391,352820,2020-10-23,0.0416666666666666,180000,172500,-7500,905547,352820.0,하이브보통주
21392,352820,2020-10-19,0.0573566084788029,200500,189000,-11500,1977996,352820.0,하이브보통주
21393,352820,2020-10-16,0.2228682170542635,258000,200500,-57500,4504395,352820.0,하이브보통주
21394,352820,2020-10-15,0.0738461538461538,162500,258000,95500,6557212,352820.0,하이브보통주
21395,352820,2020-10-27,0.0416666666666666,156000,162500,6500,1118487,352820.0,하이브보통주
21396,352820,2020-10-26,0.0956521739130434,172500,156000,-16500,987951,352820.0,하이브보통주
21397,352820,2020-10-23,0.0416666666666666,180000,172500,-7500,905547,352820.0,하이브보통주
21398,352820,2020-10-19,0.0573566084788029,200500,189000,-11500,1977996,352820.0,하이브보통주
21399,352820,2020-10-16,0.2228682170542635,258000,200500,-57500,4504395,352820.0,하이브보통주
21400,352820,2020-10-15,0.0738461538461538,162500,258000,95500,6557212,352820.0,하이브보통주
21401,352820,2020-10-27,0.0416666666666666,156000,162500,6500,1118487,352820.0,하이브보통주
21402,352820,2020-10-26,0.0956521739130434,172500,156000,-16500,987951,352820.0,하이브보통주
21403,352820,2020-10-23,0.0416666666666666,180000,172500,-7500,905547,352820.0,하이브보통주
21404,352820,2020-10-19,0.0573566084788029,200500,189000,-11500,1977996,352820.0,하이브보통주
21405,352820,2020-10-16,0.2228682170542635,258000,200500,-57500,4504395,352820.0,하이브보통주
21406,352820,2020-10-15,0.0738461538461538,162500,258000,95500,6557212,352820.0,하이브보통주
21407,352820,2020-10-27,0.0416666666666666,156000,162500,6500,1118487,352820.0,하이브보통주
21408,352820,2020-10-26,0.0956521739130434,172500,156000,-16500,987951,352820.0,하이브보통주
21409,352820,2020-10-23,0.0416666666666666,180000,172500,-7500,905547,352820.0,하이브보통주
21410,352820,2020-10-19,0.0573566084788029,200500,189000,-11500,1977996,352820.0,하이브보통주
21411,352820,2020-10-16,0.2228682170542635,258000,200500,-57500,4504395,352820.0,하이브보통주
21412,352820,2020-10-15,0.0738461538461538,162500,258000,95500,6557212,352820.0,하이브보통주
21413,352820,2020-10-27,0.0416666666666666,156000,162500,6500,1118487,352820.0,하이브보통주
21414,352820,2020-10-26,0.0956521739130434,172500,156000,-16500,987951,352820.0,하이브보통주
21415,352820,2020-10-23,0.0416666666666666,180000,172500,-7500,905547,352820.0,하이브보통주
21416,352820,2020-10-19,0.0573566084788029,200500,189000,-11500,1977996,352820.0,하이브보통주
21417,352820,2020-10-16,0.2228682170542635,258000,200500,-57500,4504395,352820.0,하이브보통주
21418,352820,2020-10-15,0.0738461538461538,162500,258000,95500,6557212,352820.0,하이브보통주
21419,352820,2020-10-27,0.0416666666666666,156000,162500,6500,1118487,352820.0,하이브보통주
21420,352820,2020-10-26,0.0956521739130434,172500,156000,-16500,987951,352820.0,하이브보통주
21421,352820,2020-10-23,0.0416666666666666,180000,172500,-7500,905547,352820.0,하이브보통주
21422,352820,2020-10-19,0.0573566084788029,200500,189000,-11500,1977996,352820.0,하이브보통주
21423,352820,2020-10-16,0.2228682170542635,258000,200500,-57500,4504395,352820.0,하이브보통주
21424,352820,2020-10-15,0.0738461538461538,162500,258000,95500,6557212,352820.0,하이브보통주
21425,352820,2020-10-27,0.0416666666666666,156000,162500,6500,1118487,352820.0,하이브보통주
21426,352820,2020-10-26,0.0956521739130434,172500,156000,-16500,987951,352820.0,하이브보통주
21427,352820,2020-10-23,0.0416666666666666,180000,172500,-7500,905547,352820.0,하이브보통주
21428,352820,2020-10-19,0.0573566084788029,200500,189000,-11500,1977996,352820.0,하이브보통주
21429,352820,2020-10-16,0.2228682170542635,258000,200500,-57500,4504395,352820.0,하이브보통주
21430,352820,2020-10-15,0.0738461538461538,162500,258000,95500,6557212,352820.0,하이브보통주
21431,352820,2020-10-27,0.0416666666666666,156000,162500,6500,1118487,352820.0,하이브보통주
21432,352820,2020-10-26,0.0956521739130434,172500,156000,-16500,987951,352820.0,하이브보통주
21433,352820,2020-10-23,0.0416666666666666,180000,172500,-7500,905547,352820.0,하이브보통주
21434,352820,2020-10-19,0.0573566084788029,200500,189000,-11500,1977996,352820.0,하이브보통주
21435,352820,2020-10-16,0.2228682170542635,258000,200500,-57500,4504395,352820.0,하이브보통주
21436,352820,2020-10-15,0.0738461538461538,162500,258000,95500,6557212,352820.0,하이브보통주
21437,352820,2020-10-27,0.0416666666666666,156000,162500,6500,1118487,352820.0,하이브보통주
21438,352820,2020-10-26,0.0956521739130434,172500,156000,-16500,987951,352820.0,하이브보통주
21439,352820,2020-10-23,0.0416666666666666,180000,172500,-7500,905547,352820.0,하이브보통주
21440,352820,2020-10-19,0.0573566084788029,200500,189000,-11500,1977996,352820.0,하이브보통주
21441,352820,2020-10-16,0.2228682170542635,258000,200500,-57500,4504395,352820.0,하이브보통주
21442,352820,2020-10-15,0.0738461538461538,162500,258000,95500,6557212,352820.0,하이브보통주
21443,352820,2020-10-27,0.0416666666666666,156000,162500,6500,1118487,352820.0,하이브보통주
21444,352820,2020-10-26,0.0956521739130434,172500,156000,-16500,987951,352820.0,하이브보통주
21445,352820,2020-10-23,0.0416666666666666,180000,172500,-7500,905547,352820.0,하이브보통주
21446,352820,2020-10-19,0.0573566084788029,200500,189000,-11500,1977996,352820.0,하이브보통주
21447,352820,2020-10-16,0.2228682170542635,258000,200500,-57500,4504395,352820.0,하이브보통주
21448,352820,2020-10-15,0.0738461538461538,162500,258000,95500,6557212,352820.0,하이브보통주
21449,352820,2020-10-27,0.0416666666666666,156000,162500,6500,1118487,352820.0,하이브보통주
21450,352820,2020-10-26,0.0956521739130434,172500,156000,-16500,987951,352820.0,하이브보통주
21451,352820,2020-10-23,0.0416666666666666,180000,172500,-7500,905547,352820.0,하이브보통주
21452,352820,2020-10-19,0.0573566084788029,200500,189000,-11500,1977996,352820.0,하이브보통주
21453,352820,2020-10-16,0.2228682170542635,258000,200500,-57500,4504395,352820.0,하이브보통주
21454,352820,2020-10-15,0.0738461538461538,162500,258000,95500,6557212,352820.0,하이브보통주
21455,352820,2020-10-27,0.0416666666666666,156000,162500,6500,1118487,352820.0,하이브보통주
21456,352820,2020-10-26,0.0956521739130434,172500,156000,-16500,987951,352820.0,하이브보통주
21457,352820,2020-10-23,0.0416666666666666,180000,172500,-7500,905547,352820.0,하이브보통주
21458,352820,2020-10-19,0.0573566084788029,200500,189000,-11500,1977996,352820.0,하이브보통주
21459,352820,2020-10-16,0.2228682170542635,258000,200500,-57500,4504395,352820.0,하이브보통주
21460,352820,2020-10-15,0.0738461538461538,162500,258000,95500,6557212,352820.0,하이브보통주
21461,352820,2020-10-27,0.0416666666666666,156000,162500,6500,1118487,352820.0,하이브보통주
21462,352820,2020-10-26,0.0956521739130434,172500,156000,-16500,987951,352820.0,하이브보통주
21463,352820,2020-10-23,0.0416666666666666,180000,172500,-7500,905547,352820.0,하이브보통주
21464,352820,2020-10-19,0.0573566084788029,200500,189000,-11500,1977996,352820.0,하이브보통주
21465,352820,2020-10-16,0.2228682170542635,258000,200500,-57500,4504395,352820.0,하이브보통주
21466,352820,2020-10-15,0.0738461538461538,162500,258000,95500,6557212,352820.0,하이브보통주
21467,352820,2020-10-27,0.0416666666666666,156000,162500,6500,1118487,352820.0,하이브보통주
21468,352820,2020-10-26,0.0956521739130434,172500,156000,-16500,987951,352820.0,하이브보통주
21469,352820,2020-10-23,0.0416666666666666,180000,172500,-7500,905547,352820.0,하이브보통주
21470,352820,2020-10-19,0.0573566084788029,200500,189000,-11500,1977996,352820.0,하이브보통주
21471,352820,2020-10-16,0.2228682170542635,258000,200500,-57500,4504395,352820.0,하이브보통주
21472,352820,2020-10-15,0.0738461538461538,162500,258000,95500,6557212,352820.0,하이브보통주
21473,352820,2020-10-27,0.0416666666666666,156000,162500,6500,1118487,352820.0,하이브보통주
21474,352820,2020-10-26,0.0956521739130434,172500,156000,-16500,987951,352820.0,하이브보통주
21475,352820,2020-10-23,0.0416666666666666,180000,172500,-7500,905547,352820.0,하이브보통주
21476,352820,2020-10-19,0.0573566084788029,200500,189000,-11500,1977996,352820.0,하이브보통주
21477,352820,2020-10-16,0.2228682170542635,258000,200500,-57500,4504395,352820.0,하이브보통주
21478,352820,2020-10-15,0.0738461538461538,162500,258000,95500,6557212,352820.0,하이브보통주
21479,352820,2020-10-27,0.0416666666666666,156000,162500,6500,1118487,352820.0,하이브보통주
21480,352820,2020-10-26,0.0956521739130434,172500,156000,-16500,987951,352820.0,하이브보통주
21481,352820,2020-10-23,0.0416666666666666,180000,172500,-7500,905547,352820.0,하이브보통주
21482,352820,2020-10-19,0.0573566084788029,200500,189000,-11500,1977996,352820.0,하이브보통주
21483,352820,2020-10-16,0.2228682170542635,258000,200500,-57500,4504395,352820.0,하이브보통주
21484,352820,2020-10-15,0.0738461538461538,162500,258000,95500,6557212,352820.0,하이브보통주
21485,352820,2020-10-27,0.0416666666666666,156000,162500,6500,1118487,352820.0,하이브보통주
21486,352820,2020-10-26,0.0956521739130434,172500,156000,-16500,987951,352820.0,하이브보통주
21487,352820,2020-10-23,0.0416666666666666,180000,172500,-7500,905547,352820.0,하이브보통주
21488,352820,2020-10-19,0.0573566084788029,200500,189000,-11500,1977996,352820.0,하이브보통주
21489,352820,2020-10-16,0.2228682170542635,258000,200500,-57500,4504395,352820.0,하이브보통주
21490,352820,2020-10-15,0.0738461538461538,162500,258000,95500,6557212,352820.0,하이브보통주
21491,352820,2020-10-27,0.0416666666666666,156000,162500,6500,1118487,352820.0,하이브보통주
21492,352820,2020-10-26,0.0956521739130434,172500,156000,-16500,987951,352820.0,하이브보통주
21493,352820,2020-10-23,0.0416666666666666,180000,172500,-7500,905547,352820.0,하이브보통주
21494,352820,2020-10-19,0.0573566084788029,200500,189000,-11500,1977996,352820.0,하이브보통주
21495,352820,2020-10-16,0.2228682170542635,258000,200500,-57500,4504395,352820.0,하이브보통주
21496,352820,2020-10-15,0.0738461538461538,162500,258000,95500,6557212,352820.0,하이브보통주
21497,352820,2020-10-27,0.0416666666666666,156000,162500,6500,1118487,352820.0,하이브보통주
21498,352820,2020-10-26,0.0956521739130434,172500,156000,-16500,987951,352820.0,하이브보통주
21499,352820,2020-10-23,0.0416666666666666,180000,172500,-7500,905547,352820.0,하이브보통주
21500,352820,2020-10-19,0.0573566084788029,200500,189000,-11500,1977996,352820.0,하이브보통주
21501,352820,2020-10-16,0.2228682170542635,258000,200500,-57500,4504395,352820.0,하이브보통주
21502,352820,2020-10-15,0.0738461538461538,162500,258000,95500,6557212,352820.0,하이브보통주
21503,352820,2020-10-27,0.0416666666666666,156000,162500,6500,1118487,352820.0,하이브보통주
21504,352820,2020-10-26,0.0956521739130434,172500,156000,-16500,987951,352820.0,하이브보통주
21505,352820,2020-10-23,0.0416666666666666,180000,172500,-7500,905547,352820.0,하이브보통주
21506,352820,2020-10-19,0.0573566084788029,200500,189000,-11500,1977996,352820.0,하이브보통주
21507,352820,2020-10-16,0.2228682170542635,258000,200500,-57500,4504395,352820.0,하이브보통주
21508,352820,2020-10-15,0.0738461538461538,162500,258000,95500,6557212,352820.0,하이브보통주
21509,352820,2020-10-27,0.0416666666666666,156000,162500,6500,1118487,352820.0,하이브보통주
21510,352820,2020-10-26,0.0956521739130434,172500,156000,-16500,987951,352820.0,하이브보통주
21511,352820,2020-10-23,0.0416666666666666,180000,172500,-7500,905547,352820.0,하이브보통주
21512,352820,2020-10-19,0.0573566084788029,200500,189000,-11500,1977996,352820.0,하이브보통주
21513,352820,2020-10-16,0.2228682170542635,258000,200500,-57500,4504395,352820.0,하이브보통주
21514,352820,2020-10-15,0.0738461538461538,162500,258000,95500,6557212,352820.0,하이브보통주
21515,352820,2020-10-27,0.0416666666666666,156000,162500,6500,1118487,352820.0,하이브보통주
21516,352820,2020-10-26,0.0956521739130434,172500,156000,-16500,987951,352820.0,하이브보통주
21517,352820,2020-10-23,0.0416666666666666,180000,172500,-7500,905547,352820.0,하이브보통주
21518,352820,2020-10-19,0.0573566084788029,200500,189000,-11500,1977996,352820.0,하이브보통주
21519,352820,2020-10-16,0.2228682170542635,258000,200500,-57500,4504395,352820.0,하이브보통주
21520,352820,2020-10-15,0.0738461538461538,162500,258000,95500,6557212,352820.0,하이브보통주
21521,352820,2020-10-27,0.0416666666666666,156000,162500,6500,1118487,352820.0,하이브보통주
21522,352820,2020-10-26,0.0956521739130434,172500,156000,-16500,987951,352820.0,하이브보통주
21523,352820,2020-10-23,0.0416666666666666,180000,172500,-7500,905547,352820.0,하이브보통주
21524,352820,2020-10-19,0.0573566084788029,200500,189000,-11500,1977996,352820.0,하이브보통주
21525,352820,2020-10-16,0.2228682170542635,258000,200500,-57500,4504395,352820.0,하이브보통주
21526,352820,2020-10-15,0.0738461538461538,162500,258000,95500,6557212,352820.0,하이브보통주
21527,352820,2020-10-27,0.0416666666666666,156000,162500,6500,1118487,352820.0,하이브보통주
21528,352820,2020-10-26,0.0956521739130434,172500,156000,-16500,987951,352820.0,하이브보통주
21529,352820,2020-10-23,0.0416666666666666,180000,172500,-7500,905547,352820.0,하이브보통주
21530,352820,2020-10-19,0.0573566084788029,200500,189000,-11500,1977996,352820.0,하이브보통주
21531,352820,2020-10-16,0.2228682170542635,258000,200500,-57500,4504395,352820.0,하이브보통주
21532,352820,2020-10-15,0.0738461538461538,162500,258000,95500,6557212,352820.0,하이브보통주
21533,352820,2020-10-27,0.0416666666666666,156000,162500,6500,1118487,352820.0,하이브보통주
21534,352820,2020-10-26,0.0956521739130434,172500,156000,-16500,987951,352820.0,하이브보통주
21535,352820,2020-10-23,0.0416666666666666,180000,172500,-7500,905547,352820.0,하이브보통주
21536,352820,2020-10-19,0.0573566084788029,200500,189000,-11500,1977996,352820.0,하이브보통주
21537,352820,2020-10-16,0.2228682170542635,258000,200500,-57500,4504395,352820.0,하이브보통주
21538,352820,2020-10-15,0.0738461538461538,162500,258000,95500,6557212,352820.0,하이브보통주
21539,352820,2020-10-27,0.0416666666666666,156000,162500,6500,1118487,352820.0,하이브보통주
21540,352820,2020-10-26,0.0956521739130434,172500,156000,-16500,987951,352820.0,하이브보통주
21541,352820,2020-10-23,0.0416666666666666,180000,172500,-7500,905547,352820.0,하이브보통주
21542,352820,2020-10-19,0.0573566084788029,200500,189000,-11500,1977996,352820.0,하이브보통주
21543,352820,2020-10-16,0.2228682170542635,258000,200500,-57500,4504395,352820.0,하이브보통주
21544,352820,2020-10-15,0.0738461538461538,162500,258000,95500,6557212,352820.0,하이브보통주
21545,352820,2020-10-27,0.0416666666666666,156000,162500,6500,1118487,352820.0,하이브보통주
21546,352820,2020-10-26,0.0956521739130434,172500,156000,-16500,987951,352820.0,하이브보통주
21547,352820,2020-10-23,0.0416666666666666,180000,172500,-7500,905547,352820.0,하이브보통주
21548,352820,2020-10-19,0.0573566084788029,200500,189000,-11500,1977996,352820.0,하이브보통주
21549,352820,2020-10-16,0.2228682170542635,258000,200500,-57500,4504395,352820.0,하이브보통주
21550,352820,2020-10-15,0.0738461538461538,162500,258000,95500,6557212,352820.0,하이브보통주
21551,352820,2020-10-27,0.0416666666666666,156000,162500,6500,1118487,352820.0,하이브보통주
21552,352820,2020-10-26,0.0956521739130434,172500,156000,-16500,987951,352820.0,하이브보통주
21553,352820,2020-10-23,0.0416666666666666,180000,172500,-7500,905547,352820.0,하이브보통주
21554,352820,2020-10-19,0.0573566084788029,200500,189000,-11500,1977996,352820.0,하이브보통주
21555,352820,2020-10-16,0.2228682170542635,258000,200500,-57500,4504395,352820.0,하이브보통주
21556,352820,2020-10-15,0.0738461538461538,162500,258000,95500,6557212,352820.0,하이브보통주
21557,352820,2020-10-27,0.0416666666666666,156000,162500,6500,1118487,352820.0,하이브보통주
21558,352820,2020-10-26,0.0956521739130434,172500,156000,-16500,987951,352820.0,하이브보통주
21559,352820,2020-10-23,0.0416666666666666,180000,172500,-7500,905547,352820.0,하이브보통주
21560,352820,2020-10-19,0.0573566084788029,200500,189000,-11500,1977996,352820.0,하이브보통주
21561,352820,2020-10-16,0.2228682170542635,258000,200500,-57500,4504395,352820.0,하이브보통주
21562,352820,2020-10-15,0.0738461538461538,162500,258000,95500,6557212,352820.0,하이브보통주
21563,352820,2020-10-27,0.0416666666666666,156000,162500,6500,1118487,352820.0,하이브보통주
21564,352820,2020-10-26,0.0956521739130434,172500,156000,-16500,987951,352820.0,하이브보통주
21565,352820,2020-10-23,0.0416666666666666,180000,172500,-7500,905547,352820.0,하이브보통주
21566,352820,2020-10-19,0.0573566084788029,200500,189000,-11500,1977996,352820.0,하이브보통주
21567,352820,2020-10-16,0.2228682170542635,258000,200500,-57500,4504395,352820.0,하이브보통주
21568,352820,2020-10-15,0.0738461538461538,162500,258000,95500,6557212,352820.0,하이브보통주
21569,352820,2020-10-27,0.0416666666666666,156000,162500,6500,1118487,352820.0,하이브보통주
21570,352820,2020-10-26,0.0956521739130434,172500,156000,-16500,987951,352820.0,하이브보통주
21571,352820,2020-10-23,0.0416666666666666,180000,172500,-7500,905547,352820.0,하이브보통주
21572,352820,2020-10-19,0.0573566084788029,200500,189000,-11500,1977996,352820.0,하이브보통주
21573,352820,2020-10-16,0.2228682170542635,258000,200500,-57500,4504395,352820.0,하이브보통주
21574,352820,2020-10-15,0.0738461538461538,162500,258000,95500,6557212,352820.0,하이브보통주
21575,352820,2020-10-27,0.0416666666666666,156000,162500,6500,1118487,352820.0,하이브보통주
21576,352820,2020-10-26,0.0956521739130434,172500,156000,-16500,987951,352820.0,하이브보통주
21577,352820,2020-10-23,0.0416666666666666,180000,172500,-7500,905547,352820.0,하이브보통주
21578,352820,2020-10-19,0.0573566084788029,200500,189000,-11500,1977996,352820.0,하이브보통주
21579,352820,2020-10-16,0.2228682170542635,258000,200500,-57500,4504395,352820.0,하이브보통주
21580,352820,2020-10-15,0.0738461538461538,162500,258000,95500,6557212,352820.0,하이브보통주
21581,352820,2020-10-27,0.0416666666666666,156000,162500,6500,1118487,352820.0,하이브보통주
21582,352820,2020-10-26,0.0956521739130434,172500,156000,-16500,987951,352820.0,하이브보통주
21583,352820,2020-10-23,0.0416666666666666,180000,172500,-7500,905547,352820.0,하이브보통주
21584,352820,2020-10-19,0.0573566084788029,200500,189000,-11500,1977996,352820.0,하이브보통주
21585,352820,2020-10-16,0.2228682170542635,258000,200500,-57500,4504395,352820.0,하이브보통주
21586,352820,2020-10-15,0.0738461538461538,162500,258000,95500,6557212,352820.0,하이브보통주
21587,352820,2020-10-27,0.0416666666666666,156000,162500,6500,1118487,352820.0,하이브보통주
21588,352820,2020-10-26,0.0956521739130434,172500,156000,-16500,987951,352820.0,하이브보통주
21589,352820,2020-10-23,0.0416666666666666,180000,172500,-7500,905547,352820.0,하이브보통주
21590,352820,2020-10-19,0.0573566084788029,200500,189000,-11500,1977996,352820.0,하이브보통주
21591,352820,2020-10-16,0.2228682170542635,258000,200500,-57500,4504395,352820.0,하이브보통주
21592,352820,2020-10-15,0.0738461538461538,162500,258000,95500,6557212,352820.0,하이브보통주
21593,352820,2020-10-27,0.0416666666666666,156000,162500,6500,1118487,352820.0,하이브보통주
21594,352820,2020-10-26,0.0956521739130434,172500,156000,-16500,987951,352820.0,하이브보통주
21595,352820,2020-10-23,0.0416666666666666,180000,172500,-7500,905547,352820.0,하이브보통주
21596,352820,2020-10-19,0.0573566084788029,200500,189000,-11500,1977996,352820.0,하이브보통주
21597,352820,2020-10-16,0.2228682170542635,258000,200500,-57500,4504395,352820.0,하이브보통주
21598,352820,2020-10-15,0.0738461538461538,162500,258000,95500,6557212,352820.0,하이브보통주
21599,352820,2020-10-27,0.0416666666666666,156000,162500,6500,1118487,352820.0,하이브보통주
21600,352820,2020-10-26,0.0956521739130434,172500,156000,-16500,987951,352820.0,하이브보통주
21601,352820,2020-10-23,0.0416666666666666,180000,172500,-7500,905547,352820.0,하이브보통주
21602,352820,2020-10-19,0.0573566084788029,200500,189000,-11500,1977996,352820.0,하이브보통주
21603,352820,2020-10-16,0.2228682170542635,258000,200500,-57500,4504395,352820.0,하이브보통주
21604,352820,2020-10-15,0.0738461538461538,162500,258000,95500,6557212,352820.0,하이브보통주
21605,352820,2020-10-27,0.0416666666666666,156000,162500,6500,1118487,352820.0,하이브보통주
21606,352820,2020-10-26,0.0956521739130434,172500,156000,-16500,987951,352820.0,하이브보통주
21607,352820,2020-10-23,0.0416666666666666,180000,172500,-7500,905547,352820.0,하이브보통주
21608,352820,2020-10-19,0.0573566084788029,200500,189000,-11500,1977996,352820.0,하이브보통주
21609,352820,2020-10-16,0.2228682170542635,258000,200500,-57500,4504395,352820.0,하이브보통주
21610,352820,2020-10-15,0.0738461538461538,162500,258000,95500,6557212,352820.0,하이브보통주
21611,352820,2020-10-27,0.0416666666666666,156000,162500,6500,1118487,352820.0,하이브보통주
21612,352820,2020-10-26,0.0956521739130434,172500,156000,-16500,987951,352820.0,하이브보통주
21613,352820,2020-10-23,0.0416666666666666,180000,172500,-7500,905547,352820.0,하이브보통주
21614,352820,2020-10-19,0.0573566084788029,200500,189000,-11500,1977996,352820.0,하이브보통주
21615,352820,2020-10-16,0.2228682170542635,258000,200500,-57500,4504395,352820.0,하이브보통주
21616,352820,2020-10-15,0.0738461538461538,162500,258000,95500,6557212,352820.0,하이브보통주
21617,352820,2020-10-27,0.0416666666666666,156000,162500,6500,1118487,352820.0,하이브보통주
21618,352820,2020-10-26,0.0956521739130434,172500,156000,-16500,987951,352820.0,하이브보통주
21619,352820,2020-10-23,0.0416666666666666,180000,172500,-7500,905547,352820.0,하이브보통주
21620,352820,2020-10-19,0.0573566084788029,200500,189000,-11500,1977996,352820.0,하이브보통주
21621,352820,2020-10-16,0.2228682170542635,258000,200500,-57500,4504395,352820.0,하이브보통주
21622,352820,2020-10-15,0.0738461538461538,162500,258000,95500,6557212,352820.0,하이브보통주
21623,352820,2020-10-27,0.0416666666666666,156000,162500,6500,1118487,352820.0,하이브보통주
21624,352820,2020-10-26,0.0956521739130434,172500,156000,-16500,987951,352820.0,하이브보통주
21625,352820,2020-10-23,0.0416666666666666,180000,172500,-7500,905547,352820.0,하이브보통주
21626,352820,2020-10-19,0.0573566084788029,200500,189000,-11500,1977996,352820.0,하이브보통주
21627,352820,2020-10-16,0.2228682170542635,258000,200500,-57500,4504395,352820.0,하이브보통주
21628,352820,2020-10-15,0.0738461538461538,162500,258000,95500,6557212,352820.0,하이브보통주
21629,352820,2020-10-27,0.0416666666666666,156000,162500,6500,1118487,352820.0,하이브보통주
21630,352820,2020-10-26,0.0956521739130434,172500,156000,-16500,987951,352820.0,하이브보통주
21631,352820,2020-10-23,0.0416666666666666,180000,172500,-7500,905547,352820.0,하이브보통주
21632,352820,2020-10-19,0.0573566084788029,200500,189000,-11500,1977996,352820.0,하이브보통주
21633,352820,2020-10-16,0.2228682170542635,258000,200500,-57500,4504395,352820.0,하이브보통주
21634,352820,2020-10-15,0.0738461538461538,162500,258000,95500,6557212,352820.0,하이브보통주
21635,352820,2020-10-27,0.0416666666666666,156000,162500,6500,1118487,352820.0,하이브보통주
21636,352820,2020-10-26,0.0956521739130434,172500,156000,-16500,987951,352820.0,하이브보통주
21637,352820,2020-10-23,0.0416666666666666,180000,172500,-7500,905547,352820.0,하이브보통주
21638,352820,2020-10-19,0.0573566084788029,200500,189000,-11500,1977996,352820.0,하이브보통주
21639,352820,2020-10-16,0.2228682170542635,258000,200500,-57500,4504395,352820.0,하이브보통주
21640,352820,2020-10-15,0.0738461538461538,162500,258000,95500,6557212,352820.0,하이브보통주
21641,352820,2020-10-27,0.0416666666666666,156000,162500,6500,1118487,352820.0,하이브보통주
21642,352820,2020-10-26,0.0956521739130434,172500,156000,-16500,987951,352820.0,하이브보통주
21643,352820,2020-10-23,0.0416666666666666,180000,172500,-7500,905547,352820.0,하이브보통주
21644,352820,2020-10-19,0.0573566084788029,200500,189000,-11500,1977996,352820.0,하이브보통주
21645,352820,2020-10-16,0.2228682170542635,258000,200500,-57500,4504395,352820.0,하이브보통주
21646,352820,2020-10-15,0.0738461538461538,162500,258000,95500,6557212,352820.0,하이브보통주
21647,352820,2020-10-27,0.0416666666666666,156000,162500,6500,1118487,352820.0,하이브보통주
21648,352820,2020-10-26,0.0956521739130434,172500,156000,-16500,987951,352820.0,하이브보통주
21649,352820,2020-10-23,0.0416666666666666,180000,172500,-7500,905547,352820.0,하이브보통주
21650,352820,2020-10-19,0.0573566084788029,200500,189000,-11500,1977996,352820.0,하이브보통주
21651,352820,2020-10-16,0.2228682170542635,258000,200500,-57500,4504395,352820.0,하이브보통주
21652,361610,2021-05-18,0.0434782608695652,138000,144000,6000,1474901,361610.0,SK아이이테크놀로지보통주
21653,361610,2021-05-12,0.0453074433656957,154500,147500,-7000,4973674,361610.0,SK아이이테크놀로지보통주
21654,361610,2021-05-11,0.3867595818815331,143500,154500,11000,11320278,361610.0,SK아이이테크놀로지보통주
21655,361610,2021-05-18,0.0434782608695652,138000,144000,6000,1474901,361610.0,SK아이이테크놀로지보통주
21656,361610,2021-05-12,0.0453074433656957,154500,147500,-7000,4973674,361610.0,SK아이이테크놀로지보통주
21657,361610,2021-05-11,0.3867595818815331,143500,154500,11000,11320278,361610.0,SK아이이테크놀로지보통주
21658,361610,2021-05-18,0.0434782608695652,138000,144000,6000,1474901,361610.0,SK아이이테크놀로지보통주
21659,361610,2021-05-12,0.0453074433656957,154500,147500,-7000,4973674,361610.0,SK아이이테크놀로지보통주
21660,361610,2021-05-11,0.3867595818815331,143500,154500,11000,11320278,361610.0,SK아이이테크놀로지보통주
21661,361610,2021-05-18,0.0434782608695652,138000,144000,6000,1474901,361610.0,SK아이이테크놀로지보통주
21662,361610,2021-05-12,0.0453074433656957,154500,147500,-7000,4973674,361610.0,SK아이이테크놀로지보통주
21663,361610,2021-05-11,0.3867595818815331,143500,154500,11000,11320278,361610.0,SK아이이테크놀로지보통주
21664,361610,2021-05-18,0.0434782608695652,138000,144000,6000,1474901,361610.0,SK아이이테크놀로지보통주
21665,361610,2021-05-12,0.0453074433656957,154500,147500,-7000,4973674,361610.0,SK아이이테크놀로지보통주
21666,361610,2021-05-11,0.3867595818815331,143500,154500,11000,11320278,361610.0,SK아이이테크놀로지보통주
21667,361610,2021-05-18,0.0434782608695652,138000,144000,6000,1474901,361610.0,SK아이이테크놀로지보통주
21668,361610,2021-05-12,0.0453074433656957,154500,147500,-7000,4973674,361610.0,SK아이이테크놀로지보통주
21669,361610,2021-05-11,0.3867595818815331,143500,154500,11000,11320278,361610.0,SK아이이테크놀로지보통주
21670,361610,2021-05-18,0.0434782608695652,138000,144000,6000,1474901,361610.0,SK아이이테크놀로지보통주
21671,361610,2021-05-12,0.0453074433656957,154500,147500,-7000,4973674,361610.0,SK아이이테크놀로지보통주
21672,361610,2021-05-11,0.3867595818815331,143500,154500,11000,11320278,361610.0,SK아이이테크놀로지보통주
21673,361610,2021-05-18,0.0434782608695652,138000,144000,6000,1474901,361610.0,SK아이이테크놀로지보통주
21674,361610,2021-05-12,0.0453074433656957,154500,147500,-7000,4973674,361610.0,SK아이이테크놀로지보통주
21675,361610,2021-05-11,0.3867595818815331,143500,154500,11000,11320278,361610.0,SK아이이테크놀로지보통주
21676,361610,2021-05-18,0.0434782608695652,138000,144000,6000,1474901,361610.0,SK아이이테크놀로지보통주
21677,361610,2021-05-12,0.0453074433656957,154500,147500,-7000,4973674,361610.0,SK아이이테크놀로지보통주
21678,361610,2021-05-11,0.3867595818815331,143500,154500,11000,11320278,361610.0,SK아이이테크놀로지보통주
21679,361610,2021-05-18,0.0434782608695652,138000,144000,6000,1474901,361610.0,SK아이이테크놀로지보통주
21680,361610,2021-05-12,0.0453074433656957,154500,147500,-7000,4973674,361610.0,SK아이이테크놀로지보통주
21681,361610,2021-05-11,0.3867595818815331,143500,154500,11000,11320278,361610.0,SK아이이테크놀로지보통주
21682,361610,2021-05-18,0.0434782608695652,138000,144000,6000,1474901,361610.0,SK아이이테크놀로지보통주
21683,361610,2021-05-12,0.0453074433656957,154500,147500,-7000,4973674,361610.0,SK아이이테크놀로지보통주
21684,361610,2021-05-11,0.3867595818815331,143500,154500,11000,11320278,361610.0,SK아이이테크놀로지보통주
21685,361610,2021-05-18,0.0434782608695652,138000,144000,6000,1474901,361610.0,SK아이이테크놀로지보통주
21686,361610,2021-05-12,0.0453074433656957,154500,147500,-7000,4973674,361610.0,SK아이이테크놀로지보통주
21687,361610,2021-05-11,0.3867595818815331,143500,154500,11000,11320278,361610.0,SK아이이테크놀로지보통주
21688,361610,2021-05-18,0.0434782608695652,138000,144000,6000,1474901,361610.0,SK아이이테크놀로지보통주
21689,361610,2021-05-12,0.0453074433656957,154500,147500,-7000,4973674,361610.0,SK아이이테크놀로지보통주
21690,361610,2021-05-11,0.3867595818815331,143500,154500,11000,11320278,361610.0,SK아이이테크놀로지보통주
21691,361610,2021-05-18,0.0434782608695652,138000,144000,6000,1474901,361610.0,SK아이이테크놀로지보통주
21692,361610,2021-05-12,0.0453074433656957,154500,147500,-7000,4973674,361610.0,SK아이이테크놀로지보통주
21693,361610,2021-05-11,0.3867595818815331,143500,154500,11000,11320278,361610.0,SK아이이테크놀로지보통주
21694,361610,2021-05-18,0.0434782608695652,138000,144000,6000,1474901,361610.0,SK아이이테크놀로지보통주
21695,361610,2021-05-12,0.0453074433656957,154500,147500,-7000,4973674,361610.0,SK아이이테크놀로지보통주
21696,361610,2021-05-11,0.3867595818815331,143500,154500,11000,11320278,361610.0,SK아이이테크놀로지보통주
21697,361610,2021-05-18,0.0434782608695652,138000,144000,6000,1474901,361610.0,SK아이이테크놀로지보통주
21698,361610,2021-05-12,0.0453074433656957,154500,147500,-7000,4973674,361610.0,SK아이이테크놀로지보통주
21699,361610,2021-05-11,0.3867595818815331,143500,154500,11000,11320278,361610.0,SK아이이테크놀로지보통주
21700,361610,2021-05-18,0.0434782608695652,138000,144000,6000,1474901,361610.0,SK아이이테크놀로지보통주
21701,361610,2021-05-12,0.0453074433656957,154500,147500,-7000,4973674,361610.0,SK아이이테크놀로지보통주
21702,361610,2021-05-11,0.3867595818815331,143500,154500,11000,11320278,361610.0,SK아이이테크놀로지보통주
21703,361610,2021-05-18,0.0434782608695652,138000,144000,6000,1474901,361610.0,SK아이이테크놀로지보통주
21704,361610,2021-05-12,0.0453074433656957,154500,147500,-7000,4973674,361610.0,SK아이이테크놀로지보통주
21705,361610,2021-05-11,0.3867595818815331,143500,154500,11000,11320278,361610.0,SK아이이테크놀로지보통주
21706,361610,2021-05-18,0.0434782608695652,138000,144000,6000,1474901,361610.0,SK아이이테크놀로지보통주
21707,361610,2021-05-12,0.0453074433656957,154500,147500,-7000,4973674,361610.0,SK아이이테크놀로지보통주
21708,361610,2021-05-11,0.3867595818815331,143500,154500,11000,11320278,361610.0,SK아이이테크놀로지보통주
21709,361610,2021-05-18,0.0434782608695652,138000,144000,6000,1474901,361610.0,SK아이이테크놀로지보통주
21710,361610,2021-05-12,0.0453074433656957,154500,147500,-7000,4973674,361610.0,SK아이이테크놀로지보통주
21711,361610,2021-05-11,0.3867595818815331,143500,154500,11000,11320278,361610.0,SK아이이테크놀로지보통주
21712,361610,2021-05-18,0.0434782608695652,138000,144000,6000,1474901,361610.0,SK아이이테크놀로지보통주
21713,361610,2021-05-12,0.0453074433656957,154500,147500,-7000,4973674,361610.0,SK아이이테크놀로지보통주
21714,361610,2021-05-11,0.3867595818815331,143500,154500,11000,11320278,361610.0,SK아이이테크놀로지보통주
21715,361610,2021-05-18,0.0434782608695652,138000,144000,6000,1474901,361610.0,SK아이이테크놀로지보통주
21716,361610,2021-05-12,0.0453074433656957,154500,147500,-7000,4973674,361610.0,SK아이이테크놀로지보통주
21717,361610,2021-05-11,0.3867595818815331,143500,154500,11000,11320278,361610.0,SK아이이테크놀로지보통주
21718,361610,2021-05-18,0.0434782608695652,138000,144000,6000,1474901,361610.0,SK아이이테크놀로지보통주
21719,361610,2021-05-12,0.0453074433656957,154500,147500,-7000,4973674,361610.0,SK아이이테크놀로지보통주
21720,361610,2021-05-11,0.3867595818815331,143500,154500,11000,11320278,361610.0,SK아이이테크놀로지보통주
21721,361610,2021-05-18,0.0434782608695652,138000,144000,6000,1474901,361610.0,SK아이이테크놀로지보통주
21722,361610,2021-05-12,0.0453074433656957,154500,147500,-7000,4973674,361610.0,SK아이이테크놀로지보통주
21723,361610,2021-05-11,0.3867595818815331,143500,154500,11000,11320278,361610.0,SK아이이테크놀로지보통주
21724,361610,2021-05-18,0.0434782608695652,138000,144000,6000,1474901,361610.0,SK아이이테크놀로지보통주
21725,361610,2021-05-12,0.0453074433656957,154500,147500,-7000,4973674,361610.0,SK아이이테크놀로지보통주
21726,361610,2021-05-11,0.3867595818815331,143500,154500,11000,11320278,361610.0,SK아이이테크놀로지보통주
21727,361610,2021-05-18,0.0434782608695652,138000,144000,6000,1474901,361610.0,SK아이이테크놀로지보통주
21728,361610,2021-05-12,0.0453074433656957,154500,147500,-7000,4973674,361610.0,SK아이이테크놀로지보통주
21729,361610,2021-05-11,0.3867595818815331,143500,154500,11000,11320278,361610.0,SK아이이테크놀로지보통주
21730,361610,2021-05-18,0.0434782608695652,138000,144000,6000,1474901,361610.0,SK아이이테크놀로지보통주
21731,361610,2021-05-12,0.0453074433656957,154500,147500,-7000,4973674,361610.0,SK아이이테크놀로지보통주
21732,361610,2021-05-11,0.3867595818815331,143500,154500,11000,11320278,361610.0,SK아이이테크놀로지보통주
21733,361610,2021-05-18,0.0434782608695652,138000,144000,6000,1474901,361610.0,SK아이이테크놀로지보통주
21734,361610,2021-05-12,0.0453074433656957,154500,147500,-7000,4973674,361610.0,SK아이이테크놀로지보통주
21735,361610,2021-05-11,0.3867595818815331,143500,154500,11000,11320278,361610.0,SK아이이테크놀로지보통주
21736,361610,2021-05-18,0.0434782608695652,138000,144000,6000,1474901,361610.0,SK아이이테크놀로지보통주
21737,361610,2021-05-12,0.0453074433656957,154500,147500,-7000,4973674,361610.0,SK아이이테크놀로지보통주
21738,361610,2021-05-11,0.3867595818815331,143500,154500,11000,11320278,361610.0,SK아이이테크놀로지보통주
21739,361610,2021-05-18,0.0434782608695652,138000,144000,6000,1474901,361610.0,SK아이이테크놀로지보통주
21740,361610,2021-05-12,0.0453074433656957,154500,147500,-7000,4973674,361610.0,SK아이이테크놀로지보통주
21741,361610,2021-05-11,0.3867595818815331,143500,154500,11000,11320278,361610.0,SK아이이테크놀로지보통주
21742,361610,2021-05-18,0.0434782608695652,138000,144000,6000,1474901,361610.0,SK아이이테크놀로지보통주
21743,361610,2021-05-12,0.0453074433656957,154500,147500,-7000,4973674,361610.0,SK아이이테크놀로지보통주
21744,361610,2021-05-11,0.3867595818815331,143500,154500,11000,11320278,361610.0,SK아이이테크놀로지보통주
21745,361610,2021-05-18,0.0434782608695652,138000,144000,6000,1474901,361610.0,SK아이이테크놀로지보통주
21746,361610,2021-05-12,0.0453074433656957,154500,147500,-7000,4973674,361610.0,SK아이이테크놀로지보통주
21747,361610,2021-05-11,0.3867595818815331,143500,154500,11000,11320278,361610.0,SK아이이테크놀로지보통주
21748,361610,2021-05-18,0.0434782608695652,138000,144000,6000,1474901,361610.0,SK아이이테크놀로지보통주
21749,361610,2021-05-12,0.0453074433656957,154500,147500,-7000,4973674,361610.0,SK아이이테크놀로지보통주
21750,361610,2021-05-11,0.3867595818815331,143500,154500,11000,11320278,361610.0,SK아이이테크놀로지보통주
21751,361610,2021-05-18,0.0434782608695652,138000,144000,6000,1474901,361610.0,SK아이이테크놀로지보통주
21752,361610,2021-05-12,0.0453074433656957,154500,147500,-7000,4973674,361610.0,SK아이이테크놀로지보통주
21753,361610,2021-05-11,0.3867595818815331,143500,154500,11000,11320278,361610.0,SK아이이테크놀로지보통주
21754,361610,2021-05-18,0.0434782608695652,138000,144000,6000,1474901,361610.0,SK아이이테크놀로지보통주
21755,361610,2021-05-12,0.0453074433656957,154500,147500,-7000,4973674,361610.0,SK아이이테크놀로지보통주
21756,361610,2021-05-11,0.3867595818815331,143500,154500,11000,11320278,361610.0,SK아이이테크놀로지보통주
21757,361610,2021-05-18,0.0434782608695652,138000,144000,6000,1474901,361610.0,SK아이이테크놀로지보통주
21758,361610,2021-05-12,0.0453074433656957,154500,147500,-7000,4973674,361610.0,SK아이이테크놀로지보통주
21759,361610,2021-05-11,0.3867595818815331,143500,154500,11000,11320278,361610.0,SK아이이테크놀로지보통주
21760,361610,2021-05-18,0.0434782608695652,138000,144000,6000,1474901,361610.0,SK아이이테크놀로지보통주
21761,361610,2021-05-12,0.0453074433656957,154500,147500,-7000,4973674,361610.0,SK아이이테크놀로지보통주
21762,361610,2021-05-11,0.3867595818815331,143500,154500,11000,11320278,361610.0,SK아이이테크놀로지보통주
21763,361610,2021-05-18,0.0434782608695652,138000,144000,6000,1474901,361610.0,SK아이이테크놀로지보통주
21764,361610,2021-05-12,0.0453074433656957,154500,147500,-7000,4973674,361610.0,SK아이이테크놀로지보통주
21765,361610,2021-05-11,0.3867595818815331,143500,154500,11000,11320278,361610.0,SK아이이테크놀로지보통주
21766,361610,2021-05-18,0.0434782608695652,138000,144000,6000,1474901,361610.0,SK아이이테크놀로지보통주
21767,361610,2021-05-12,0.0453074433656957,154500,147500,-7000,4973674,361610.0,SK아이이테크놀로지보통주
21768,361610,2021-05-11,0.3867595818815331,143500,154500,11000,11320278,361610.0,SK아이이테크놀로지보통주
21769,361610,2021-05-18,0.0434782608695652,138000,144000,6000,1474901,361610.0,SK아이이테크놀로지보통주
21770,361610,2021-05-12,0.0453074433656957,154500,147500,-7000,4973674,361610.0,SK아이이테크놀로지보통주
21771,361610,2021-05-11,0.3867595818815331,143500,154500,11000,11320278,361610.0,SK아이이테크놀로지보통주
21772,361610,2021-05-18,0.0434782608695652,138000,144000,6000,1474901,361610.0,SK아이이테크놀로지보통주
21773,361610,2021-05-12,0.0453074433656957,154500,147500,-7000,4973674,361610.0,SK아이이테크놀로지보통주
21774,361610,2021-05-11,0.3867595818815331,143500,154500,11000,11320278,361610.0,SK아이이테크놀로지보통주
21775,361610,2021-05-18,0.0434782608695652,138000,144000,6000,1474901,361610.0,SK아이이테크놀로지보통주
21776,361610,2021-05-12,0.0453074433656957,154500,147500,-7000,4973674,361610.0,SK아이이테크놀로지보통주
21777,361610,2021-05-11,0.3867595818815331,143500,154500,11000,11320278,361610.0,SK아이이테크놀로지보통주
21778,361610,2021-05-18,0.0434782608695652,138000,144000,6000,1474901,361610.0,SK아이이테크놀로지보통주
21779,361610,2021-05-12,0.0453074433656957,154500,147500,-7000,4973674,361610.0,SK아이이테크놀로지보통주
21780,361610,2021-05-11,0.3867595818815331,143500,154500,11000,11320278,361610.0,SK아이이테크놀로지보통주
21781,361610,2021-05-18,0.0434782608695652,138000,144000,6000,1474901,361610.0,SK아이이테크놀로지보통주
21782,361610,2021-05-12,0.0453074433656957,154500,147500,-7000,4973674,361610.0,SK아이이테크놀로지보통주
21783,361610,2021-05-11,0.3867595818815331,143500,154500,11000,11320278,361610.0,SK아이이테크놀로지보통주
21784,361610,2021-05-18,0.0434782608695652,138000,144000,6000,1474901,361610.0,SK아이이테크놀로지보통주
21785,361610,2021-05-12,0.0453074433656957,154500,147500,-7000,4973674,361610.0,SK아이이테크놀로지보통주
21786,361610,2021-05-11,0.3867595818815331,143500,154500,11000,11320278,361610.0,SK아이이테크놀로지보통주
21787,361610,2021-05-18,0.0434782608695652,138000,144000,6000,1474901,361610.0,SK아이이테크놀로지보통주
21788,361610,2021-05-12,0.0453074433656957,154500,147500,-7000,4973674,361610.0,SK아이이테크놀로지보통주
21789,361610,2021-05-11,0.3867595818815331,143500,154500,11000,11320278,361610.0,SK아이이테크놀로지보통주
21790,361610,2021-05-18,0.0434782608695652,138000,144000,6000,1474901,361610.0,SK아이이테크놀로지보통주
21791,361610,2021-05-12,0.0453074433656957,154500,147500,-7000,4973674,361610.0,SK아이이테크놀로지보통주
21792,361610,2021-05-11,0.3867595818815331,143500,154500,11000,11320278,361610.0,SK아이이테크놀로지보통주
21793,361610,2021-05-18,0.0434782608695652,138000,144000,6000,1474901,361610.0,SK아이이테크놀로지보통주
21794,361610,2021-05-12,0.0453074433656957,154500,147500,-7000,4973674,361610.0,SK아이이테크놀로지보통주
21795,361610,2021-05-11,0.3867595818815331,143500,154500,11000,11320278,361610.0,SK아이이테크놀로지보통주
21796,361610,2021-05-18,0.0434782608695652,138000,144000,6000,1474901,361610.0,SK아이이테크놀로지보통주
21797,361610,2021-05-12,0.0453074433656957,154500,147500,-7000,4973674,361610.0,SK아이이테크놀로지보통주
21798,361610,2021-05-11,0.3867595818815331,143500,154500,11000,11320278,361610.0,SK아이이테크놀로지보통주
21799,361610,2021-05-18,0.0434782608695652,138000,144000,6000,1474901,361610.0,SK아이이테크놀로지보통주
21800,361610,2021-05-12,0.0453074433656957,154500,147500,-7000,4973674,361610.0,SK아이이테크놀로지보통주
21801,361610,2021-05-11,0.3867595818815331,143500,154500,11000,11320278,361610.0,SK아이이테크놀로지보통주
21802,361610,2021-05-18,0.0434782608695652,138000,144000,6000,1474901,361610.0,SK아이이테크놀로지보통주
21803,361610,2021-05-12,0.0453074433656957,154500,147500,-7000,4973674,361610.0,SK아이이테크놀로지보통주
21804,361610,2021-05-11,0.3867595818815331,143500,154500,11000,11320278,361610.0,SK아이이테크놀로지보통주
21805,361610,2021-05-18,0.0434782608695652,138000,144000,6000,1474901,361610.0,SK아이이테크놀로지보통주
21806,361610,2021-05-12,0.0453074433656957,154500,147500,-7000,4973674,361610.0,SK아이이테크놀로지보통주
21807,361610,2021-05-11,0.3867595818815331,143500,154500,11000,11320278,361610.0,SK아이이테크놀로지보통주
21808,361610,2021-05-18,0.0434782608695652,138000,144000,6000,1474901,361610.0,SK아이이테크놀로지보통주
21809,361610,2021-05-12,0.0453074433656957,154500,147500,-7000,4973674,361610.0,SK아이이테크놀로지보통주
21810,361610,2021-05-11,0.3867595818815331,143500,154500,11000,11320278,361610.0,SK아이이테크놀로지보통주
21811,361610,2021-05-18,0.0434782608695652,138000,144000,6000,1474901,361610.0,SK아이이테크놀로지보통주
21812,361610,2021-05-12,0.0453074433656957,154500,147500,-7000,4973674,361610.0,SK아이이테크놀로지보통주
21813,361610,2021-05-11,0.3867595818815331,143500,154500,11000,11320278,361610.0,SK아이이테크놀로지보통주
21814,361610,2021-05-18,0.0434782608695652,138000,144000,6000,1474901,361610.0,SK아이이테크놀로지보통주
21815,361610,2021-05-12,0.0453074433656957,154500,147500,-7000,4973674,361610.0,SK아이이테크놀로지보통주
21816,361610,2021-05-11,0.3867595818815331,143500,154500,11000,11320278,361610.0,SK아이이테크놀로지보통주
21817,361610,2021-05-18,0.0434782608695652,138000,144000,6000,1474901,361610.0,SK아이이테크놀로지보통주
21818,361610,2021-05-12,0.0453074433656957,154500,147500,-7000,4973674,361610.0,SK아이이테크놀로지보통주
21819,361610,2021-05-11,0.3867595818815331,143500,154500,11000,11320278,361610.0,SK아이이테크놀로지보통주
21820,361610,2021-05-18,0.0434782608695652,138000,144000,6000,1474901,361610.0,SK아이이테크놀로지보통주
21821,361610,2021-05-12,0.0453074433656957,154500,147500,-7000,4973674,361610.0,SK아이이테크놀로지보통주
21822,361610,2021-05-11,0.3867595818815331,143500,154500,11000,11320278,361610.0,SK아이이테크놀로지보통주
21823,361610,2021-05-18,0.0434782608695652,138000,144000,6000,1474901,361610.0,SK아이이테크놀로지보통주
21824,361610,2021-05-12,0.0453074433656957,154500,147500,-7000,4973674,361610.0,SK아이이테크놀로지보통주
21825,361610,2021-05-11,0.3867595818815331,143500,154500,11000,11320278,361610.0,SK아이이테크놀로지보통주
21826,361610,2021-05-18,0.0434782608695652,138000,144000,6000,1474901,361610.0,SK아이이테크놀로지보통주
21827,361610,2021-05-12,0.0453074433656957,154500,147500,-7000,4973674,361610.0,SK아이이테크놀로지보통주
21828,361610,2021-05-11,0.3867595818815331,143500,154500,11000,11320278,361610.0,SK아이이테크놀로지보통주
21829,361610,2021-05-18,0.0434782608695652,138000,144000,6000,1474901,361610.0,SK아이이테크놀로지보통주
21830,361610,2021-05-12,0.0453074433656957,154500,147500,-7000,4973674,361610.0,SK아이이테크놀로지보통주
21831,361610,2021-05-11,0.3867595818815331,143500,154500,11000,11320278,361610.0,SK아이이테크놀로지보통주
21832,361610,2021-05-18,0.0434782608695652,138000,144000,6000,1474901,361610.0,SK아이이테크놀로지보통주
21833,361610,2021-05-12,0.0453074433656957,154500,147500,-7000,4973674,361610.0,SK아이이테크놀로지보통주
21834,361610,2021-05-11,0.3867595818815331,143500,154500,11000,11320278,361610.0,SK아이이테크놀로지보통주
21835,361610,2021-05-18,0.0434782608695652,138000,144000,6000,1474901,361610.0,SK아이이테크놀로지보통주
21836,361610,2021-05-12,0.0453074433656957,154500,147500,-7000,4973674,361610.0,SK아이이테크놀로지보통주
21837,361610,2021-05-11,0.3867595818815331,143500,154500,11000,11320278,361610.0,SK아이이테크놀로지보통주
21838,361610,2021-05-18,0.0434782608695652,138000,144000,6000,1474901,361610.0,SK아이이테크놀로지보통주
21839,361610,2021-05-12,0.0453074433656957,154500,147500,-7000,4973674,361610.0,SK아이이테크놀로지보통주
21840,361610,2021-05-11,0.3867595818815331,143500,154500,11000,11320278,361610.0,SK아이이테크놀로지보통주
21841,361610,2021-05-18,0.0434782608695652,138000,144000,6000,1474901,361610.0,SK아이이테크놀로지보통주
21842,361610,2021-05-12,0.0453074433656957,154500,147500,-7000,4973674,361610.0,SK아이이테크놀로지보통주
21843,361610,2021-05-11,0.3867595818815331,143500,154500,11000,11320278,361610.0,SK아이이테크놀로지보통주
21844,361610,2021-05-18,0.0434782608695652,138000,144000,6000,1474901,361610.0,SK아이이테크놀로지보통주
21845,361610,2021-05-12,0.0453074433656957,154500,147500,-7000,4973674,361610.0,SK아이이테크놀로지보통주
21846,361610,2021-05-11,0.3867595818815331,143500,154500,11000,11320278,361610.0,SK아이이테크놀로지보통주
21847,361610,2021-05-18,0.0434782608695652,138000,144000,6000,1474901,361610.0,SK아이이테크놀로지보통주
21848,361610,2021-05-12,0.0453074433656957,154500,147500,-7000,4973674,361610.0,SK아이이테크놀로지보통주
21849,361610,2021-05-11,0.3867595818815331,143500,154500,11000,11320278,361610.0,SK아이이테크놀로지보통주
21850,361610,2021-05-18,0.0434782608695652,138000,144000,6000,1474901,361610.0,SK아이이테크놀로지보통주
21851,361610,2021-05-12,0.0453074433656957,154500,147500,-7000,4973674,361610.0,SK아이이테크놀로지보통주
21852,361610,2021-05-11,0.3867595818815331,143500,154500,11000,11320278,361610.0,SK아이이테크놀로지보통주
21853,361610,2021-05-18,0.0434782608695652,138000,144000,6000,1474901,361610.0,SK아이이테크놀로지보통주
21854,361610,2021-05-12,0.0453074433656957,154500,147500,-7000,4973674,361610.0,SK아이이테크놀로지보통주
21855,361610,2021-05-11,0.3867595818815331,143500,154500,11000,11320278,361610.0,SK아이이테크놀로지보통주
21856,361610,2021-05-18,0.0434782608695652,138000,144000,6000,1474901,361610.0,SK아이이테크놀로지보통주
21857,361610,2021-05-12,0.0453074433656957,154500,147500,-7000,4973674,361610.0,SK아이이테크놀로지보통주
21858,361610,2021-05-11,0.3867595818815331,143500,154500,11000,11320278,361610.0,SK아이이테크놀로지보통주
21859,361610,2021-05-18,0.0434782608695652,138000,144000,6000,1474901,361610.0,SK아이이테크놀로지보통주
21860,361610,2021-05-12,0.0453074433656957,154500,147500,-7000,4973674,361610.0,SK아이이테크놀로지보통주
21861,361610,2021-05-11,0.3867595818815331,143500,154500,11000,11320278,361610.0,SK아이이테크놀로지보통주
21862,361610,2021-05-18,0.0434782608695652,138000,144000,6000,1474901,361610.0,SK아이이테크놀로지보통주
21863,361610,2021-05-12,0.0453074433656957,154500,147500,-7000,4973674,361610.0,SK아이이테크놀로지보통주
21864,361610,2021-05-11,0.3867595818815331,143500,154500,11000,11320278,361610.0,SK아이이테크놀로지보통주
21865,361610,2021-05-18,0.0434782608695652,138000,144000,6000,1474901,361610.0,SK아이이테크놀로지보통주
21866,361610,2021-05-12,0.0453074433656957,154500,147500,-7000,4973674,361610.0,SK아이이테크놀로지보통주
21867,361610,2021-05-11,0.3867595818815331,143500,154500,11000,11320278,361610.0,SK아이이테크놀로지보통주
21868,361610,2021-05-18,0.0434782608695652,138000,144000,6000,1474901,361610.0,SK아이이테크놀로지보통주
21869,361610,2021-05-12,0.0453074433656957,154500,147500,-7000,4973674,361610.0,SK아이이테크놀로지보통주
21870,361610,2021-05-11,0.3867595818815331,143500,154500,11000,11320278,361610.0,SK아이이테크놀로지보통주
21871,361610,2021-05-18,0.0434782608695652,138000,144000,6000,1474901,361610.0,SK아이이테크놀로지보통주
21872,361610,2021-05-12,0.0453074433656957,154500,147500,-7000,4973674,361610.0,SK아이이테크놀로지보통주
21873,361610,2021-05-11,0.3867595818815331,143500,154500,11000,11320278,361610.0,SK아이이테크놀로지보통주
21874,361610,2021-05-18,0.0434782608695652,138000,144000,6000,1474901,361610.0,SK아이이테크놀로지보통주
21875,361610,2021-05-12,0.0453074433656957,154500,147500,-7000,4973674,361610.0,SK아이이테크놀로지보통주
21876,361610,2021-05-11,0.3867595818815331,143500,154500,11000,11320278,361610.0,SK아이이테크놀로지보통주
21877,361610,2021-05-18,0.0434782608695652,138000,144000,6000,1474901,361610.0,SK아이이테크놀로지보통주
21878,361610,2021-05-12,0.0453074433656957,154500,147500,-7000,4973674,361610.0,SK아이이테크놀로지보통주
21879,361610,2021-05-11,0.3867595818815331,143500,154500,11000,11320278,361610.0,SK아이이테크놀로지보통주
21880,361610,2021-05-18,0.0434782608695652,138000,144000,6000,1474901,361610.0,SK아이이테크놀로지보통주
21881,361610,2021-05-12,0.0453074433656957,154500,147500,-7000,4973674,361610.0,SK아이이테크놀로지보통주
21882,361610,2021-05-11,0.3867595818815331,143500,154500,11000,11320278,361610.0,SK아이이테크놀로지보통주
21883,361610,2021-05-18,0.0434782608695652,138000,144000,6000,1474901,361610.0,SK아이이테크놀로지보통주
21884,361610,2021-05-12,0.0453074433656957,154500,147500,-7000,4973674,361610.0,SK아이이테크놀로지보통주
21885,361610,2021-05-11,0.3867595818815331,143500,154500,11000,11320278,361610.0,SK아이이테크놀로지보통주
21886,361610,2021-05-18,0.0434782608695652,138000,144000,6000,1474901,361610.0,SK아이이테크놀로지보통주
21887,361610,2021-05-12,0.0453074433656957,154500,147500,-7000,4973674,361610.0,SK아이이테크놀로지보통주
21888,361610,2021-05-11,0.3867595818815331,143500,154500,11000,11320278,361610.0,SK아이이테크놀로지보통주
21889,361610,2021-05-18,0.0434782608695652,138000,144000,6000,1474901,361610.0,SK아이이테크놀로지보통주
21890,361610,2021-05-12,0.0453074433656957,154500,147500,-7000,4973674,361610.0,SK아이이테크놀로지보통주
21891,361610,2021-05-11,0.3867595818815331,143500,154500,11000,11320278,361610.0,SK아이이테크놀로지보통주
21892,361610,2021-05-18,0.0434782608695652,138000,144000,6000,1474901,361610.0,SK아이이테크놀로지보통주
21893,361610,2021-05-12,0.0453074433656957,154500,147500,-7000,4973674,361610.0,SK아이이테크놀로지보통주
21894,361610,2021-05-11,0.3867595818815331,143500,154500,11000,11320278,361610.0,SK아이이테크놀로지보통주
21895,361610,2021-05-18,0.0434782608695652,138000,144000,6000,1474901,361610.0,SK아이이테크놀로지보통주
21896,361610,2021-05-12,0.0453074433656957,154500,147500,-7000,4973674,361610.0,SK아이이테크놀로지보통주
21897,361610,2021-05-11,0.3867595818815331,143500,154500,11000,11320278,361610.0,SK아이이테크놀로지보통주
21898,361610,2021-05-18,0.0434782608695652,138000,144000,6000,1474901,361610.0,SK아이이테크놀로지보통주
21899,361610,2021-05-12,0.0453074433656957,154500,147500,-7000,4973674,361610.0,SK아이이테크놀로지보통주
21900,361610,2021-05-11,0.3867595818815331,143500,154500,11000,11320278,361610.0,SK아이이테크놀로지보통주
21901,361610,2021-05-18,0.0434782608695652,138000,144000,6000,1474901,361610.0,SK아이이테크놀로지보통주
21902,361610,2021-05-12,0.0453074433656957,154500,147500,-7000,4973674,361610.0,SK아이이테크놀로지보통주
21903,361610,2021-05-11,0.3867595818815331,143500,154500,11000,11320278,361610.0,SK아이이테크놀로지보통주
21904,361610,2021-05-18,0.0434782608695652,138000,144000,6000,1474901,361610.0,SK아이이테크놀로지보통주
21905,361610,2021-05-12,0.0453074433656957,154500,147500,-7000,4973674,361610.0,SK아이이테크놀로지보통주
21906,361610,2021-05-11,0.3867595818815331,143500,154500,11000,11320278,361610.0,SK아이이테크놀로지보통주
21907,361610,2021-05-18,0.0434782608695652,138000,144000,6000,1474901,361610.0,SK아이이테크놀로지보통주
21908,361610,2021-05-12,0.0453074433656957,154500,147500,-7000,4973674,361610.0,SK아이이테크놀로지보통주
21909,361610,2021-05-11,0.3867595818815331,143500,154500,11000,11320278,361610.0,SK아이이테크놀로지보통주
21910,361610,2021-05-18,0.0434782608695652,138000,144000,6000,1474901,361610.0,SK아이이테크놀로지보통주
21911,361610,2021-05-12,0.0453074433656957,154500,147500,-7000,4973674,361610.0,SK아이이테크놀로지보통주
21912,361610,2021-05-11,0.3867595818815331,143500,154500,11000,11320278,361610.0,SK아이이테크놀로지보통주
21913,361610,2021-05-18,0.0434782608695652,138000,144000,6000,1474901,361610.0,SK아이이테크놀로지보통주
21914,361610,2021-05-12,0.0453074433656957,154500,147500,-7000,4973674,361610.0,SK아이이테크놀로지보통주
21915,361610,2021-05-11,0.3867595818815331,143500,154500,11000,11320278,361610.0,SK아이이테크놀로지보통주
21916,361610,2021-05-18,0.0434782608695652,138000,144000,6000,1474901,361610.0,SK아이이테크놀로지보통주
21917,361610,2021-05-12,0.0453074433656957,154500,147500,-7000,4973674,361610.0,SK아이이테크놀로지보통주
21918,361610,2021-05-11,0.3867595818815331,143500,154500,11000,11320278,361610.0,SK아이이테크놀로지보통주
21919,361610,2021-05-18,0.0434782608695652,138000,144000,6000,1474901,361610.0,SK아이이테크놀로지보통주
21920,361610,2021-05-12,0.0453074433656957,154500,147500,-7000,4973674,361610.0,SK아이이테크놀로지보통주
21921,361610,2021-05-11,0.3867595818815331,143500,154500,11000,11320278,361610.0,SK아이이테크놀로지보통주
21922,361610,2021-05-18,0.0434782608695652,138000,144000,6000,1474901,361610.0,SK아이이테크놀로지보통주
21923,361610,2021-05-12,0.0453074433656957,154500,147500,-7000,4973674,361610.0,SK아이이테크놀로지보통주
21924,361610,2021-05-11,0.3867595818815331,143500,154500,11000,11320278,361610.0,SK아이이테크놀로지보통주
21925,361610,2021-05-18,0.0434782608695652,138000,144000,6000,1474901,361610.0,SK아이이테크놀로지보통주
21926,361610,2021-05-12,0.0453074433656957,154500,147500,-7000,4973674,361610.0,SK아이이테크놀로지보통주
21927,361610,2021-05-11,0.3867595818815331,143500,154500,11000,11320278,361610.0,SK아이이테크놀로지보통주
21928,361610,2021-05-18,0.0434782608695652,138000,144000,6000,1474901,361610.0,SK아이이테크놀로지보통주
21929,361610,2021-05-12,0.0453074433656957,154500,147500,-7000,4973674,361610.0,SK아이이테크놀로지보통주
21930,361610,2021-05-11,0.3867595818815331,143500,154500,11000,11320278,361610.0,SK아이이테크놀로지보통주
21931,361610,2021-05-18,0.0434782608695652,138000,144000,6000,1474901,361610.0,SK아이이테크놀로지보통주
21932,361610,2021-05-12,0.0453074433656957,154500,147500,-7000,4973674,361610.0,SK아이이테크놀로지보통주
21933,361610,2021-05-11,0.3867595818815331,143500,154500,11000,11320278,361610.0,SK아이이테크놀로지보통주
21934,361610,2021-05-18,0.0434782608695652,138000,144000,6000,1474901,361610.0,SK아이이테크놀로지보통주
21935,361610,2021-05-12,0.0453074433656957,154500,147500,-7000,4973674,361610.0,SK아이이테크놀로지보통주
21936,361610,2021-05-11,0.3867595818815331,143500,154500,11000,11320278,361610.0,SK아이이테크놀로지보통주
21937,361610,2021-05-18,0.0434782608695652,138000,144000,6000,1474901,361610.0,SK아이이테크놀로지보통주
21938,361610,2021-05-12,0.0453074433656957,154500,147500,-7000,4973674,361610.0,SK아이이테크놀로지보통주
21939,361610,2021-05-11,0.3867595818815331,143500,154500,11000,11320278,361610.0,SK아이이테크놀로지보통주
21940,361610,2021-05-18,0.0434782608695652,138000,144000,6000,1474901,361610.0,SK아이이테크놀로지보통주
21941,361610,2021-05-12,0.0453074433656957,154500,147500,-7000,4973674,361610.0,SK아이이테크놀로지보통주
21942,361610,2021-05-11,0.3867595818815331,143500,154500,11000,11320278,361610.0,SK아이이테크놀로지보통주
21943,361610,2021-05-18,0.0434782608695652,138000,144000,6000,1474901,361610.0,SK아이이테크놀로지보통주
21944,361610,2021-05-12,0.0453074433656957,154500,147500,-7000,4973674,361610.0,SK아이이테크놀로지보통주
21945,361610,2021-05-11,0.3867595818815331,143500,154500,11000,11320278,361610.0,SK아이이테크놀로지보통주
21946,361610,2021-05-18,0.0434782608695652,138000,144000,6000,1474901,361610.0,SK아이이테크놀로지보통주
21947,361610,2021-05-12,0.0453074433656957,154500,147500,-7000,4973674,361610.0,SK아이이테크놀로지보통주
21948,361610,2021-05-11,0.3867595818815331,143500,154500,11000,11320278,361610.0,SK아이이테크놀로지보통주
21949,361610,2021-05-18,0.0434782608695652,138000,144000,6000,1474901,361610.0,SK아이이테크놀로지보통주
21950,361610,2021-05-12,0.0453074433656957,154500,147500,-7000,4973674,361610.0,SK아이이테크놀로지보통주
21951,361610,2021-05-11,0.3867595818815331,143500,154500,11000,11320278,361610.0,SK아이이테크놀로지보통주
21952,361610,2021-05-18,0.0434782608695652,138000,144000,6000,1474901,361610.0,SK아이이테크놀로지보통주
21953,361610,2021-05-12,0.0453074433656957,154500,147500,-7000,4973674,361610.0,SK아이이테크놀로지보통주
21954,361610,2021-05-11,0.3867595818815331,143500,154500,11000,11320278,361610.0,SK아이이테크놀로지보통주
21955,361610,2021-05-18,0.0434782608695652,138000,144000,6000,1474901,361610.0,SK아이이테크놀로지보통주
21956,361610,2021-05-12,0.0453074433656957,154500,147500,-7000,4973674,361610.0,SK아이이테크놀로지보통주
21957,361610,2021-05-11,0.3867595818815331,143500,154500,11000,11320278,361610.0,SK아이이테크놀로지보통주
21958,361610,2021-05-18,0.0434782608695652,138000,144000,6000,1474901,361610.0,SK아이이테크놀로지보통주
21959,361610,2021-05-12,0.0453074433656957,154500,147500,-7000,4973674,361610.0,SK아이이테크놀로지보통주
21960,361610,2021-05-11,0.3867595818815331,143500,154500,11000,11320278,361610.0,SK아이이테크놀로지보통주
21961,361610,2021-05-18,0.0434782608695652,138000,144000,6000,1474901,361610.0,SK아이이테크놀로지보통주
21962,361610,2021-05-12,0.0453074433656957,154500,147500,-7000,4973674,361610.0,SK아이이테크놀로지보통주
21963,361610,2021-05-11,0.3867595818815331,143500,154500,11000,11320278,361610.0,SK아이이테크놀로지보통주
21964,361610,2021-05-18,0.0434782608695652,138000,144000,6000,1474901,361610.0,SK아이이테크놀로지보통주
21965,361610,2021-05-12,0.0453074433656957,154500,147500,-7000,4973674,361610.0,SK아이이테크놀로지보통주
21966,361610,2021-05-11,0.3867595818815331,143500,154500,11000,11320278,361610.0,SK아이이테크놀로지보통주
21967,361610,2021-05-18,0.0434782608695652,138000,144000,6000,1474901,361610.0,SK아이이테크놀로지보통주
21968,361610,2021-05-12,0.0453074433656957,154500,147500,-7000,4973674,361610.0,SK아이이테크놀로지보통주
21969,361610,2021-05-11,0.3867595818815331,143500,154500,11000,11320278,361610.0,SK아이이테크놀로지보통주
21970,361610,2021-05-18,0.0434782608695652,138000,144000,6000,1474901,361610.0,SK아이이테크놀로지보통주
21971,361610,2021-05-12,0.0453074433656957,154500,147500,-7000,4973674,361610.0,SK아이이테크놀로지보통주
21972,361610,2021-05-11,0.3867595818815331,143500,154500,11000,11320278,361610.0,SK아이이테크놀로지보통주
21973,361610,2021-05-18,0.0434782608695652,138000,144000,6000,1474901,361610.0,SK아이이테크놀로지보통주
21974,361610,2021-05-12,0.0453074433656957,154500,147500,-7000,4973674,361610.0,SK아이이테크놀로지보통주
21975,361610,2021-05-11,0.3867595818815331,143500,154500,11000,11320278,361610.0,SK아이이테크놀로지보통주
21976,361610,2021-05-18,0.0434782608695652,138000,144000,6000,1474901,361610.0,SK아이이테크놀로지보통주
21977,361610,2021-05-12,0.0453074433656957,154500,147500,-7000,4973674,361610.0,SK아이이테크놀로지보통주
21978,361610,2021-05-11,0.3867595818815331,143500,154500,11000,11320278,361610.0,SK아이이테크놀로지보통주
21979,361610,2021-05-18,0.0434782608695652,138000,144000,6000,1474901,361610.0,SK아이이테크놀로지보통주
21980,361610,2021-05-12,0.0453074433656957,154500,147500,-7000,4973674,361610.0,SK아이이테크놀로지보통주
21981,361610,2021-05-11,0.3867595818815331,143500,154500,11000,11320278,361610.0,SK아이이테크놀로지보통주
21982,361610,2021-05-18,0.0434782608695652,138000,144000,6000,1474901,361610.0,SK아이이테크놀로지보통주
21983,361610,2021-05-12,0.0453074433656957,154500,147500,-7000,4973674,361610.0,SK아이이테크놀로지보통주
21984,361610,2021-05-11,0.3867595818815331,143500,154500,11000,11320278,361610.0,SK아이이테크놀로지보통주
21985,361610,2021-05-18,0.0434782608695652,138000,144000,6000,1474901,361610.0,SK아이이테크놀로지보통주
21986,361610,2021-05-12,0.0453074433656957,154500,147500,-7000,4973674,361610.0,SK아이이테크놀로지보통주
21987,361610,2021-05-11,0.3867595818815331,143500,154500,11000,11320278,361610.0,SK아이이테크놀로지보통주
21988,361610,2021-05-18,0.0434782608695652,138000,144000,6000,1474901,361610.0,SK아이이테크놀로지보통주
21989,361610,2021-05-12,0.0453074433656957,154500,147500,-7000,4973674,361610.0,SK아이이테크놀로지보통주
21990,361610,2021-05-11,0.3867595818815331,143500,154500,11000,11320278,361610.0,SK아이이테크놀로지보통주
21991,361610,2021-05-18,0.0434782608695652,138000,144000,6000,1474901,361610.0,SK아이이테크놀로지보통주
21992,361610,2021-05-12,0.0453074433656957,154500,147500,-7000,4973674,361610.0,SK아이이테크놀로지보통주
21993,361610,2021-05-11,0.3867595818815331,143500,154500,11000,11320278,361610.0,SK아이이테크놀로지보통주
21994,361610,2021-05-18,0.0434782608695652,138000,144000,6000,1474901,361610.0,SK아이이테크놀로지보통주
21995,361610,2021-05-12,0.0453074433656957,154500,147500,-7000,4973674,361610.0,SK아이이테크놀로지보통주
21996,361610,2021-05-11,0.3867595818815331,143500,154500,11000,11320278,361610.0,SK아이이테크놀로지보통주
21997,361610,2021-05-18,0.0434782608695652,138000,144000,6000,1474901,361610.0,SK아이이테크놀로지보통주
21998,361610,2021-05-12,0.0453074433656957,154500,147500,-7000,4973674,361610.0,SK아이이테크놀로지보통주
21999,361610,2021-05-11,0.3867595818815331,143500,154500,11000,11320278,361610.0,SK아이이테크놀로지보통주
22000,361610,2021-05-18,0.0434782608695652,138000,144000,6000,1474901,361610.0,SK아이이테크놀로지보통주
22001,361610,2021-05-12,0.0453074433656957,154500,147500,-7000,4973674,361610.0,SK아이이테크놀로지보통주
22002,361610,2021-05-11,0.3867595818815331,143500,154500,11000,11320278,361610.0,SK아이이테크놀로지보통주
22003,361610,2021-05-18,0.0434782608695652,138000,144000,6000,1474901,361610.0,SK아이이테크놀로지보통주
22004,361610,2021-05-12,0.0453074433656957,154500,147500,-7000,4973674,361610.0,SK아이이테크놀로지보통주
22005,375500,2021-05-17,0.046594982078853,139500,133000,-6500,431460,375500.0,DL이앤씨보통주
22006,375500,2021-04-27,0.0415094339622641,132500,138000,5500,390860,375500.0,DL이앤씨보통주
22007,375500,2021-03-09,0.0514018691588785,107000,112500,5500,436668,375500.0,DL이앤씨보통주
22008,375500,2021-02-26,0.0472103004291845,116500,111000,-5500,770923,375500.0,DL이앤씨보통주
22009,375500,2021-02-25,0.1201923076923077,104000,116500,12500,732921,375500.0,DL이앤씨보통주
22010,375500,2021-02-24,0.0588235294117647,110500,104000,-6500,599492,375500.0,DL이앤씨보통주
22011,375500,2021-02-01,0.0582959641255605,111500,118000,6500,641899,375500.0,DL이앤씨보통주
22012,375500,2021-01-29,0.0708333333333333,120000,111500,-8500,1105949,375500.0,DL이앤씨보통주
22013,375500,2021-01-27,0.0711462450592885,126500,117500,-9000,1082796,375500.0,DL이앤씨보통주
22014,375500,2021-01-25,0.0458333333333333,120000,127500,7500,3005049,375500.0,DL이앤씨보통주
22015,375500,2021-02-01,0.0582959641255605,111500,118000,6500,641899,375500.0,DL이앤씨보통주
22016,375500,2021-01-29,0.0708333333333333,120000,111500,-8500,1105949,375500.0,DL이앤씨보통주
22017,375500,2021-01-27,0.0711462450592885,126500,117500,-9000,1082796,375500.0,DL이앤씨보통주
22018,375500,2021-01-25,0.0458333333333333,120000,127500,7500,3005049,375500.0,DL이앤씨보통주
22019,375500,2021-02-01,0.0582959641255605,111500,118000,6500,641899,375500.0,DL이앤씨보통주
22020,375500,2021-01-29,0.0708333333333333,120000,111500,-8500,1105949,375500.0,DL이앤씨보통주
22021,375500,2021-01-27,0.0711462450592885,126500,117500,-9000,1082796,375500.0,DL이앤씨보통주
22022,375500,2021-01-25,0.0458333333333333,120000,127500,7500,3005049,375500.0,DL이앤씨보통주
22023,375500,2021-02-01,0.0582959641255605,111500,118000,6500,641899,375500.0,DL이앤씨보통주
22024,375500,2021-01-29,0.0708333333333333,120000,111500,-8500,1105949,375500.0,DL이앤씨보통주
22025,375500,2021-01-27,0.0711462450592885,126500,117500,-9000,1082796,375500.0,DL이앤씨보통주
22026,375500,2021-01-25,0.0458333333333333,120000,127500,7500,3005049,375500.0,DL이앤씨보통주
22027,375500,2021-02-01,0.0582959641255605,111500,118000,6500,641899,375500.0,DL이앤씨보통주
22028,375500,2021-01-29,0.0708333333333333,120000,111500,-8500,1105949,375500.0,DL이앤씨보통주
22029,375500,2021-01-27,0.0711462450592885,126500,117500,-9000,1082796,375500.0,DL이앤씨보통주
22030,375500,2021-01-25,0.0458333333333333,120000,127500,7500,3005049,375500.0,DL이앤씨보통주
22031,375500,2021-02-01,0.0582959641255605,111500,118000,6500,641899,375500.0,DL이앤씨보통주
22032,375500,2021-01-29,0.0708333333333333,120000,111500,-8500,1105949,375500.0,DL이앤씨보통주
22033,375500,2021-01-27,0.0711462450592885,126500,117500,-9000,1082796,375500.0,DL이앤씨보통주
22034,375500,2021-01-25,0.0458333333333333,120000,127500,7500,3005049,375500.0,DL이앤씨보통주
22035,375500,2021-02-01,0.0582959641255605,111500,118000,6500,641899,375500.0,DL이앤씨보통주
22036,375500,2021-01-29,0.0708333333333333,120000,111500,-8500,1105949,375500.0,DL이앤씨보통주
22037,375500,2021-01-27,0.0711462450592885,126500,117500,-9000,1082796,375500.0,DL이앤씨보통주
22038,375500,2021-01-25,0.0458333333333333,120000,127500,7500,3005049,375500.0,DL이앤씨보통주
22039,375500,2021-02-01,0.0582959641255605,111500,118000,6500,641899,375500.0,DL이앤씨보통주
22040,375500,2021-01-29,0.0708333333333333,120000,111500,-8500,1105949,375500.0,DL이앤씨보통주
22041,375500,2021-01-27,0.0711462450592885,126500,117500,-9000,1082796,375500.0,DL이앤씨보통주
22042,375500,2021-01-25,0.0458333333333333,120000,127500,7500,3005049,375500.0,DL이앤씨보통주
22043,375500,2021-02-01,0.0582959641255605,111500,118000,6500,641899,375500.0,DL이앤씨보통주
22044,375500,2021-01-29,0.0708333333333333,120000,111500,-8500,1105949,375500.0,DL이앤씨보통주
22045,375500,2021-01-27,0.0711462450592885,126500,117500,-9000,1082796,375500.0,DL이앤씨보통주
22046,375500,2021-01-25,0.0458333333333333,120000,127500,7500,3005049,375500.0,DL이앤씨보통주
22047,375500,2021-02-01,0.0582959641255605,111500,118000,6500,641899,375500.0,DL이앤씨보통주
22048,375500,2021-01-29,0.0708333333333333,120000,111500,-8500,1105949,375500.0,DL이앤씨보통주
22049,375500,2021-01-27,0.0711462450592885,126500,117500,-9000,1082796,375500.0,DL이앤씨보통주
22050,375500,2021-01-25,0.0458333333333333,120000,127500,7500,3005049,375500.0,DL이앤씨보통주
22051,375500,2021-02-01,0.0582959641255605,111500,118000,6500,641899,375500.0,DL이앤씨보통주
22052,375500,2021-01-29,0.0708333333333333,120000,111500,-8500,1105949,375500.0,DL이앤씨보통주
22053,375500,2021-01-27,0.0711462450592885,126500,117500,-9000,1082796,375500.0,DL이앤씨보통주
22054,375500,2021-01-25,0.0458333333333333,120000,127500,7500,3005049,375500.0,DL이앤씨보통주
22055,375500,2021-02-01,0.0582959641255605,111500,118000,6500,641899,375500.0,DL이앤씨보통주
22056,375500,2021-01-29,0.0708333333333333,120000,111500,-8500,1105949,375500.0,DL이앤씨보통주
22057,375500,2021-01-27,0.0711462450592885,126500,117500,-9000,1082796,375500.0,DL이앤씨보통주
22058,375500,2021-01-25,0.0458333333333333,120000,127500,7500,3005049,375500.0,DL이앤씨보통주
22059,375500,2021-02-01,0.0582959641255605,111500,118000,6500,641899,375500.0,DL이앤씨보통주
22060,375500,2021-01-29,0.0708333333333333,120000,111500,-8500,1105949,375500.0,DL이앤씨보통주
22061,375500,2021-01-27,0.0711462450592885,126500,117500,-9000,1082796,375500.0,DL이앤씨보통주
22062,375500,2021-01-25,0.0458333333333333,120000,127500,7500,3005049,375500.0,DL이앤씨보통주
22063,375500,2021-02-01,0.0582959641255605,111500,118000,6500,641899,375500.0,DL이앤씨보통주
22064,375500,2021-01-29,0.0708333333333333,120000,111500,-8500,1105949,375500.0,DL이앤씨보통주
22065,375500,2021-01-27,0.0711462450592885,126500,117500,-9000,1082796,375500.0,DL이앤씨보통주
22066,375500,2021-01-25,0.0458333333333333,120000,127500,7500,3005049,375500.0,DL이앤씨보통주
22067,375500,2021-02-01,0.0582959641255605,111500,118000,6500,641899,375500.0,DL이앤씨보통주
22068,375500,2021-01-29,0.0708333333333333,120000,111500,-8500,1105949,375500.0,DL이앤씨보통주
22069,375500,2021-01-27,0.0711462450592885,126500,117500,-9000,1082796,375500.0,DL이앤씨보통주
22070,375500,2021-01-25,0.0458333333333333,120000,127500,7500,3005049,375500.0,DL이앤씨보통주
22071,375500,2021-02-01,0.0582959641255605,111500,118000,6500,641899,375500.0,DL이앤씨보통주
22072,375500,2021-01-29,0.0708333333333333,120000,111500,-8500,1105949,375500.0,DL이앤씨보통주
22073,375500,2021-01-27,0.0711462450592885,126500,117500,-9000,1082796,375500.0,DL이앤씨보통주
22074,375500,2021-01-25,0.0458333333333333,120000,127500,7500,3005049,375500.0,DL이앤씨보통주
22075,375500,2021-02-01,0.0582959641255605,111500,118000,6500,641899,375500.0,DL이앤씨보통주
22076,375500,2021-01-29,0.0708333333333333,120000,111500,-8500,1105949,375500.0,DL이앤씨보통주
22077,375500,2021-01-27,0.0711462450592885,126500,117500,-9000,1082796,375500.0,DL이앤씨보통주
22078,375500,2021-01-25,0.0458333333333333,120000,127500,7500,3005049,375500.0,DL이앤씨보통주
22079,375500,2021-02-01,0.0582959641255605,111500,118000,6500,641899,375500.0,DL이앤씨보통주
22080,375500,2021-01-29,0.0708333333333333,120000,111500,-8500,1105949,375500.0,DL이앤씨보통주
22081,375500,2021-01-27,0.0711462450592885,126500,117500,-9000,1082796,375500.0,DL이앤씨보통주
22082,375500,2021-01-25,0.0458333333333333,120000,127500,7500,3005049,375500.0,DL이앤씨보통주
22083,375500,2021-02-01,0.0582959641255605,111500,118000,6500,641899,375500.0,DL이앤씨보통주
22084,375500,2021-01-29,0.0708333333333333,120000,111500,-8500,1105949,375500.0,DL이앤씨보통주
22085,375500,2021-01-27,0.0711462450592885,126500,117500,-9000,1082796,375500.0,DL이앤씨보통주
22086,375500,2021-01-25,0.0458333333333333,120000,127500,7500,3005049,375500.0,DL이앤씨보통주
22087,375500,2021-02-01,0.0582959641255605,111500,118000,6500,641899,375500.0,DL이앤씨보통주
22088,375500,2021-01-29,0.0708333333333333,120000,111500,-8500,1105949,375500.0,DL이앤씨보통주
22089,375500,2021-01-27,0.0711462450592885,126500,117500,-9000,1082796,375500.0,DL이앤씨보통주
22090,375500,2021-01-25,0.0458333333333333,120000,127500,7500,3005049,375500.0,DL이앤씨보통주
22091,375500,2021-02-01,0.0582959641255605,111500,118000,6500,641899,375500.0,DL이앤씨보통주
22092,375500,2021-01-29,0.0708333333333333,120000,111500,-8500,1105949,375500.0,DL이앤씨보통주
22093,375500,2021-01-27,0.0711462450592885,126500,117500,-9000,1082796,375500.0,DL이앤씨보통주
22094,375500,2021-01-25,0.0458333333333333,120000,127500,7500,3005049,375500.0,DL이앤씨보통주
22095,375500,2021-02-01,0.0582959641255605,111500,118000,6500,641899,375500.0,DL이앤씨보통주
22096,375500,2021-01-29,0.0708333333333333,120000,111500,-8500,1105949,375500.0,DL이앤씨보통주
22097,375500,2021-01-27,0.0711462450592885,126500,117500,-9000,1082796,375500.0,DL이앤씨보통주
22098,375500,2021-01-25,0.0458333333333333,120000,127500,7500,3005049,375500.0,DL이앤씨보통주
22099,375500,2021-02-01,0.0582959641255605,111500,118000,6500,641899,375500.0,DL이앤씨보통주
22100,375500,2021-01-29,0.0708333333333333,120000,111500,-8500,1105949,375500.0,DL이앤씨보통주
22101,375500,2021-01-27,0.0711462450592885,126500,117500,-9000,1082796,375500.0,DL이앤씨보통주
22102,375500,2021-01-25,0.0458333333333333,120000,127500,7500,3005049,375500.0,DL이앤씨보통주
22103,375500,2021-02-01,0.0582959641255605,111500,118000,6500,641899,375500.0,DL이앤씨보통주
22104,375500,2021-01-29,0.0708333333333333,120000,111500,-8500,1105949,375500.0,DL이앤씨보통주
22105,375500,2021-01-27,0.0711462450592885,126500,117500,-9000,1082796,375500.0,DL이앤씨보통주
22106,375500,2021-01-25,0.0458333333333333,120000,127500,7500,3005049,375500.0,DL이앤씨보통주
22107,375500,2021-02-01,0.0582959641255605,111500,118000,6500,641899,375500.0,DL이앤씨보통주
22108,375500,2021-01-29,0.0708333333333333,120000,111500,-8500,1105949,375500.0,DL이앤씨보통주
22109,375500,2021-01-27,0.0711462450592885,126500,117500,-9000,1082796,375500.0,DL이앤씨보통주
22110,375500,2021-01-25,0.0458333333333333,120000,127500,7500,3005049,375500.0,DL이앤씨보통주
22111,375500,2021-02-01,0.0582959641255605,111500,118000,6500,641899,375500.0,DL이앤씨보통주
22112,375500,2021-01-29,0.0708333333333333,120000,111500,-8500,1105949,375500.0,DL이앤씨보통주
22113,375500,2021-01-27,0.0711462450592885,126500,117500,-9000,1082796,375500.0,DL이앤씨보통주
22114,375500,2021-01-25,0.0458333333333333,120000,127500,7500,3005049,375500.0,DL이앤씨보통주
22115,375500,2021-02-01,0.0582959641255605,111500,118000,6500,641899,375500.0,DL이앤씨보통주
22116,375500,2021-01-29,0.0708333333333333,120000,111500,-8500,1105949,375500.0,DL이앤씨보통주
22117,375500,2021-01-27,0.0711462450592885,126500,117500,-9000,1082796,375500.0,DL이앤씨보통주
22118,375500,2021-01-25,0.0458333333333333,120000,127500,7500,3005049,375500.0,DL이앤씨보통주
22119,375500,2021-02-01,0.0582959641255605,111500,118000,6500,641899,375500.0,DL이앤씨보통주
22120,375500,2021-01-29,0.0708333333333333,120000,111500,-8500,1105949,375500.0,DL이앤씨보통주
22121,375500,2021-01-27,0.0711462450592885,126500,117500,-9000,1082796,375500.0,DL이앤씨보통주
22122,375500,2021-01-25,0.0458333333333333,120000,127500,7500,3005049,375500.0,DL이앤씨보통주
22123,375500,2021-02-01,0.0582959641255605,111500,118000,6500,641899,375500.0,DL이앤씨보통주
22124,375500,2021-01-29,0.0708333333333333,120000,111500,-8500,1105949,375500.0,DL이앤씨보통주
22125,375500,2021-01-27,0.0711462450592885,126500,117500,-9000,1082796,375500.0,DL이앤씨보통주
22126,375500,2021-01-25,0.0458333333333333,120000,127500,7500,3005049,375500.0,DL이앤씨보통주
22127,375500,2021-02-01,0.0582959641255605,111500,118000,6500,641899,375500.0,DL이앤씨보통주
22128,375500,2021-01-29,0.0708333333333333,120000,111500,-8500,1105949,375500.0,DL이앤씨보통주
22129,375500,2021-01-27,0.0711462450592885,126500,117500,-9000,1082796,375500.0,DL이앤씨보통주
22130,375500,2021-01-25,0.0458333333333333,120000,127500,7500,3005049,375500.0,DL이앤씨보통주
22131,375500,2021-02-01,0.0582959641255605,111500,118000,6500,641899,375500.0,DL이앤씨보통주
22132,375500,2021-01-29,0.0708333333333333,120000,111500,-8500,1105949,375500.0,DL이앤씨보통주
22133,375500,2021-01-27,0.0711462450592885,126500,117500,-9000,1082796,375500.0,DL이앤씨보통주
22134,375500,2021-01-25,0.0458333333333333,120000,127500,7500,3005049,375500.0,DL이앤씨보통주
22135,375500,2021-02-01,0.0582959641255605,111500,118000,6500,641899,375500.0,DL이앤씨보통주
22136,375500,2021-01-29,0.0708333333333333,120000,111500,-8500,1105949,375500.0,DL이앤씨보통주
22137,375500,2021-01-27,0.0711462450592885,126500,117500,-9000,1082796,375500.0,DL이앤씨보통주
22138,375500,2021-01-25,0.0458333333333333,120000,127500,7500,3005049,375500.0,DL이앤씨보통주
22139,375500,2021-02-01,0.0582959641255605,111500,118000,6500,641899,375500.0,DL이앤씨보통주
22140,375500,2021-01-29,0.0708333333333333,120000,111500,-8500,1105949,375500.0,DL이앤씨보통주
22141,375500,2021-01-27,0.0711462450592885,126500,117500,-9000,1082796,375500.0,DL이앤씨보통주
22142,375500,2021-01-25,0.0458333333333333,120000,127500,7500,3005049,375500.0,DL이앤씨보통주
22143,375500,2021-02-01,0.0582959641255605,111500,118000,6500,641899,375500.0,DL이앤씨보통주
22144,375500,2021-01-29,0.0708333333333333,120000,111500,-8500,1105949,375500.0,DL이앤씨보통주
22145,375500,2021-01-27,0.0711462450592885,126500,117500,-9000,1082796,375500.0,DL이앤씨보통주
22146,375500,2021-01-25,0.0458333333333333,120000,127500,7500,3005049,375500.0,DL이앤씨보통주
22147,375500,2021-02-01,0.0582959641255605,111500,118000,6500,641899,375500.0,DL이앤씨보통주
22148,375500,2021-01-29,0.0708333333333333,120000,111500,-8500,1105949,375500.0,DL이앤씨보통주
22149,375500,2021-01-27,0.0711462450592885,126500,117500,-9000,1082796,375500.0,DL이앤씨보통주
22150,375500,2021-01-25,0.0458333333333333,120000,127500,7500,3005049,375500.0,DL이앤씨보통주
22151,375500,2021-02-01,0.0582959641255605,111500,118000,6500,641899,375500.0,DL이앤씨보통주
22152,375500,2021-01-29,0.0708333333333333,120000,111500,-8500,1105949,375500.0,DL이앤씨보통주
22153,375500,2021-01-27,0.0711462450592885,126500,117500,-9000,1082796,375500.0,DL이앤씨보통주
22154,375500,2021-01-25,0.0458333333333333,120000,127500,7500,3005049,375500.0,DL이앤씨보통주
22155,375500,2021-02-01,0.0582959641255605,111500,118000,6500,641899,375500.0,DL이앤씨보통주
22156,375500,2021-01-29,0.0708333333333333,120000,111500,-8500,1105949,375500.0,DL이앤씨보통주
22157,375500,2021-01-27,0.0711462450592885,126500,117500,-9000,1082796,375500.0,DL이앤씨보통주
22158,375500,2021-01-25,0.0458333333333333,120000,127500,7500,3005049,375500.0,DL이앤씨보통주
22159,375500,2021-02-01,0.0582959641255605,111500,118000,6500,641899,375500.0,DL이앤씨보통주
22160,375500,2021-01-29,0.0708333333333333,120000,111500,-8500,1105949,375500.0,DL이앤씨보통주
22161,375500,2021-01-27,0.0711462450592885,126500,117500,-9000,1082796,375500.0,DL이앤씨보통주
22162,375500,2021-01-25,0.0458333333333333,120000,127500,7500,3005049,375500.0,DL이앤씨보통주
22163,375500,2021-02-01,0.0582959641255605,111500,118000,6500,641899,375500.0,DL이앤씨보통주
22164,375500,2021-01-29,0.0708333333333333,120000,111500,-8500,1105949,375500.0,DL이앤씨보통주
22165,375500,2021-01-27,0.0711462450592885,126500,117500,-9000,1082796,375500.0,DL이앤씨보통주
22166,375500,2021-01-25,0.0458333333333333,120000,127500,7500,3005049,375500.0,DL이앤씨보통주
22167,375500,2021-02-01,0.0582959641255605,111500,118000,6500,641899,375500.0,DL이앤씨보통주
22168,375500,2021-01-29,0.0708333333333333,120000,111500,-8500,1105949,375500.0,DL이앤씨보통주
22169,375500,2021-01-27,0.0711462450592885,126500,117500,-9000,1082796,375500.0,DL이앤씨보통주
22170,375500,2021-01-25,0.0458333333333333,120000,127500,7500,3005049,375500.0,DL이앤씨보통주
22171,375500,2021-02-01,0.0582959641255605,111500,118000,6500,641899,375500.0,DL이앤씨보통주
22172,375500,2021-01-29,0.0708333333333333,120000,111500,-8500,1105949,375500.0,DL이앤씨보통주
22173,375500,2021-01-27,0.0711462450592885,126500,117500,-9000,1082796,375500.0,DL이앤씨보통주
22174,375500,2021-01-25,0.0458333333333333,120000,127500,7500,3005049,375500.0,DL이앤씨보통주
22175,375500,2021-02-01,0.0582959641255605,111500,118000,6500,641899,375500.0,DL이앤씨보통주
22176,375500,2021-01-29,0.0708333333333333,120000,111500,-8500,1105949,375500.0,DL이앤씨보통주
22177,375500,2021-01-27,0.0711462450592885,126500,117500,-9000,1082796,375500.0,DL이앤씨보통주
22178,375500,2021-01-25,0.0458333333333333,120000,127500,7500,3005049,375500.0,DL이앤씨보통주
22179,375500,2021-02-01,0.0582959641255605,111500,118000,6500,641899,375500.0,DL이앤씨보통주
22180,375500,2021-01-29,0.0708333333333333,120000,111500,-8500,1105949,375500.0,DL이앤씨보통주
22181,375500,2021-01-27,0.0711462450592885,126500,117500,-9000,1082796,375500.0,DL이앤씨보통주
22182,375500,2021-01-25,0.0458333333333333,120000,127500,7500,3005049,375500.0,DL이앤씨보통주
22183,375500,2021-02-01,0.0582959641255605,111500,118000,6500,641899,375500.0,DL이앤씨보통주
22184,375500,2021-01-29,0.0708333333333333,120000,111500,-8500,1105949,375500.0,DL이앤씨보통주
22185,375500,2021-01-27,0.0711462450592885,126500,117500,-9000,1082796,375500.0,DL이앤씨보통주
22186,375500,2021-01-25,0.0458333333333333,120000,127500,7500,3005049,375500.0,DL이앤씨보통주
22187,375500,2021-02-01,0.0582959641255605,111500,118000,6500,641899,375500.0,DL이앤씨보통주
22188,375500,2021-01-29,0.0708333333333333,120000,111500,-8500,1105949,375500.0,DL이앤씨보통주
22189,375500,2021-01-27,0.0711462450592885,126500,117500,-9000,1082796,375500.0,DL이앤씨보통주
22190,375500,2021-01-25,0.0458333333333333,120000,127500,7500,3005049,375500.0,DL이앤씨보통주
22191,375500,2021-02-01,0.0582959641255605,111500,118000,6500,641899,375500.0,DL이앤씨보통주
22192,375500,2021-01-29,0.0708333333333333,120000,111500,-8500,1105949,375500.0,DL이앤씨보통주
22193,375500,2021-01-27,0.0711462450592885,126500,117500,-9000,1082796,375500.0,DL이앤씨보통주
22194,375500,2021-01-25,0.0458333333333333,120000,127500,7500,3005049,375500.0,DL이앤씨보통주
22195,375500,2021-02-01,0.0582959641255605,111500,118000,6500,641899,375500.0,DL이앤씨보통주
22196,375500,2021-01-29,0.0708333333333333,120000,111500,-8500,1105949,375500.0,DL이앤씨보통주
22197,375500,2021-01-27,0.0711462450592885,126500,117500,-9000,1082796,375500.0,DL이앤씨보통주
22198,375500,2021-01-25,0.0458333333333333,120000,127500,7500,3005049,375500.0,DL이앤씨보통주
22199,375500,2021-02-01,0.0582959641255605,111500,118000,6500,641899,375500.0,DL이앤씨보통주
22200,375500,2021-01-29,0.0708333333333333,120000,111500,-8500,1105949,375500.0,DL이앤씨보통주
22201,375500,2021-01-27,0.0711462450592885,126500,117500,-9000,1082796,375500.0,DL이앤씨보통주
22202,375500,2021-01-25,0.0458333333333333,120000,127500,7500,3005049,375500.0,DL이앤씨보통주
22203,375500,2021-02-01,0.0582959641255605,111500,118000,6500,641899,375500.0,DL이앤씨보통주
22204,375500,2021-01-29,0.0708333333333333,120000,111500,-8500,1105949,375500.0,DL이앤씨보통주
22205,375500,2021-01-27,0.0711462450592885,126500,117500,-9000,1082796,375500.0,DL이앤씨보통주
22206,375500,2021-01-25,0.0458333333333333,120000,127500,7500,3005049,375500.0,DL이앤씨보통주
22207,375500,2021-02-01,0.0582959641255605,111500,118000,6500,641899,375500.0,DL이앤씨보통주
22208,375500,2021-01-29,0.0708333333333333,120000,111500,-8500,1105949,375500.0,DL이앤씨보통주
22209,375500,2021-01-27,0.0711462450592885,126500,117500,-9000,1082796,375500.0,DL이앤씨보통주
22210,375500,2021-01-25,0.0458333333333333,120000,127500,7500,3005049,375500.0,DL이앤씨보통주
22211,375500,2021-02-01,0.0582959641255605,111500,118000,6500,641899,375500.0,DL이앤씨보통주
22212,375500,2021-01-29,0.0708333333333333,120000,111500,-8500,1105949,375500.0,DL이앤씨보통주
22213,375500,2021-01-27,0.0711462450592885,126500,117500,-9000,1082796,375500.0,DL이앤씨보통주
22214,375500,2021-01-25,0.0458333333333333,120000,127500,7500,3005049,375500.0,DL이앤씨보통주
22215,375500,2021-02-01,0.0582959641255605,111500,118000,6500,641899,375500.0,DL이앤씨보통주
22216,375500,2021-01-29,0.0708333333333333,120000,111500,-8500,1105949,375500.0,DL이앤씨보통주
22217,375500,2021-01-27,0.0711462450592885,126500,117500,-9000,1082796,375500.0,DL이앤씨보통주
22218,375500,2021-01-25,0.0458333333333333,120000,127500,7500,3005049,375500.0,DL이앤씨보통주
22219,375500,2021-02-01,0.0582959641255605,111500,118000,6500,641899,375500.0,DL이앤씨보통주
22220,375500,2021-01-29,0.0708333333333333,120000,111500,-8500,1105949,375500.0,DL이앤씨보통주
22221,375500,2021-01-27,0.0711462450592885,126500,117500,-9000,1082796,375500.0,DL이앤씨보통주
22222,375500,2021-01-25,0.0458333333333333,120000,127500,7500,3005049,375500.0,DL이앤씨보통주
22223,375500,2021-02-01,0.0582959641255605,111500,118000,6500,641899,375500.0,DL이앤씨보통주
22224,375500,2021-01-29,0.0708333333333333,120000,111500,-8500,1105949,375500.0,DL이앤씨보통주
22225,375500,2021-01-27,0.0711462450592885,126500,117500,-9000,1082796,375500.0,DL이앤씨보통주
22226,375500,2021-01-25,0.0458333333333333,120000,127500,7500,3005049,375500.0,DL이앤씨보통주
22227,375500,2021-02-01,0.0582959641255605,111500,118000,6500,641899,375500.0,DL이앤씨보통주
22228,375500,2021-01-29,0.0708333333333333,120000,111500,-8500,1105949,375500.0,DL이앤씨보통주
22229,375500,2021-01-27,0.0711462450592885,126500,117500,-9000,1082796,375500.0,DL이앤씨보통주
22230,375500,2021-01-25,0.0458333333333333,120000,127500,7500,3005049,375500.0,DL이앤씨보통주
22231,375500,2021-02-01,0.0582959641255605,111500,118000,6500,641899,375500.0,DL이앤씨보통주
22232,375500,2021-01-29,0.0708333333333333,120000,111500,-8500,1105949,375500.0,DL이앤씨보통주
22233,375500,2021-01-27,0.0711462450592885,126500,117500,-9000,1082796,375500.0,DL이앤씨보통주
22234,375500,2021-01-25,0.0458333333333333,120000,127500,7500,3005049,375500.0,DL이앤씨보통주
22235,375500,2021-02-01,0.0582959641255605,111500,118000,6500,641899,375500.0,DL이앤씨보통주
22236,375500,2021-01-29,0.0708333333333333,120000,111500,-8500,1105949,375500.0,DL이앤씨보통주
22237,375500,2021-01-27,0.0711462450592885,126500,117500,-9000,1082796,375500.0,DL이앤씨보통주
22238,375500,2021-01-25,0.0458333333333333,120000,127500,7500,3005049,375500.0,DL이앤씨보통주
22239,375500,2021-02-01,0.0582959641255605,111500,118000,6500,641899,375500.0,DL이앤씨보통주
22240,375500,2021-01-29,0.0708333333333333,120000,111500,-8500,1105949,375500.0,DL이앤씨보통주
22241,375500,2021-01-27,0.0711462450592885,126500,117500,-9000,1082796,375500.0,DL이앤씨보통주
22242,375500,2021-01-25,0.0458333333333333,120000,127500,7500,3005049,375500.0,DL이앤씨보통주
22243,375500,2021-02-01,0.0582959641255605,111500,118000,6500,641899,375500.0,DL이앤씨보통주
22244,375500,2021-01-29,0.0708333333333333,120000,111500,-8500,1105949,375500.0,DL이앤씨보통주
22245,375500,2021-01-27,0.0711462450592885,126500,117500,-9000,1082796,375500.0,DL이앤씨보통주
22246,375500,2021-01-25,0.0458333333333333,120000,127500,7500,3005049,375500.0,DL이앤씨보통주
22247,375500,2021-02-01,0.0582959641255605,111500,118000,6500,641899,375500.0,DL이앤씨보통주
22248,375500,2021-01-29,0.0708333333333333,120000,111500,-8500,1105949,375500.0,DL이앤씨보통주
22249,375500,2021-01-27,0.0711462450592885,126500,117500,-9000,1082796,375500.0,DL이앤씨보통주
22250,375500,2021-01-25,0.0458333333333333,120000,127500,7500,3005049,375500.0,DL이앤씨보통주
22251,375500,2021-02-01,0.0582959641255605,111500,118000,6500,641899,375500.0,DL이앤씨보통주
22252,375500,2021-01-29,0.0708333333333333,120000,111500,-8500,1105949,375500.0,DL이앤씨보통주
22253,375500,2021-01-27,0.0711462450592885,126500,117500,-9000,1082796,375500.0,DL이앤씨보통주
22254,375500,2021-01-25,0.0458333333333333,120000,127500,7500,3005049,375500.0,DL이앤씨보통주
22255,375500,2021-02-01,0.0582959641255605,111500,118000,6500,641899,375500.0,DL이앤씨보통주
22256,375500,2021-01-29,0.0708333333333333,120000,111500,-8500,1105949,375500.0,DL이앤씨보통주
22257,375500,2021-01-27,0.0711462450592885,126500,117500,-9000,1082796,375500.0,DL이앤씨보통주
22258,375500,2021-01-25,0.0458333333333333,120000,127500,7500,3005049,375500.0,DL이앤씨보통주
22259,375500,2021-02-01,0.0582959641255605,111500,118000,6500,641899,375500.0,DL이앤씨보통주
22260,375500,2021-01-29,0.0708333333333333,120000,111500,-8500,1105949,375500.0,DL이앤씨보통주
22261,375500,2021-01-27,0.0711462450592885,126500,117500,-9000,1082796,375500.0,DL이앤씨보통주
22262,375500,2021-01-25,0.0458333333333333,120000,127500,7500,3005049,375500.0,DL이앤씨보통주
22263,375500,2021-02-01,0.0582959641255605,111500,118000,6500,641899,375500.0,DL이앤씨보통주
22264,375500,2021-01-29,0.0708333333333333,120000,111500,-8500,1105949,375500.0,DL이앤씨보통주
22265,375500,2021-01-27,0.0711462450592885,126500,117500,-9000,1082796,375500.0,DL이앤씨보통주
22266,375500,2021-01-25,0.0458333333333333,120000,127500,7500,3005049,375500.0,DL이앤씨보통주
22267,375500,2021-02-01,0.0582959641255605,111500,118000,6500,641899,375500.0,DL이앤씨보통주
22268,375500,2021-01-29,0.0708333333333333,120000,111500,-8500,1105949,375500.0,DL이앤씨보통주
22269,375500,2021-01-27,0.0711462450592885,126500,117500,-9000,1082796,375500.0,DL이앤씨보통주
22270,375500,2021-01-25,0.0458333333333333,120000,127500,7500,3005049,375500.0,DL이앤씨보통주
22271,375500,2021-02-01,0.0582959641255605,111500,118000,6500,641899,375500.0,DL이앤씨보통주
22272,375500,2021-01-29,0.0708333333333333,120000,111500,-8500,1105949,375500.0,DL이앤씨보통주
22273,375500,2021-01-27,0.0711462450592885,126500,117500,-9000,1082796,375500.0,DL이앤씨보통주
22274,375500,2021-01-25,0.0458333333333333,120000,127500,7500,3005049,375500.0,DL이앤씨보통주
22275,375500,2021-02-01,0.0582959641255605,111500,118000,6500,641899,375500.0,DL이앤씨보통주
22276,375500,2021-01-29,0.0708333333333333,120000,111500,-8500,1105949,375500.0,DL이앤씨보통주
22277,375500,2021-01-27,0.0711462450592885,126500,117500,-9000,1082796,375500.0,DL이앤씨보통주
22278,375500,2021-01-25,0.0458333333333333,120000,127500,7500,3005049,375500.0,DL이앤씨보통주
22279,375500,2021-02-01,0.0582959641255605,111500,118000,6500,641899,375500.0,DL이앤씨보통주
22280,375500,2021-01-29,0.0708333333333333,120000,111500,-8500,1105949,375500.0,DL이앤씨보통주
22281,375500,2021-01-27,0.0711462450592885,126500,117500,-9000,1082796,375500.0,DL이앤씨보통주
22282,375500,2021-01-25,0.0458333333333333,120000,127500,7500,3005049,375500.0,DL이앤씨보통주
22283,375500,2021-02-01,0.0582959641255605,111500,118000,6500,641899,375500.0,DL이앤씨보통주
22284,375500,2021-01-29,0.0708333333333333,120000,111500,-8500,1105949,375500.0,DL이앤씨보통주
22285,375500,2021-01-27,0.0711462450592885,126500,117500,-9000,1082796,375500.0,DL이앤씨보통주
22286,375500,2021-01-25,0.0458333333333333,120000,127500,7500,3005049,375500.0,DL이앤씨보통주
22287,375500,2021-02-01,0.0582959641255605,111500,118000,6500,641899,375500.0,DL이앤씨보통주
22288,375500,2021-01-29,0.0708333333333333,120000,111500,-8500,1105949,375500.0,DL이앤씨보통주
22289,375500,2021-01-27,0.0711462450592885,126500,117500,-9000,1082796,375500.0,DL이앤씨보통주
22290,375500,2021-01-25,0.0458333333333333,120000,127500,7500,3005049,375500.0,DL이앤씨보통주
22291,375500,2021-02-01,0.0582959641255605,111500,118000,6500,641899,375500.0,DL이앤씨보통주
22292,375500,2021-01-29,0.0708333333333333,120000,111500,-8500,1105949,375500.0,DL이앤씨보통주
22293,375500,2021-01-27,0.0711462450592885,126500,117500,-9000,1082796,375500.0,DL이앤씨보통주
22294,375500,2021-01-25,0.0458333333333333,120000,127500,7500,3005049,375500.0,DL이앤씨보통주
22295,375500,2021-02-01,0.0582959641255605,111500,118000,6500,641899,375500.0,DL이앤씨보통주
22296,375500,2021-01-29,0.0708333333333333,120000,111500,-8500,1105949,375500.0,DL이앤씨보통주
22297,375500,2021-01-27,0.0711462450592885,126500,117500,-9000,1082796,375500.0,DL이앤씨보통주
22298,375500,2021-01-25,0.0458333333333333,120000,127500,7500,3005049,375500.0,DL이앤씨보통주
22299,375500,2021-02-01,0.0582959641255605,111500,118000,6500,641899,375500.0,DL이앤씨보통주
22300,375500,2021-01-29,0.0708333333333333,120000,111500,-8500,1105949,375500.0,DL이앤씨보통주
22301,375500,2021-01-27,0.0711462450592885,126500,117500,-9000,1082796,375500.0,DL이앤씨보통주
22302,375500,2021-01-25,0.0458333333333333,120000,127500,7500,3005049,375500.0,DL이앤씨보통주
22303,375500,2021-02-01,0.0582959641255605,111500,118000,6500,641899,375500.0,DL이앤씨보통주
22304,375500,2021-01-29,0.0708333333333333,120000,111500,-8500,1105949,375500.0,DL이앤씨보통주
22305,375500,2021-01-27,0.0711462450592885,126500,117500,-9000,1082796,375500.0,DL이앤씨보통주
22306,375500,2021-01-25,0.0458333333333333,120000,127500,7500,3005049,375500.0,DL이앤씨보통주
22307,375500,2021-02-01,0.0582959641255605,111500,118000,6500,641899,375500.0,DL이앤씨보통주
22308,375500,2021-01-29,0.0708333333333333,120000,111500,-8500,1105949,375500.0,DL이앤씨보통주
22309,375500,2021-01-27,0.0711462450592885,126500,117500,-9000,1082796,375500.0,DL이앤씨보통주
22310,375500,2021-01-25,0.0458333333333333,120000,127500,7500,3005049,375500.0,DL이앤씨보통주
22311,375500,2021-02-01,0.0582959641255605,111500,118000,6500,641899,375500.0,DL이앤씨보통주
22312,375500,2021-01-29,0.0708333333333333,120000,111500,-8500,1105949,375500.0,DL이앤씨보통주
22313,375500,2021-01-27,0.0711462450592885,126500,117500,-9000,1082796,375500.0,DL이앤씨보통주
22314,375500,2021-01-25,0.0458333333333333,120000,127500,7500,3005049,375500.0,DL이앤씨보통주
22315,375500,2021-02-01,0.0582959641255605,111500,118000,6500,641899,375500.0,DL이앤씨보통주
22316,375500,2021-01-29,0.0708333333333333,120000,111500,-8500,1105949,375500.0,DL이앤씨보통주
22317,375500,2021-01-27,0.0711462450592885,126500,117500,-9000,1082796,375500.0,DL이앤씨보통주
22318,375500,2021-01-25,0.0458333333333333,120000,127500,7500,3005049,375500.0,DL이앤씨보통주
22319,375500,2021-02-01,0.0582959641255605,111500,118000,6500,641899,375500.0,DL이앤씨보통주
22320,375500,2021-01-29,0.0708333333333333,120000,111500,-8500,1105949,375500.0,DL이앤씨보통주
22321,375500,2021-01-27,0.0711462450592885,126500,117500,-9000,1082796,375500.0,DL이앤씨보통주
22322,375500,2021-01-25,0.0458333333333333,120000,127500,7500,3005049,375500.0,DL이앤씨보통주
22323,375500,2021-02-01,0.0582959641255605,111500,118000,6500,641899,375500.0,DL이앤씨보통주
22324,375500,2021-01-29,0.0708333333333333,120000,111500,-8500,1105949,375500.0,DL이앤씨보통주
22325,375500,2021-01-27,0.0711462450592885,126500,117500,-9000,1082796,375500.0,DL이앤씨보통주
22326,375500,2021-01-25,0.0458333333333333,120000,127500,7500,3005049,375500.0,DL이앤씨보통주
22327,375500,2021-02-01,0.0582959641255605,111500,118000,6500,641899,375500.0,DL이앤씨보통주
22328,375500,2021-01-29,0.0708333333333333,120000,111500,-8500,1105949,375500.0,DL이앤씨보통주
22329,375500,2021-01-27,0.0711462450592885,126500,117500,-9000,1082796,375500.0,DL이앤씨보통주
22330,375500,2021-01-25,0.0458333333333333,120000,127500,7500,3005049,375500.0,DL이앤씨보통주
22331,375500,2021-02-01,0.0582959641255605,111500,118000,6500,641899,375500.0,DL이앤씨보통주
22332,375500,2021-01-29,0.0708333333333333,120000,111500,-8500,1105949,375500.0,DL이앤씨보통주
22333,375500,2021-01-27,0.0711462450592885,126500,117500,-9000,1082796,375500.0,DL이앤씨보통주
22334,375500,2021-01-25,0.0458333333333333,120000,127500,7500,3005049,375500.0,DL이앤씨보통주
22335,375500,2021-02-01,0.0582959641255605,111500,118000,6500,641899,375500.0,DL이앤씨보통주
22336,375500,2021-01-29,0.0708333333333333,120000,111500,-8500,1105949,375500.0,DL이앤씨보통주
22337,375500,2021-01-27,0.0711462450592885,126500,117500,-9000,1082796,375500.0,DL이앤씨보통주
22338,375500,2021-01-25,0.0458333333333333,120000,127500,7500,3005049,375500.0,DL이앤씨보통주
22339,375500,2021-02-01,0.0582959641255605,111500,118000,6500,641899,375500.0,DL이앤씨보통주
22340,375500,2021-01-29,0.0708333333333333,120000,111500,-8500,1105949,375500.0,DL이앤씨보통주
22341,375500,2021-01-27,0.0711462450592885,126500,117500,-9000,1082796,375500.0,DL이앤씨보통주
22342,375500,2021-01-25,0.0458333333333333,120000,127500,7500,3005049,375500.0,DL이앤씨보통주
22343,375500,2021-02-01,0.0582959641255605,111500,118000,6500,641899,375500.0,DL이앤씨보통주
22344,375500,2021-01-29,0.0708333333333333,120000,111500,-8500,1105949,375500.0,DL이앤씨보통주
22345,375500,2021-01-27,0.0711462450592885,126500,117500,-9000,1082796,375500.0,DL이앤씨보통주
22346,375500,2021-01-25,0.0458333333333333,120000,127500,7500,3005049,375500.0,DL이앤씨보통주
22347,375500,2021-02-01,0.0582959641255605,111500,118000,6500,641899,375500.0,DL이앤씨보통주
22348,375500,2021-01-29,0.0708333333333333,120000,111500,-8500,1105949,375500.0,DL이앤씨보통주
22349,375500,2021-01-27,0.0711462450592885,126500,117500,-9000,1082796,375500.0,DL이앤씨보통주
22350,375500,2021-01-25,0.0458333333333333,120000,127500,7500,3005049,375500.0,DL이앤씨보통주
22351,375500,2021-02-01,0.0582959641255605,111500,118000,6500,641899,375500.0,DL이앤씨보통주
22352,375500,2021-01-29,0.0708333333333333,120000,111500,-8500,1105949,375500.0,DL이앤씨보통주
22353,375500,2021-01-27,0.0711462450592885,126500,117500,-9000,1082796,375500.0,DL이앤씨보통주
22354,375500,2021-01-25,0.0458333333333333,120000,127500,7500,3005049,375500.0,DL이앤씨보통주
22355,375500,2021-02-01,0.0582959641255605,111500,118000,6500,641899,375500.0,DL이앤씨보통주
22356,375500,2021-01-29,0.0708333333333333,120000,111500,-8500,1105949,375500.0,DL이앤씨보통주
22357,375500,2021-01-27,0.0711462450592885,126500,117500,-9000,1082796,375500.0,DL이앤씨보통주
22358,375500,2021-01-25,0.0458333333333333,120000,127500,7500,3005049,375500.0,DL이앤씨보통주
22359,375500,2021-02-01,0.0582959641255605,111500,118000,6500,641899,375500.0,DL이앤씨보통주
22360,375500,2021-01-29,0.0708333333333333,120000,111500,-8500,1105949,375500.0,DL이앤씨보통주
22361,375500,2021-01-27,0.0711462450592885,126500,117500,-9000,1082796,375500.0,DL이앤씨보통주
22362,375500,2021-01-25,0.0458333333333333,120000,127500,7500,3005049,375500.0,DL이앤씨보통주
22363,375500,2021-02-01,0.0582959641255605,111500,118000,6500,641899,375500.0,DL이앤씨보통주
22364,375500,2021-01-29,0.0708333333333333,120000,111500,-8500,1105949,375500.0,DL이앤씨보통주
22365,375500,2021-01-27,0.0711462450592885,126500,117500,-9000,1082796,375500.0,DL이앤씨보통주
22366,375500,2021-01-25,0.0458333333333333,120000,127500,7500,3005049,375500.0,DL이앤씨보통주
22367,375500,2021-02-01,0.0582959641255605,111500,118000,6500,641899,375500.0,DL이앤씨보통주
22368,375500,2021-01-29,0.0708333333333333,120000,111500,-8500,1105949,375500.0,DL이앤씨보통주
22369,375500,2021-01-27,0.0711462450592885,126500,117500,-9000,1082796,375500.0,DL이앤씨보통주
22370,375500,2021-01-25,0.0458333333333333,120000,127500,7500,3005049,375500.0,DL이앤씨보통주
22371,375500,2021-02-01,0.0582959641255605,111500,118000,6500,641899,375500.0,DL이앤씨보통주
22372,375500,2021-01-29,0.0708333333333333,120000,111500,-8500,1105949,375500.0,DL이앤씨보통주
22373,375500,2021-01-27,0.0711462450592885,126500,117500,-9000,1082796,375500.0,DL이앤씨보통주
22374,375500,2021-01-25,0.0458333333333333,120000,127500,7500,3005049,375500.0,DL이앤씨보통주
22375,375500,2021-02-01,0.0582959641255605,111500,118000,6500,641899,375500.0,DL이앤씨보통주
22376,375500,2021-01-29,0.0708333333333333,120000,111500,-8500,1105949,375500.0,DL이앤씨보통주
22377,375500,2021-01-27,0.0711462450592885,126500,117500,-9000,1082796,375500.0,DL이앤씨보통주
22378,375500,2021-01-25,0.0458333333333333,120000,127500,7500,3005049,375500.0,DL이앤씨보통주
22379,375500,2021-02-01,0.0582959641255605,111500,118000,6500,641899,375500.0,DL이앤씨보통주
22380,375500,2021-01-29,0.0708333333333333,120000,111500,-8500,1105949,375500.0,DL이앤씨보통주
22381,375500,2021-01-27,0.0711462450592885,126500,117500,-9000,1082796,375500.0,DL이앤씨보통주
22382,375500,2021-01-25,0.0458333333333333,120000,127500,7500,3005049,375500.0,DL이앤씨보통주
22383,375500,2021-02-01,0.0582959641255605,111500,118000,6500,641899,375500.0,DL이앤씨보통주
22384,375500,2021-01-29,0.0708333333333333,120000,111500,-8500,1105949,375500.0,DL이앤씨보통주
22385,375500,2021-01-27,0.0711462450592885,126500,117500,-9000,1082796,375500.0,DL이앤씨보통주
22386,375500,2021-01-25,0.0458333333333333,120000,127500,7500,3005049,375500.0,DL이앤씨보통주
22387,375500,2021-02-01,0.0582959641255605,111500,118000,6500,641899,375500.0,DL이앤씨보통주
22388,375500,2021-01-29,0.0708333333333333,120000,111500,-8500,1105949,375500.0,DL이앤씨보통주
22389,375500,2021-01-27,0.0711462450592885,126500,117500,-9000,1082796,375500.0,DL이앤씨보통주
22390,375500,2021-01-25,0.0458333333333333,120000,127500,7500,3005049,375500.0,DL이앤씨보통주
22391,375500,2021-02-01,0.0582959641255605,111500,118000,6500,641899,375500.0,DL이앤씨보통주
22392,375500,2021-01-29,0.0708333333333333,120000,111500,-8500,1105949,375500.0,DL이앤씨보통주
22393,375500,2021-01-27,0.0711462450592885,126500,117500,-9000,1082796,375500.0,DL이앤씨보통주
22394,375500,2021-01-25,0.0458333333333333,120000,127500,7500,3005049,375500.0,DL이앤씨보통주
22395,375500,2021-02-01,0.0582959641255605,111500,118000,6500,641899,375500.0,DL이앤씨보통주
22396,375500,2021-01-29,0.0708333333333333,120000,111500,-8500,1105949,375500.0,DL이앤씨보통주
22397,375500,2021-01-27,0.0711462450592885,126500,117500,-9000,1082796,375500.0,DL이앤씨보통주
22398,375500,2021-01-25,0.0458333333333333,120000,127500,7500,3005049,375500.0,DL이앤씨보통주
22399,375500,2021-02-01,0.0582959641255605,111500,118000,6500,641899,375500.0,DL이앤씨보통주
22400,375500,2021-01-29,0.0708333333333333,120000,111500,-8500,1105949,375500.0,DL이앤씨보통주
22401,375500,2021-01-27,0.0711462450592885,126500,117500,-9000,1082796,375500.0,DL이앤씨보통주
22402,375500,2021-01-25,0.0458333333333333,120000,127500,7500,3005049,375500.0,DL이앤씨보통주
22403,375500,2021-02-01,0.0582959641255605,111500,118000,6500,641899,375500.0,DL이앤씨보통주
22404,375500,2021-01-29,0.0708333333333333,120000,111500,-8500,1105949,375500.0,DL이앤씨보통주
22405,375500,2021-01-27,0.0711462450592885,126500,117500,-9000,1082796,375500.0,DL이앤씨보통주
22406,375500,2021-01-25,0.0458333333333333,120000,127500,7500,3005049,375500.0,DL이앤씨보통주
22407,375500,2021-02-01,0.0582959641255605,111500,118000,6500,641899,375500.0,DL이앤씨보통주
22408,375500,2021-01-29,0.0708333333333333,120000,111500,-8500,1105949,375500.0,DL이앤씨보통주
22409,375500,2021-01-27,0.0711462450592885,126500,117500,-9000,1082796,375500.0,DL이앤씨보통주
22410,375500,2021-01-25,0.0458333333333333,120000,127500,7500,3005049,375500.0,DL이앤씨보통주
22411,375500,2021-02-01,0.0582959641255605,111500,118000,6500,641899,375500.0,DL이앤씨보통주
22412,375500,2021-01-29,0.0708333333333333,120000,111500,-8500,1105949,375500.0,DL이앤씨보통주
22413,375500,2021-01-27,0.0711462450592885,126500,117500,-9000,1082796,375500.0,DL이앤씨보통주
22414,375500,2021-01-25,0.0458333333333333,120000,127500,7500,3005049,375500.0,DL이앤씨보통주
22415,375500,2021-02-01,0.0582959641255605,111500,118000,6500,641899,375500.0,DL이앤씨보통주
22416,375500,2021-01-29,0.0708333333333333,120000,111500,-8500,1105949,375500.0,DL이앤씨보통주
22417,375500,2021-01-27,0.0711462450592885,126500,117500,-9000,1082796,375500.0,DL이앤씨보통주
22418,375500,2021-01-25,0.0458333333333333,120000,127500,7500,3005049,375500.0,DL이앤씨보통주
22419,375500,2021-02-01,0.0582959641255605,111500,118000,6500,641899,375500.0,DL이앤씨보통주
22420,375500,2021-01-29,0.0708333333333333,120000,111500,-8500,1105949,375500.0,DL이앤씨보통주
22421,375500,2021-01-27,0.0711462450592885,126500,117500,-9000,1082796,375500.0,DL이앤씨보통주
22422,375500,2021-01-25,0.0458333333333333,120000,127500,7500,3005049,375500.0,DL이앤씨보통주
22423,375500,2021-02-01,0.0582959641255605,111500,118000,6500,641899,375500.0,DL이앤씨보통주
22424,375500,2021-01-29,0.0708333333333333,120000,111500,-8500,1105949,375500.0,DL이앤씨보통주
22425,375500,2021-01-27,0.0711462450592885,126500,117500,-9000,1082796,375500.0,DL이앤씨보통주
22426,375500,2021-01-25,0.0458333333333333,120000,127500,7500,3005049,375500.0,DL이앤씨보통주
22427,375500,2021-02-01,0.0582959641255605,111500,118000,6500,641899,375500.0,DL이앤씨보통주
22428,375500,2021-01-29,0.0708333333333333,120000,111500,-8500,1105949,375500.0,DL이앤씨보통주
22429,375500,2021-01-27,0.0711462450592885,126500,117500,-9000,1082796,375500.0,DL이앤씨보통주
22430,375500,2021-01-25,0.0458333333333333,120000,127500,7500,3005049,375500.0,DL이앤씨보통주
22431,375500,2021-02-01,0.0582959641255605,111500,118000,6500,641899,375500.0,DL이앤씨보통주
22432,375500,2021-01-29,0.0708333333333333,120000,111500,-8500,1105949,375500.0,DL이앤씨보통주
22433,375500,2021-01-27,0.0711462450592885,126500,117500,-9000,1082796,375500.0,DL이앤씨보통주
22434,375500,2021-01-25,0.0458333333333333,120000,127500,7500,3005049,375500.0,DL이앤씨보통주
22435,375500,2021-02-01,0.0582959641255605,111500,118000,6500,641899,375500.0,DL이앤씨보통주
22436,375500,2021-01-29,0.0708333333333333,120000,111500,-8500,1105949,375500.0,DL이앤씨보통주
22437,375500,2021-01-27,0.0711462450592885,126500,117500,-9000,1082796,375500.0,DL이앤씨보통주
22438,375500,2021-01-25,0.0458333333333333,120000,127500,7500,3005049,375500.0,DL이앤씨보통주
22439,375500,2021-02-01,0.0582959641255605,111500,118000,6500,641899,375500.0,DL이앤씨보통주
22440,375500,2021-01-29,0.0708333333333333,120000,111500,-8500,1105949,375500.0,DL이앤씨보통주
22441,375500,2021-01-27,0.0711462450592885,126500,117500,-9000,1082796,375500.0,DL이앤씨보통주
22442,375500,2021-01-25,0.0458333333333333,120000,127500,7500,3005049,375500.0,DL이앤씨보통주
22443,375500,2021-02-01,0.0582959641255605,111500,118000,6500,641899,375500.0,DL이앤씨보통주
22444,375500,2021-01-29,0.0708333333333333,120000,111500,-8500,1105949,375500.0,DL이앤씨보통주
22445,375500,2021-01-27,0.0711462450592885,126500,117500,-9000,1082796,375500.0,DL이앤씨보통주
22446,375500,2021-01-25,0.0458333333333333,120000,127500,7500,3005049,375500.0,DL이앤씨보통주
22447,375500,2021-02-01,0.0582959641255605,111500,118000,6500,641899,375500.0,DL이앤씨보통주
22448,375500,2021-01-29,0.0708333333333333,120000,111500,-8500,1105949,375500.0,DL이앤씨보통주
22449,375500,2021-01-27,0.0711462450592885,126500,117500,-9000,1082796,375500.0,DL이앤씨보통주
22450,375500,2021-01-25,0.0458333333333333,120000,127500,7500,3005049,375500.0,DL이앤씨보통주
22451,375500,2021-02-01,0.0582959641255605,111500,118000,6500,641899,375500.0,DL이앤씨보통주
22452,375500,2021-01-29,0.0708333333333333,120000,111500,-8500,1105949,375500.0,DL이앤씨보통주
22453,375500,2021-01-27,0.0711462450592885,126500,117500,-9000,1082796,375500.0,DL이앤씨보통주
22454,383220,2021-06-01,0.0956618464961067,449500,492500,43000,137800,383220.0,F&F보통주
22455,383220,2021-05-24,0.0787878787878787,412500,445000,32500,175980,383220.0,F&F보통주
22456,383220,2021-05-21,0.1272727272727272,412500,412500,0,554836,383220.0,F&F보통주
22457,383220,2021-05-21,0.1272727272727272,412500,412500,0,554836,383220.0,F&F보통주
22458,383220,2021-05-21,0.1272727272727272,412500,412500,0,554836,383220.0,F&F보통주
22459,383220,2021-05-21,0.1272727272727272,412500,412500,0,554836,383220.0,F&F보통주
22460,383220,2021-05-21,0.1272727272727272,412500,412500,0,554836,383220.0,F&F보통주
22461,383220,2021-05-21,0.1272727272727272,412500,412500,0,554836,383220.0,F&F보통주
22462,383220,2021-05-21,0.1272727272727272,412500,412500,0,554836,383220.0,F&F보통주
22463,383220,2021-05-21,0.1272727272727272,412500,412500,0,554836,383220.0,F&F보통주
22464,383220,2021-05-21,0.1272727272727272,412500,412500,0,554836,383220.0,F&F보통주
22465,383220,2021-05-21,0.1272727272727272,412500,412500,0,554836,383220.0,F&F보통주
22466,383220,2021-05-21,0.1272727272727272,412500,412500,0,554836,383220.0,F&F보통주
22467,383220,2021-05-21,0.1272727272727272,412500,412500,0,554836,383220.0,F&F보통주
22468,383220,2021-05-21,0.1272727272727272,412500,412500,0,554836,383220.0,F&F보통주
22469,383220,2021-05-21,0.1272727272727272,412500,412500,0,554836,383220.0,F&F보통주
22470,383220,2021-05-21,0.1272727272727272,412500,412500,0,554836,383220.0,F&F보통주
22471,383220,2021-05-21,0.1272727272727272,412500,412500,0,554836,383220.0,F&F보통주
22472,383220,2021-05-21,0.1272727272727272,412500,412500,0,554836,383220.0,F&F보통주
22473,383220,2021-05-21,0.1272727272727272,412500,412500,0,554836,383220.0,F&F보통주
22474,383220,2021-05-21,0.1272727272727272,412500,412500,0,554836,383220.0,F&F보통주
22475,383220,2021-05-21,0.1272727272727272,412500,412500,0,554836,383220.0,F&F보통주
22476,383220,2021-05-21,0.1272727272727272,412500,412500,0,554836,383220.0,F&F보통주
22477,383220,2021-05-21,0.1272727272727272,412500,412500,0,554836,383220.0,F&F보통주
22478,383220,2021-05-21,0.1272727272727272,412500,412500,0,554836,383220.0,F&F보통주
22479,383220,2021-05-21,0.1272727272727272,412500,412500,0,554836,383220.0,F&F보통주
22480,383220,2021-05-21,0.1272727272727272,412500,412500,0,554836,383220.0,F&F보통주
22481,383220,2021-05-21,0.1272727272727272,412500,412500,0,554836,383220.0,F&F보통주
22482,383220,2021-05-21,0.1272727272727272,412500,412500,0,554836,383220.0,F&F보통주
22483,383220,2021-05-21,0.1272727272727272,412500,412500,0,554836,383220.0,F&F보통주
22484,383220,2021-05-21,0.1272727272727272,412500,412500,0,554836,383220.0,F&F보통주
22485,383220,2021-05-21,0.1272727272727272,412500,412500,0,554836,383220.0,F&F보통주
22486,383220,2021-05-21,0.1272727272727272,412500,412500,0,554836,383220.0,F&F보통주
22487,383220,2021-05-21,0.1272727272727272,412500,412500,0,554836,383220.0,F&F보통주
22488,383220,2021-05-21,0.1272727272727272,412500,412500,0,554836,383220.0,F&F보통주
22489,383220,2021-05-21,0.1272727272727272,412500,412500,0,554836,383220.0,F&F보통주
22490,383220,2021-05-21,0.1272727272727272,412500,412500,0,554836,383220.0,F&F보통주
22491,383220,2021-05-21,0.1272727272727272,412500,412500,0,554836,383220.0,F&F보통주
22492,383220,2021-05-21,0.1272727272727272,412500,412500,0,554836,383220.0,F&F보통주
22493,383220,2021-05-21,0.1272727272727272,412500,412500,0,554836,383220.0,F&F보통주
22494,383220,2021-05-21,0.1272727272727272,412500,412500,0,554836,383220.0,F&F보통주
22495,383220,2021-05-21,0.1272727272727272,412500,412500,0,554836,383220.0,F&F보통주
22496,383220,2021-05-21,0.1272727272727272,412500,412500,0,554836,383220.0,F&F보통주
22497,383220,2021-05-21,0.1272727272727272,412500,412500,0,554836,383220.0,F&F보통주
22498,383220,2021-05-21,0.1272727272727272,412500,412500,0,554836,383220.0,F&F보통주
22499,383220,2021-05-21,0.1272727272727272,412500,412500,0,554836,383220.0,F&F보통주
22500,383220,2021-05-21,0.1272727272727272,412500,412500,0,554836,383220.0,F&F보통주
22501,383220,2021-05-21,0.1272727272727272,412500,412500,0,554836,383220.0,F&F보통주
22502,383220,2021-05-21,0.1272727272727272,412500,412500,0,554836,383220.0,F&F보통주
22503,383220,2021-05-21,0.1272727272727272,412500,412500,0,554836,383220.0,F&F보통주
22504,383220,2021-05-21,0.1272727272727272,412500,412500,0,554836,383220.0,F&F보통주
22505,383220,2021-05-21,0.1272727272727272,412500,412500,0,554836,383220.0,F&F보통주
22506,383220,2021-05-21,0.1272727272727272,412500,412500,0,554836,383220.0,F&F보통주
22507,383220,2021-05-21,0.1272727272727272,412500,412500,0,554836,383220.0,F&F보통주
22508,383220,2021-05-21,0.1272727272727272,412500,412500,0,554836,383220.0,F&F보통주
22509,383220,2021-05-21,0.1272727272727272,412500,412500,0,554836,383220.0,F&F보통주
22510,383220,2021-05-21,0.1272727272727272,412500,412500,0,554836,383220.0,F&F보통주
22511,383220,2021-05-21,0.1272727272727272,412500,412500,0,554836,383220.0,F&F보통주
22512,383220,2021-05-21,0.1272727272727272,412500,412500,0,554836,383220.0,F&F보통주
22513,383220,2021-05-21,0.1272727272727272,412500,412500,0,554836,383220.0,F&F보통주
22514,383220,2021-05-21,0.1272727272727272,412500,412500,0,554836,383220.0,F&F보통주
22515,383220,2021-05-21,0.1272727272727272,412500,412500,0,554836,383220.0,F&F보통주
22516,383220,2021-05-21,0.1272727272727272,412500,412500,0,554836,383220.0,F&F보통주
22517,383220,2021-05-21,0.1272727272727272,412500,412500,0,554836,383220.0,F&F보통주
22518,383220,2021-05-21,0.1272727272727272,412500,412500,0,554836,383220.0,F&F보통주
22519,383220,2021-05-21,0.1272727272727272,412500,412500,0,554836,383220.0,F&F보통주
22520,383220,2021-05-21,0.1272727272727272,412500,412500,0,554836,383220.0,F&F보통주
22521,383220,2021-05-21,0.1272727272727272,412500,412500,0,554836,383220.0,F&F보통주
22522,383220,2021-05-21,0.1272727272727272,412500,412500,0,554836,383220.0,F&F보통주
22523,383220,2021-05-21,0.1272727272727272,412500,412500,0,554836,383220.0,F&F보통주
22524,383220,2021-05-21,0.1272727272727272,412500,412500,0,554836,383220.0,F&F보통주
22525,383220,2021-05-21,0.1272727272727272,412500,412500,0,554836,383220.0,F&F보통주
22526,383220,2021-05-21,0.1272727272727272,412500,412500,0,554836,383220.0,F&F보통주
22527,383220,2021-05-21,0.1272727272727272,412500,412500,0,554836,383220.0,F&F보통주
22528,383220,2021-05-21,0.1272727272727272,412500,412500,0,554836,383220.0,F&F보통주
22529,383220,2021-05-21,0.1272727272727272,412500,412500,0,554836,383220.0,F&F보통주
22530,383220,2021-05-21,0.1272727272727272,412500,412500,0,554836,383220.0,F&F보통주
22531,383220,2021-05-21,0.1272727272727272,412500,412500,0,554836,383220.0,F&F보통주
22532,383220,2021-05-21,0.1272727272727272,412500,412500,0,554836,383220.0,F&F보통주
22533,383220,2021-05-21,0.1272727272727272,412500,412500,0,554836,383220.0,F&F보통주
22534,383220,2021-05-21,0.1272727272727272,412500,412500,0,554836,383220.0,F&F보통주
22535,383220,2021-05-21,0.1272727272727272,412500,412500,0,554836,383220.0,F&F보통주
22536,383220,2021-05-21,0.1272727272727272,412500,412500,0,554836,383220.0,F&F보통주
22537,383220,2021-05-21,0.1272727272727272,412500,412500,0,554836,383220.0,F&F보통주
22538,383220,2021-05-21,0.1272727272727272,412500,412500,0,554836,383220.0,F&F보통주
22539,383220,2021-05-21,0.1272727272727272,412500,412500,0,554836,383220.0,F&F보통주
22540,383220,2021-05-21,0.1272727272727272,412500,412500,0,554836,383220.0,F&F보통주
22541,383220,2021-05-21,0.1272727272727272,412500,412500,0,554836,383220.0,F&F보통주
22542,383220,2021-05-21,0.1272727272727272,412500,412500,0,554836,383220.0,F&F보통주
22543,383220,2021-05-21,0.1272727272727272,412500,412500,0,554836,383220.0,F&F보통주
22544,383220,2021-05-21,0.1272727272727272,412500,412500,0,554836,383220.0,F&F보통주
22545,383220,2021-05-21,0.1272727272727272,412500,412500,0,554836,383220.0,F&F보통주
22546,383220,2021-05-21,0.1272727272727272,412500,412500,0,554836,383220.0,F&F보통주
22547,383220,2021-05-21,0.1272727272727272,412500,412500,0,554836,383220.0,F&F보통주
22548,383220,2021-05-21,0.1272727272727272,412500,412500,0,554836,383220.0,F&F보통주
22549,383220,2021-05-21,0.1272727272727272,412500,412500,0,554836,383220.0,F&F보통주
22550,383220,2021-05-21,0.1272727272727272,412500,412500,0,554836,383220.0,F&F보통주
22551,383220,2021-05-21,0.1272727272727272,412500,412500,0,554836,383220.0,F&F보통주
22552,383220,2021-05-21,0.1272727272727272,412500,412500,0,554836,383220.0,F&F보통주
22553,383220,2021-05-21,0.1272727272727272,412500,412500,0,554836,383220.0,F&F보통주
22554,383220,2021-05-21,0.1272727272727272,412500,412500,0,554836,383220.0,F&F보통주
22555,383220,2021-05-21,0.1272727272727272,412500,412500,0,554836,383220.0,F&F보통주
22556,383220,2021-05-21,0.1272727272727272,412500,412500,0,554836,383220.0,F&F보통주
22557,383220,2021-05-21,0.1272727272727272,412500,412500,0,554836,383220.0,F&F보통주
22558,383220,2021-05-21,0.1272727272727272,412500,412500,0,554836,383220.0,F&F보통주
22559,383220,2021-05-21,0.1272727272727272,412500,412500,0,554836,383220.0,F&F보통주
22560,383220,2021-05-21,0.1272727272727272,412500,412500,0,554836,383220.0,F&F보통주
22561,383220,2021-05-21,0.1272727272727272,412500,412500,0,554836,383220.0,F&F보통주
22562,383220,2021-05-21,0.1272727272727272,412500,412500,0,554836,383220.0,F&F보통주
22563,383220,2021-05-21,0.1272727272727272,412500,412500,0,554836,383220.0,F&F보통주
22564,383220,2021-05-21,0.1272727272727272,412500,412500,0,554836,383220.0,F&F보통주
22565,383220,2021-05-21,0.1272727272727272,412500,412500,0,554836,383220.0,F&F보통주
22566,383220,2021-05-21,0.1272727272727272,412500,412500,0,554836,383220.0,F&F보통주
22567,383220,2021-05-21,0.1272727272727272,412500,412500,0,554836,383220.0,F&F보통주
22568,383220,2021-05-21,0.1272727272727272,412500,412500,0,554836,383220.0,F&F보통주
22569,383220,2021-05-21,0.1272727272727272,412500,412500,0,554836,383220.0,F&F보통주
22570,383220,2021-05-21,0.1272727272727272,412500,412500,0,554836,383220.0,F&F보통주
22571,383220,2021-05-21,0.1272727272727272,412500,412500,0,554836,383220.0,F&F보통주
22572,383220,2021-05-21,0.1272727272727272,412500,412500,0,554836,383220.0,F&F보통주
22573,950210,2021-05-26,0.0547703180212014,28300,29850,1550,835849,950210.0,프레스티지바이오파마KDR
22574,950210,2021-05-04,0.054858934169279,31900,30150,-1750,664558,950210.0,프레스티지바이오파마KDR
22575,950210,2021-05-03,0.0576070901033973,33850,31900,-1950,564073,950210.0,프레스티지바이오파마KDR
22576,950210,2021-04-28,0.0708898944193061,33150,35500,2350,4133708,950210.0,프레스티지바이오파마KDR
22577,950210,2021-04-26,0.1081081081081081,37000,33000,-4000,1623467,950210.0,프레스티지바이오파마KDR
22578,950210,2021-04-22,0.0819423368740516,32950,35650,2700,7643291,950210.0,프레스티지바이오파마KDR
22579,950210,2021-04-16,0.0419354838709677,31000,32300,1300,5614650,950210.0,프레스티지바이오파마KDR
22580,950210,2021-04-15,0.0526315789473684,29450,31000,1550,2446476,950210.0,프레스티지바이오파마KDR
22581,950210,2021-04-09,0.0780669144981412,26900,29000,2100,1817501,950210.0,프레스티지바이오파마KDR
22582,950210,2021-04-06,0.0408921933085501,26900,25800,-1100,761757,950210.0,프레스티지바이오파마KDR
22583,950210,2021-04-05,0.047787610619469,28250,26900,-1350,584687,950210.0,프레스티지바이오파마KDR
22584,950210,2021-03-09,0.1160409556313993,29300,32700,3400,9155017,950210.0,프레스티지바이오파마KDR
22585,950210,2021-03-08,0.0624,31250,29300,-1950,1565709,950210.0,프레스티지바이오파마KDR
22586,950210,2021-03-05,0.0544629349470499,33050,31250,-1800,2016202,950210.0,프레스티지바이오파마KDR
22587,950210,2021-03-04,0.0447976878612716,34600,33050,-1550,1384889,950210.0,프레스티지바이오파마KDR
22588,950210,2021-03-03,0.0520547945205479,36500,34600,-1900,1721501,950210.0,프레스티지바이오파마KDR
22589,950210,2021-03-02,0.0592783505154639,38800,36500,-2300,2681476,950210.0,프레스티지바이오파마KDR
22590,950210,2021-02-25,0.1308823529411764,34000,38450,4450,10523135,950210.0,프레스티지바이오파마KDR
22591,950210,2021-02-24,0.081081081081081,37000,34000,-3000,4947810,950210.0,프레스티지바이오파마KDR
22592,950210,2021-02-22,0.0554089709762532,37900,35800,-2100,3437054,950210.0,프레스티지바이오파마KDR
22593,950210,2021-02-18,0.1541057367829021,44450,37600,-6850,4516835,950210.0,프레스티지바이오파마KDR
22594,950210,2021-02-17,0.0816115702479338,48400,44450,-3950,3173071,950210.0,프레스티지바이오파마KDR
22595,950210,2021-02-09,0.1737089201877934,42600,50000,7400,27039598,950210.0,프레스티지바이오파마KDR
22596,950210,2021-02-08,0.298780487804878,32800,42600,9800,22798386,950210.0,프레스티지바이오파마KDR
22597,950210,2021-02-05,0.1219512195121951,32800,32800,0,41481126,950210.0,프레스티지바이오파마KDR
22598,950210,2021-02-05,0.1219512195121951,32800,32800,0,41481126,950210.0,프레스티지바이오파마KDR
22599,950210,2021-02-05,0.1219512195121951,32800,32800,0,41481126,950210.0,프레스티지바이오파마KDR
22600,950210,2021-02-05,0.1219512195121951,32800,32800,0,41481126,950210.0,프레스티지바이오파마KDR
22601,950210,2021-02-05,0.1219512195121951,32800,32800,0,41481126,950210.0,프레스티지바이오파마KDR
22602,950210,2021-02-05,0.1219512195121951,32800,32800,0,41481126,950210.0,프레스티지바이오파마KDR
22603,950210,2021-02-05,0.1219512195121951,32800,32800,0,41481126,950210.0,프레스티지바이오파마KDR
22604,950210,2021-02-05,0.1219512195121951,32800,32800,0,41481126,950210.0,프레스티지바이오파마KDR
22605,950210,2021-02-05,0.1219512195121951,32800,32800,0,41481126,950210.0,프레스티지바이오파마KDR
22606,950210,2021-02-05,0.1219512195121951,32800,32800,0,41481126,950210.0,프레스티지바이오파마KDR
22607,950210,2021-02-05,0.1219512195121951,32800,32800,0,41481126,950210.0,프레스티지바이오파마KDR
22608,950210,2021-02-05,0.1219512195121951,32800,32800,0,41481126,950210.0,프레스티지바이오파마KDR
22609,950210,2021-02-05,0.1219512195121951,32800,32800,0,41481126,950210.0,프레스티지바이오파마KDR
22610,950210,2021-02-05,0.1219512195121951,32800,32800,0,41481126,950210.0,프레스티지바이오파마KDR
22611,950210,2021-02-05,0.1219512195121951,32800,32800,0,41481126,950210.0,프레스티지바이오파마KDR
22612,950210,2021-02-05,0.1219512195121951,32800,32800,0,41481126,950210.0,프레스티지바이오파마KDR
22613,950210,2021-02-05,0.1219512195121951,32800,32800,0,41481126,950210.0,프레스티지바이오파마KDR
22614,950210,2021-02-05,0.1219512195121951,32800,32800,0,41481126,950210.0,프레스티지바이오파마KDR
22615,950210,2021-02-05,0.1219512195121951,32800,32800,0,41481126,950210.0,프레스티지바이오파마KDR
22616,950210,2021-02-05,0.1219512195121951,32800,32800,0,41481126,950210.0,프레스티지바이오파마KDR
22617,950210,2021-02-05,0.1219512195121951,32800,32800,0,41481126,950210.0,프레스티지바이오파마KDR
22618,950210,2021-02-05,0.1219512195121951,32800,32800,0,41481126,950210.0,프레스티지바이오파마KDR
22619,950210,2021-02-05,0.1219512195121951,32800,32800,0,41481126,950210.0,프레스티지바이오파마KDR
22620,950210,2021-02-05,0.1219512195121951,32800,32800,0,41481126,950210.0,프레스티지바이오파마KDR
22621,950210,2021-02-05,0.1219512195121951,32800,32800,0,41481126,950210.0,프레스티지바이오파마KDR
22622,950210,2021-02-05,0.1219512195121951,32800,32800,0,41481126,950210.0,프레스티지바이오파마KDR
22623,950210,2021-02-05,0.1219512195121951,32800,32800,0,41481126,950210.0,프레스티지바이오파마KDR
22624,950210,2021-02-05,0.1219512195121951,32800,32800,0,41481126,950210.0,프레스티지바이오파마KDR
22625,950210,2021-02-05,0.1219512195121951,32800,32800,0,41481126,950210.0,프레스티지바이오파마KDR
22626,950210,2021-02-05,0.1219512195121951,32800,32800,0,41481126,950210.0,프레스티지바이오파마KDR
22627,950210,2021-02-05,0.1219512195121951,32800,32800,0,41481126,950210.0,프레스티지바이오파마KDR
22628,950210,2021-02-05,0.1219512195121951,32800,32800,0,41481126,950210.0,프레스티지바이오파마KDR
22629,950210,2021-02-05,0.1219512195121951,32800,32800,0,41481126,950210.0,프레스티지바이오파마KDR
22630,950210,2021-02-05,0.1219512195121951,32800,32800,0,41481126,950210.0,프레스티지바이오파마KDR
22631,950210,2021-02-05,0.1219512195121951,32800,32800,0,41481126,950210.0,프레스티지바이오파마KDR
22632,950210,2021-02-05,0.1219512195121951,32800,32800,0,41481126,950210.0,프레스티지바이오파마KDR
22633,950210,2021-02-05,0.1219512195121951,32800,32800,0,41481126,950210.0,프레스티지바이오파마KDR
22634,950210,2021-02-05,0.1219512195121951,32800,32800,0,41481126,950210.0,프레스티지바이오파마KDR
22635,950210,2021-02-05,0.1219512195121951,32800,32800,0,41481126,950210.0,프레스티지바이오파마KDR
22636,950210,2021-02-05,0.1219512195121951,32800,32800,0,41481126,950210.0,프레스티지바이오파마KDR
22637,950210,2021-02-05,0.1219512195121951,32800,32800,0,41481126,950210.0,프레스티지바이오파마KDR
22638,950210,2021-02-05,0.1219512195121951,32800,32800,0,41481126,950210.0,프레스티지바이오파마KDR
22639,950210,2021-02-05,0.1219512195121951,32800,32800,0,41481126,950210.0,프레스티지바이오파마KDR
22640,950210,2021-02-05,0.1219512195121951,32800,32800,0,41481126,950210.0,프레스티지바이오파마KDR
22641,950210,2021-02-05,0.1219512195121951,32800,32800,0,41481126,950210.0,프레스티지바이오파마KDR
22642,950210,2021-02-05,0.1219512195121951,32800,32800,0,41481126,950210.0,프레스티지바이오파마KDR
22643,950210,2021-02-05,0.1219512195121951,32800,32800,0,41481126,950210.0,프레스티지바이오파마KDR
22644,950210,2021-02-05,0.1219512195121951,32800,32800,0,41481126,950210.0,프레스티지바이오파마KDR
22645,950210,2021-02-05,0.1219512195121951,32800,32800,0,41481126,950210.0,프레스티지바이오파마KDR
22646,950210,2021-02-05,0.1219512195121951,32800,32800,0,41481126,950210.0,프레스티지바이오파마KDR
22647,950210,2021-02-05,0.1219512195121951,32800,32800,0,41481126,950210.0,프레스티지바이오파마KDR
22648,950210,2021-02-05,0.1219512195121951,32800,32800,0,41481126,950210.0,프레스티지바이오파마KDR
22649,950210,2021-02-05,0.1219512195121951,32800,32800,0,41481126,950210.0,프레스티지바이오파마KDR
22650,950210,2021-02-05,0.1219512195121951,32800,32800,0,41481126,950210.0,프레스티지바이오파마KDR
22651,950210,2021-02-05,0.1219512195121951,32800,32800,0,41481126,950210.0,프레스티지바이오파마KDR
22652,950210,2021-02-05,0.1219512195121951,32800,32800,0,41481126,950210.0,프레스티지바이오파마KDR
22653,950210,2021-02-05,0.1219512195121951,32800,32800,0,41481126,950210.0,프레스티지바이오파마KDR
22654,950210,2021-02-05,0.1219512195121951,32800,32800,0,41481126,950210.0,프레스티지바이오파마KDR
22655,950210,2021-02-05,0.1219512195121951,32800,32800,0,41481126,950210.0,프레스티지바이오파마KDR
22656,950210,2021-02-05,0.1219512195121951,32800,32800,0,41481126,950210.0,프레스티지바이오파마KDR
22657,950210,2021-02-05,0.1219512195121951,32800,32800,0,41481126,950210.0,프레스티지바이오파마KDR
22658,950210,2021-02-05,0.1219512195121951,32800,32800,0,41481126,950210.0,프레스티지바이오파마KDR
22659,950210,2021-02-05,0.1219512195121951,32800,32800,0,41481126,950210.0,프레스티지바이오파마KDR
22660,950210,2021-02-05,0.1219512195121951,32800,32800,0,41481126,950210.0,프레스티지바이오파마KDR
22661,950210,2021-02-05,0.1219512195121951,32800,32800,0,41481126,950210.0,프레스티지바이오파마KDR
22662,950210,2021-02-05,0.1219512195121951,32800,32800,0,41481126,950210.0,프레스티지바이오파마KDR
22663,950210,2021-02-05,0.1219512195121951,32800,32800,0,41481126,950210.0,프레스티지바이오파마KDR
22664,950210,2021-02-05,0.1219512195121951,32800,32800,0,41481126,950210.0,프레스티지바이오파마KDR
22665,950210,2021-02-05,0.1219512195121951,32800,32800,0,41481126,950210.0,프레스티지바이오파마KDR
22666,950210,2021-02-05,0.1219512195121951,32800,32800,0,41481126,950210.0,프레스티지바이오파마KDR
22667,950210,2021-02-05,0.1219512195121951,32800,32800,0,41481126,950210.0,프레스티지바이오파마KDR
22668,950210,2021-02-05,0.1219512195121951,32800,32800,0,41481126,950210.0,프레스티지바이오파마KDR
22669,950210,2021-02-05,0.1219512195121951,32800,32800,0,41481126,950210.0,프레스티지바이오파마KDR
22670,950210,2021-02-05,0.1219512195121951,32800,32800,0,41481126,950210.0,프레스티지바이오파마KDR
22671,950210,2021-02-05,0.1219512195121951,32800,32800,0,41481126,950210.0,프레스티지바이오파마KDR
22672,950210,2021-02-05,0.1219512195121951,32800,32800,0,41481126,950210.0,프레스티지바이오파마KDR
22673,950210,2021-02-05,0.1219512195121951,32800,32800,0,41481126,950210.0,프레스티지바이오파마KDR
22674,950210,2021-02-05,0.1219512195121951,32800,32800,0,41481126,950210.0,프레스티지바이오파마KDR
22675,950210,2021-02-05,0.1219512195121951,32800,32800,0,41481126,950210.0,프레스티지바이오파마KDR
22676,950210,2021-02-05,0.1219512195121951,32800,32800,0,41481126,950210.0,프레스티지바이오파마KDR
22677,950210,2021-02-05,0.1219512195121951,32800,32800,0,41481126,950210.0,프레스티지바이오파마KDR
22678,950210,2021-02-05,0.1219512195121951,32800,32800,0,41481126,950210.0,프레스티지바이오파마KDR
22679,950210,2021-02-05,0.1219512195121951,32800,32800,0,41481126,950210.0,프레스티지바이오파마KDR
22680,950210,2021-02-05,0.1219512195121951,32800,32800,0,41481126,950210.0,프레스티지바이오파마KDR
22681,950210,2021-02-05,0.1219512195121951,32800,32800,0,41481126,950210.0,프레스티지바이오파마KDR
22682,950210,2021-02-05,0.1219512195121951,32800,32800,0,41481126,950210.0,프레스티지바이오파마KDR
22683,950210,2021-02-05,0.1219512195121951,32800,32800,0,41481126,950210.0,프레스티지바이오파마KDR
22684,950210,2021-02-05,0.1219512195121951,32800,32800,0,41481126,950210.0,프레스티지바이오파마KDR
22685,950210,2021-02-05,0.1219512195121951,32800,32800,0,41481126,950210.0,프레스티지바이오파마KDR
22686,950210,2021-02-05,0.1219512195121951,32800,32800,0,41481126,950210.0,프레스티지바이오파마KDR
22687,950210,2021-02-05,0.1219512195121951,32800,32800,0,41481126,950210.0,프레스티지바이오파마KDR
22688,950210,2021-02-05,0.1219512195121951,32800,32800,0,41481126,950210.0,프레스티지바이오파마KDR
22689,950210,2021-02-05,0.1219512195121951,32800,32800,0,41481126,950210.0,프레스티지바이오파마KDR
22690,950210,2021-02-05,0.1219512195121951,32800,32800,0,41481126,950210.0,프레스티지바이오파마KDR
22691,950210,2021-02-05,0.1219512195121951,32800,32800,0,41481126,950210.0,프레스티지바이오파마KDR
22692,950210,2021-02-05,0.1219512195121951,32800,32800,0,41481126,950210.0,프레스티지바이오파마KDR
22693,950210,2021-02-05,0.1219512195121951,32800,32800,0,41481126,950210.0,프레스티지바이오파마KDR
22694,950210,2021-02-05,0.1219512195121951,32800,32800,0,41481126,950210.0,프레스티지바이오파마KDR
22695,950210,2021-02-05,0.1219512195121951,32800,32800,0,41481126,950210.0,프레스티지바이오파마KDR
22696,950210,2021-02-05,0.1219512195121951,32800,32800,0,41481126,950210.0,프레스티지바이오파마KDR
22697,950210,2021-02-05,0.1219512195121951,32800,32800,0,41481126,950210.0,프레스티지바이오파마KDR
22698,950210,2021-02-05,0.1219512195121951,32800,32800,0,41481126,950210.0,프레스티지바이오파마KDR
22699,950210,2021-02-05,0.1219512195121951,32800,32800,0,41481126,950210.0,프레스티지바이오파마KDR
22700,950210,2021-02-05,0.1219512195121951,32800,32800,0,41481126,950210.0,프레스티지바이오파마KDR
22701,950210,2021-02-05,0.1219512195121951,32800,32800,0,41481126,950210.0,프레스티지바이오파마KDR
22702,950210,2021-02-05,0.1219512195121951,32800,32800,0,41481126,950210.0,프레스티지바이오파마KDR
22703,950210,2021-02-05,0.1219512195121951,32800,32800,0,41481126,950210.0,프레스티지바이오파마KDR
22704,950210,2021-02-05,0.1219512195121951,32800,32800,0,41481126,950210.0,프레스티지바이오파마KDR
22705,950210,2021-02-05,0.1219512195121951,32800,32800,0,41481126,950210.0,프레스티지바이오파마KDR
22706,950210,2021-02-05,0.1219512195121951,32800,32800,0,41481126,950210.0,프레스티지바이오파마KDR
